,Part,TrialN,PairID,LValue,RValue,ChosenITM,ChoiceRT,Conf,ConfRT,BlockCond,tDDT,lIA_DT,rIA_DT,tGSF,lastFixat,DV,zDV,absDV,zAbsDV,zConf,zChoiceRT,TotVal,ValCh,ValUnCh,Correct,zTotVal,zValCh,zValUnCh,zGSF,zDDT,absDDT,zValR,zValL,ConfSplit,GSFMedSplit,DDTMedSplit,BaseCode,High,Low
0,1,1,49,110,131,0,4261.735,74,1584.966,LESS,-508,2392,1884,4,2,21.0,1.9685577674164243,21.0,2.0952908873087353,0.38883333852157215,1.2284490278498308,241,110,131,1,1.6155472260277064,1.170500554541026,1.9898509427197442,1.3121451823858008,-0.061319474522427676,0.061319474522427676,1.9898509427197442,1.170500554541026,1,1,1,2,1.9898509427197442,1.170500554541026
1,1,2,13,47,50,1,3559.258,54,1864.387,LESS,-504,2188,1684,4,1,3.0,0.28122253820234633,3.0,-1.0476454436543674,-0.6400531140162148,0.6552951027993201,97,47,50,1,-1.2565367313548828,-1.2875506099951286,-1.170500554541026,1.3121451823858008,-0.056456869571037405,0.056456869571037405,-1.170500554541026,-1.2875506099951286,0,1,1,0,-1.2875506099951286,-1.170500554541026
2,1,3,16,50,44,1,3754.464,64,3778.807,LESS,-48,1644,1596,2,1,-6.0,-0.5624450764046927,6.0,-0.5238227218271837,-0.1256098877473213,0.8145644953821521,94,50,44,0,-1.3163718138003533,-1.170500554541026,-1.4046006654492311,-0.3993485337695917,0.49788009488745305,0.49788009488745305,-1.4046006654492311,-1.170500554541026,0,0,1,0,-1.170500554541026,-1.4046006654492311
3,1,4,7,57,50,0,2431.751,84,3064.179,LESS,-2462,3136,674,2,1,-7.0,-0.6561859224721414,7.0,-0.34921514788478913,0.9032765647904656,-0.2646425785367606,107,57,50,0,-1.0570864565366473,-0.8973837584814532,-1.170500554541026,-0.3993485337695917,-2.436701993276573,2.436701993276573,-1.170500554541026,-0.8973837584814532,1,0,0,0,-0.8973837584814532,-1.170500554541026
4,1,5,18,42,50,0,2199.342,44,2850.845,LESS,-1130,1672,542,2,1,8.0,0.7499267685395902,8.0,-0.17460757394239454,-1.1544963402851085,-0.4542660545609781,92,42,50,1,-1.3562618687640005,-1.4826340357519663,-1.170500554541026,-0.3993485337695917,-0.8174545444636141,0.8174545444636141,-1.170500554541026,-1.4826340357519663,0,0,0,0,-1.4826340357519663,-1.170500554541026
5,1,6,51,108,110,0,3269.922,44,3745.039,LESS,-1490,2472,982,2,1,2.0,0.18748169213489754,2.0,-1.222253017596762,-1.1544963402851085,0.4192246491639493,218,108,110,1,1.156811593945765,1.092467184238291,1.170500554541026,-0.3993485337695917,-1.255088990088738,1.255088990088738,1.170500554541026,1.092467184238291,0,0,0,2,1.170500554541026,1.092467184238291
6,1,7,31,78,80,0,6606.698,74,2425.516,LESS,-1170,3474,2304,5,1,2.0,0.18748169213489754,2.0,-1.222253017596762,0.38883333852157215,3.1417141561717847,158,78,80,1,-0.03989005496364707,-0.07803337030273506,0.0,2.1678920404634967,-0.8660805939775168,0.8660805939775168,0.0,-0.07803337030273506,1,1,0,1,-0.07803337030273506,0.0
7,1,8,58,110,92,1,3642.146,74,3030.001,LESS,-1680,3044,1364,2,2,-18.0,-1.6873352292140782,18.0,1.571468165481551,0.38883333852157215,0.7229237689899384,202,110,92,0,0.8376911542365885,1.170500554541026,0.4682002218164104,-0.3993485337695917,-1.4860627252797758,1.4860627252797758,0.4682002218164104,1.170500554541026,1,0,0,2,1.170500554541026,0.4682002218164104
8,1,9,12,50,48,1,5213.48,54,2229.314,LESS,-472,2860,2388,6,1,-2.0,-0.18748169213489754,2.0,-1.222253017596762,-0.6400531140162148,2.0049817576006963,98,50,48,0,-1.2365917038730592,-1.170500554541026,-1.248533924843761,3.023638898541193,-0.017556029959915273,0.017556029959915273,-1.248533924843761,-1.170500554541026,0,1,1,0,-1.170500554541026,-1.248533924843761
9,1,10,54,110,101,1,5511.334,34,1727.761,LESS,752,2000,2752,5,2,-9.0,-0.8436676146070391,9.0,0.0,-1.6689395665540017,2.2480020830946192,211,110,101,0,1.0171964015730004,1.170500554541026,0.8193503881787182,2.1678920404634967,1.4704010851655065,1.4704010851655065,0.8193503881787182,1.170500554541026,0,1,1,2,1.170500554541026,0.8193503881787182
10,1,11,14,46,50,0,2007.957,74,1249.337,LESS,-772,1334,562,2,1,4.0,0.3749633842697951,4.0,-0.8730378697119728,0.38883333852157215,-0.6104178772481151,96,46,50,1,-1.2764817588367063,-1.3265672951464962,-1.170500554541026,-0.3993485337695917,-0.3822514013141853,0.3822514013141853,-1.170500554541026,-1.3265672951464962,1,0,0,0,-1.3265672951464962,-1.170500554541026
11,1,12,22,80,83,1,3124.521,64,1956.342,LESS,-918,2186,1268,4,1,3.0,0.28122253820234633,3.0,-1.0476454436543674,-0.1256098877473213,0.3005913645777361,163,80,83,1,0.05983508244547061,0.0,0.1170500554541026,1.3121451823858008,-0.5597364820399301,0.5597364820399301,0.1170500554541026,0.0,0,1,0,1,0.1170500554541026,0.0
12,1,13,6,50,56,0,1978.076,74,3940.974,LESS,-1050,1608,558,2,1,6.0,0.5624450764046927,6.0,-0.5238227218271837,0.38883333852157215,-0.6347979102377139,106,50,56,1,-1.077031484018471,-1.170500554541026,-0.9364004436328208,-0.3993485337695917,-0.7202024454358088,0.7202024454358088,-0.9364004436328208,-1.170500554541026,1,0,0,0,-1.170500554541026,-0.9364004436328208
13,1,14,13,50,47,1,2508.548,34,2032.978,LESS,-428,1614,1186,3,1,-3.0,-0.28122253820234633,3.0,-1.0476454436543674,-1.6689395665540017,-0.20198358474464526,97,50,47,0,-1.2565367313548828,-1.170500554541026,-1.2875506099951286,0.4563983243081045,0.03593262450537767,0.03593262450537767,-1.2875506099951286,-1.170500554541026,0,1,1,0,-1.170500554541026,-1.2875506099951286
14,1,15,46,110,124,1,3907.246,4,1461.971,LESS,-660,2542,1882,5,1,14.0,1.3123718449442827,14.0,0.8730378697119728,-3.2122692453606816,0.9392199687671416,234,110,124,1,1.4759320336549415,1.170500554541026,1.7167341466601715,2.1678920404634967,-0.2460984626752578,0.2460984626752578,1.7167341466601715,1.170500554541026,0,1,1,2,1.7167341466601715,1.170500554541026
15,1,16,27,91,80,1,3482.062,64,2540.283,LESS,-660,2246,1586,4,1,-11.0,-1.0311493067419364,11.0,0.34921514788478913,-0.1256098877473213,0.5923105632368872,171,91,80,0,0.21939530230005888,0.4291835366650429,0.0,1.3121451823858008,-0.2460984626752578,0.2460984626752578,0.0,0.4291835366650429,0,1,1,1,0.4291835366650429,0.0
16,1,17,40,64,80,0,1823.377,74,2167.7470000000008,LESS,-750,1256,506,2,1,16.0,1.4998535370791803,16.0,1.222253017596762,0.38883333852157215,-0.7610174719477614,144,64,80,1,-0.3191204397091766,-0.6242669624218805,0.0,-0.3993485337695917,-0.3555070740815388,0.3555070740815388,0.0,-0.6242669624218805,1,0,0,1,-0.6242669624218805,0.0
17,1,18,22,83,80,0,5111.944,64,1821.922,LESS,-1778,3340,1562,4,2,-3.0,-0.28122253820234633,3.0,-1.0476454436543674,-0.1256098877473213,1.9221381101447248,163,83,80,0,0.05983508244547061,0.1170500554541026,0.0,1.3121451823858008,-1.6051965465888374,1.6051965465888374,0.0,0.1170500554541026,0,1,0,1,0.1170500554541026,0.0
18,1,19,54,101,110,0,4920.474,54,3188.875,LESS,-2694,3968,1274,4,1,9.0,0.8436676146070391,9.0,0.0,-0.6400531140162148,1.7659169356017552,211,101,110,1,1.0171964015730004,0.8193503881787182,1.170500554541026,1.3121451823858008,-2.7187330804572083,2.7187330804572083,1.170500554541026,0.8193503881787182,0,1,0,2,1.170500554541026,0.8193503881787182
19,1,20,6,56,50,0,1869.935,54,1348.091,LESS,-620,1160,540,2,1,-6.0,-0.5624450764046927,6.0,-0.5238227218271837,-0.6400531140162148,-0.7230306048439251,106,56,50,0,-1.077031484018471,-0.9364004436328208,-1.170500554541026,-0.3993485337695917,-0.19747241316135514,0.19747241316135514,-1.170500554541026,-0.9364004436328208,0,1,1,0,-0.9364004436328208,-1.170500554541026
20,1,21,18,50,42,0,1705.811,84,1299.314,LESS,20,1130,1150,2,2,-8.0,-0.7499267685395902,8.0,-0.17460757394239454,0.9032765647904656,-0.8569400635094614,92,50,42,0,-1.3562618687640005,-1.170500554541026,-1.4826340357519663,-0.3993485337695917,0.5805443790610876,0.5805443790610876,-1.4826340357519663,-1.170500554541026,1,0,1,0,-1.170500554541026,-1.4826340357519663
21,1,22,43,110,117,0,3083.54,54,2248.677,LESS,-1634,2252,618,2,1,7.0,0.6561859224721414,7.0,-0.34921514788478913,-0.6400531140162148,0.2671547951206648,227,110,117,1,1.3363168412821769,1.170500554541026,1.4436173506005987,-0.3993485337695917,-1.4301427683387877,1.4301427683387877,1.4436173506005987,1.170500554541026,0,0,0,2,1.4436173506005987,1.170500554541026
22,1,23,32,77,80,0,2474.714,24,1261.502,LESS,-1258,1954,696,2,1,3.0,0.28122253820234633,3.0,-1.0476454436543674,-2.1833827928228957,-0.22958888698252475,157,77,80,1,-0.05983508244547061,-0.1170500554541026,0.0,-0.3993485337695917,-0.9730579029081027,0.9730579029081027,0.0,-0.1170500554541026,0,1,0,1,-0.1170500554541026,0.0
23,1,24,27,80,91,0,2272.349,74,1373.872,LESS,-728,1536,808,2,1,11.0,1.0311493067419364,11.0,0.34921514788478913,0.38883333852157215,-0.3946993376347831,171,80,91,1,0.21939530230005888,0.0,0.4291835366650429,-0.3993485337695917,-0.32876274684889234,0.32876274684889234,0.4291835366650429,0.0,1,0,0,1,0.4291835366650429,0.0
24,1,25,16,44,50,0,3790.48,64,2175.914,LESS,-616,1952,1336,4,1,6.0,0.5624450764046927,6.0,-0.5238227218271837,-0.1256098877473213,0.8439501005544485,94,44,50,1,-1.3163718138003533,-1.4046006654492311,-1.170500554541026,1.3121451823858008,-0.19260980820996487,0.19260980820996487,-1.170500554541026,-1.4046006654492311,0,1,1,0,-1.4046006654492311,-1.170500554541026
25,1,26,7,50,57,0,2046.062,64,1804.283,LESS,-774,1330,556,2,1,7.0,0.6561859224721414,7.0,-0.34921514788478913,-0.1256098877473213,-0.5793278482307244,107,50,57,1,-1.0570864565366473,-1.170500554541026,-0.8973837584814532,-0.3993485337695917,-0.38468270378988045,0.38468270378988045,-0.8973837584814532,-1.170500554541026,0,0,0,0,-1.170500554541026,-0.8973837584814532
26,1,27,14,50,46,1,3822.251,64,1246.179,LESS,686,1538,2224,3,2,-4.0,-0.3749633842697951,4.0,-0.8730378697119728,-0.1256098877473213,0.8698721924560765,96,50,46,0,-1.2764817588367063,-1.170500554541026,-1.3265672951464962,0.4563983243081045,1.390168103467567,1.390168103467567,-1.3265672951464962,-1.170500554541026,0,1,1,0,-1.170500554541026,-1.3265672951464962
27,1,28,51,110,108,0,3347.54,64,1979.166,LESS,-1556,2496,940,4,1,-2.0,-0.18748169213489754,2.0,-1.222253017596762,-0.1256098877473213,0.4825535002929834,218,110,108,0,1.156811593945765,1.170500554541026,1.092467184238291,1.3121451823858008,-1.3353219717866776,1.3353219717866776,1.092467184238291,1.170500554541026,0,1,0,2,1.170500554541026,1.092467184238291
28,1,29,50,133,110,1,2252.245,54,2859.177,LESS,-236,1374,1138,1,1,-23.0,-2.1560394595513217,23.0,2.444506035193524,-0.6400531140162148,-0.41110227539532973,243,133,110,0,1.6554372809913533,2.0678843130224793,1.170500554541026,-1.2550953918472878,0.26933766217211047,0.26933766217211047,1.170500554541026,2.0678843130224793,0,0,1,2,2.0678843130224793,1.170500554541026
29,1,30,49,131,110,1,2083.424,74,1310.553,LESS,388,964,1352,1,2,-21.0,-1.9685577674164243,21.0,2.0952908873087353,0.38883333852157215,-0.5488440360237237,241,131,110,0,1.6155472260277064,1.9898509427197442,1.170500554541026,-1.2550953918472878,1.0279040345889923,1.0279040345889923,1.170500554541026,1.9898509427197442,1,0,1,2,1.9898509427197442,1.170500554541026
30,1,31,47,126,110,1,4155.502,44,1021.733,LESS,-726,2120,1394,3,2,-16.0,-1.4998535370791803,16.0,1.222253017596762,-1.1544963402851085,1.1417730784310018,236,126,110,0,1.5158220886185887,1.7947675169629065,1.170500554541026,0.4563983243081045,-0.3263314443731972,0.3263314443731972,1.170500554541026,1.7947675169629065,0,1,0,2,1.7947675169629065,1.170500554541026
31,1,32,50,110,133,0,2550.939,84,2476.876,LESS,-610,1748,1138,2,2,23.0,2.1560394595513217,23.0,2.444506035193524,0.9032765647904656,-0.1673965903849491,243,110,133,1,1.6554372809913533,1.170500554541026,2.0678843130224793,-0.3993485337695917,-0.1853159007828795,0.1853159007828795,2.0678843130224793,1.170500554541026,1,0,1,2,2.0678843130224793,1.170500554541026
32,1,33,47,110,126,0,5814.551,64,1875.655,LESS,-2620,3952,1332,3,2,16.0,1.4998535370791803,16.0,1.222253017596762,-0.1256098877473213,2.495398102739449,236,110,126,1,1.5158220886185887,1.170500554541026,1.7947675169629065,0.4563983243081045,-2.6287748888564884,2.6287748888564884,1.7947675169629065,1.170500554541026,0,1,0,2,1.7947675169629065,1.170500554541026
33,1,34,12,48,50,0,1428.2879999999998,94,3195.264,LESS,538,1024,1562,2,2,2.0,0.18748169213489754,2.0,-1.222253017596762,1.417719791059359,-1.0833722409925577,98,48,50,1,-1.2365917038730592,-1.248533924843761,-1.170500554541026,-0.3993485337695917,1.2102517202661272,1.2102517202661272,-1.170500554541026,-1.248533924843761,1,0,1,0,-1.248533924843761,-1.170500554541026
34,1,35,32,80,77,0,1743.991,84,714.693,LESS,-582,1362,780,3,2,-3.0,-0.28122253820234633,3.0,-1.0476454436543674,0.9032765647904656,-0.8257888416781011,157,80,77,0,-0.05983508244547061,0.0,-0.1170500554541026,0.4563983243081045,-0.1512776661231476,0.1512776661231476,-0.1170500554541026,0.0,1,1,1,1,0.0,-0.1170500554541026
35,1,36,43,117,110,1,2329.644,34,2402.523,LESS,-514,1568,1054,3,1,-7.0,-0.6561859224721414,7.0,-0.34921514788478913,-1.6689395665540017,-0.34795210728308645,227,117,110,0,1.3363168412821769,1.4436173506005987,1.170500554541026,0.4563983243081045,-0.06861338194951308,0.06861338194951308,1.170500554541026,1.4436173506005987,0,1,1,2,1.4436173506005987,1.170500554541026
36,1,37,40,80,64,1,3381.75,74,1358.669,LESS,-252,1750,1498,3,2,-16.0,-1.4998535370791803,16.0,1.222253017596762,0.38883333852157215,0.5104655825048964,144,80,64,0,-0.3191204397091766,0.0,-0.6242669624218805,0.4563983243081045,0.2498872423665494,0.2498872423665494,-0.6242669624218805,0.0,1,1,1,1,0.0,-0.6242669624218805
37,1,38,31,80,78,0,2209.993,34,1186.315,LESS,-956,1456,500,2,1,-2.0,-0.18748169213489754,2.0,-1.222253017596762,-1.6689395665540017,-0.4455758590731359,158,80,78,0,-0.03989005496364707,0.0,-0.07803337030273506,-0.3993485337695917,-0.6059312290781376,0.6059312290781376,-0.07803337030273506,0.0,0,0,0,1,0.0,-0.07803337030273506
38,1,39,46,124,110,1,3602.313,64,1465.37,LESS,390,1444,1834,3,2,-14.0,-1.3123718449442827,14.0,0.8730378697119728,-0.1256098877473213,0.6904238575386923,234,124,110,0,1.4759320336549415,1.7167341466601715,1.170500554541026,0.4563983243081045,1.0303353370646873,1.0303353370646873,1.170500554541026,1.7167341466601715,0,1,1,2,1.7167341466601715,1.170500554541026
39,1,40,58,92,110,0,2506.099,84,3023.266,LESS,-294,1550,1256,2,2,18.0,1.6873352292140782,18.0,1.571468165481551,0.9032765647904656,-0.20398173409679268,202,92,110,1,0.8376911542365885,0.4682002218164104,1.170500554541026,-0.3993485337695917,0.19882989037695162,0.19882989037695162,1.170500554541026,0.4682002218164104,1,0,1,2,1.170500554541026,0.4682002218164104
40,1,41,49,110,131,1,1734.284,74,2314.899,MORE,-92,726,634,0,2,21.0,1.9685577674164243,21.0,2.0952908873087353,0.38883333852157215,-0.8337088236141149,241,110,131,0,1.6155472260277064,1.170500554541026,1.9898509427197442,-2.110842249924984,0.4443914404221601,0.4443914404221601,1.9898509427197442,1.170500554541026,1,0,1,2,1.9898509427197442,1.170500554541026
41,1,42,13,47,50,0,6555.37,64,2919.419000000001,MORE,-3882,5110,1228,4,1,3.0,0.28122253820234633,3.0,-1.0476454436543674,-0.1256098877473213,3.0998354260994936,97,47,50,0,-1.2565367313548828,-1.2875506099951286,-1.170500554541026,1.3121451823858008,-4.162926751020118,4.162926751020118,-1.170500554541026,-1.2875506099951286,0,1,0,0,-1.2875506099951286,-1.170500554541026
42,1,43,16,50,44,0,3174.566,64,1513.1989999999996,MORE,-638,1764,1126,4,1,-6.0,-0.5624450764046927,6.0,-0.5238227218271837,-0.1256098877473213,0.3414232895790566,94,50,44,1,-1.3163718138003533,-1.170500554541026,-1.4046006654492311,1.3121451823858008,-0.21935413544261134,0.21935413544261134,-1.4046006654492311,-1.170500554541026,0,1,0,0,-1.170500554541026,-1.4046006654492311
43,1,44,7,57,50,1,2877.579,74,1177.6760000000004,MORE,-352,1472,1120,3,2,-7.0,-0.6561859224721414,7.0,-0.34921514788478913,0.38883333852157215,0.09911035301461986,107,57,50,1,-1.0570864565366473,-0.8973837584814532,-1.170500554541026,0.4563983243081045,0.12832211858179274,0.12832211858179274,-1.170500554541026,-0.8973837584814532,1,1,0,0,-0.8973837584814532,-1.170500554541026
44,1,45,18,42,50,1,1806.31,54,1375.2279999999996,MORE,194,772,966,1,2,8.0,0.7499267685395902,8.0,-0.17460757394239454,-0.6400531140162148,-0.77494250869464,92,42,50,0,-1.3562618687640005,-1.4826340357519663,-1.170500554541026,-1.2550953918472878,0.7920676944465642,0.7920676944465642,-1.170500554541026,-1.4826340357519663,0,0,1,0,-1.4826340357519663,-1.170500554541026
45,1,46,51,108,110,0,3636.816,64,1251.974,MORE,-686,1854,1168,3,1,2.0,0.18748169213489754,2.0,-1.222253017596762,-0.1256098877473213,0.7185749996771787,218,108,110,0,1.156811593945765,1.092467184238291,1.170500554541026,0.4563983243081045,-0.2777053948592946,0.2777053948592946,1.170500554541026,1.092467184238291,0,1,0,2,1.170500554541026,1.092467184238291
46,1,47,31,78,80,1,3650.266,100,1077.556,MORE,24,2008,2032,1,2,2.0,0.18748169213489754,2.0,-1.222253017596762,1.7263857268206952,0.7295489109823596,158,78,80,0,-0.03989005496364707,-0.07803337030273506,0.0,-1.2550953918472878,0.5854069840124778,0.5854069840124778,0.0,-0.07803337030273506,1,0,1,1,-0.07803337030273506,0.0
47,1,48,58,110,92,0,3078.223,74,1222.433,MORE,-364,1728,1364,4,1,-18.0,-1.6873352292140782,18.0,1.571468165481551,0.38883333852157215,0.26281663256232685,202,110,92,1,0.8376911542365885,1.170500554541026,0.4682002218164104,1.3121451823858008,0.11373430372762193,0.11373430372762193,0.4682002218164104,1.170500554541026,1,1,0,2,1.170500554541026,0.4682002218164104
48,1,49,12,50,48,1,1259.268,94,1471.1989999999996,MORE,946,466,1412,1,2,-2.0,-0.18748169213489754,2.0,-1.222253017596762,1.417719791059359,-1.2212763665540167,98,50,48,1,-1.2365917038730592,-1.170500554541026,-1.248533924843761,-1.2550953918472878,1.7062374253079344,1.7062374253079344,-1.248533924843761,-1.170500554541026,1,0,1,0,-1.170500554541026,-1.248533924843761
49,1,50,54,110,101,0,3440.738,24,2589.771,MORE,-1738,2902,1164,4,1,-9.0,-0.8436676146070391,9.0,0.0,-2.1833827928228957,0.5585941386439293,211,110,101,1,1.0171964015730004,1.170500554541026,0.8193503881787182,1.3121451823858008,-1.5565704970749348,1.5565704970749348,0.8193503881787182,1.170500554541026,0,1,0,2,1.170500554541026,0.8193503881787182
50,1,51,14,46,50,1,5698.026999999999,44,1077.134,MORE,-290,1972,1682,3,2,4.0,0.3749633842697951,4.0,-0.8730378697119728,-1.1544963402851085,2.4003256833398297,96,46,50,0,-1.2764817588367063,-1.3265672951464962,-1.170500554541026,0.4563983243081045,0.20369249532834188,0.20369249532834188,-1.170500554541026,-1.3265672951464962,0,1,1,0,-1.3265672951464962,-1.170500554541026
51,1,52,22,80,83,1,8224.466999999999,64,1717.749,MORE,-1804,4458,2654,7,2,3.0,0.28122253820234633,3.0,-1.0476454436543674,-0.1256098877473213,4.461658655671466,163,80,83,0,0.05983508244547061,0.0,0.1170500554541026,3.8793857566188894,-1.636803478772874,1.636803478772874,0.1170500554541026,0.0,0,1,0,1,0.1170500554541026,0.0
52,1,53,6,50,56,1,2626.168,64,2225.933,MORE,-434,1480,1046,3,2,6.0,0.5624450764046927,6.0,-0.5238227218271837,-0.1256098877473213,-0.10601693435688696,106,50,56,0,-1.077031484018471,-1.170500554541026,-0.9364004436328208,0.4563983243081045,0.028638717078292266,0.028638717078292266,-0.9364004436328208,-1.170500554541026,0,1,0,0,-1.170500554541026,-0.9364004436328208
53,1,54,13,50,47,0,1991.413,34,929.111,MORE,-994,1494,500,2,1,-3.0,-0.28122253820234633,3.0,-1.0476454436543674,-1.6689395665540017,-0.6239161961055806,97,50,47,1,-1.2565367313548828,-1.170500554541026,-1.2875506099951286,-0.3993485337695917,-0.652125976116345,0.652125976116345,-1.2875506099951286,-1.170500554541026,0,1,0,0,-1.170500554541026,-1.2875506099951286
54,1,55,46,110,124,1,1671.149,64,893.164,MORE,432,654,1086,1,2,14.0,1.3123718449442827,14.0,0.8730378697119728,-0.1256098877473213,-0.8852209344135633,234,110,124,0,1.4759320336549415,1.170500554541026,1.7167341466601715,-1.2550953918472878,1.081392689054285,1.081392689054285,1.7167341466601715,1.170500554541026,0,0,1,2,1.7167341466601715,1.170500554541026
55,1,56,27,91,80,0,2607.607,54,1793.0870000000002,MORE,-1654,2206,552,2,1,-11.0,-1.0311493067419364,11.0,0.34921514788478913,-0.6400531140162148,-0.12116093195803633,171,91,80,1,0.21939530230005888,0.4291835366650429,0.0,-0.3993485337695917,-1.4544557930957391,1.4544557930957391,0.0,0.4291835366650429,0,1,0,1,0.4291835366650429,0.0
56,1,57,40,64,80,1,1527.826,100,813.322,MORE,758,562,1320,1,2,16.0,1.4998535370791803,16.0,1.222253017596762,1.7263857268206952,-1.0021587701007306,144,64,80,0,-0.3191204397091766,-0.6242669624218805,0.0,-1.2550953918472878,1.477694992592592,1.477694992592592,0.0,-0.6242669624218805,1,0,1,1,-0.6242669624218805,0.0
57,1,58,22,83,80,0,5043.16,64,1399.128,MORE,-526,2494,1968,6,1,-3.0,-0.28122253820234633,3.0,-1.0476454436543674,-0.1256098877473213,1.8660169565971,163,83,80,1,0.05983508244547061,0.1170500554541026,0.0,3.023638898541193,-0.08320119680368387,0.08320119680368387,0.0,0.1170500554541026,0,1,0,1,0.1170500554541026,0.0
58,1,59,54,101,110,1,2267.665,34,986.77,MORE,142,996,1138,1,2,9.0,0.8436676146070391,9.0,0.0,-1.6689395665540017,-0.3985210328432194,211,101,110,0,1.0171964015730004,0.8193503881787182,1.170500554541026,-1.2550953918472878,0.7288538300784908,0.7288538300784908,1.170500554541026,0.8193503881787182,0,0,1,2,1.170500554541026,0.8193503881787182
59,1,60,6,56,50,0,4499.543,74,1357.733,MORE,-1232,2734,1502,4,2,-6.0,-0.5624450764046927,6.0,-0.5238227218271837,0.38883333852157215,1.4224775705756594,106,56,50,1,-1.077031484018471,-0.9364004436328208,-1.170500554541026,1.3121451823858008,-0.9414509707240659,0.9414509707240659,-1.170500554541026,-0.9364004436328208,1,1,0,0,-0.9364004436328208,-1.170500554541026
60,1,61,18,50,42,0,5571.061,74,991.395,MORE,-696,2884,2188,4,2,-8.0,-0.7499267685395902,8.0,-0.17460757394239454,0.38883333852157215,2.2967335924272976,92,50,42,1,-1.3562618687640005,-1.170500554541026,-1.4826340357519663,1.3121451823858008,-0.2898619072377702,0.2898619072377702,-1.4826340357519663,-1.170500554541026,1,1,0,0,-1.170500554541026,-1.4826340357519663
61,1,62,43,110,117,1,2045.641,84,1732.67,MORE,556,1108,1664,1,2,7.0,0.6561859224721414,7.0,-0.34921514788478913,0.9032765647904656,-0.5796713438931392,227,110,117,0,1.3363168412821769,1.170500554541026,1.4436173506005987,-1.2550953918472878,1.2321334425473833,1.2321334425473833,1.4436173506005987,1.170500554541026,1,0,1,2,1.4436173506005987,1.170500554541026
62,1,63,32,77,80,1,1402.112,64,2053.806,MORE,518,482,1000,1,2,3.0,0.28122253820234633,3.0,-1.0476454436543674,-0.1256098877473213,-1.104729348972067,157,77,80,0,-0.05983508244547061,-0.1170500554541026,0.0,-1.2550953918472878,1.185938695509176,1.185938695509176,0.0,-0.1170500554541026,0,0,1,1,-0.1170500554541026,0.0
63,1,64,27,80,91,1,2736.625,74,1971.489,MORE,190,1316,1506,3,2,11.0,1.0311493067419364,11.0,0.34921514788478913,0.38883333852157215,-0.015894605655300712,171,80,91,0,0.21939530230005888,0.0,0.4291835366650429,0.4563983243081045,0.787205089495174,0.787205089495174,0.4291835366650429,0.0,1,1,1,1,0.4291835366650429,0.0
64,1,65,16,44,50,1,2065.604,64,2403.31,MORE,294,818,1112,0,2,6.0,0.5624450764046927,6.0,-0.5238227218271837,-0.1256098877473213,-0.5633834486228554,94,44,50,0,-1.3163718138003533,-1.4046006654492311,-1.170500554541026,-2.110842249924984,0.9136328182313209,0.9136328182313209,-1.170500554541026,-1.4046006654492311,0,0,1,0,-1.4046006654492311,-1.170500554541026
65,1,66,7,50,57,1,3058.203,64,1657.954,MORE,-6,1416,1410,3,2,7.0,0.6561859224721414,7.0,-0.34921514788478913,-0.1256098877473213,0.24648223075342604,107,50,57,0,-1.0570864565366473,-1.170500554541026,-0.8973837584814532,0.4563983243081045,0.5489374468770508,0.5489374468770508,-0.8973837584814532,-1.170500554541026,0,1,1,0,-1.170500554541026,-0.8973837584814532
66,1,67,14,50,46,1,1613.454,64,1014.648,MORE,358,608,966,1,2,-4.0,-0.3749633842697951,4.0,-0.8730378697119728,-0.1256098877473213,-0.9322945264397636,96,50,46,1,-1.2764817588367063,-1.170500554541026,-1.3265672951464962,-1.2550953918472878,0.9914344974535652,0.9914344974535652,-1.3265672951464962,-1.170500554541026,0,0,1,0,-1.170500554541026,-1.3265672951464962
67,1,68,51,110,108,1,1931.482,84,1086.543,MORE,460,998,1458,1,2,-2.0,-0.18748169213489754,2.0,-1.222253017596762,0.9032765647904656,-0.6728141498922556,218,110,108,1,1.156811593945765,1.170500554541026,1.092467184238291,-1.2550953918472878,1.115430923714017,1.115430923714017,1.092467184238291,1.170500554541026,1,0,1,2,1.170500554541026,1.092467184238291
68,1,69,50,133,110,0,4895.517,74,964.583,MORE,-1858,3392,1534,4,2,-23.0,-2.1560394595513217,23.0,2.444506035193524,0.38883333852157215,1.7455544148252946,243,133,110,1,1.6554372809913533,2.0678843130224793,1.170500554541026,1.3121451823858008,-1.7024486456166428,1.7024486456166428,1.170500554541026,2.0678843130224793,1,1,0,2,2.0678843130224793,1.170500554541026
69,1,70,49,131,110,1,3197.86,34,1226.561,MORE,-104,1512,1408,2,2,-21.0,-1.9685577674164243,21.0,2.0952908873087353,-1.6689395665540017,0.3604289616937689,241,131,110,1,1.6155472260277064,1.9898509427197442,1.170500554541026,-0.3993485337695917,0.4298036255679893,0.4298036255679893,1.170500554541026,1.9898509427197442,0,0,1,2,1.9898509427197442,1.170500554541026
70,1,71,47,126,110,1,2000.688,64,1976.766,MORE,1668,814,2482,1,2,-16.0,-1.4998535370791803,16.0,1.222253017596762,-0.1256098877473213,-0.6163486847780303,236,126,110,1,1.5158220886185887,1.7947675169629065,1.170500554541026,-1.2550953918472878,2.5839376190338776,2.5839376190338776,1.170500554541026,1.7947675169629065,0,0,1,2,1.7947675169629065,1.170500554541026
71,1,72,50,110,133,1,1921.251,94,1085.583,MORE,388,902,1290,1,2,23.0,2.1560394595513217,23.0,2.444506035193524,1.417719791059359,-0.6811616656218692,243,110,133,0,1.6554372809913533,1.170500554541026,2.0678843130224793,-1.2550953918472878,1.0279040345889923,1.0279040345889923,2.0678843130224793,1.170500554541026,1,0,1,2,2.0678843130224793,1.170500554541026
72,1,73,47,110,126,1,2050.4970000000008,94,671.347,MORE,400,986,1386,1,2,16.0,1.4998535370791803,16.0,1.222253017596762,1.417719791059359,-0.575709313164666,236,110,126,0,1.5158220886185887,1.170500554541026,1.7947675169629065,-1.2550953918472878,1.042491849443163,1.042491849443163,1.7947675169629065,1.170500554541026,1,0,1,2,1.7947675169629065,1.170500554541026
73,1,74,12,48,50,1,2219.756,64,947.498,MORE,1160,504,1664,1,2,2.0,0.18748169213489754,2.0,-1.222253017596762,-0.1256098877473213,-0.43761018650269146,98,48,50,0,-1.2365917038730592,-1.248533924843761,-1.170500554541026,-1.2550953918472878,1.9663867902073138,1.9663867902073138,-1.170500554541026,-1.248533924843761,0,0,1,0,-1.248533924843761,-1.170500554541026
74,1,75,32,80,77,1,1635.473,34,1756.646,MORE,298,644,942,0,2,-3.0,-0.28122253820234633,3.0,-1.0476454436543674,-1.6689395665540017,-0.9143291321625316,157,80,77,1,-0.05983508244547061,0.0,-0.1170500554541026,-2.110842249924984,0.9184954231827112,0.9184954231827112,-0.1170500554541026,0.0,0,0,1,1,0.0,-0.1170500554541026
75,1,76,43,117,110,0,5608.432,64,1783.309,MORE,-674,2874,2200,6,1,-7.0,-0.6561859224721414,7.0,-0.34921514788478913,-0.1256098877473213,2.3272247477719743,227,117,110,1,1.3363168412821769,1.4436173506005987,1.170500554541026,3.023638898541193,-0.26311758000512375,0.26311758000512375,1.170500554541026,1.4436173506005987,0,1,0,2,1.4436173506005987,1.170500554541026
76,1,77,40,80,64,0,4443.018,34,914.203,MORE,-1002,2624,1622,4,1,-16.0,-1.4998535370791803,16.0,1.222253017596762,-1.6689395665540017,1.376358586447382,144,80,64,1,-0.3191204397091766,0.0,-0.6242669624218805,1.3121451823858008,-0.6618511860191256,0.6618511860191256,-0.6242669624218805,0.0,0,1,0,1,0.0,-0.6242669624218805
77,1,78,31,80,78,1,2620.927,100,1013.713,MORE,408,1098,1506,3,2,-2.0,-0.18748169213489754,2.0,-1.222253017596762,1.7263857268206952,-0.11029308819706922,158,80,78,1,-0.03989005496364707,0.0,-0.07803337030273506,0.4563983243081045,1.0522170593459435,1.0522170593459435,-0.07803337030273506,0.0,1,1,1,1,0.0,-0.07803337030273506
78,1,79,46,124,110,1,1725.9029999999998,64,2174.1620000000007,MORE,-200,1128,928,1,1,-14.0,-1.3123718449442827,14.0,0.8730378697119728,-0.1256098877473213,-0.84054691659915,234,124,110,1,1.4759320336549415,1.7167341466601715,1.170500554541026,-1.2550953918472878,0.3131011067346229,0.3131011067346229,1.170500554541026,1.7167341466601715,0,0,1,2,1.7167341466601715,1.170500554541026
79,1,80,58,92,110,1,3225.23,54,1560.319,MORE,-480,1938,1458,3,1,18.0,1.6873352292140782,18.0,1.571468165481551,-0.6400531140162148,0.3827602592716717,202,92,110,0,0.8376911542365885,0.4682002218164104,1.170500554541026,0.4563983243081045,-0.027281239862695806,0.027281239862695806,1.170500554541026,0.4682002218164104,0,1,0,2,1.170500554541026,0.4682002218164104
80,1,81,48,128,110,1,7964.300999999998,54,1952.117,LESS,-734,3890,3156,4,1,-18.0,-1.6873352292140782,18.0,1.571468165481551,-0.6400531140162148,4.249388127149263,238,128,110,0,1.5557121435822359,1.8728008872656416,1.170500554541026,1.3121451823858008,-0.33605665427597775,0.33605665427597775,1.170500554541026,1.8728008872656416,0,1,0,2,1.8728008872656416,1.170500554541026
81,1,82,8,50,58,0,1743.8239999999996,64,2343.446,LESS,-960,1426,466,2,1,8.0,0.7499267685395902,8.0,-0.17460757394239454,-0.1256098877473213,-0.8259250976772066,108,50,58,1,-1.0371414290548238,-1.170500554541026,-0.8583670733300858,-0.3993485337695917,-0.6107938340295278,0.6107938340295278,-0.8583670733300858,-1.170500554541026,1,0,0,0,-1.170500554541026,-0.8583670733300858
82,1,83,4,54,50,0,2122.334,54,1286.756,LESS,-1186,1716,530,2,1,-4.0,-0.3749633842697951,4.0,-0.8730378697119728,-0.6400531140162148,-0.5170972041363946,104,54,50,0,-1.116921538982118,-1.0144338139355558,-1.170500554541026,-0.3993485337695917,-0.8855310137830779,0.8855310137830779,-1.170500554541026,-1.0144338139355558,0,0,0,0,-1.0144338139355558,-1.170500554541026
83,1,84,37,80,69,1,2518.011,84,2851.118,LESS,212,1776,1988,3,2,-11.0,-1.0311493067419364,11.0,0.34921514788478913,0.9032765647904656,-0.1942626834300782,149,80,69,0,-0.21939530230005888,0.0,-0.4291835366650429,0.4563983243081045,0.8139494167278204,0.8139494167278204,-0.4291835366650429,0.0,1,1,1,1,0.0,-0.4291835366650429
84,1,85,52,105,110,0,2201.475,64,1874.471,LESS,-944,1712,768,2,1,5.0,0.4687042303372438,5.0,-0.6984302957695783,-0.1256098877473213,-0.4525257309316882,215,105,110,1,1.0969765115002945,0.9754171287841883,1.170500554541026,-0.3993485337695917,-0.5913434142239667,0.5913434142239667,1.170500554541026,0.9754171287841883,1,0,0,2,1.170500554541026,0.9754171287841883
85,1,86,5,55,50,0,2131.478,64,1083.81,LESS,-634,1302,668,2,1,-5.0,-0.4687042303372438,5.0,-0.6984302957695783,-0.1256098877473213,-0.5096365762572441,105,55,50,0,-1.0969765115002945,-0.9754171287841883,-1.170500554541026,-0.3993485337695917,-0.21449153049122108,0.21449153049122108,-1.170500554541026,-0.9754171287841883,1,0,1,0,-0.9754171287841883,-1.170500554541026
86,1,87,30,96,80,0,2017.429,4,1183.942,LESS,-1858,2362,504,2,1,-16.0,-1.4998535370791803,16.0,1.222253017596762,-3.2122692453606816,-0.6026896327958721,176,96,80,0,0.3191204397091766,0.6242669624218805,0.0,-0.3993485337695917,-1.7024486456166428,1.7024486456166428,0.0,0.6242669624218805,0,0,0,1,0.6242669624218805,0.0
87,1,88,33,80,75,1,3241.381,64,1875.688,LESS,712,1180,1892,3,2,-5.0,-0.4687042303372438,5.0,-0.6984302957695783,-0.1256098877473213,0.3959379277839372,155,80,75,0,-0.09972513740911768,0.0,-0.19508342575683765,0.4563983243081045,1.421775035651604,1.421775035651604,-0.19508342575683765,0.0,1,1,1,1,0.0,-0.19508342575683765
88,1,89,48,110,128,0,2528.386,64,1824.788,LESS,-1444,2070,626,2,1,18.0,1.6873352292140782,18.0,1.571468165481551,-0.1256098877473213,-0.18579767749764334,238,110,128,1,1.5557121435822359,1.170500554541026,1.8728008872656416,-0.3993485337695917,-1.19916903314775,1.19916903314775,1.8728008872656416,1.170500554541026,0,0,0,2,1.8728008872656416,1.170500554541026
89,1,90,9,59,50,1,1679.8729999999996,64,1211.035,LESS,444,628,1072,1,2,-9.0,-0.8436676146070391,9.0,0.0,-0.1256098877473213,-0.8781029862926419,109,59,50,0,-1.0171964015730004,-0.8193503881787182,-1.170500554541026,-1.2550953918472878,1.095980503908456,1.095980503908456,-1.170500554541026,-0.8193503881787182,0,0,1,0,-0.8193503881787182,-1.170500554541026
90,1,91,44,110,119,0,1513.221,24,1929.333,LESS,-672,1086,414,2,1,9.0,0.8436676146070391,9.0,0.0,-2.1833827928228957,-1.0140750507410403,229,110,119,1,1.376206896245824,1.170500554541026,1.5216507209033339,-0.3993485337695917,-0.26068627752942863,0.26068627752942863,1.5216507209033339,1.170500554541026,0,0,0,2,1.5216507209033339,1.170500554541026
91,1,92,2,52,50,1,3359.407,74,1520.963,LESS,974,1046,2020,3,2,-2.0,-0.18748169213489754,2.0,-1.222253017596762,0.38883333852157215,0.4922358352713165,102,52,50,0,-1.156811593945765,-1.092467184238291,-1.170500554541026,0.4563983243081045,1.7402756599676663,1.7402756599676663,-1.170500554541026,-1.092467184238291,1,1,1,0,-1.092467184238291,-1.170500554541026
92,1,93,8,58,50,0,3815.203,74,1109.56,LESS,-556,2110,1554,4,2,-8.0,-0.7499267685395902,8.0,-0.17460757394239454,0.38883333852157215,0.8641216997513244,108,58,50,0,-1.0371414290548238,-0.8583670733300858,-1.170500554541026,1.3121451823858008,-0.11967073393911087,0.11967073393911087,-1.170500554541026,-0.8583670733300858,1,1,1,0,-0.8583670733300858,-1.170500554541026
93,1,94,44,119,110,0,4747.633,24,1125.921,LESS,98,2082,2180,4,1,-9.0,-0.8436676146070391,9.0,0.0,-2.1833827928228957,1.6248952401446008,229,119,110,0,1.376206896245824,1.5216507209033339,1.170500554541026,1.3121451823858008,0.6753651756131979,0.6753651756131979,1.170500554541026,1.5216507209033339,0,1,1,2,1.5216507209033339,1.170500554541026
94,1,95,34,74,80,0,3013.6240000000007,100,1360.27,LESS,882,1144,2026,3,2,6.0,0.5624450764046927,6.0,-0.5238227218271837,1.7263857268206952,0.2101100380341964,154,74,80,1,-0.11967016489094122,-0.2341001109082052,0.0,0.4563983243081045,1.6284357460856902,1.6284357460856902,0.0,-0.2341001109082052,1,1,1,1,-0.2341001109082052,0.0
95,1,96,24,86,80,0,3695.847,74,2038.684,LESS,-376,2298,1922,5,2,-6.0,-0.5624450764046927,6.0,-0.5238227218271837,0.38883333852157215,0.7667386396962214,166,86,80,0,0.11967016489094122,0.2341001109082052,0.0,2.1678920404634967,0.09914648887345114,0.09914648887345114,0.0,0.2341001109082052,1,1,1,1,0.2341001109082052,0.0
96,1,97,39,66,80,0,1818.684,74,1972.947,LESS,-730,1246,516,2,1,14.0,1.3123718449442827,14.0,0.8730378697119728,0.38883333852157215,-0.7648465102938738,146,66,80,1,-0.2792303847455295,-0.5462335921191455,0.0,-0.3993485337695917,-0.3311940493245875,0.3311940493245875,0.0,-0.5462335921191455,1,0,0,1,-0.5462335921191455,0.0
97,1,98,9,50,59,0,3040.837,74,1288.515,LESS,-1704,2296,592,2,2,9.0,0.8436676146070391,9.0,0.0,0.38883333852157215,0.232313238654856,109,50,59,1,-1.0171964015730004,-1.170500554541026,-0.8193503881787182,-0.3993485337695917,-1.5152383549881174,1.5152383549881174,-0.8193503881787182,-1.170500554541026,1,0,0,0,-1.170500554541026,-0.8193503881787182
98,1,99,57,94,110,0,3156.807,100,1195.264,LESS,-1062,2242,1180,1,2,16.0,1.4998535370791803,16.0,1.222253017596762,1.7263857268206952,0.3269336471352869,204,94,110,1,0.8775812092002355,0.5462335921191455,1.170500554541026,-1.2550953918472878,-0.7347902602899796,0.7347902602899796,1.170500554541026,0.5462335921191455,1,0,0,2,1.170500554541026,0.5462335921191455
99,1,100,60,110,87,1,5926.643,94,1651.2089999999996,LESS,-950,3560,2610,3,2,-23.0,-2.1560394595513217,23.0,2.444506035193524,1.417719791059359,2.586854434785568,197,110,87,0,0.7379660168274708,1.170500554541026,0.27311679605957273,0.4563983243081045,-0.5986373216510522,0.5986373216510522,0.27311679605957273,1.170500554541026,1,1,0,2,1.170500554541026,0.27311679605957273
100,1,101,33,75,80,1,4156.099,94,1382.8929999999998,LESS,1626,1500,3126,3,2,5.0,0.4687042303372438,5.0,-0.6984302957695783,1.417719791059359,1.1422601732301985,155,75,80,1,-0.09972513740911768,-0.19508342575683765,0.0,0.4563983243081045,2.53288026704428,2.53288026704428,0.0,-0.19508342575683765,1,1,1,1,-0.19508342575683765,0.0
101,1,102,15,50,45,1,2333.893,64,2767.159,LESS,-698,1704,1006,3,1,-5.0,-0.4687042303372438,5.0,-0.6984302957695783,-0.1256098877473213,-0.3444853303956727,95,50,45,0,-1.2964267863185297,-1.170500554541026,-1.3655839802978638,0.4563983243081045,-0.29229320971346534,0.29229320971346534,-1.3655839802978638,-1.170500554541026,0,1,0,0,-1.170500554541026,-1.3655839802978638
102,1,103,59,89,110,0,2362.993,84,1411.2120000000002,LESS,966,832,1798,3,2,21.0,1.9685577674164243,21.0,2.0952908873087353,0.9032765647904656,-0.3207425185755422,199,89,110,1,0.7778560717911179,0.3511501663623078,1.170500554541026,0.4563983243081045,1.7305504500648858,1.7305504500648858,1.170500554541026,0.3511501663623078,1,1,1,2,1.170500554541026,0.3511501663623078
103,1,104,29,80,94,0,1705.088,54,1625.9920000000004,LESS,-128,1012,884,1,1,14.0,1.3123718449442827,14.0,0.8730378697119728,-0.6400531140162148,-0.8575299622361264,174,80,94,1,0.2792303847455295,0.0,0.5462335921191455,-1.2550953918472878,0.4006279958596477,0.4006279958596477,0.5462335921191455,0.0,0,0,1,1,0.5462335921191455,0.0
104,1,105,55,110,98,1,1720.385,64,1479.807,LESS,-840,1380,540,2,1,-12.0,-1.124890152809385,12.0,0.5238227218271837,-0.1256098877473213,-0.8450490758989259,208,110,98,0,0.9573613191275298,1.170500554541026,0.7023003327246156,-0.3993485337695917,-0.4649156854878198,0.4649156854878198,0.7023003327246156,1.170500554541026,0,0,0,2,1.170500554541026,0.7023003327246156
105,1,106,29,94,80,0,1728.2179999999996,24,1289.573,LESS,-586,1148,562,2,1,-14.0,-1.3123718449442827,14.0,0.8730378697119728,-2.1833827928228957,-0.8386580984079611,174,94,80,0,0.2792303847455295,0.5462335921191455,0.0,-0.3993485337695917,-0.15614027107453787,0.15614027107453787,0.0,0.5462335921191455,0,0,1,1,0.5462335921191455,0.0
106,1,107,57,110,94,1,2498.348,64,1178.775,LESS,-44,1216,1172,3,2,-16.0,-1.4998535370791803,16.0,1.222253017596762,-0.1256098877473213,-0.21030580744448465,204,110,94,0,0.8775812092002355,1.170500554541026,0.5462335921191455,0.4563983243081045,0.5027426998388433,0.5027426998388433,0.5462335921191455,1.170500554541026,0,1,1,2,1.170500554541026,0.5462335921191455
107,1,108,39,80,66,1,3240.4590000000007,54,1331.467,LESS,664,1148,1812,3,2,-14.0,-1.3123718449442827,14.0,0.8730378697119728,-0.6400531140162148,0.3951856641242073,146,80,66,0,-0.2792303847455295,0.0,-0.5462335921191455,0.4563983243081045,1.3634237762349206,1.3634237762349206,-0.5462335921191455,0.0,0,1,1,1,0.0,-0.5462335921191455
108,1,109,4,50,54,1,2765.97,84,1498.4129999999998,LESS,538,1174,1712,3,2,4.0,0.3749633842697951,4.0,-0.8730378697119728,0.9032765647904656,0.008048102690463096,104,50,54,1,-1.116921538982118,-1.170500554541026,-1.0144338139355558,0.4563983243081045,1.2102517202661272,1.2102517202661272,-1.0144338139355558,-1.170500554541026,1,1,1,0,-1.170500554541026,-1.0144338139355558
109,1,110,55,98,110,1,2998.353,84,982.983,LESS,154,1404,1558,3,2,12.0,1.124890152809385,12.0,0.5238227218271837,0.9032765647904656,0.19765036520583795,208,98,110,1,0.9573613191275298,0.7023003327246156,1.170500554541026,0.4563983243081045,0.7434416449326616,0.7434416449326616,1.170500554541026,0.7023003327246156,1,1,1,2,1.170500554541026,0.7023003327246156
110,1,111,2,50,52,0,2079.715,54,1525.128,LESS,-808,1406,598,2,1,2.0,0.18748169213489754,2.0,-1.222253017596762,-0.6400531140162148,-0.5518702246505574,102,50,52,1,-1.156811593945765,-1.170500554541026,-1.092467184238291,-0.3993485337695917,-0.4260148458766977,0.4260148458766977,-1.092467184238291,-1.170500554541026,0,1,0,0,-1.170500554541026,-1.092467184238291
111,1,112,59,110,89,1,1666.1029999999996,64,1778.183,LESS,-742,1250,508,2,1,-21.0,-1.9685577674164243,21.0,2.0952908873087353,-0.1256098877473213,-0.8893379869374254,199,110,89,0,0.7778560717911179,1.170500554541026,0.3511501663623078,-0.3993485337695917,-0.3457818641787583,0.3457818641787583,0.3511501663623078,1.170500554541026,0,0,0,2,1.170500554541026,0.3511501663623078
112,1,113,60,87,110,0,2426.928,64,901.849,LESS,-1404,1898,494,2,2,23.0,2.1560394595513217,23.0,2.444506035193524,-0.1256098877473213,-0.26857768442708696,197,87,110,1,0.7379660168274708,0.27311679605957273,1.170500554541026,-0.3993485337695917,-1.1505429836338474,1.1505429836338474,1.170500554541026,0.27311679605957273,0,0,0,2,1.170500554541026,0.27311679605957273
113,1,114,52,110,105,1,3263.2990000000004,74,903.194,LESS,-444,1734,1290,3,2,-5.0,-0.4687042303372438,5.0,-0.6984302957695783,0.38883333852157215,0.4138209157383577,215,110,105,0,1.0969765115002945,1.170500554541026,0.9754171287841883,0.4563983243081045,0.016482204699816597,0.016482204699816597,0.9754171287841883,1.170500554541026,1,1,1,2,1.170500554541026,0.9754171287841883
114,1,115,30,80,96,0,1723.836,84,872.135,LESS,328,800,1128,2,2,16.0,1.4998535370791803,16.0,1.222253017596762,0.9032765647904656,-0.8422333905521467,176,80,96,1,0.3191204397091766,0.0,0.6242669624218805,-0.3993485337695917,0.9549649603181382,0.9549649603181382,0.6242669624218805,0.0,1,0,1,1,0.6242669624218805,0.0
115,1,116,24,80,86,0,1368.6429999999998,94,1116.496,LESS,1122,464,1586,1,2,6.0,0.5624450764046927,6.0,-0.5238227218271837,1.417719791059359,-1.1320368461819628,166,80,86,1,0.11967016489094122,0.0,0.2341001109082052,-1.2550953918472878,1.9201920431691062,1.9201920431691062,0.2341001109082052,0.0,1,0,1,1,0.2341001109082052,0.0
116,1,117,5,50,55,0,1990.443,74,1166.408,LESS,-670,1340,670,2,2,5.0,0.4687042303372438,5.0,-0.6984302957695783,0.38883333852157215,-0.6247076231662516,105,50,55,1,-1.0969765115002945,-1.170500554541026,-0.9754171287841883,-0.3993485337695917,-0.25825497505373346,0.25825497505373346,-0.9754171287841883,-1.170500554541026,1,0,0,0,-1.170500554541026,-0.9754171287841883
117,1,118,34,80,74,0,2997.126,94,929.632,LESS,164,1510,1674,3,2,-6.0,-0.5624450764046927,6.0,-0.5238227218271837,1.417719791059359,0.1966492507692985,154,80,74,0,-0.11967016489094122,0.0,-0.2341001109082052,0.4563983243081045,0.7555981573111372,0.7555981573111372,-0.2341001109082052,0.0,1,1,1,1,0.0,-0.2341001109082052
118,1,119,15,45,50,0,1573.53,54,1699.412,LESS,-4,802,798,2,1,5.0,0.4687042303372438,5.0,-0.6984302957695783,-0.6400531140162148,-0.9648686851719592,95,45,50,1,-1.2964267863185297,-1.3655839802978638,-1.170500554541026,-0.3993485337695917,0.5513687493527459,0.5513687493527459,-1.170500554541026,-1.3655839802978638,0,0,1,0,-1.3655839802978638,-1.170500554541026
119,1,120,37,69,80,0,2306.153,64,1397.419,LESS,-982,1696,714,2,1,11.0,1.0311493067419364,11.0,0.34921514788478913,-0.1256098877473213,-0.3671185125224915,149,69,80,1,-0.21939530230005888,-0.4291835366650429,0.0,-0.3993485337695917,-0.6375381612621742,0.6375381612621742,0.0,-0.4291835366650429,1,0,0,1,-0.4291835366650429,0.0
120,1,121,48,128,110,0,1686.53,84,947.11,MORE,-156,1208,1052,2,2,-18.0,-1.6873352292140782,18.0,1.571468165481551,0.9032765647904656,-0.8726715121247169,238,128,110,1,1.5557121435822359,1.8728008872656416,1.170500554541026,-0.3993485337695917,0.3665897611999158,0.3665897611999158,1.170500554541026,1.8728008872656416,1,1,1,2,1.8728008872656416,1.170500554541026
121,1,122,8,50,58,1,2010.532,74,1007.719,MORE,10,942,952,3,2,8.0,0.7499267685395902,8.0,-0.17460757394239454,0.38883333852157215,-0.6083169239684989,108,50,58,0,-1.0371414290548238,-1.170500554541026,-0.8583670733300858,0.4563983243081045,0.5683878666826119,0.5683878666826119,-0.8583670733300858,-1.170500554541026,1,1,1,0,-1.170500554541026,-0.8583670733300858
122,1,123,4,54,50,0,2244.929,64,1086.016,MORE,-1434,1996,562,2,1,-4.0,-0.3749633842697951,4.0,-0.8730378697119728,-0.1256098877473213,-0.41707143042199896,104,54,50,1,-1.116921538982118,-1.0144338139355558,-1.170500554541026,-0.3993485337695917,-1.1870125207692743,1.1870125207692743,-1.170500554541026,-1.0144338139355558,0,1,0,0,-1.0144338139355558,-1.170500554541026
123,1,124,37,80,69,0,2092.94,74,1731.996,MORE,-848,1684,836,3,1,-11.0,-1.0311493067419364,11.0,0.34921514788478913,0.38883333852157215,-0.5410798917872851,149,80,69,1,-0.21939530230005888,0.0,-0.4291835366650429,0.4563983243081045,-0.4746408953906004,0.4746408953906004,-0.4291835366650429,0.0,1,1,0,1,0.0,-0.4291835366650429
124,1,125,52,105,110,1,1361.319,94,676.7919999999998,MORE,628,574,1202,1,2,5.0,0.4687042303372438,5.0,-0.6984302957695783,1.417719791059359,-1.138012528442122,215,105,110,0,1.0969765115002945,0.9754171287841883,1.170500554541026,-1.2550953918472878,1.3196603316724083,1.3196603316724083,1.170500554541026,0.9754171287841883,1,0,1,2,1.170500554541026,0.9754171287841883
125,1,126,5,55,50,1,1596.589,74,931.733,MORE,866,616,1482,1,2,-5.0,-0.4687042303372438,5.0,-0.6984302957695783,0.38883333852157215,-0.9460547505410182,105,55,50,1,-1.0969765115002945,-0.9754171287841883,-1.170500554541026,-1.2550953918472878,1.608985326280129,1.608985326280129,-1.170500554541026,-0.9754171287841883,1,0,1,0,-0.9754171287841883,-1.170500554541026
126,1,127,30,96,80,0,2850.121,74,1650.773,MORE,-1778,2456,678,2,1,-16.0,-1.4998535370791803,16.0,1.222253017596762,0.38883333852157215,0.07670725586832615,176,96,80,1,0.3191204397091766,0.6242669624218805,0.0,-0.3993485337695917,-1.6051965465888374,1.6051965465888374,0.0,0.6242669624218805,1,1,0,1,0.6242669624218805,0.0
127,1,128,33,80,75,1,1380.8970000000004,94,1098.922,MORE,560,530,1090,1,2,-5.0,-0.4687042303372438,5.0,-0.6984302957695783,1.417719791059359,-1.1220387562835472,155,80,75,1,-0.09972513740911768,0.0,-0.19508342575683765,-1.2550953918472878,1.2369960474987738,1.2369960474987738,-0.19508342575683765,0.0,1,0,1,1,0.0,-0.19508342575683765
128,1,129,48,110,128,1,1391.672,64,1794.924,MORE,-234,1162,928,1,1,18.0,1.6873352292140782,18.0,1.571468165481551,-0.1256098877473213,-1.113247388676609,238,110,128,0,1.5557121435822359,1.170500554541026,1.8728008872656416,-1.2550953918472878,0.2717689646478056,0.2717689646478056,1.8728008872656416,1.170500554541026,0,0,1,2,1.8728008872656416,1.170500554541026
129,1,130,9,59,50,0,2101.903,74,1239.822,MORE,-990,1578,588,2,1,-9.0,-0.8436676146070391,9.0,0.0,0.38883333852157215,-0.5337669425658478,109,59,50,1,-1.0171964015730004,-0.8193503881787182,-1.170500554541026,-0.3993485337695917,-0.6472633711649548,0.6472633711649548,-1.170500554541026,-0.8193503881787182,1,1,0,0,-0.8193503881787182,-1.170500554541026
130,1,131,44,110,119,1,1582.34,54,1258.389,MORE,28,826,854,1,2,9.0,0.8436676146070391,9.0,0.0,-0.6400531140162148,-0.9576805692910196,229,110,119,0,1.376206896245824,1.170500554541026,1.5216507209033339,-1.2550953918472878,0.590269588963868,0.590269588963868,1.5216507209033339,1.170500554541026,0,0,1,2,1.5216507209033339,1.170500554541026
131,1,132,2,52,50,0,2320.312,74,1463.68,MORE,-1118,1626,508,2,1,-2.0,-0.18748169213489754,2.0,-1.222253017596762,0.38883333852157215,-0.3555661251492533,102,52,50,1,-1.156811593945765,-1.092467184238291,-1.170500554541026,-0.3993485337695917,-0.8028667296094433,0.8028667296094433,-1.170500554541026,-1.092467184238291,1,1,0,0,-1.092467184238291,-1.170500554541026
132,1,133,8,58,50,0,2184.782,64,1365.006,MORE,-572,1342,770,2,1,-8.0,-0.7499267685395902,8.0,-0.17460757394239454,-0.1256098877473213,-0.4661456195129059,108,58,50,1,-1.0371414290548238,-0.8583670733300858,-1.170500554541026,-0.3993485337695917,-0.13912115374467193,0.13912115374467193,-1.170500554541026,-0.8583670733300858,0,1,0,0,-0.8583670733300858,-1.170500554541026
133,1,134,44,119,110,0,2602.684,24,1035.977,MORE,-1200,2076,876,2,1,-9.0,-0.8436676146070391,9.0,0.0,-2.1833827928228957,-0.12517762826698814,229,119,110,1,1.376206896245824,1.5216507209033339,1.170500554541026,-0.3993485337695917,-0.9025501311129438,0.9025501311129438,1.170500554541026,1.5216507209033339,0,1,0,2,1.5216507209033339,1.170500554541026
134,1,135,34,74,80,1,2890.742,64,1896.005,MORE,-574,1792,1218,3,1,6.0,0.5624450764046927,6.0,-0.5238227218271837,-0.1256098877473213,0.10985009981834422,154,74,80,0,-0.11967016489094122,-0.2341001109082052,0.0,0.4563983243081045,-0.14155245622036708,0.14155245622036708,0.0,-0.2341001109082052,0,1,0,1,-0.2341001109082052,0.0
135,1,136,24,86,80,1,1954.547,84,1049.5510000000004,MORE,274,1024,1298,1,2,-6.0,-0.5624450764046927,6.0,-0.5238227218271837,0.9032765647904656,-0.6539953198361967,166,86,80,1,0.11967016489094122,0.2341001109082052,0.0,-1.2550953918472878,0.8893197934743696,0.8893197934743696,0.0,0.2341001109082052,1,0,1,1,0.2341001109082052,0.0
136,1,137,39,66,80,1,1901.984,64,1813.237,MORE,124,1098,1222,1,1,14.0,1.3123718449442827,14.0,0.8730378697119728,-0.1256098877473213,-0.6968816915785172,146,66,80,0,-0.2792303847455295,-0.5462335921191455,0.0,-1.2550953918472878,0.7069721077972346,0.7069721077972346,0.0,-0.5462335921191455,0,0,1,1,-0.5462335921191455,0.0
137,1,138,9,50,59,1,3133.506,44,953.615,MORE,-398,1646,1248,3,1,9.0,0.8436676146070391,9.0,0.0,-1.1544963402851085,0.30792226369127096,109,50,59,0,-1.0171964015730004,-1.170500554541026,-0.8193503881787182,0.4563983243081045,0.07240216164080467,0.07240216164080467,-0.8193503881787182,-1.170500554541026,0,1,0,0,-1.170500554541026,-0.8193503881787182
138,1,139,57,94,110,1,2545.418,64,2154.544,MORE,336,1248,1584,3,2,16.0,1.4998535370791803,16.0,1.222253017596762,-0.1256098877473213,-0.17190119739728366,204,94,110,0,0.8775812092002355,0.5462335921191455,1.170500554541026,0.4563983243081045,0.9646901702209187,0.9646901702209187,1.170500554541026,0.5462335921191455,0,1,1,2,1.170500554541026,0.5462335921191455
139,1,140,60,110,87,0,2023.468,74,1120.839,MORE,-952,1604,652,2,2,-23.0,-2.1560394595513217,23.0,2.444506035193524,0.38883333852157215,-0.5977623874150552,197,110,87,1,0.7379660168274708,1.170500554541026,0.27311679605957273,-0.3993485337695917,-0.6010686241267473,0.6010686241267473,0.27311679605957273,1.170500554541026,1,1,0,2,1.170500554541026,0.27311679605957273
140,1,141,33,75,80,1,3330.755,84,846.965,MORE,430,1490,1920,3,2,5.0,0.4687042303372438,5.0,-0.6984302957695783,0.9032765647904656,0.4688585485266298,155,75,80,0,-0.09972513740911768,-0.19508342575683765,0.0,0.4563983243081045,1.07896138657859,1.07896138657859,0.0,-0.19508342575683765,1,1,1,1,-0.19508342575683765,0.0
141,1,142,15,50,45,0,1866.57,54,2507.707000000001,MORE,-1126,1720,594,2,1,-5.0,-0.4687042303372438,5.0,-0.6984302957695783,-0.6400531140162148,-0.7257761224306858,95,50,45,1,-1.2964267863185297,-1.170500554541026,-1.3655839802978638,-0.3993485337695917,-0.8125919395122239,0.8125919395122239,-1.3655839802978638,-1.170500554541026,0,1,0,0,-1.170500554541026,-1.3655839802978638
142,1,143,59,89,110,1,1604.858,74,1110.665,MORE,294,784,1078,1,2,21.0,1.9685577674164243,21.0,2.0952908873087353,0.38883333852157215,-0.9393080388248444,199,89,110,0,0.7778560717911179,0.3511501663623078,1.170500554541026,-1.2550953918472878,0.9136328182313209,0.9136328182313209,1.170500554541026,0.3511501663623078,1,0,1,2,1.170500554541026,0.3511501663623078
143,1,144,29,80,94,1,2458.127,70,1505.0179999999998,MORE,838,1266,2104,3,2,14.0,1.3123718449442827,14.0,0.8730378697119728,0.1830560480140148,-0.2431222897199992,174,80,94,0,0.2792303847455295,0.0,0.5462335921191455,0.4563983243081045,1.5749470916203971,1.5749470916203971,0.5462335921191455,0.0,0,1,1,1,0.5462335921191455,0.0
144,1,145,55,110,98,0,4970.636,64,2027.965,MORE,-1374,2898,1524,4,1,-12.0,-1.124890152809385,12.0,0.5238227218271837,-0.1256098877473213,1.8068443213928689,208,110,98,1,0.9573613191275298,1.170500554541026,0.7023003327246156,1.3121451823858008,-1.1140734464984203,1.1140734464984203,0.7023003327246156,1.170500554541026,0,1,0,2,1.170500554541026,0.7023003327246156
145,1,146,29,94,80,0,3115.157,64,1281.616,MORE,-1762,2416,654,2,1,-14.0,-1.3123718449442827,14.0,0.8730378697119728,-0.1256098877473213,0.29295123777760884,174,94,80,1,0.2792303847455295,0.5462335921191455,0.0,-0.3993485337695917,-1.5857461267832762,1.5857461267832762,0.0,0.5462335921191455,0,1,0,1,0.5462335921191455,0.0
146,1,147,57,110,94,0,3128.098,64,1306.006,MORE,-1426,2218,792,2,1,-16.0,-1.4998535370791803,16.0,1.222253017596762,-0.1256098877473213,0.3035098538519836,204,110,94,1,0.8775812092002355,1.170500554541026,0.5462335921191455,-0.3993485337695917,-1.1772873108664939,1.1772873108664939,0.5462335921191455,1.170500554541026,0,0,0,2,1.170500554541026,0.5462335921191455
147,1,148,39,80,66,0,3745.136,80,1356.805,MORE,-1382,2860,1478,2,2,-14.0,-1.3123718449442827,14.0,0.8730378697119728,0.6974992742829083,0.8069537411327302,146,80,66,1,-0.2792303847455295,0.0,-0.5462335921191455,-0.3993485337695917,-1.123798656401201,1.123798656401201,-0.5462335921191455,0.0,1,0,0,1,0.0,-0.5462335921191455
148,1,149,4,50,54,1,3673.352,64,1957.847,MORE,-686,2190,1504,3,1,4.0,0.3749633842697951,4.0,-0.8730378697119728,-0.1256098877473213,0.7483848750263298,104,50,54,0,-1.116921538982118,-1.170500554541026,-1.0144338139355558,0.4563983243081045,-0.2777053948592946,0.2777053948592946,-1.0144338139355558,-1.170500554541026,0,1,0,0,-1.170500554541026,-1.0144338139355558
149,1,150,55,98,110,1,4942.765,74,1805.4,MORE,-1618,3112,1494,2,2,12.0,1.124890152809385,12.0,0.5238227218271837,0.38883333852157215,1.78410425581765,208,98,110,0,0.9573613191275298,0.7023003327246156,1.170500554541026,-0.3993485337695917,-1.4106923485332268,1.4106923485332268,1.170500554541026,0.7023003327246156,1,0,0,2,1.170500554541026,0.7023003327246156
150,1,151,2,50,52,0,2224.593,74,1510.151,MORE,-1022,1600,578,2,1,2.0,0.18748169213489754,2.0,-1.222253017596762,0.38883333852157215,-0.4336636579537578,102,50,52,0,-1.156811593945765,-1.170500554541026,-1.092467184238291,-0.3993485337695917,-0.6861642107760769,0.6861642107760769,-1.092467184238291,-1.170500554541026,1,0,0,0,-1.170500554541026,-1.092467184238291
151,1,152,59,110,89,1,2997.098,4,1262.236,MORE,-2028,3020,992,2,1,-21.0,-1.9685577674164243,21.0,2.0952908873087353,-3.2122692453606816,0.1966264054520831,199,110,89,1,0.7778560717911179,1.170500554541026,0.3511501663623078,-0.3993485337695917,-1.909109356050729,1.909109356050729,0.3511501663623078,1.170500554541026,0,0,0,2,1.170500554541026,0.3511501663623078
152,1,153,60,87,110,1,1391.7379999999996,84,1035.328,MORE,460,696,1156,1,2,23.0,2.1560394595513217,23.0,2.444506035193524,0.9032765647904656,-1.1131935390003165,197,87,110,0,0.7379660168274708,0.27311679605957273,1.170500554541026,-1.2550953918472878,1.115430923714017,1.115430923714017,1.170500554541026,0.27311679605957273,1,0,1,2,1.170500554541026,0.27311679605957273
153,1,154,52,110,105,0,3340.985,100,835.78,MORE,-940,2234,1294,2,2,-5.0,-0.4687042303372438,5.0,-0.6984302957695783,1.7263857268206952,0.4772052483520572,215,110,105,1,1.0969765115002945,1.170500554541026,0.9754171287841883,-0.3993485337695917,-0.5864808092725765,0.5864808092725765,0.9754171287841883,1.170500554541026,1,0,0,2,1.170500554541026,0.9754171287841883
154,1,155,30,80,96,1,1648.785,84,747.819,MORE,48,970,1018,1,2,16.0,1.4998535370791803,16.0,1.222253017596762,0.9032765647904656,-0.9034678156350546,176,80,96,0,0.3191204397091766,0.0,0.6242669624218805,-1.2550953918472878,0.6145826137208195,0.6145826137208195,0.6242669624218805,0.0,1,0,1,1,0.6242669624218805,0.0
155,1,156,24,80,86,0,1990.089,44,1589.569,MORE,-1548,2114,566,2,1,6.0,0.5624450764046927,6.0,-0.5238227218271837,-1.1544963402851085,-0.6249964532481872,166,80,86,0,0.11967016489094122,0.0,0.2341001109082052,-0.3993485337695917,-1.325596761883897,1.325596761883897,0.2341001109082052,0.0,0,0,0,1,0.2341001109082052,0.0
156,1,157,5,50,55,1,2490.532,74,893.86,MORE,362,1096,1458,2,2,5.0,0.4687042303372438,5.0,-0.6984302957695783,0.38883333852157215,-0.21668291456428315,105,50,55,0,-1.0969765115002945,-1.170500554541026,-0.9754171287841883,-0.3993485337695917,0.9962971024049555,0.9962971024049555,-0.9754171287841883,-1.170500554541026,1,0,1,0,-1.170500554541026,-0.9754171287841883
157,1,158,34,80,74,0,2508.0170000000007,64,2009.535,MORE,-1012,1672,660,2,1,-6.0,-0.5624450764046927,6.0,-0.5238227218271837,-0.1256098877473213,-0.20241682986754786,154,80,74,1,-0.11967016489094122,0.0,-0.2341001109082052,-0.3993485337695917,-0.6740076983976012,0.6740076983976012,-0.2341001109082052,0.0,0,0,0,1,0.0,-0.2341001109082052
158,1,159,15,45,50,1,2293.524,64,2147.895,MORE,-302,1312,1010,3,1,5.0,0.4687042303372438,5.0,-0.6984302957695783,-0.1256098877473213,-0.3774225664907536,95,45,50,0,-1.2964267863185297,-1.3655839802978638,-1.170500554541026,0.4563983243081045,0.1891046804741711,0.1891046804741711,-1.170500554541026,-1.3655839802978638,0,1,0,0,-1.3655839802978638,-1.170500554541026
159,1,160,37,69,80,1,3004.818,24,800.012,MORE,-898,1828,930,3,2,11.0,1.0311493067419364,11.0,0.34921514788478913,-2.1833827928228957,0.20292518577000115,149,69,80,0,-0.21939530230005888,-0.4291835366650429,0.0,0.4563983243081045,-0.5354234572829787,0.5354234572829787,0.0,-0.4291835366650429,0,1,0,1,-0.4291835366650429,0.0
160,1,161,3,50,53,0,2773.406,54,1318.667,LESS,-514,1546,1032,4,1,3.0,0.28122253820234633,3.0,-1.0476454436543674,-0.6400531140162148,0.014115166219483525,103,50,53,1,-1.1368665664639415,-1.170500554541026,-1.0534504990869233,1.3121451823858008,-0.06861338194951308,0.06861338194951308,-1.0534504990869233,-1.170500554541026,0,1,1,0,-1.170500554541026,-1.0534504990869233
161,1,162,20,50,40,1,2122.486,84,813.427,LESS,986,646,1632,1,2,-10.0,-0.9374084606744876,10.0,0.17460757394239454,0.9032765647904656,-0.5169731867000832,90,50,40,0,-1.3961519237276474,-1.170500554541026,-1.5606674060547012,-1.2550953918472878,1.754863474821837,1.754863474821837,-1.5606674060547012,-1.170500554541026,1,0,1,0,-1.170500554541026,-1.5606674060547012
162,1,163,25,80,88,0,1541.2910000000004,64,889.138,LESS,-644,1088,444,2,1,8.0,0.7499267685395902,8.0,-0.17460757394239454,-0.1256098877473213,-0.991172620232756,168,80,88,1,0.1595602198545883,0.0,0.31213348121094026,-0.3993485337695917,-0.22664804286969675,0.22664804286969675,0.31213348121094026,0.0,0,0,1,1,0.31213348121094026,0.0
163,1,164,42,115,110,0,1792.184,4,970.264,LESS,-1446,1990,544,2,1,-5.0,-0.4687042303372438,5.0,-0.6984302957695783,-3.2122692453606816,-0.7864679712297316,225,115,110,0,1.2964267863185297,1.3655839802978638,1.170500554541026,-0.3993485337695917,-1.2016003356234453,1.2016003356234453,1.170500554541026,1.3655839802978638,0,0,0,2,1.3655839802978638,1.170500554541026
164,1,165,53,103,110,0,1719.1229999999996,54,1986.11,LESS,-1332,1834,502,2,1,7.0,0.6561859224721414,7.0,-0.34921514788478913,-0.6400531140162148,-0.8460787469819847,213,103,110,1,1.0570864565366473,0.8973837584814532,1.170500554541026,-0.3993485337695917,-1.0630160945088225,1.0630160945088225,1.170500554541026,0.8973837584814532,0,0,0,2,1.170500554541026,0.8973837584814532
165,1,166,26,90,80,1,5485.479,4,2758.4240000000004,LESS,-1090,3638,2548,4,1,-10.0,-0.9374084606744876,10.0,0.17460757394239454,-3.2122692453606816,2.2269068803588987,170,90,80,0,0.19945027481823535,0.3901668515136753,0.0,1.3121451823858008,-0.7688284949497115,0.7688284949497115,0.0,0.3901668515136753,0,1,0,1,0.3901668515136753,0.0
166,1,167,35,80,72,1,4941.353,74,1431.467,LESS,-784,2636,1852,5,2,-8.0,-0.7499267685395902,8.0,-0.17460757394239454,0.38883333852157215,1.7829521991066524,152,80,72,0,-0.1595602198545883,0.0,-0.31213348121094026,2.1678920404634967,-0.3968392161683561,0.3968392161683561,-0.31213348121094026,0.0,1,1,0,1,0.0,-0.31213348121094026
167,1,168,28,93,80,1,1580.206,64,2648.327,LESS,-650,1388,738,3,1,-13.0,-1.218630998876834,13.0,0.6984302957695783,-0.1256098877473213,-0.9594217088244956,173,93,80,0,0.25928535726370594,0.5072169069677779,0.0,0.4563983243081045,-0.23394195029678216,0.23394195029678216,0.0,0.5072169069677779,0,1,1,1,0.5072169069677779,0.0
168,1,169,26,80,90,0,3148.962,64,1415.5120000000004,LESS,-82,1546,1464,4,1,10.0,0.9374084606744876,10.0,0.17460757394239454,-0.1256098877473213,0.3205328787940869,170,80,90,1,0.19945027481823535,0.0,0.3901668515136753,1.3121451823858008,0.45654795280063576,0.45654795280063576,0.3901668515136753,0.0,0,1,1,1,0.3901668515136753,0.0
169,1,170,25,88,80,1,2129.2,64,1067.862,LESS,-166,1114,948,3,2,-8.0,-0.7499267685395902,8.0,-0.17460757394239454,-0.1256098877473213,-0.5114952059935418,168,88,80,0,0.1595602198545883,0.31213348121094026,0.0,0.4563983243081045,0.35443324882144017,0.35443324882144017,0.0,0.31213348121094026,0,1,1,1,0.31213348121094026,0.0
170,1,171,36,80,70,0,1528.68,44,1224.553,LESS,-974,1490,516,2,1,-10.0,-0.9374084606744876,10.0,0.17460757394239454,-1.1544963402851085,-1.0014619879256657,150,80,70,0,-0.19945027481823535,0.0,-0.3901668515136753,-0.3993485337695917,-0.6278129513593937,0.6278129513593937,-0.3901668515136753,0.0,0,0,0,1,0.0,-0.3901668515136753
171,1,172,28,80,93,0,1442.214,94,877.346,LESS,284,786,1070,2,2,13.0,1.218630998876834,13.0,0.6984302957695783,1.417719791059359,-1.0720099592947177,173,80,93,1,0.25928535726370594,0.0,0.5072169069677779,-0.3993485337695917,0.9014763058528452,0.9014763058528452,0.5072169069677779,0.0,1,0,1,1,0.5072169069677779,0.0
172,1,173,21,82,80,0,1628.017,34,1046.34,LESS,-990,1626,636,2,1,-2.0,-0.18748169213489754,2.0,-1.222253017596762,-1.6689395665540017,-0.920412513775277,162,82,80,0,0.03989005496364707,0.07803337030273506,0.0,-0.3993485337695917,-0.6472633711649548,0.6472633711649548,0.0,0.07803337030273506,0,0,0,1,0.07803337030273506,0.0
173,1,174,19,50,41,1,2346.231,64,2004.1,LESS,-230,1232,1002,3,2,-9.0,-0.8436676146070391,9.0,0.0,-0.1256098877473213,-0.3344187045456117,91,50,41,0,-1.376206896245824,-1.170500554541026,-1.5216507209033339,0.4563983243081045,0.2766315695991959,0.2766315695991959,-1.5216507209033339,-1.170500554541026,0,1,1,0,-1.170500554541026,-1.5216507209033339
174,1,175,56,96,110,0,3316.3390000000004,74,1293.82,LESS,-750,2054,1304,4,1,14.0,1.3123718449442827,14.0,0.8730378697119728,0.38883333852157215,0.4570964737775234,206,96,110,1,0.9174712641638826,0.6242669624218805,1.170500554541026,1.3121451823858008,-0.3555070740815388,0.3555070740815388,1.170500554541026,0.6242669624218805,1,1,0,2,1.170500554541026,0.6242669624218805
175,1,176,23,80,85,0,3031.183,74,1120.025,LESS,-868,1766,898,1,1,5.0,0.4687042303372438,5.0,-0.6984302957695783,0.38883333852157215,0.22443649964071372,165,80,85,1,0.09972513740911768,0.0,0.19508342575683765,-1.2550953918472878,-0.4989539201475517,0.4989539201475517,0.19508342575683765,0.0,1,0,0,1,0.19508342575683765,0.0
176,1,177,10,60,50,0,2266.764,64,1075.631,LESS,-902,1552,650,2,1,-10.0,-0.9374084606744876,10.0,0.17460757394239454,-0.1256098877473213,-0.3992561625150384,110,60,50,0,-0.9972513740911768,-0.7803337030273506,-1.170500554541026,-0.3993485337695917,-0.5402860622343689,0.5402860622343689,-1.170500554541026,-0.7803337030273506,1,0,0,0,-0.7803337030273506,-1.170500554541026
177,1,178,19,41,50,0,1321.42,100,742.828,LESS,546,722,1268,3,2,9.0,0.8436676146070391,9.0,0.0,1.7263857268206952,-1.170566289569661,91,41,50,1,-1.376206896245824,-1.5216507209033339,-1.170500554541026,0.4563983243081045,1.2199769301689078,1.2199769301689078,-1.170500554541026,-1.5216507209033339,1,1,1,0,-1.5216507209033339,-1.170500554541026
178,1,179,56,110,96,1,2265.431,64,1102.483,LESS,-918,1634,716,3,2,-14.0,-1.3123718449442827,14.0,0.8730378697119728,-0.1256098877473213,-0.4003437627953214,206,110,96,0,0.9174712641638826,1.170500554541026,0.6242669624218805,0.4563983243081045,-0.5597364820399301,0.5597364820399301,0.6242669624218805,1.170500554541026,1,1,0,2,1.170500554541026,0.6242669624218805
179,1,180,35,72,80,0,4164.13,64,1025.624,LESS,-510,2232,1722,4,1,8.0,0.7499267685395902,8.0,-0.17460757394239454,-0.1256098877473213,1.1488126997500427,152,72,80,1,-0.1595602198545883,-0.31213348121094026,0.0,1.3121451823858008,-0.0637507769981228,0.0637507769981228,0.0,-0.31213348121094026,0,1,1,1,-0.31213348121094026,0.0
180,1,181,11,49,50,0,2726.3920000000007,54,1155.84,LESS,-1320,2026,706,2,1,1.0,0.09374084606744876,1.0,-1.3968605915391563,-0.6400531140162148,-0.024243753193286238,99,49,50,1,-1.2166466763912356,-1.2095172396923934,-1.170500554541026,-0.3993485337695917,-1.0484282796546518,1.0484282796546518,-1.170500554541026,-1.2095172396923934,0,0,0,0,-1.2095172396923934,-1.170500554541026
181,1,182,17,43,50,1,2464.949,84,739.11,LESS,-436,1472,1036,2,2,7.0,0.6561859224721414,7.0,-0.34921514788478913,0.9032765647904656,-0.23755619136134165,93,43,50,1,-1.3363168412821769,-1.4436173506005987,-1.170500554541026,-0.3993485337695917,0.02620741460259713,0.02620741460259713,-1.170500554541026,-1.4436173506005987,1,0,1,0,-1.4436173506005987,-1.170500554541026
182,1,183,1,51,50,1,1844.314,74,1503.046,LESS,86,920,1006,1,2,-1.0,-0.09374084606744876,1.0,-1.3968605915391563,0.38883333852157215,-0.7439348860000611,101,51,50,0,-1.1767566214275886,-1.1314838693896585,-1.170500554541026,-1.2550953918472878,0.660777360759027,0.660777360759027,-1.170500554541026,-1.1314838693896585,1,0,1,0,-1.1314838693896585,-1.170500554541026
183,1,184,41,112,110,1,4667.099,84,1290.065,LESS,802,1590,2392,4,2,-2.0,-0.18748169213489754,2.0,-1.222253017596762,0.9032765647904656,1.5591872124084365,222,112,110,0,1.2365917038730592,1.248533924843761,1.170500554541026,1.3121451823858008,1.5311836470578848,1.5311836470578848,1.170500554541026,1.248533924843761,1,1,1,2,1.248533924843761,1.170500554541026
184,1,185,20,40,50,0,3192.2270000000008,80,1272.118,LESS,-358,1968,1610,2,2,10.0,0.9374084606744876,10.0,0.17460757394239454,0.6974992742829083,0.3558329734125737,90,40,50,1,-1.3961519237276474,-1.5606674060547012,-1.170500554541026,-0.3993485337695917,0.12102821115470734,0.12102821115470734,-1.170500554541026,-1.5606674060547012,1,0,1,0,-1.5606674060547012,-1.170500554541026
185,1,186,1,50,51,0,2169.18,74,1218.1989999999996,LESS,-926,1538,612,2,1,1.0,0.09374084606744876,1.0,-1.3968605915391563,0.38883333852157215,-0.4788753566269157,101,50,51,1,-1.1767566214275886,-1.170500554541026,-1.1314838693896585,-0.3993485337695917,-0.5694616919427106,0.5694616919427106,-1.1314838693896585,-1.170500554541026,1,0,0,0,-1.170500554541026,-1.1314838693896585
186,1,187,23,85,80,1,2349.446,74,2338.112,LESS,-870,1736,866,3,1,-5.0,-0.4687042303372438,5.0,-0.6984302957695783,0.38883333852157215,-0.33179557258678993,165,85,80,0,0.09972513740911768,0.19508342575683765,0.0,0.4563983243081045,-0.5013852226232468,0.5013852226232468,0.0,0.19508342575683765,1,1,0,1,0.19508342575683765,0.0
187,1,188,11,50,49,0,3171.303,84,1148.621,LESS,-824,2006,1182,4,2,-1.0,-0.09374084606744876,1.0,-1.3968605915391563,0.9032765647904656,0.33876099421929423,99,50,49,0,-1.2166466763912356,-1.170500554541026,-1.2095172396923934,1.3121451823858008,-0.44546526568225875,0.44546526568225875,-1.2095172396923934,-1.170500554541026,1,1,0,0,-1.170500554541026,-1.2095172396923934
188,1,189,17,50,43,0,2993.885,84,824.794,LESS,-1362,2340,978,2,2,-7.0,-0.6561859224721414,7.0,-0.34921514788478913,0.9032765647904656,0.19400490530163386,93,50,43,0,-1.3363168412821769,-1.170500554541026,-1.4436173506005987,-0.3993485337695917,-1.0994856316442496,1.0994856316442496,-1.4436173506005987,-1.170500554541026,1,0,0,0,-1.170500554541026,-1.4436173506005987
189,1,190,21,80,82,0,2046.197,74,1904.786,LESS,-1160,1766,606,2,1,2.0,0.18748169213489754,2.0,-1.222253017596762,0.38883333852157215,-0.5792177011655795,162,80,82,1,0.03989005496364707,0.0,0.07803337030273506,-0.3993485337695917,-0.8539240815990411,0.8539240815990411,0.07803337030273506,0.0,1,0,0,1,0.07803337030273506,0.0
190,1,191,10,50,60,0,2000.771,84,944.253,LESS,-698,1600,902,2,2,10.0,0.9374084606744876,10.0,0.17460757394239454,0.9032765647904656,-0.6162809647305709,110,50,60,1,-0.9972513740911768,-1.170500554541026,-0.7803337030273506,-0.3993485337695917,-0.29229320971346534,0.29229320971346534,-0.7803337030273506,-1.170500554541026,1,0,0,0,-1.170500554541026,-0.7803337030273506
191,1,192,3,53,50,1,3949.34,0,1103.534,LESS,-1192,2932,1740,4,1,-3.0,-0.28122253820234633,3.0,-1.0476454436543674,-3.4180465358682395,0.9735646395835188,103,53,50,0,-1.1368665664639415,-1.0534504990869233,-1.170500554541026,1.3121451823858008,-0.8928249212101632,0.8928249212101632,-1.170500554541026,-1.0534504990869233,0,1,0,0,-1.0534504990869233,-1.170500554541026
192,1,193,45,122,110,1,2302.897,64,1668.531,LESS,-954,1710,756,3,2,-12.0,-1.124890152809385,12.0,0.5238227218271837,-0.1256098877473213,-0.36977509655295,232,122,110,0,1.4360419786912946,1.6387007763574364,1.170500554541026,0.4563983243081045,-0.6034999266024424,0.6034999266024424,1.170500554541026,1.6387007763574364,0,1,0,2,1.6387007763574364,1.170500554541026
193,1,194,38,67,80,0,1967.521,64,1759.361,LESS,-996,1610,614,2,1,13.0,1.218630998876834,13.0,0.6984302957695783,-0.1256098877473213,-0.6434097789236753,147,67,80,1,-0.25928535726370594,-0.5072169069677779,0.0,-0.3993485337695917,-0.6545572785920402,0.6545572785920402,0.0,-0.5072169069677779,0,0,0,1,-0.5072169069677779,0.0
194,1,195,38,80,67,0,5436.005,64,1471.9979999999996,LESS,-1502,3344,1842,3,2,-13.0,-1.218630998876834,13.0,0.6984302957695783,-0.1256098877473213,2.186540836647932,147,80,67,0,-0.25928535726370594,0.0,-0.5072169069677779,0.4563983243081045,-1.269676804942909,1.269676804942909,-0.5072169069677779,0.0,0,1,0,1,0.0,-0.5072169069677779
195,1,196,36,70,80,0,1555.042,74,1102.927,LESS,-608,1266,658,2,2,10.0,0.9374084606744876,10.0,0.17460757394239454,0.38883333852157215,-0.9799531217675118,150,70,80,1,-0.19945027481823535,-0.3901668515136753,0.0,-0.3993485337695917,-0.18288459830718434,0.18288459830718434,0.0,-0.3901668515136753,1,0,1,1,-0.3901668515136753,0.0
196,1,197,45,110,122,0,1991.723,74,1501.471,LESS,-158,1348,1190,2,2,12.0,1.124890152809385,12.0,0.5238227218271837,0.38883333852157215,-0.6236632658078404,232,110,122,1,1.4360419786912946,1.170500554541026,1.6387007763574364,-0.3993485337695917,0.3641584587242207,0.3641584587242207,1.6387007763574364,1.170500554541026,1,0,1,2,1.6387007763574364,1.170500554541026
197,1,198,42,110,115,0,3401.665,74,1125.329,LESS,-676,1924,1248,4,1,5.0,0.4687042303372438,5.0,-0.6984302957695783,0.38883333852157215,0.52671431437424,225,110,115,1,1.2964267863185297,1.170500554541026,1.3655839802978638,1.3121451823858008,-0.26554888248081887,0.26554888248081887,1.3655839802978638,1.170500554541026,1,1,0,2,1.3655839802978638,1.170500554541026
198,1,199,41,110,112,1,4202.816,74,712.398,LESS,-930,2248,1318,2,2,2.0,0.18748169213489754,2.0,-1.222253017596762,0.38883333852157215,1.1803767690996496,222,110,112,1,1.2365917038730592,1.170500554541026,1.248533924843761,-0.3993485337695917,-0.5743242968941008,0.5743242968941008,1.248533924843761,1.170500554541026,1,0,0,2,1.248533924843761,1.170500554541026
199,1,200,53,110,103,1,2110.906,44,1689.99,LESS,-212,1486,1274,4,1,-7.0,-0.6561859224721414,7.0,-0.34921514788478913,-1.1544963402851085,-0.5264213571769599,213,110,103,0,1.0570864565366473,1.170500554541026,0.8973837584814532,1.3121451823858008,0.29851329188045206,0.29851329188045206,0.8973837584814532,1.170500554541026,0,1,1,2,1.170500554541026,0.8973837584814532
200,1,201,3,50,53,1,3496.366,84,432.927,MORE,538,1100,1638,3,1,3.0,0.28122253820234633,3.0,-1.0476454436543674,0.9032765647904656,0.6039812567171329,103,50,53,0,-1.1368665664639415,-1.170500554541026,-1.0534504990869233,0.4563983243081045,1.2102517202661272,1.2102517202661272,-1.0534504990869233,-1.170500554541026,1,1,1,0,-1.170500554541026,-1.0534504990869233
201,1,202,20,50,40,1,2849.513,44,1664.501,MORE,-398,1728,1330,4,1,-10.0,-0.9374084606744876,10.0,0.17460757394239454,-1.1544963402851085,0.07621118612308066,90,50,40,1,-1.3961519237276474,-1.170500554541026,-1.5606674060547012,1.3121451823858008,0.07240216164080467,0.07240216164080467,-1.5606674060547012,-1.170500554541026,0,1,0,0,-1.170500554541026,-1.5606674060547012
202,1,203,25,80,88,1,1540.3929999999998,84,738.904,MORE,704,510,1214,1,2,8.0,0.7499267685395902,8.0,-0.17460757394239454,0.9032765647904656,-0.9919053021920168,168,80,88,0,0.1595602198545883,0.0,0.31213348121094026,-1.2550953918472878,1.4120498257488232,1.4120498257488232,0.31213348121094026,0.0,1,0,1,1,0.31213348121094026,0.0
203,1,204,42,115,110,0,2342.863,94,908.769,MORE,-424,1676,1252,2,2,-5.0,-0.4687042303372438,5.0,-0.6984302957695783,1.417719791059359,-0.33716666984493154,225,115,110,1,1.2964267863185297,1.3655839802978638,1.170500554541026,-0.3993485337695917,0.04079522945676793,0.04079522945676793,1.170500554541026,1.3655839802978638,1,0,0,2,1.3655839802978638,1.170500554541026
204,1,205,53,103,110,1,2502.521,74,987.566,MORE,734,1164,1898,3,2,7.0,0.6561859224721414,7.0,-0.34921514788478913,0.38883333852157215,-0.20690103927522654,213,103,110,0,1.0570864565366473,0.8973837584814532,1.170500554541026,0.4563983243081045,1.4485193628842503,1.4485193628842503,1.170500554541026,0.8973837584814532,1,1,1,2,1.170500554541026,0.8973837584814532
205,1,206,26,90,80,0,1799.6270000000004,74,1023.062,MORE,-412,1320,908,2,2,-10.0,-0.9374084606744876,10.0,0.17460757394239454,0.38883333852157215,-0.7803951963714071,170,90,80,1,0.19945027481823535,0.3901668515136753,0.0,-0.3993485337695917,0.05538304431093873,0.05538304431093873,0.0,0.3901668515136753,1,1,0,1,0.3901668515136753,0.0
206,1,207,35,80,72,1,5352.23,74,1152.651,MORE,-1290,3068,1778,3,2,-8.0,-0.7499267685395902,8.0,-0.17460757394239454,0.38883333852157215,2.1181884634441017,152,80,72,1,-0.1595602198545883,0.0,-0.31213348121094026,0.4563983243081045,-1.011958742519225,1.011958742519225,-0.31213348121094026,0.0,1,1,0,1,0.0,-0.31213348121094026
207,1,208,28,93,80,0,2424.21,54,2050.051,MORE,-1682,2104,422,2,1,-13.0,-1.218630998876834,13.0,0.6984302957695783,-0.6400531140162148,-0.27079531200533824,173,93,80,1,0.25928535726370594,0.5072169069677779,0.0,-0.3993485337695917,-1.488494027755471,1.488494027755471,0.0,0.5072169069677779,0,0,0,1,0.5072169069677779,0.0
208,1,209,26,80,90,1,1269.404,94,2162.822,MORE,620,850,1470,1,2,10.0,0.9374084606744876,10.0,0.17460757394239454,1.417719791059359,-1.213006361722098,170,80,90,0,0.19945027481823535,0.0,0.3901668515136753,-1.2550953918472878,1.3099351217696278,1.3099351217696278,0.3901668515136753,0.0,1,0,1,1,0.3901668515136753,0.0
209,1,210,25,88,80,0,2779.274000000001,64,1320.794,MORE,154,1314,1468,4,1,-8.0,-0.7499267685395902,8.0,-0.17460757394239454,-0.1256098877473213,0.01890289198445075,168,88,80,1,0.1595602198545883,0.31213348121094026,0.0,1.3121451823858008,0.7434416449326616,0.7434416449326616,0.0,0.31213348121094026,0,1,1,1,0.31213348121094026,0.0
210,1,211,36,80,70,0,2537.132,74,992.259,MORE,-1214,1742,528,2,1,-10.0,-0.9374084606744876,10.0,0.17460757394239454,0.38883333852157215,-0.17866177948462394,150,80,70,1,-0.19945027481823535,0.0,-0.3901668515136753,-0.3993485337695917,-0.9195692484428097,0.9195692484428097,-0.3901668515136753,0.0,1,0,0,1,0.0,-0.3901668515136753
211,1,212,28,80,93,1,2351.272,54,1543.057,MORE,124,1088,1212,3,2,13.0,1.218630998876834,13.0,0.6984302957695783,-0.6400531140162148,-0.3303057315426814,173,80,93,0,0.25928535726370594,0.0,0.5072169069677779,0.4563983243081045,0.7069721077972346,0.7069721077972346,0.5072169069677779,0.0,0,1,1,1,0.5072169069677779,0.0
212,1,213,21,82,80,0,2358.716,64,1835.591,MORE,-798,1616,818,2,1,-2.0,-0.18748169213489754,2.0,-1.222253017596762,-0.1256098877473213,-0.32423214078017104,162,82,80,1,0.03989005496364707,0.07803337030273506,0.0,-0.3993485337695917,-0.41385833349822204,0.41385833349822204,0.0,0.07803337030273506,0,0,0,1,0.07803337030273506,0.0
213,1,214,19,50,41,0,2684.724,94,777.5010000000002,MORE,-130,1620,1490,4,2,-9.0,-0.8436676146070391,9.0,0.0,1.417719791059359,-0.05824084882631765,91,50,41,1,-1.376206896245824,-1.170500554541026,-1.5216507209033339,1.3121451823858008,0.3981966933839526,0.3981966933839526,-1.5216507209033339,-1.170500554541026,1,1,1,0,-1.170500554541026,-1.5216507209033339
214,1,215,56,96,110,1,1983.477,54,1333.025,MORE,-206,1164,958,3,2,14.0,1.3123718449442827,14.0,0.8730378697119728,-0.6400531140162148,-0.6303912117277302,206,96,110,0,0.9174712641638826,0.6242669624218805,1.170500554541026,0.4563983243081045,0.30580719930753747,0.30580719930753747,1.170500554541026,0.6242669624218805,0,1,1,2,1.170500554541026,0.6242669624218805
215,1,216,23,80,85,1,4650.79,74,1294.437,MORE,-186,2200,2014,3,2,5.0,0.4687042303372438,5.0,-0.6984302957695783,0.38883333852157215,1.5458806310347415,165,80,85,0,0.09972513740911768,0.0,0.19508342575683765,0.4563983243081045,0.3301202240644888,0.3301202240644888,0.19508342575683765,0.0,1,1,1,1,0.19508342575683765,0.0
216,1,217,10,60,50,0,3835.065,74,1112.861,MORE,-1362,2464,1102,4,1,-10.0,-0.9374084606744876,10.0,0.17460757394239454,0.38883333852157215,0.8803271886987963,110,60,50,1,-0.9972513740911768,-0.7803337030273506,-1.170500554541026,1.3121451823858008,-1.0994856316442496,1.0994856316442496,-1.170500554541026,-0.7803337030273506,1,1,0,0,-0.7803337030273506,-1.170500554541026
217,1,218,19,41,50,1,3849.206,74,1285.45,MORE,-844,2306,1462,3,2,9.0,0.8436676146070391,9.0,0.0,0.38883333852157215,0.8918648897966819,91,41,50,0,-1.376206896245824,-1.5216507209033339,-1.170500554541026,0.4563983243081045,-0.4697782904392101,0.4697782904392101,-1.170500554541026,-1.5216507209033339,1,1,0,0,-1.5216507209033339,-1.170500554541026
218,1,219,56,110,96,0,3243.343,94,856.525,MORE,-1114,2346,1232,2,2,-14.0,-1.3123718449442827,14.0,0.8730378697119728,1.417719791059359,0.3975387317973769,206,110,96,1,0.9174712641638826,1.170500554541026,0.6242669624218805,-0.3993485337695917,-0.798004124658053,0.798004124658053,0.6242669624218805,1.170500554541026,1,0,0,2,1.170500554541026,0.6242669624218805
219,1,220,35,72,80,1,1644.5839999999996,74,911.53,MORE,-192,954,762,1,2,8.0,0.7499267685395902,8.0,-0.17460757394239454,0.38883333852157215,-0.906895429121528,152,72,80,0,-0.1595602198545883,-0.31213348121094026,0.0,-1.2550953918472878,0.3228263166374034,0.3228263166374034,0.0,-0.31213348121094026,1,0,1,1,-0.31213348121094026,0.0
220,1,221,11,49,50,1,1274.981,84,1153.684,MORE,798,452,1250,1,2,1.0,0.09374084606744876,1.0,-1.3968605915391563,0.9032765647904656,-1.2084560640753326,99,49,50,0,-1.2166466763912356,-1.2095172396923934,-1.170500554541026,-1.2550953918472878,1.5263210421064946,1.5263210421064946,-1.170500554541026,-1.2095172396923934,1,0,1,0,-1.2095172396923934,-1.170500554541026
221,1,222,17,43,50,1,2589.055,84,1447.4779999999996,MORE,1496,1084,2580,3,2,7.0,0.6561859224721414,7.0,-0.34921514788478913,0.9032765647904656,-0.13629758642150938,93,43,50,0,-1.3363168412821769,-1.4436173506005987,-1.170500554541026,0.4563983243081045,2.3748456061240963,2.3748456061240963,-1.170500554541026,-1.4436173506005987,1,1,1,0,-1.4436173506005987,-1.170500554541026
222,1,223,1,51,50,0,2300.565,64,1864.028,MORE,-1120,1764,644,2,1,-1.0,-0.09374084606744876,1.0,-1.3968605915391563,-0.1256098877473213,-0.37167778511530536,101,51,50,1,-1.1767566214275886,-1.1314838693896585,-1.170500554541026,-0.3993485337695917,-0.8052980320851385,0.8052980320851385,-1.170500554541026,-1.1314838693896585,0,0,0,0,-1.1314838693896585,-1.170500554541026
223,1,224,41,112,110,0,2922.026,84,666.538,MORE,-1002,1912,910,2,2,-2.0,-0.18748169213489754,2.0,-1.222253017596762,0.9032765647904656,0.13537484638126368,222,112,110,1,1.2365917038730592,1.248533924843761,1.170500554541026,-0.3993485337695917,-0.6618511860191256,0.6618511860191256,1.170500554541026,1.248533924843761,1,0,0,2,1.248533924843761,1.170500554541026
224,1,225,20,40,50,1,1135.847,64,1704.19,MORE,478,398,876,1,2,10.0,0.9374084606744876,10.0,0.17460757394239454,-0.1256098877473213,-1.3219760771262619,90,40,50,0,-1.3961519237276474,-1.5606674060547012,-1.170500554541026,-1.2550953918472878,1.1373126459952732,1.1373126459952732,-1.170500554541026,-1.5606674060547012,0,0,1,0,-1.5606674060547012,-1.170500554541026
225,1,226,1,50,51,1,1991.672,74,1875.281,MORE,104,964,1068,3,2,1.0,0.09374084606744876,1.0,-1.3968605915391563,0.38883333852157215,-0.6237048769213395,101,50,51,0,-1.1767566214275886,-1.170500554541026,-1.1314838693896585,0.4563983243081045,0.6826590830402832,0.6826590830402832,-1.1314838693896585,-1.170500554541026,1,1,1,0,-1.170500554541026,-1.1314838693896585
226,1,227,23,85,80,0,1851.808,94,874.096,MORE,-572,1508,936,2,2,-5.0,-0.4687042303372438,5.0,-0.6984302957695783,1.417719791059359,-0.7378205000282378,165,85,80,1,0.09972513740911768,0.19508342575683765,0.0,-0.3993485337695917,-0.13912115374467193,0.13912115374467193,0.0,0.19508342575683765,1,0,0,1,0.19508342575683765,0.0
227,1,228,11,50,49,1,1321.034,64,1625.473,MORE,170,582,752,1,2,-1.0,-0.09374084606744876,1.0,-1.3968605915391563,-0.1256098877473213,-1.1708812285855568,99,50,49,1,-1.2166466763912356,-1.170500554541026,-1.2095172396923934,-1.2550953918472878,0.7628920647382227,0.7628920647382227,-1.2095172396923934,-1.170500554541026,0,0,1,0,-1.170500554541026,-1.2095172396923934
228,1,229,17,50,43,1,4003.124,84,710.547,MORE,-558,2450,1892,5,2,-7.0,-0.6561859224721414,7.0,-0.34921514788478913,0.9032765647904656,1.0174472303372608,93,50,43,1,-1.3363168412821769,-1.170500554541026,-1.4436173506005987,2.1678920404634967,-0.122102036414806,0.122102036414806,-1.4436173506005987,-1.170500554541026,1,1,0,0,-1.170500554541026,-1.4436173506005987
229,1,230,21,80,82,0,1954.281,64,1126.757,MORE,-966,1518,552,2,1,2.0,0.18748169213489754,2.0,-1.222253017596762,-0.1256098877473213,-0.6542123503497417,162,80,82,0,0.03989005496364707,0.0,0.07803337030273506,-0.3993485337695917,-0.6180877414566133,0.6180877414566133,0.07803337030273506,0.0,0,0,0,1,0.07803337030273506,0.0
230,1,231,10,50,60,1,2030.128,84,954.748,MORE,644,914,1558,3,2,10.0,0.9374084606744876,10.0,0.17460757394239454,0.9032765647904656,-0.5923284655345719,110,50,60,0,-0.9972513740911768,-1.170500554541026,-0.7803337030273506,0.4563983243081045,1.3391107514779692,1.3391107514779692,-0.7803337030273506,-1.170500554541026,1,1,1,0,-1.170500554541026,-0.7803337030273506
231,1,232,3,53,50,0,1964.125,74,876.316,MORE,-798,1458,660,2,2,-3.0,-0.28122253820234633,3.0,-1.0476454436543674,0.38883333852157215,-0.6461805895402102,103,53,50,1,-1.1368665664639415,-1.0534504990869233,-1.170500554541026,-0.3993485337695917,-0.41385833349822204,0.41385833349822204,-1.170500554541026,-1.0534504990869233,1,0,0,0,-1.0534504990869233,-1.170500554541026
232,1,233,45,122,110,0,2014.069,34,984.045,MORE,-1062,1572,510,2,1,-12.0,-1.124890152809385,12.0,0.5238227218271837,-1.6689395665540017,-0.6054310708617016,232,122,110,1,1.4360419786912946,1.6387007763574364,1.170500554541026,-0.3993485337695917,-0.7347902602899796,0.7347902602899796,1.170500554541026,1.6387007763574364,0,0,0,2,1.6387007763574364,1.170500554541026
233,1,234,38,67,80,1,1598.829,64,1315.51,MORE,160,694,854,1,2,13.0,1.218630998876834,13.0,0.6984302957695783,-0.1256098877473213,-0.9442271251637984,147,67,80,0,-0.25928535726370594,-0.5072169069677779,0.0,-1.2550953918472878,0.750735552359747,0.750735552359747,0.0,-0.5072169069677779,0,0,1,1,-0.5072169069677779,0.0
234,1,235,38,80,67,1,1453.6029999999996,64,1718.6129999999996,MORE,170,724,894,1,1,-13.0,-1.218630998876834,13.0,0.6984302957695783,-0.1256098877473213,-1.0627176265174167,147,80,67,1,-0.25928535726370594,0.0,-0.5072169069677779,-1.2550953918472878,0.7628920647382227,0.7628920647382227,-0.5072169069677779,0.0,0,0,1,1,0.0,-0.5072169069677779
235,1,236,36,70,80,1,1977.727,54,1440.858,MORE,-852,1508,656,3,2,10.0,0.9374084606744876,10.0,0.17460757394239454,-0.6400531140162148,-0.6350826607987181,150,70,80,0,-0.19945027481823535,-0.3901668515136753,0.0,0.4563983243081045,-0.47950350034199063,0.47950350034199063,0.0,-0.3901668515136753,0,1,0,1,-0.3901668515136753,0.0
236,1,237,45,110,122,1,1623.8970000000004,84,1477.973,MORE,822,576,1398,1,2,12.0,1.124890152809385,12.0,0.5238227218271837,0.9032765647904656,-0.923774039022663,232,110,122,0,1.4360419786912946,1.170500554541026,1.6387007763574364,-1.2550953918472878,1.5554966718148362,1.5554966718148362,1.6387007763574364,1.170500554541026,1,0,1,2,1.6387007763574364,1.170500554541026
237,1,238,42,110,115,1,2901.364,64,2333.854,MORE,-650,1714,1064,3,2,5.0,0.4687042303372438,5.0,-0.6984302957695783,-0.1256098877473213,0.11851663408478487,225,110,115,0,1.2964267863185297,1.170500554541026,1.3655839802978638,0.4563983243081045,-0.23394195029678216,0.23394195029678216,1.3655839802978638,1.170500554541026,0,1,0,2,1.3655839802978638,1.170500554541026
238,1,239,41,110,112,1,1565.164,74,810.788,MORE,142,794,936,1,2,2.0,0.18748169213489754,2.0,-1.222253017596762,0.38883333852157215,-0.9716945395942004,222,110,112,0,1.2365917038730592,1.170500554541026,1.248533924843761,-1.2550953918472878,0.7288538300784908,0.7288538300784908,1.248533924843761,1.170500554541026,1,0,1,2,1.248533924843761,1.170500554541026
239,1,240,53,110,103,1,1559.884,94,647.066,MORE,772,710,1482,1,2,-7.0,-0.6561859224721414,7.0,-0.34921514788478913,1.417719791059359,-0.9760025136976468,213,110,103,1,1.0570864565366473,1.170500554541026,0.8973837584814532,-1.2550953918472878,1.494714109922458,1.494714109922458,0.8973837584814532,1.170500554541026,1,0,1,2,1.170500554541026,0.8973837584814532
240,2,1,49,110,131,1,6228.547,44,2706.716,MORE,-774,2818,2044,0,1,21.0,1.9685577674164243,21.0,2.0952908873087353,-0.2383866467636475,-0.3827015480638571,241,110,131,0,1.6155472260277064,1.170500554541026,1.9898509427197442,-1.2453033096779946,0.08615765871235868,0.08615765871235868,1.9898509427197442,1.170500554541026,0,0,0,2,1.9898509427197442,1.170500554541026
241,2,2,13,47,50,1,6635.751,54,1508.9879999999996,MORE,-100,2964,2864,1,2,3.0,0.28122253820234633,3.0,-1.0476454436543674,0.3862071875515856,-0.3377033166291929,97,47,50,0,-1.2565367313548828,-1.2875506099951286,-1.170500554541026,-0.9649348347035869,0.2578531063212773,0.2578531063212773,-1.170500554541026,-1.2875506099951286,1,0,1,0,-1.2875506099951286,-1.170500554541026
242,2,3,16,50,44,0,4766.7440000000015,64,1664.542,MORE,-2342,3374,1032,1,1,-6.0,-0.5624450764046927,6.0,-0.5238227218271837,1.0108010218668186,-0.544238639315137,94,50,44,1,-1.3163718138003533,-1.170500554541026,-1.4046006654492311,-0.9649348347035869,-0.3132762609475587,0.3132762609475587,-1.4046006654492311,-1.170500554541026,1,0,0,0,-1.170500554541026,-1.4046006654492311
243,2,4,7,57,50,0,10945.402,44,3357.675,MORE,-3794,6598,2804,3,1,-7.0,-0.6561859224721414,7.0,-0.34921514788478913,-0.2383866467636475,0.13853629079271718,107,57,50,1,-1.0570864565366473,-0.8973837584814532,-1.170500554541026,-0.40419788475477125,-0.6831602222652884,0.6831602222652884,-1.170500554541026,-0.8973837584814532,0,1,0,0,-0.8973837584814532,-1.170500554541026
244,2,5,18,42,50,1,5673.265,54,1448.471,MORE,-2798,4022,1224,1,2,8.0,0.7499267685395902,8.0,-0.17460757394239454,0.3862071875515856,-0.4440631946771102,92,42,50,0,-1.3562618687640005,-1.4826340357519663,-1.170500554541026,-0.9649348347035869,-0.42943816615477964,0.42943816615477964,-1.170500554541026,-1.4826340357519663,1,0,0,0,-1.4826340357519663,-1.170500554541026
245,2,6,51,108,110,1,46657.359,44,2199.183,MORE,19840,3150,22990,0,2,2.0,0.18748169213489754,2.0,-1.222253017596762,-0.2383866467636475,4.084899553606373,218,108,110,0,1.156811593945765,1.092467184238291,1.170500554541026,-1.2453033096779946,5.337389048935279,5.337389048935279,1.170500554541026,1.092467184238291,0,0,1,2,1.170500554541026,1.092467184238291
246,2,7,31,78,80,0,7750.691,54,1752.105,MORE,-2098,4108,2010,3,2,2.0,0.18748169213489754,2.0,-1.222253017596762,0.3862071875515856,-0.2144964518740227,158,78,80,0,-0.03989005496364707,-0.07803337030273506,0.0,-0.40419788475477125,-0.2511194520208879,0.2511194520208879,0.0,-0.07803337030273506,1,0,0,1,-0.07803337030273506,0.0
247,2,8,58,110,92,0,9776.843,44,1876.795,MORE,40,4390,4430,1,2,-18.0,-1.6873352292140782,18.0,1.571468165481551,-0.2383866467636475,0.00940423824151533,202,110,92,1,0.8376911542365885,1.170500554541026,0.4682002218164104,-0.9649348347035869,0.29351684914805565,0.29351684914805565,0.4682002218164104,1.170500554541026,0,0,1,2,1.170500554541026,0.4682002218164104
248,2,9,12,50,48,1,7758.235,54,1338.013,MORE,1078,2096,3174,1,2,-2.0,-0.18748169213489754,2.0,-1.222253017596762,0.3862071875515856,-0.2136627993118104,98,50,48,1,-1.2365917038730592,-1.170500554541026,-1.248533924843761,-0.9649348347035869,0.5579380281065979,0.5579380281065979,-1.248533924843761,-1.170500554541026,1,0,1,0,-1.170500554541026,-1.248533924843761
249,2,10,54,110,101,0,44526.337,34,1508.46,MORE,-25146,28094,2948,0,1,-9.0,-0.8436676146070391,9.0,0.0,-0.8629804810788805,3.84941016463092,211,110,101,1,1.0171964015730004,1.170500554541026,0.8193503881787182,-1.2453033096779946,-6.122390485389368,6.122390485389368,0.8193503881787182,1.170500554541026,0,0,0,2,1.170500554541026,0.8193503881787182
250,2,11,14,46,50,1,10806.455,44,1927.361,MORE,-1044,4480,3436,1,2,4.0,0.3749633842697951,4.0,-0.8730378697119728,-0.2383866467636475,0.12318190020924485,96,46,50,0,-1.2764817588367063,-1.3265672951464962,-1.170500554541026,-0.9649348347035869,0.01737758326071474,0.01737758326071474,-1.170500554541026,-1.3265672951464962,0,0,0,0,-1.3265672951464962,-1.170500554541026
251,2,12,22,80,83,1,5936.281,44,1562.155,MORE,-1008,2684,1676,1,2,3.0,0.28122253820234633,3.0,-1.0476454436543674,-0.2383866467636475,-0.4149985125054724,163,80,83,0,0.05983508244547061,0.0,0.1170500554541026,-0.9649348347035869,0.0265482599876006,0.0265482599876006,0.1170500554541026,0.0,0,0,0,1,0.1170500554541026,0.0
252,2,13,6,50,56,0,22118.048,34,1101.606,MORE,9542,2232,11774,1,2,6.0,0.5624450764046927,6.0,-0.5238227218271837,-0.8629804810788805,1.3731737463323823,106,50,56,0,-1.077031484018471,-1.170500554541026,-0.9364004436328208,-0.9649348347035869,2.71406602300554,2.71406602300554,-0.9364004436328208,-1.170500554541026,0,0,1,0,-1.170500554541026,-0.9364004436328208
253,2,14,13,50,47,0,7867.571999999999,44,3369.01,MORE,-1188,4166,2978,3,2,-3.0,-0.28122253820234633,3.0,-1.0476454436543674,-0.2383866467636475,-0.2015804729339461,97,50,47,1,-1.2565367313548828,-1.170500554541026,-1.2875506099951286,-0.40419788475477125,-0.0193051236468287,0.0193051236468287,-1.2875506099951286,-1.170500554541026,0,0,0,0,-1.170500554541026,-1.2875506099951286
254,2,15,46,110,124,1,24336.379,54,1630.879,MORE,-8906,12596,3690,0,2,14.0,1.3123718449442827,14.0,0.8730378697119728,0.3862071875515856,1.6183112492466218,234,110,124,0,1.4759320336549415,1.170500554541026,1.7167341466601715,-1.2453033096779946,-1.9853963174830804,1.9853963174830804,1.7167341466601715,1.170500554541026,1,0,0,2,1.7167341466601715,1.170500554541026
255,2,16,27,91,80,0,12568.18,64,2302.5460000000007,MORE,-5716,7476,1760,2,1,-11.0,-1.0311493067419364,11.0,0.34921514788478913,1.0108010218668186,0.3178619850665488,171,91,80,1,0.21939530230005888,0.4291835366650429,0.0,-0.6845663597291791,-1.1727724630729166,1.1727724630729166,0.0,0.4291835366650429,1,0,0,1,0.4291835366650429,0.0
256,2,17,40,64,80,1,7216.4209999999985,54,2637.44,MORE,1098,2618,3716,1,2,16.0,1.4998535370791803,16.0,1.222253017596762,0.3862071875515856,-0.27353615951097626,144,64,80,0,-0.3191204397091766,-0.6242669624218805,0.0,-0.9649348347035869,0.5630328485104233,0.5630328485104233,0.0,-0.6242669624218805,1,0,1,1,-0.6242669624218805,0.0
257,2,18,22,83,80,0,24450.946,14,2532.688,MORE,7056,3328,10384,0,1,-3.0,-0.28122253820234633,3.0,-1.0476454436543674,-2.1121681497093467,1.6309715187448957,163,83,80,1,0.05983508244547061,0.1170500554541026,0.0,-1.2453033096779946,2.0807798468100334,2.0807798468100334,0.0,0.1170500554541026,0,0,1,1,0.1170500554541026,0.0
258,2,19,54,101,110,1,20652.52,64,1312.765,MORE,-9126,12034,2908,0,2,9.0,0.8436676146070391,9.0,0.0,1.0108010218668186,1.2112250225527037,211,101,110,0,1.0171964015730004,0.8193503881787182,1.170500554541026,-1.2453033096779946,-2.0414393419251606,2.0414393419251606,1.170500554541026,0.8193503881787182,1,0,0,2,1.170500554541026,0.8193503881787182
259,2,20,6,56,50,0,9962.632,54,2276.246,MORE,-1074,3966,2892,0,2,-6.0,-0.5624450764046927,6.0,-0.5238227218271837,0.3862071875515856,0.029934921682775124,106,56,50,1,-1.077031484018471,-0.9364004436328208,-1.170500554541026,-1.2453033096779946,0.009735352654976524,0.009735352654976524,-1.170500554541026,-0.9364004436328208,1,0,0,0,-0.9364004436328208,-1.170500554541026
260,2,21,18,50,42,0,15264.738,54,1635.842,MORE,-880,4796,3916,0,2,-8.0,-0.7499267685395902,8.0,-0.17460757394239454,0.3862071875515856,0.6158461427884643,92,50,42,1,-1.3562618687640005,-1.170500554541026,-1.4826340357519663,-1.2453033096779946,0.059155110572083655,0.059155110572083655,-1.4826340357519663,-1.170500554541026,1,0,0,0,-1.170500554541026,-1.4826340357519663
261,2,22,43,110,117,1,14577.04,44,2014.369,MORE,-3946,6904,2958,0,2,7.0,0.6561859224721414,7.0,-0.34921514788478913,-0.2383866467636475,0.5398518162073022,227,110,117,0,1.3363168412821769,1.170500554541026,1.4436173506005987,-1.2453033096779946,-0.721880857334362,0.721880857334362,1.4436173506005987,1.170500554541026,0,0,0,2,1.4436173506005987,1.170500554541026
262,2,23,32,77,80,0,10502.538,44,1051.856,MORE,-2756,4920,2164,1,2,3.0,0.28122253820234633,3.0,-1.0476454436543674,-0.2383866467636475,0.08959743762309935,157,77,80,0,-0.05983508244547061,-0.1170500554541026,0.0,-0.9649348347035869,-0.41873904330674616,0.41873904330674616,0.0,-0.1170500554541026,1,0,0,1,-0.1170500554541026,0.0
263,2,24,27,80,91,1,8938.346,44,1513.951,MORE,-1476,4144,2668,0,2,11.0,1.0311493067419364,11.0,0.34921514788478913,-0.2383866467636475,-0.08325418864837668,171,80,91,0,0.21939530230005888,0.0,0.4291835366650429,-1.2453033096779946,-0.09267053746191557,0.09267053746191557,0.4291835366650429,0.0,0,0,0,1,0.4291835366650429,0.0
264,2,25,16,44,50,1,8371.705,34,1023.203,MORE,-438,3020,2582,1,2,6.0,0.5624450764046927,6.0,-0.5238227218271837,-0.8629804810788805,-0.1458710658361486,94,44,50,0,-1.3163718138003533,-1.4046006654492311,-1.170500554541026,-0.9649348347035869,0.17175064149662672,0.17175064149662672,-1.170500554541026,-1.4046006654492311,0,0,1,0,-1.4046006654492311,-1.170500554541026
265,2,26,7,50,57,0,8634.889000000001,54,2300.298,MORE,1150,2756,3906,1,2,7.0,0.6561859224721414,7.0,-0.34921514788478913,0.3862071875515856,-0.1167878187612164,107,50,57,0,-1.0570864565366473,-1.170500554541026,-0.8973837584814532,-0.9649348347035869,0.5762793815603696,0.5762793815603696,-0.8973837584814532,-1.170500554541026,1,0,1,0,-1.170500554541026,-0.8973837584814532
266,2,27,14,50,46,0,9256.349,54,2087.074,MORE,-3174,5374,2200,1,2,-4.0,-0.3749633842697951,4.0,-0.8730378697119728,0.3862071875515856,-0.048113147325311315,96,50,46,1,-1.2764817588367063,-1.170500554541026,-1.3265672951464962,-0.9649348347035869,-0.5252207897466986,0.5252207897466986,-1.3265672951464962,-1.170500554541026,1,0,0,0,-1.170500554541026,-1.3265672951464962
267,2,28,51,110,108,0,98982.33,54,1930.567,MORE,-38214,41894,3680,2,1,-2.0,-0.18748169213489754,2.0,-1.222253017596762,0.3862071875515856,9.867090187465783,218,110,108,1,1.156811593945765,1.170500554541026,1.092467184238291,-0.6845663597291791,-9.451346137248935,9.451346137248935,1.092467184238291,1.170500554541026,1,0,0,2,1.170500554541026,1.092467184238291
268,2,29,50,133,110,0,71123.695,44,3266.077,MORE,-23686,30474,6788,0,2,-23.0,-2.1560394595513217,23.0,2.444506035193524,-0.2383866467636475,6.788561231011935,243,133,110,1,1.6554372809913533,2.0678843130224793,1.170500554541026,-1.2453033096779946,-5.7504685959101085,5.7504685959101085,1.170500554541026,2.0678843130224793,0,0,0,2,2.0678843130224793,1.170500554541026
269,2,30,49,131,110,1,14323.977,64,1098.639,MORE,-2602,5912,3310,7,2,-21.0,-1.9685577674164243,21.0,2.0952908873087353,1.0108010218668186,0.5118869940504707,241,131,110,1,1.6155472260277064,1.9898509427197442,1.170500554541026,0.7172760151428601,-0.37950892619728993,0.37950892619728993,1.170500554541026,1.9898509427197442,1,1,0,2,1.9898509427197442,1.170500554541026
270,2,31,47,126,110,1,11246.8,54,1615.594,MORE,-4838,7190,2352,2,2,-16.0,-1.4998535370791803,16.0,1.222253017596762,0.3862071875515856,0.17184239033482593,236,126,110,1,1.5158220886185887,1.7947675169629065,1.170500554541026,-0.6845663597291791,-0.9491098473449784,0.9491098473449784,1.170500554541026,1.7947675169629065,1,0,0,2,1.7947675169629065,1.170500554541026
271,2,32,50,110,133,1,5729.5819999999985,64,903.808,MORE,-698,2656,1958,2,2,23.0,2.1560394595513217,23.0,2.444506035193524,1.0108010218668186,-0.4378398633746036,243,110,133,0,1.6554372809913533,1.170500554541026,2.0678843130224793,-0.6845663597291791,0.1055179762468955,0.1055179762468955,2.0678843130224793,1.170500554541026,1,0,0,2,2.0678843130224793,1.170500554541026
272,2,33,47,110,126,1,15507.063,54,2221.023,MORE,2616,4156,6772,4,2,16.0,1.4998535370791803,16.0,1.222253017596762,0.3862071875515856,0.6426243582097396,236,110,126,0,1.5158220886185887,1.170500554541026,1.7947675169629065,-0.1238294097803634,0.9497297171607771,0.9497297171607771,1.7947675169629065,1.170500554541026,1,1,1,2,1.7947675169629065,1.170500554541026
273,2,34,12,48,50,0,9584.002,54,1453.896,MORE,-2686,4780,2094,2,2,2.0,0.18748169213489754,2.0,-1.222253017596762,0.3862071875515856,-0.011905729116595277,98,48,50,0,-1.2365917038730592,-1.248533924843761,-1.170500554541026,-0.6845663597291791,-0.40090717189335695,0.40090717189335695,-1.170500554541026,-1.248533924843761,1,0,0,0,-1.248533924843761,-1.170500554541026
274,2,35,32,80,77,1,15060.043,44,1704.187,MORE,-442,5714,5272,5,2,-3.0,-0.28122253820234633,3.0,-1.0476454436543674,-0.2383866467636475,0.593226244694343,157,80,77,1,-0.05983508244547061,0.0,-0.1170500554541026,0.15653906519404445,0.17073167741586162,0.17073167741586162,-0.1170500554541026,0.0,0,1,1,1,0.0,-0.1170500554541026
275,2,36,43,117,110,1,13755.941,54,1722.052,MORE,-430,5400,4970,4,2,-7.0,-0.6561859224721414,7.0,-0.34921514788478913,0.3862071875515856,0.44911596186213054,227,117,110,1,1.3363168412821769,1.4436173506005987,1.170500554541026,-0.1238294097803634,0.1737885696581569,0.1737885696581569,1.170500554541026,1.4436173506005987,1,1,1,2,1.4436173506005987,1.170500554541026
276,2,37,40,80,64,0,4962.179,74,1493.033,MORE,-338,2306,1968,2,2,-16.0,-1.4998535370791803,16.0,1.222253017596762,1.6353948561820515,-0.5226420210097336,144,80,64,1,-0.3191204397091766,0.0,-0.6242669624218805,-0.6845663597291791,0.1972247435157541,0.1972247435157541,-0.6242669624218805,0.0,1,0,1,1,0.0,-0.6242669624218805
277,2,38,31,80,78,1,7058.905,44,1628.685,MORE,-1242,3130,1888,2,2,-2.0,-0.18748169213489754,2.0,-1.222253017596762,-0.2383866467636475,-0.29094252443534463,158,80,78,1,-0.03989005496364707,0.0,-0.07803337030273506,-0.6845663597291791,-0.033061138737157485,0.033061138737157485,-0.07803337030273506,0.0,0,0,0,1,0.0,-0.07803337030273506
278,2,39,46,124,110,1,6745.102,54,2401.298,MORE,648,2616,3264,2,2,-14.0,-1.3123718449442827,14.0,0.8730378697119728,0.3862071875515856,-0.3256194431760542,234,124,110,1,1.4759320336549415,1.7167341466601715,1.170500554541026,-0.6845663597291791,0.44839938942435015,0.44839938942435015,1.170500554541026,1.7167341466601715,1,0,1,2,1.7167341466601715,1.170500554541026
279,2,40,58,92,110,1,5223.511,74,2397.822,MORE,-12,3050,3038,2,1,18.0,1.6873352292140782,18.0,1.571468165481551,1.6353948561820515,-0.49376342989254496,202,92,110,0,0.8376911542365885,0.4682002218164104,1.170500554541026,-0.6845663597291791,0.2802703160981094,0.2802703160981094,1.170500554541026,0.4682002218164104,1,0,1,2,1.170500554541026,0.4682002218164104
280,2,41,49,110,131,0,4393.264,54,1958.711,LESS,-918,2668,1750,4,1,21.0,1.9685577674164243,21.0,2.0952908873087353,0.3862071875515856,-0.5855101874242381,241,110,131,1,1.6155472260277064,1.170500554541026,1.9898509427197442,-0.1238294097803634,0.04947495180481525,0.04947495180481525,1.9898509427197442,1.170500554541026,1,0,0,2,1.9898509427197442,1.170500554541026
281,2,42,13,47,50,1,9018.968,44,2451.178,LESS,1000,3406,4406,4,2,3.0,0.28122253820234633,3.0,-1.0476454436543674,-0.2383866467636475,-0.07434502416392774,97,47,50,1,-1.2565367313548828,-1.2875506099951286,-1.170500554541026,-0.1238294097803634,0.5380682285316786,0.5380682285316786,-1.170500554541026,-1.2875506099951286,0,1,1,0,-1.2875506099951286,-1.170500554541026
282,2,43,16,50,44,1,2271.286,64,1742.966,LESS,-210,1354,1144,1,2,-6.0,-0.5624450764046927,6.0,-0.5238227218271837,1.0108010218668186,-0.8200001657723527,94,50,44,0,-1.3163718138003533,-1.170500554541026,-1.4046006654492311,-0.9649348347035869,0.22983159410023715,0.22983159410023715,-1.4046006654492311,-1.170500554541026,1,0,1,0,-1.170500554541026,-1.4046006654492311
283,2,44,7,57,50,0,13824.456,34,2131.072,LESS,1356,5574,6930,11,2,-7.0,-0.6561859224721414,7.0,-0.34921514788478913,-0.8629804810788805,0.4566872377502504,107,57,50,0,-1.0570864565366473,-0.8973837584814532,-1.170500554541026,1.8387499150404916,0.628756031719772,0.628756031719772,-1.170500554541026,-0.8973837584814532,0,1,1,0,-0.8973837584814532,-1.170500554541026
284,2,45,18,42,50,0,2308.854,74,932.459,LESS,-698,1702,1004,2,2,8.0,0.7499267685395902,8.0,-0.17460757394239454,1.6353948561820515,-0.8158486997785573,92,42,50,1,-1.3562618687640005,-1.4826340357519663,-1.170500554541026,-0.6845663597291791,0.1055179762468955,0.1055179762468955,-1.170500554541026,-1.4826340357519663,1,0,1,0,-1.4826340357519663,-1.170500554541026
285,2,46,51,108,110,0,6735.222,24,2393.238,LESS,-1646,3936,2290,2,1,2.0,0.18748169213489754,2.0,-1.222253017596762,-1.4875743153941137,-0.3267112362983577,218,108,110,1,1.156811593945765,1.092467184238291,1.170500554541026,-0.6845663597291791,-0.13597651089443213,0.13597651089443213,1.170500554541026,1.092467184238291,0,0,0,2,1.170500554541026,1.092467184238291
286,2,47,31,78,80,0,4220.918,54,1672.646,LESS,-1260,2626,1366,4,1,2.0,0.18748169213489754,2.0,-1.222253017596762,0.3862071875515856,-0.6045553470858295,158,78,80,1,-0.03989005496364707,-0.07803337030273506,0.0,-0.1238294097803634,-0.037646477100600415,0.037646477100600415,0.0,-0.07803337030273506,1,1,0,1,-0.07803337030273506,0.0
287,2,48,58,110,92,1,4542.710999999998,64,1656.1029999999996,LESS,884,1768,2652,2,2,-18.0,-1.6873352292140782,18.0,1.571468165481551,1.0108010218668186,-0.5689954903848766,202,110,92,0,0.8376911542365885,1.170500554541026,0.4682002218164104,-0.6845663597291791,0.5085182701894908,0.5085182701894908,0.4682002218164104,1.170500554541026,1,0,1,2,1.170500554541026,0.4682002218164104
288,2,49,12,50,48,1,10213.207,64,2050.486,LESS,-1040,5650,4610,5,2,-2.0,-0.18748169213489754,2.0,-1.222253017596762,1.0108010218668186,0.057624806462249274,98,50,48,0,-1.2365917038730592,-1.170500554541026,-1.248533924843761,0.15653906519404445,0.018396547341479837,0.018396547341479837,-1.248533924843761,-1.170500554541026,1,1,0,0,-1.170500554541026,-1.248533924843761
289,2,50,54,110,101,0,12842.266,34,2003.719,LESS,-96,5570,5474,6,2,-9.0,-0.8436676146070391,9.0,0.0,-0.8629804810788805,0.3481499617588242,211,110,101,0,1.0171964015730004,1.170500554541026,0.8193503881787182,0.4369075401684523,0.25887207040204235,0.25887207040204235,0.8193503881787182,1.170500554541026,0,1,1,2,1.170500554541026,0.8193503881787182
290,2,51,14,46,50,0,5697.236,64,2140.884,LESS,332,3004,3336,2,2,4.0,0.3749633842697951,4.0,-0.8730378697119728,1.0108010218668186,-0.4414142702910032,96,46,50,1,-1.2764817588367063,-1.3265672951464962,-1.170500554541026,-0.6845663597291791,0.3679012270439076,0.3679012270439076,-1.170500554541026,-1.3265672951464962,1,0,1,0,-1.3265672951464962,-1.170500554541026
291,2,52,22,80,83,1,9507.452,44,2118.243,LESS,-336,4594,4258,5,2,3.0,0.28122253820234633,3.0,-1.0476454436543674,-0.2383866467636475,-0.020364915706912626,163,80,83,1,0.05983508244547061,0.0,0.1170500554541026,0.15653906519404445,0.19773422555613665,0.19773422555613665,0.1170500554541026,0.0,0,1,1,1,0.1170500554541026,0.0
292,2,53,6,50,56,0,2202.626,74,1487.098,LESS,-70,1430,1360,3,2,6.0,0.5624450764046927,6.0,-0.5238227218271837,1.6353948561820515,-0.8275874649401016,106,50,56,1,-1.077031484018471,-1.170500554541026,-0.9364004436328208,-0.40419788475477125,0.2654953369270155,0.2654953369270155,-0.9364004436328208,-1.170500554541026,1,0,1,0,-1.170500554541026,-0.9364004436328208
293,2,54,13,50,47,0,10523.383,34,1958.964,LESS,-1666,4070,2404,2,1,-3.0,-0.28122253820234633,3.0,-1.0476454436543674,-0.8629804810788805,0.09190092220148156,97,50,47,0,-1.2565367313548828,-1.170500554541026,-1.2875506099951286,-0.6845663597291791,-0.1410713312982576,0.1410713312982576,-1.2875506099951286,-1.170500554541026,0,0,0,0,-1.170500554541026,-1.2875506099951286
294,2,55,46,110,124,0,5659.319,54,1844.987,LESS,-1344,3058,1714,4,1,14.0,1.3123718449442827,14.0,0.8730378697119728,0.3862071875515856,-0.4456043026612848,234,110,124,1,1.4759320336549415,1.170500554541026,1.7167341466601715,-0.1238294097803634,-0.05904472279666742,0.05904472279666742,1.7167341466601715,1.170500554541026,1,1,0,2,1.7167341466601715,1.170500554541026
295,2,56,27,91,80,0,11711.122,34,1805.081,LESS,1348,4050,5398,6,2,-11.0,-1.0311493067419364,11.0,0.34921514788478913,-0.8629804810788805,0.22315246787877466,171,91,80,0,0.21939530230005888,0.4291835366650429,0.0,0.4369075401684523,0.6267181035582419,0.6267181035582419,0.0,0.4291835366650429,0,1,1,1,0.4291835366650429,0.0
296,2,57,40,64,80,0,4957.49,74,1107.567,LESS,-1200,2784,1584,4,2,16.0,1.4998535370791803,16.0,1.222253017596762,1.6353948561820515,-0.5231601807213208,144,64,80,1,-0.3191204397091766,-0.6242669624218805,0.0,-0.1238294097803634,-0.022362015889123985,0.022362015889123985,0.0,-0.6242669624218805,1,1,0,1,-0.6242669624218805,0.0
297,2,58,22,83,80,1,4295.431,54,1443.805,LESS,214,1914,2128,3,2,-3.0,-0.28122253820234633,3.0,-1.0476454436543674,0.3862071875515856,-0.5963212599479548,163,83,80,0,0.05983508244547061,0.1170500554541026,0.0,-0.40419788475477125,0.3378417866613373,0.3378417866613373,0.0,0.1170500554541026,1,0,1,1,0.1170500554541026,0.0
298,2,59,54,101,110,0,3120.003,64,1850.169,LESS,-464,2398,1934,3,2,9.0,0.8436676146070391,9.0,0.0,1.0108010218668186,-0.7262123739320617,211,101,110,1,1.0171964015730004,0.8193503881787182,1.170500554541026,-0.40419788475477125,0.16512737497165358,0.16512737497165358,1.170500554541026,0.8193503881787182,1,0,1,2,1.170500554541026,0.8193503881787182
299,2,60,6,56,50,1,6435.686,54,2238.014,LESS,628,2624,3252,4,2,-6.0,-0.5624450764046927,6.0,-0.5238227218271837,0.3862071875515856,-0.3598115748289555,106,56,50,0,-1.077031484018471,-0.9364004436328208,-1.170500554541026,-0.1238294097803634,0.4433045690205247,0.4433045690205247,-1.170500554541026,-0.9364004436328208,1,1,1,0,-0.9364004436328208,-1.170500554541026
300,2,61,18,50,42,1,4288.92,54,3228.427,LESS,12,1926,1938,2,1,-8.0,-0.7499267685395902,8.0,-0.17460757394239454,0.3862071875515856,-0.5970407604559829,92,50,42,0,-1.3562618687640005,-1.170500554541026,-1.4826340357519663,-0.6845663597291791,0.2863841005827,0.2863841005827,-1.4826340357519663,-1.170500554541026,1,0,1,0,-1.170500554541026,-1.4826340357519663
301,2,62,43,110,117,0,9699.076,74,1452.641,LESS,-3352,6362,3010,5,2,7.0,0.6561859224721414,7.0,-0.34921514788478913,1.6353948561820515,0.0008105666076915104,227,110,117,1,1.3363168412821769,1.170500554541026,1.4436173506005987,0.15653906519404445,-0.5705646913407454,0.5705646913407454,1.4436173506005987,1.170500554541026,1,1,0,2,1.4436173506005987,1.170500554541026
302,2,63,32,77,80,0,12993.588,44,1630.684,LESS,-1182,5796,4614,7,1,3.0,0.28122253820234633,3.0,-1.0476454436543674,-0.2383866467636475,0.3648718563795947,157,77,80,1,-0.05983508244547061,-0.1170500554541026,0.0,0.7172760151428601,-0.017776677525681055,0.017776677525681055,0.0,-0.1170500554541026,0,1,0,1,-0.1170500554541026,0.0
303,2,64,27,80,91,0,6368.911,74,1303.266,LESS,-272,3348,3076,4,2,11.0,1.0311493067419364,11.0,0.34921514788478913,1.6353948561820515,-0.3671905713615281,171,80,91,1,0.21939530230005888,0.0,0.4291835366650429,-0.1238294097803634,0.21403765084837817,0.21403765084837817,0.4291835366650429,0.0,1,0,1,1,0.4291835366650429,0.0
304,2,65,16,44,50,0,5931.459,74,1220.198,LESS,-362,3042,2680,6,2,6.0,0.5624450764046927,6.0,-0.5238227218271837,1.6353948561820515,-0.4155313694321676,94,44,50,1,-1.3163718138003533,-1.4046006654492311,-1.170500554541026,0.4369075401684523,0.1911109590311635,0.1911109590311635,-1.170500554541026,-1.4046006654492311,1,1,1,0,-1.4046006654492311,-1.170500554541026
305,2,66,7,50,57,0,13766.499,34,1932.302,LESS,-310,5368,5058,12,2,7.0,0.6561859224721414,7.0,-0.34921514788478913,-0.8629804810788805,0.4502826776298714,107,50,57,1,-1.0570864565366473,-1.170500554541026,-0.8973837584814532,2.1191183900148993,0.20435749208110976,0.20435749208110976,-0.8973837584814532,-1.170500554541026,0,1,1,0,-1.170500554541026,-0.8973837584814532
306,2,67,14,50,46,1,3602.769,64,1430.108,LESS,1312,1330,2642,3,2,-4.0,-0.3749633842697951,4.0,-0.8730378697119728,1.0108010218668186,-0.6728641352193108,96,50,46,0,-1.2764817588367063,-1.170500554541026,-1.3265672951464962,-0.40419788475477125,0.617547426831356,0.617547426831356,-1.3265672951464962,-1.170500554541026,1,0,1,0,-1.170500554541026,-1.3265672951464962
307,2,68,51,110,108,1,8029.58,44,1799.54,LESS,194,3022,3216,2,2,-2.0,-0.18748169213489754,2.0,-1.222253017596762,-0.2383866467636475,-0.1836777178572104,218,110,108,0,1.156811593945765,1.170500554541026,1.092467184238291,-0.6845663597291791,0.3327469662575118,0.3327469662575118,1.092467184238291,1.170500554541026,0,0,1,2,1.170500554541026,1.092467184238291
308,2,69,50,133,110,1,9357.582,44,3986.084,LESS,458,3508,3966,1,2,-23.0,-2.1560394595513217,23.0,2.444506035193524,-0.2383866467636475,-0.03692635652064005,243,133,110,0,1.6554372809913533,2.0678843130224793,1.170500554541026,-0.9649348347035869,0.3999985955880081,0.3999985955880081,1.170500554541026,2.0678843130224793,0,0,1,2,2.0678843130224793,1.170500554541026
309,2,70,49,131,110,1,14391.407,34,1880.438,LESS,924,5904,6828,6,2,-21.0,-1.9685577674164243,21.0,2.0952908873087353,-0.8629804810788805,0.5193383716048152,241,131,110,0,1.6155472260277064,1.9898509427197442,1.170500554541026,0.4369075401684523,0.5187079109971418,0.5187079109971418,1.170500554541026,1.9898509427197442,0,1,1,2,1.9898509427197442,1.170500554541026
310,2,71,47,126,110,1,13627.4,24,1952.1,LESS,2036,4230,6266,4,2,-16.0,-1.4998535370791803,16.0,1.222253017596762,-1.4875743153941137,0.4349114902291328,236,126,110,0,1.5158220886185887,1.7947675169629065,1.170500554541026,-0.1238294097803634,0.8019799254498383,0.8019799254498383,1.170500554541026,1.7947675169629065,0,0,1,2,1.7947675169629065,1.170500554541026
311,2,72,50,110,133,0,4957.208,90,1779.016,LESS,-1454,3530,2076,3,2,23.0,2.1560394595513217,23.0,2.444506035193524,2.6347449910864245,-0.5231913432375647,243,110,133,1,1.6554372809913533,1.170500554541026,2.0678843130224793,-0.40419788475477125,-0.08706623501770755,0.08706623501770755,2.0678843130224793,1.170500554541026,1,0,0,2,2.0678843130224793,1.170500554541026
312,2,73,47,110,126,0,5640.1680000000015,74,1236.212,LESS,-1488,3630,2142,5,2,16.0,1.4998535370791803,16.0,1.222253017596762,1.6353948561820515,-0.4477205911314501,236,110,126,1,1.5158220886185887,1.170500554541026,1.7947675169629065,0.15653906519404445,-0.09572742970421086,0.09572742970421086,1.7947675169629065,1.170500554541026,1,1,0,2,1.7947675169629065,1.170500554541026
313,2,74,12,48,50,1,8963.665,64,1536.0479999999998,LESS,-2592,5632,3040,3,2,2.0,0.18748169213489754,2.0,-1.222253017596762,1.0108010218668186,-0.08045630301440865,98,48,50,1,-1.2365917038730592,-1.248533924843761,-1.170500554541026,-0.40419788475477125,-0.3769615159953772,0.3769615159953772,-1.170500554541026,-1.248533924843761,1,0,0,0,-1.248533924843761,-1.170500554541026
314,2,75,32,80,77,0,12768.284,34,1704.979,LESS,-1760,6420,4660,4,2,-3.0,-0.28122253820234633,3.0,-1.0476454436543674,-0.8629804810788805,0.3399745529760045,157,80,77,0,-0.05983508244547061,0.0,-0.1170500554541026,-0.1238294097803634,-0.16501698719623736,0.16501698719623736,-0.1170500554541026,0.0,0,1,0,1,0.0,-0.1170500554541026
315,2,76,43,117,110,1,13402.299,34,1770.7420000000004,LESS,-2652,7602,4950,8,2,-7.0,-0.6561859224721414,7.0,-0.34921514788478913,-0.8629804810788805,0.4100366194170232,227,117,110,0,1.3363168412821769,1.4436173506005987,1.170500554541026,0.997644490117268,-0.39224597720685367,0.39224597720685367,1.170500554541026,1.4436173506005987,0,1,0,2,1.4436173506005987,1.170500554541026
316,2,77,40,80,64,0,8565.537,54,1287.286,LESS,-284,3972,3688,4,2,-16.0,-1.4998535370791803,16.0,1.222253017596762,0.3862071875515856,-0.12445158764967737,144,80,64,0,-0.3191204397091766,0.0,-0.6242669624218805,-0.1238294097803634,0.2109807586060829,0.2109807586060829,-0.6242669624218805,0.0,1,1,1,1,0.0,-0.6242669624218805
317,2,78,31,80,78,1,8977.981,54,1892.798,LESS,1130,3416,4546,5,2,-2.0,-0.18748169213489754,2.0,-1.222253017596762,0.3862071875515856,-0.07887430804083617,158,80,78,0,-0.03989005496364707,0.0,-0.07803337030273506,0.15653906519404445,0.5711845611565441,0.5711845611565441,-0.07803337030273506,0.0,1,1,1,1,0.0,-0.07803337030273506
318,2,79,46,124,110,1,19471.289,24,2425.003,LESS,950,6942,7892,11,2,-14.0,-1.3123718449442827,14.0,0.8730378697119728,-1.4875743153941137,1.0806926458673085,234,124,110,0,1.4759320336549415,1.7167341466601715,1.170500554541026,1.8387499150404916,0.5253311775221149,0.5253311775221149,1.170500554541026,1.7167341466601715,0,1,1,2,1.7167341466601715,1.170500554541026
319,2,80,58,92,110,0,3362.804,64,1473.7679999999998,LESS,-692,1688,996,2,2,18.0,1.6873352292140782,18.0,1.571468165481551,1.0108010218668186,-0.6993815579514528,202,92,110,1,0.8376911542365885,0.4682002218164104,1.170500554541026,-0.6845663597291791,0.10704642236804314,0.10704642236804314,1.170500554541026,0.4682002218164104,1,0,1,2,1.170500554541026,0.4682002218164104
320,2,81,48,128,110,0,6980.156,74,1286.724,MORE,-548,2164,1616,5,2,-18.0,-1.6873352292140782,18.0,1.571468165481551,1.6353948561820515,-0.2996447123491381,238,128,110,1,1.5557121435822359,1.8728008872656416,1.170500554541026,0.15653906519404445,0.1437291292755866,0.1437291292755866,1.170500554541026,1.8728008872656416,1,1,0,2,1.8728008872656416,1.170500554541026
321,2,82,8,50,58,1,7323.464,54,1152.661,MORE,180,2692,2872,8,2,8.0,0.7499267685395902,8.0,-0.17460757394239454,0.3862071875515856,-0.2617073324673794,108,50,58,0,-1.0371414290548238,-1.170500554541026,-0.8583670733300858,0.997644490117268,0.32918059197483396,0.32918059197483396,-0.8583670733300858,-1.170500554541026,1,1,1,0,-1.170500554541026,-0.8583670733300858
322,2,83,4,54,50,1,12685.652,34,1611.108,MORE,-48,5540,5492,11,2,-4.0,-0.3749633842697951,4.0,-0.8730378697119728,-0.8629804810788805,0.3308432726842855,104,54,50,1,-1.116921538982118,-1.0144338139355558,-1.170500554541026,1.8387499150404916,0.2710996393712235,0.2710996393712235,-1.170500554541026,-1.0144338139355558,0,1,1,0,-1.0144338139355558,-1.170500554541026
323,2,84,37,80,69,0,6234.269,64,1158.75,MORE,-880,3384,2504,4,2,-11.0,-1.0311493067419364,11.0,0.34921514788478913,1.0108010218668186,-0.3820692362980857,149,80,69,1,-0.21939530230005888,0.0,-0.4291835366650429,-0.1238294097803634,0.059155110572083655,0.059155110572083655,-0.4291835366650429,0.0,1,1,0,1,0.0,-0.4291835366650429
324,2,85,52,105,110,1,7470.982,64,1301.8,MORE,122,3444,3566,3,2,5.0,0.4687042303372438,5.0,-0.6984302957695783,1.0108010218668186,-0.2454058002997711,215,105,110,0,1.0969765115002945,0.9754171287841883,1.170500554541026,-0.40419788475477125,0.3144056128037401,0.3144056128037401,1.170500554541026,0.9754171287841883,1,1,1,2,1.170500554541026,0.9754171287841883
325,2,86,5,55,50,0,19803.463,14,1765.461,MORE,-4124,10918,6794,18,1,-5.0,-0.4687042303372438,5.0,-0.6984302957695783,-2.1121681497093467,1.1173996588843174,105,55,50,1,-1.0969765115002945,-0.9754171287841883,-1.170500554541026,3.8013292398613463,-0.7672247589284088,0.7672247589284088,-1.170500554541026,-0.9754171287841883,0,1,0,0,-0.9754171287841883,-1.170500554541026
326,2,87,30,96,80,0,4605.276,54,1815.553,MORE,916,1932,2848,3,2,-16.0,-1.4998535370791803,16.0,1.222253017596762,0.3862071875515856,-0.5620817214884269,176,96,80,1,0.3191204397091766,0.6242669624218805,0.0,-0.40419788475477125,0.5166699828356115,0.5166699828356115,0.0,0.6242669624218805,1,1,1,1,0.6242669624218805,0.0
327,2,88,33,80,75,1,10068.237,34,1499.13,MORE,-1038,4528,3490,3,1,-5.0,-0.4687042303372438,5.0,-0.6984302957695783,-0.8629804810788805,0.041604841994603306,155,80,75,1,-0.09972513740911768,0.0,-0.19508342575683765,-0.40419788475477125,0.018906029381862383,0.018906029381862383,-0.19508342575683765,0.0,0,1,0,1,0.0,-0.19508342575683765
328,2,89,48,110,128,1,4717.351,64,2130.6620000000007,MORE,-882,2750,1868,3,2,18.0,1.6873352292140782,18.0,1.571468165481551,1.0108010218668186,-0.5496968313890176,238,110,128,0,1.5557121435822359,1.170500554541026,1.8728008872656416,-0.40419788475477125,0.058645628531701105,0.058645628531701105,1.8728008872656416,1.170500554541026,1,1,0,2,1.8728008872656416,1.170500554541026
329,2,90,9,59,50,0,10498.412,34,2495.783,MORE,-2006,5568,3562,8,1,-9.0,-0.8436676146070391,9.0,0.0,-0.8629804810788805,0.08914149243862317,109,59,50,1,-1.0171964015730004,-0.8193503881787182,-1.170500554541026,0.997644490117268,-0.22768327816329073,0.22768327816329073,-1.170500554541026,-0.8193503881787182,0,1,0,0,-0.8193503881787182,-1.170500554541026
330,2,91,44,110,119,1,4786.207,54,1197.771,MORE,328,2112,2440,1,2,9.0,0.8436676146070391,9.0,0.0,0.3862071875515856,-0.5420878731674252,229,110,119,0,1.376206896245824,1.170500554541026,1.5216507209033339,-0.9649348347035869,0.3668822629631425,0.3668822629631425,1.5216507209033339,1.170500554541026,1,0,1,2,1.5216507209033339,1.170500554541026
331,2,92,2,52,50,0,17514.256999999998,44,1972.418,MORE,-7076,11884,4808,9,2,-2.0,-0.18748169213489754,2.0,-1.222253017596762,-0.2383866467636475,0.8644300873928249,102,52,50,1,-1.156811593945765,-1.092467184238291,-1.170500554541026,1.2780129650916758,-1.5192202505330492,1.5192202505330492,-1.170500554541026,-1.092467184238291,0,1,0,0,-1.092467184238291,-1.170500554541026
332,2,93,8,58,50,0,7383.357,54,2735.914,MORE,-486,3646,3160,4,1,-8.0,-0.7499267685395902,8.0,-0.17460757394239454,0.3862071875515856,-0.2550888339376097,108,58,50,1,-1.0371414290548238,-0.8583670733300858,-1.170500554541026,-0.1238294097803634,0.15952307252744558,0.15952307252744558,-1.170500554541026,-0.8583670733300858,1,1,1,0,-0.8583670733300858,-1.170500554541026
333,2,94,44,119,110,0,19661.432,34,1301.864,MORE,-6016,11564,5548,7,1,-9.0,-0.8436676146070391,9.0,0.0,-0.8629804810788805,1.1017044697189442,229,119,110,1,1.376206896245824,1.5216507209033339,1.170500554541026,0.7172760151428601,-1.249194769130299,1.249194769130299,1.170500554541026,1.5216507209033339,0,1,0,2,1.5216507209033339,1.170500554541026
334,2,95,34,74,80,1,11765.399,64,1349.447,MORE,-788,6156,5368,0,2,6.0,0.5624450764046927,6.0,-0.5238227218271837,1.0108010218668186,0.2291503682127087,154,74,80,0,-0.11967016489094122,-0.2341001109082052,0.0,-1.2453033096779946,0.08259128442968085,0.08259128442968085,0.0,-0.2341001109082052,1,0,0,1,-0.2341001109082052,0.0
335,2,96,24,86,80,0,11965.88,44,1244.369,MORE,-1194,5802,4608,5,1,-6.0,-0.5624450764046927,6.0,-0.5238227218271837,-0.2383866467636475,0.2513045966491997,166,86,80,1,0.11967016489094122,0.2341001109082052,0.0,0.15653906519404445,-0.020833569767976342,0.020833569767976342,0.0,0.2341001109082052,0,1,0,1,0.2341001109082052,0.0
336,2,97,39,66,80,1,3989.236,74,933.976,MORE,-222,2226,2004,3,2,14.0,1.3123718449442827,14.0,0.8730378697119728,1.6353948561820515,-0.6301574537823399,146,66,80,0,-0.2792303847455295,-0.5462335921191455,0.0,-0.40419788475477125,0.22677470185794188,0.22677470185794188,0.0,-0.5462335921191455,1,1,1,1,-0.5462335921191455,0.0
337,2,98,9,50,59,0,9313.449,44,1556.543,MORE,-894,4894,4000,3,2,9.0,0.8436676146070391,9.0,0.0,-0.2383866467636475,-0.04180329031280815,109,50,59,0,-1.0171964015730004,-1.170500554541026,-0.8193503881787182,-0.40419788475477125,0.05558873628940582,0.05558873628940582,-0.8193503881787182,-1.170500554541026,0,1,0,0,-1.170500554541026,-0.8193503881787182
338,2,99,57,94,110,1,10580.194,64,1378.042,MORE,-334,4974,4640,5,2,16.0,1.4998535370791803,16.0,1.222253017596762,1.0108010218668186,0.09817884316010347,204,94,110,0,0.8775812092002355,0.5462335921191455,1.170500554541026,0.15653906519404445,0.1982437075965192,0.1982437075965192,1.170500554541026,0.5462335921191455,1,1,1,2,1.170500554541026,0.5462335921191455
339,2,100,60,110,87,0,6636.98,54,1463.95,MORE,-1810,3586,1776,2,1,-23.0,-2.1560394595513217,23.0,2.444506035193524,0.3862071875515856,-0.3375675055211656,197,110,87,1,0.7379660168274708,1.170500554541026,0.27311679605957273,-0.6845663597291791,-0.17775403820580105,0.17775403820580105,0.27311679605957273,1.170500554541026,1,0,0,2,1.170500554541026,0.27311679605957273
340,2,101,33,75,80,1,6202.516,54,1406.7620000000004,MORE,-1494,3456,1962,3,2,5.0,0.4687042303372438,5.0,-0.6984302957695783,0.3862071875515856,-0.385578113526072,155,75,80,0,-0.09972513740911768,-0.19508342575683765,0.0,-0.40419788475477125,-0.09725587582535851,0.09725587582535851,0.0,-0.19508342575683765,1,1,0,1,-0.19508342575683765,0.0
341,2,102,15,50,45,1,28899.841,24,1851.009,MORE,-366,12188,11822,20,2,-5.0,-0.4687042303372438,5.0,-0.6984302957695783,-1.4875743153941137,2.1225983368471733,95,50,45,1,-1.2964267863185297,-1.170500554541026,-1.3655839802978638,4.362066189810162,0.19009199495039844,0.19009199495039844,-1.3655839802978638,-1.170500554541026,0,1,1,0,-1.170500554541026,-1.3655839802978638
342,2,103,59,89,110,1,9338.527,54,999.693,MORE,-174,3918,3744,3,2,21.0,1.9685577674164243,21.0,2.0952908873087353,0.3862071875515856,-0.039032036474637384,199,89,110,0,0.7778560717911179,0.3511501663623078,1.170500554541026,-0.40419788475477125,0.23900227082712303,0.23900227082712303,1.170500554541026,0.3511501663623078,1,1,1,2,1.170500554541026,0.3511501663623078
343,2,104,29,80,94,1,4110.953,74,1388.961,MORE,396,2040,2436,3,2,14.0,1.3123718449442827,14.0,0.8730378697119728,1.6353948561820515,-0.6167070708402935,174,80,94,0,0.2792303847455295,0.0,0.5462335921191455,-0.40419788475477125,0.38420465233614914,0.38420465233614914,0.5462335921191455,0.0,1,0,1,1,0.5462335921191455,0.0
344,2,105,55,110,98,0,5941.794,54,1108.923,MORE,-752,3174,2422,5,2,-12.0,-1.124890152809385,12.0,0.5238227218271837,0.3862071875515856,-0.4143892963634421,208,110,98,1,0.9573613191275298,1.170500554541026,0.7023003327246156,0.15653906519404445,0.09176196115656671,0.09176196115656671,0.7023003327246156,1.170500554541026,1,1,0,2,1.170500554541026,0.7023003327246156
345,2,106,29,94,80,0,2614.124,64,1645.33,MORE,110,1714,1824,3,2,-14.0,-1.3123718449442827,14.0,0.8730378697119728,1.0108010218668186,-0.7821147234176672,174,94,80,1,0.2792303847455295,0.5462335921191455,0.0,-0.40419788475477125,0.3113487205614448,0.3113487205614448,0.0,0.5462335921191455,1,0,1,1,0.5462335921191455,0.0
346,2,107,57,110,94,0,5470.66,74,1045.761,MORE,-306,3116,2810,5,2,-16.0,-1.4998535370791803,16.0,1.222253017596762,1.6353948561820515,-0.4664521365338212,204,110,94,1,0.8775812092002355,1.170500554541026,0.5462335921191455,0.15653906519404445,0.20537645616187486,0.20537645616187486,0.5462335921191455,1.170500554541026,1,1,1,2,1.170500554541026,0.5462335921191455
347,2,108,39,80,66,0,11858.61,54,1564.235,MORE,-92,4986,4894,4,2,-14.0,-1.3123718449442827,14.0,0.8730378697119728,0.3862071875515856,0.23945068488508056,146,80,66,1,-0.2792303847455295,0.0,-0.5462335921191455,-0.1238294097803634,0.2598910344828075,0.2598910344828075,-0.5462335921191455,0.0,1,1,1,1,0.0,-0.5462335921191455
348,2,109,4,50,54,1,4419.104,54,1371.331,MORE,56,2164,2220,3,2,4.0,0.3749633842697951,4.0,-0.8730378697119728,0.3862071875515856,-0.5826547284889827,104,50,54,0,-1.116921538982118,-1.170500554541026,-1.0144338139355558,-0.40419788475477125,0.297592705471116,0.297592705471116,-1.0144338139355558,-1.170500554541026,1,0,1,0,-1.170500554541026,-1.0144338139355558
349,2,110,55,98,110,1,8740.806,24,2327.713,MORE,-44,3874,3830,9,2,12.0,1.124890152809385,12.0,0.5238227218271837,-1.4875743153941137,-0.10508342077184182,208,98,110,0,0.9573613191275298,0.7023003327246156,1.170500554541026,1.2780129650916758,0.2721186034519886,0.2721186034519886,1.170500554541026,0.7023003327246156,0,1,1,2,1.170500554541026,0.7023003327246156
350,2,111,2,50,52,0,11192.925,34,1615.539,MORE,-3272,6726,3454,2,1,2.0,0.18748169213489754,2.0,-1.222253017596762,-0.8629804810788805,0.16588891316234594,102,50,52,0,-1.156811593945765,-1.170500554541026,-1.092467184238291,-0.6845663597291791,-0.5501854097254435,0.5501854097254435,-1.092467184238291,-1.170500554541026,0,0,0,0,-1.170500554541026,-1.092467184238291
351,2,112,59,110,89,0,11204.062,34,2638.626,MORE,-3066,6246,3180,4,1,-21.0,-1.9685577674164243,21.0,2.0952908873087353,-0.8629804810788805,0.16711961154322602,199,110,89,1,0.7778560717911179,1.170500554541026,0.3511501663623078,-0.1238294097803634,-0.49770875956604105,0.49770875956604105,0.3511501663623078,1.170500554541026,0,1,0,2,1.170500554541026,0.3511501663623078
352,2,113,60,87,110,1,7304.684,54,1306.144,MORE,-356,3222,2866,3,2,23.0,2.1560394595513217,23.0,2.444506035193524,0.3862071875515856,-0.2637826234427701,197,87,110,0,0.7379660168274708,0.27311679605957273,1.170500554541026,-0.40419788475477125,0.19263940515231118,0.19263940515231118,1.170500554541026,0.27311679605957273,1,0,1,2,1.170500554541026,0.27311679605957273
353,2,114,52,110,105,1,8140.553000000001,34,1603.5410000000004,MORE,34,3522,3556,3,2,-5.0,-0.4687042303372438,5.0,-0.6984302957695783,-0.8629804810788805,-0.17141460468298073,215,110,105,1,1.0969765115002945,1.170500554541026,0.9754171287841883,-0.40419788475477125,0.291988403026908,0.291988403026908,0.9754171287841883,1.170500554541026,0,0,1,2,1.170500554541026,0.9754171287841883
354,2,115,30,80,96,1,10329.606,44,1550.286,MORE,-1212,5220,4008,4,2,16.0,1.4998535370791803,16.0,1.222253017596762,-0.2383866467636475,0.07048752181073169,176,80,96,0,0.3191204397091766,0.0,0.6242669624218805,-0.1238294097803634,-0.025418908131419272,0.025418908131419272,0.6242669624218805,0.0,0,1,0,1,0.6242669624218805,0.0
355,2,116,24,80,86,1,6838.95,34,2177.724,MORE,490,2908,3398,3,2,6.0,0.5624450764046927,6.0,-0.5238227218271837,-0.8629804810788805,-0.3152487345786918,166,80,86,0,0.11967016489094122,0.0,0.2341001109082052,-0.40419788475477125,0.40815030823412884,0.40815030823412884,0.2341001109082052,0.0,0,0,1,1,0.2341001109082052,0.0
356,2,117,5,50,55,1,7156.2530000000015,64,3211.713,MORE,758,3310,4068,3,2,5.0,0.4687042303372438,5.0,-0.6984302957695783,1.0108010218668186,-0.28018504701935226,105,50,55,0,-1.0969765115002945,-1.170500554541026,-0.9754171287841883,-0.40419788475477125,0.47642090164539025,0.47642090164539025,-0.9754171287841883,-1.170500554541026,1,0,1,0,-1.170500554541026,-0.9754171287841883
357,2,118,34,80,74,0,23243.997000000007,14,1990.092,MORE,-3182,11950,8768,17,1,-6.0,-0.5624450764046927,6.0,-0.5238227218271837,-2.1121681497093467,1.4975971647802095,154,80,74,1,-0.11967016489094122,0.0,-0.2341001109082052,3.5209607648869383,-0.5272587179082288,0.5272587179082288,-0.2341001109082052,0.0,0,1,0,1,0.0,-0.2341001109082052
358,2,119,15,45,50,1,8328.395,54,1783.434,MORE,-548,4172,3624,5,2,5.0,0.4687042303372438,5.0,-0.6984302957695783,0.3862071875515856,-0.15065705370325028,95,45,50,0,-1.2964267863185297,-1.3655839802978638,-1.170500554541026,0.15653906519404445,0.1437291292755866,0.1437291292755866,-1.170500554541026,-1.3655839802978638,1,1,1,0,-1.3655839802978638,-1.170500554541026
359,2,120,37,69,80,1,2418.19,64,1362.421,MORE,-2,1124,1122,1,2,11.0,1.0311493067419364,11.0,0.34921514788478913,1.0108010218668186,-0.8037664839060696,149,69,80,0,-0.21939530230005888,-0.4291835366650429,0.0,-0.9649348347035869,0.2828177263000221,0.2828177263000221,0.0,-0.4291835366650429,1,0,1,1,-0.4291835366650429,0.0
360,2,121,48,128,110,1,10371.722,44,2409.062,LESS,882,4660,5542,5,2,-18.0,-1.6873352292140782,18.0,1.571468165481551,-0.2383866467636475,0.07514156625799231,238,128,110,0,1.5557121435822359,1.8728008872656416,1.170500554541026,0.15653906519404445,0.5080087881491082,0.5080087881491082,1.170500554541026,1.8728008872656416,0,1,1,2,1.8728008872656416,1.170500554541026
361,2,122,8,50,58,0,6100.871,74,1496.749,LESS,-578,3590,3012,5,2,8.0,0.7499267685395902,8.0,-0.17460757394239454,1.6353948561820515,-0.3968104325459648,108,50,58,1,-1.0371414290548238,-1.170500554541026,-0.8583670733300858,0.15653906519404445,0.13608689866984836,0.13608689866984836,-0.8583670733300858,-1.170500554541026,1,1,1,0,-1.170500554541026,-0.8583670733300858
362,2,123,4,54,50,1,10341.341,44,1249.981,LESS,-1096,4662,3566,4,2,-4.0,-0.3749633842697951,4.0,-0.8730378697119728,-0.2383866467636475,0.07178430240690906,104,54,50,0,-1.116921538982118,-1.0144338139355558,-1.170500554541026,-0.1238294097803634,0.004131050210768499,0.004131050210768499,-1.170500554541026,-1.0144338139355558,0,1,0,0,-1.0144338139355558,-1.170500554541026
363,2,124,37,80,69,1,6921.445,74,1239.681,LESS,2918,2068,4986,2,2,-11.0,-1.0311493067419364,11.0,0.34921514788478913,1.6353948561820515,-0.3061325935235877,149,80,69,0,-0.21939530230005888,0.0,-0.4291835366650429,-0.6845663597291791,1.026661505258542,1.026661505258542,-0.4291835366650429,0.0,1,0,1,1,0.0,-0.4291835366650429
364,2,125,52,105,110,0,3024.208,74,1439.642,LESS,-750,2012,1262,2,2,5.0,0.4687042303372438,5.0,-0.6984302957695783,1.6353948561820515,-0.7367982364979591,215,105,110,1,1.0969765115002945,0.9754171287841883,1.170500554541026,-0.6845663597291791,0.09227144319694926,0.09227144319694926,1.170500554541026,0.9754171287841883,1,0,1,2,1.170500554541026,0.9754171287841883
365,2,126,5,55,50,1,8126.898,34,1543.9,LESS,96,3714,3810,5,2,-5.0,-0.4687042303372438,5.0,-0.6984302957695783,-0.8629804810788805,-0.17292355560252073,105,55,50,0,-1.0969765115002945,-0.9754171287841883,-1.170500554541026,0.15653906519404445,0.30778234627876694,0.30778234627876694,-1.170500554541026,-0.9754171287841883,0,1,1,0,-0.9754171287841883,-1.170500554541026
366,2,127,30,96,80,0,6204.749,64,1485.842,LESS,-1704,3484,1780,3,2,-16.0,-1.4998535370791803,16.0,1.222253017596762,1.0108010218668186,-0.38533135501978616,176,96,80,0,0.3191204397091766,0.6242669624218805,0.0,-0.40419788475477125,-0.15075149006552602,0.15075149006552602,0.0,0.6242669624218805,1,0,0,1,0.6242669624218805,0.0
367,2,128,33,80,75,0,4774.057,54,1705.605,LESS,-2044,3212,1168,2,1,-5.0,-0.4687042303372438,5.0,-0.6984302957695783,0.3862071875515856,-0.5434305134949544,155,80,75,0,-0.09972513740911768,0.0,-0.19508342575683765,-0.6845663597291791,-0.23736343693055914,0.23736343693055914,-0.19508342575683765,0.0,1,0,0,1,0.0,-0.19508342575683765
368,2,129,48,110,128,0,4717.593,64,1710.856,LESS,-1470,3024,1554,5,2,18.0,1.6873352292140782,18.0,1.571468165481551,1.0108010218668186,-0.5496700890878436,238,110,128,1,1.5557121435822359,1.170500554541026,1.8728008872656416,0.15653906519404445,-0.09114209134076794,0.09114209134076794,1.8728008872656416,1.170500554541026,1,1,0,2,1.8728008872656416,1.170500554541026
369,2,130,9,59,50,0,12861.619,44,1141.561,LESS,-1538,6498,4960,8,2,-9.0,-0.8436676146070391,9.0,0.0,-0.2383866467636475,0.3502885723150935,109,59,50,0,-1.0171964015730004,-0.8193503881787182,-1.170500554541026,0.997644490117268,-0.10846448071377456,0.10846448071377456,-1.170500554541026,-0.8193503881787182,0,1,0,0,-0.8193503881787182,-1.170500554541026
370,2,131,44,110,119,0,8381.153,44,1091.35,LESS,-2634,5174,2540,2,1,9.0,0.8436676146070391,9.0,0.0,-0.2383866467636475,-0.14482701103660162,229,110,119,1,1.376206896245824,1.170500554541026,1.5216507209033339,-0.6845663597291791,-0.38766063884341073,0.38766063884341073,1.5216507209033339,1.170500554541026,0,0,0,2,1.5216507209033339,1.170500554541026
371,2,132,2,52,50,1,7201.565,54,981.146,LESS,-3152,5152,2000,1,2,-2.0,-0.18748169213489754,2.0,-1.222253017596762,0.3862071875515856,-0.2751778273879945,102,52,50,0,-1.156811593945765,-1.092467184238291,-1.170500554541026,-0.9649348347035869,-0.5196164873024905,0.5196164873024905,-1.170500554541026,-1.092467184238291,1,0,0,0,-1.092467184238291,-1.170500554541026
372,2,133,8,58,50,1,6935.852,64,1981.256,LESS,536,2516,3052,3,2,-8.0,-0.7499267685395902,8.0,-0.17460757394239454,1.0108010218668186,-0.3045405425607307,108,58,50,0,-1.0371414290548238,-0.8583670733300858,-1.170500554541026,-0.40419788475477125,0.41986839516292745,0.41986839516292745,-1.170500554541026,-0.8583670733300858,1,0,1,0,-0.8583670733300858,-1.170500554541026
373,2,134,44,119,110,1,8155.781999999998,64,1353.3529999999996,LESS,1344,3230,4574,3,2,-9.0,-0.8436676146070391,9.0,0.0,1.0108010218668186,-0.1697317183004344,229,119,110,0,1.376206896245824,1.5216507209033339,1.170500554541026,-0.40419788475477125,0.6256991394774768,0.6256991394774768,1.170500554541026,1.5216507209033339,1,0,1,2,1.5216507209033339,1.170500554541026
374,2,135,34,74,80,0,11231.186000000003,44,1232.924,LESS,-2280,6098,3818,4,1,6.0,0.5624450764046927,6.0,-0.5238227218271837,-0.2383866467636475,0.1701169593822305,154,74,80,1,-0.11967016489094122,-0.2341001109082052,0.0,-0.1238294097803634,-0.29748231769569977,0.29748231769569977,0.0,-0.2341001109082052,0,1,0,1,-0.2341001109082052,0.0
375,2,136,24,86,80,1,13460.855,34,1694.064,LESS,-192,6134,5942,6,2,-6.0,-0.5624450764046927,6.0,-0.5238227218271837,-0.8629804810788805,0.4165073722580762,166,86,80,0,0.11967016489094122,0.2341001109082052,0.0,0.4369075401684523,0.2344169324636801,0.2344169324636801,0.0,0.2341001109082052,0,1,1,1,0.2341001109082052,0.0
376,2,137,39,66,80,0,5129.368,74,941.8,LESS,-1288,3138,1850,2,2,14.0,1.3123718449442827,14.0,0.8730378697119728,1.6353948561820515,-0.504166737576049,146,66,80,1,-0.2792303847455295,-0.5462335921191455,0.0,-0.6845663597291791,-0.04477922566595609,0.04477922566595609,0.0,-0.5462335921191455,1,0,0,1,-0.5462335921191455,0.0
377,2,138,9,50,59,0,3361.5370000000007,74,873.8480000000002,LESS,-1076,2344,1268,2,2,9.0,0.8436676146070391,9.0,0.0,1.6353948561820515,-0.6995215682637969,109,50,59,1,-1.0171964015730004,-1.170500554541026,-0.8193503881787182,-0.6845663597291791,0.009225870614593977,0.009225870614593977,-0.8193503881787182,-1.170500554541026,1,0,0,0,-1.170500554541026,-0.8193503881787182
378,2,139,57,94,110,0,13908.459,44,2340.302,LESS,-2680,7324,4644,10,1,16.0,1.4998535370791803,16.0,1.222253017596762,-0.2383866467636475,0.4659700209134957,204,94,110,1,0.8775812092002355,0.5462335921191455,1.170500554541026,1.5583814400660836,-0.39937872577220934,0.39937872577220934,1.170500554541026,0.5462335921191455,0,1,0,2,1.170500554541026,0.5462335921191455
379,2,140,60,110,87,1,6783.104,64,1301.281,LESS,-738,3230,2492,3,2,-23.0,-2.1560394595513217,23.0,2.444506035193524,1.0108010218668186,-0.32142001784874863,197,110,87,0,0.7379660168274708,1.170500554541026,0.27311679605957273,-0.40419788475477125,0.09532833543924454,0.09532833543924454,0.27311679605957273,1.170500554541026,1,0,1,2,1.170500554541026,0.27311679605957273
380,2,141,33,75,80,0,9203.481,24,1686.943,LESS,-3252,6470,3218,6,1,5.0,0.4687042303372438,5.0,-0.6984302957695783,-1.4875743153941137,-0.05395534558340268,155,75,80,1,-0.09972513740911768,-0.19508342575683765,0.0,0.4369075401684523,-0.545090589321618,0.545090589321618,0.0,-0.19508342575683765,0,1,0,1,-0.19508342575683765,0.0
381,2,142,15,50,45,1,5052.915,44,1003.969,LESS,264,2290,2554,3,2,-5.0,-0.4687042303372438,5.0,-0.6984302957695783,-0.2383866467636475,-0.5126152051448214,95,50,45,0,-1.2964267863185297,-1.170500554541026,-1.3655839802978638,-0.40419788475477125,0.350578837670901,0.350578837670901,-1.3655839802978638,-1.170500554541026,0,0,1,0,-1.170500554541026,-1.3655839802978638
382,2,143,59,89,110,0,6342.498000000001,64,1003.626,LESS,-3500,4610,1110,2,1,21.0,1.9685577674164243,21.0,2.0952908873087353,1.0108010218668186,-0.3701093498776618,199,89,110,1,0.7778560717911179,0.3511501663623078,1.170500554541026,-0.6845663597291791,-0.6082663623290538,0.6082663623290538,1.170500554541026,0.3511501663623078,1,0,0,2,1.170500554541026,0.3511501663623078
383,2,144,29,80,94,0,3910.52,44,1509.731,LESS,-1330,2612,1282,2,1,14.0,1.3123718449442827,14.0,0.8730378697119728,-0.2383866467636475,-0.6388559950187005,174,80,94,1,0.2792303847455295,0.0,0.5462335921191455,-0.6845663597291791,-0.05547834851398959,0.05547834851398959,0.5462335921191455,0.0,0,0,0,1,0.5462335921191455,0.0
384,2,145,55,110,98,1,4594.054,54,1203.888,LESS,-620,2484,1864,3,2,-12.0,-1.124890152809385,12.0,0.5238227218271837,0.3862071875515856,-0.563321812826331,208,110,98,0,0.9573613191275298,1.170500554541026,0.7023003327246156,-0.40419788475477125,0.12538777582181487,0.12538777582181487,0.7023003327246156,1.170500554541026,1,0,1,2,1.170500554541026,0.7023003327246156
385,2,146,29,94,80,0,15601.451,24,1100.065,LESS,-2058,8070,6012,10,1,-14.0,-1.3123718449442827,14.0,0.8730378697119728,-1.4875743153941137,0.6530547397105476,174,94,80,0,0.2792303847455295,0.5462335921191455,0.0,1.5583814400660836,-0.24092981121323698,0.24092981121323698,0.0,0.5462335921191455,0,1,0,1,0.5462335921191455,0.0
386,2,147,57,110,94,1,7309.275,24,1638.976,LESS,786,3044,3830,3,2,-16.0,-1.4998535370791803,16.0,1.222253017596762,-1.4875743153941137,-0.2632752932581046,204,110,94,0,0.8775812092002355,1.170500554541026,0.5462335921191455,-0.40419788475477125,0.4835536502107459,0.4835536502107459,0.5462335921191455,1.170500554541026,0,0,1,2,1.170500554541026,0.5462335921191455
387,2,148,39,80,66,1,5190.82,24,2606.4,LESS,704,2182,2886,3,1,-14.0,-1.3123718449442827,14.0,0.8730378697119728,-1.4875743153941137,-0.4973759611639241,146,80,66,0,-0.2792303847455295,0.0,-0.5462335921191455,-0.40419788475477125,0.4626648865550615,0.4626648865550615,-0.5462335921191455,0.0,0,0,1,1,0.0,-0.5462335921191455
388,2,149,4,50,54,0,20879.898,24,1616.398,LESS,-1756,10028,8272,21,1,4.0,0.3749633842697951,4.0,-0.8730378697119728,-1.4875743153941137,1.2363515141076764,104,50,54,1,-1.116921538982118,-1.170500554541026,-1.0144338139355558,4.64243466478457,-0.16399802311547226,0.16399802311547226,-1.0144338139355558,-1.170500554541026,0,1,0,0,-1.170500554541026,-1.0144338139355558
389,2,150,55,98,110,0,4408.831,54,1312.763,LESS,-1082,2670,1588,5,2,12.0,1.124890152809385,12.0,0.5238227218271837,0.3862071875515856,-0.5837899502243495,208,98,110,1,0.9573613191275298,0.7023003327246156,1.170500554541026,0.15653906519404445,0.007697424493446334,0.007697424493446334,1.170500554541026,0.7023003327246156,1,1,0,2,1.170500554541026,0.7023003327246156
390,2,151,2,50,52,0,13117.59,34,1703.693,LESS,-2310,7062,4752,10,2,2.0,0.18748169213489754,2.0,-1.222253017596762,-0.8629804810788805,0.3785747441075179,102,50,52,1,-1.156811593945765,-1.170500554541026,-1.092467184238291,1.5583814400660836,-0.305124548301438,0.305124548301438,-1.092467184238291,-1.170500554541026,0,1,0,0,-1.170500554541026,-1.092467184238291
391,2,152,59,110,89,1,5613.9659999999985,74,1144.659,LESS,1096,2352,3448,3,2,-21.0,-1.9685577674164243,21.0,2.0952908873087353,1.6353948561820515,-0.4506160530130898,199,110,89,0,0.7778560717911179,1.170500554541026,0.3511501663623078,-0.40419788475477125,0.5625233664700409,0.5625233664700409,0.3511501663623078,1.170500554541026,1,0,1,2,1.170500554541026,0.3511501663623078
392,2,153,60,87,110,0,5082.736,74,1092.619,LESS,-474,2826,2352,5,2,23.0,2.1560394595513217,23.0,2.444506035193524,1.6353948561820515,-0.5093198243047189,197,87,110,1,0.7379660168274708,0.27311679605957273,1.170500554541026,0.15653906519404445,0.16257996476974085,0.16257996476974085,1.170500554541026,0.27311679605957273,1,1,1,2,1.170500554541026,0.27311679605957273
393,2,154,52,110,105,0,8499.643,24,1508.2220000000002,LESS,-1162,4506,3344,6,1,-5.0,-0.4687042303372438,5.0,-0.6984302957695783,-1.4875743153941137,-0.13173322894533204,215,110,105,0,1.0969765115002945,1.170500554541026,0.9754171287841883,0.4369075401684523,-0.012681857121855577,0.012681857121855577,0.9754171287841883,1.170500554541026,0,1,0,2,1.170500554541026,0.9754171287841883
394,2,155,30,80,96,0,7979.472,54,1411.614,LESS,-2612,5064,2452,6,2,16.0,1.4998535370791803,16.0,1.222253017596762,0.3862071875515856,-0.189214921275468,176,80,96,1,0.3191204397091766,0.0,0.6242669624218805,0.4369075401684523,-0.3820563363992027,0.3820563363992027,0.6242669624218805,0.0,1,1,0,1,0.6242669624218805,0.0
395,2,156,24,80,86,1,15395.867,34,1630.552,LESS,848,6316,7164,6,2,6.0,0.5624450764046927,6.0,-0.5238227218271837,-0.8629804810788805,0.6303366023364945,166,80,86,1,0.11967016489094122,0.0,0.2341001109082052,0.4369075401684523,0.49934759346260493,0.49934759346260493,0.2341001109082052,0.0,0,1,1,1,0.2341001109082052,0.0
396,2,157,5,50,55,0,8201.57,64,1107.142,LESS,-478,4210,3732,7,2,5.0,0.4687042303372438,5.0,-0.6984302957695783,1.0108010218668186,-0.1646718981097426,105,50,55,1,-1.0969765115002945,-1.170500554541026,-0.9754171287841883,0.7172760151428601,0.16156100068897575,0.16156100068897575,-0.9754171287841883,-1.170500554541026,1,1,1,0,-1.170500554541026,-0.9754171287841883
397,2,158,34,80,74,1,6820.1680000000015,54,1301.198,LESS,-160,3166,3006,5,2,-6.0,-0.5624450764046927,6.0,-0.5238227218271837,0.3862071875515856,-0.31732424656483577,154,80,74,0,-0.11967016489094122,0.0,-0.2341001109082052,0.15653906519404445,0.24256864510980083,0.24256864510980083,-0.2341001109082052,0.0,1,1,1,1,0.0,-0.2341001109082052
398,2,159,15,45,50,0,8076.828,44,1552.155,LESS,-578,3810,3232,8,2,5.0,0.4687042303372438,5.0,-0.6984302957695783,-0.2383866467636475,-0.1784565598164617,95,45,50,1,-1.2964267863185297,-1.3655839802978638,-1.170500554541026,0.997644490117268,0.13608689866984836,0.13608689866984836,-1.170500554541026,-1.3655839802978638,0,1,1,0,-1.3655839802978638,-1.170500554541026
399,2,160,37,69,80,0,5123.042,64,1627.2679999999998,LESS,-730,3156,2426,5,2,11.0,1.0311493067419364,11.0,0.34921514788478913,1.0108010218668186,-0.5048657945893782,149,69,80,1,-0.21939530230005888,-0.4291835366650429,0.0,0.15653906519404445,0.09736626360077474,0.09736626360077474,0.0,-0.4291835366650429,1,1,1,1,-0.4291835366650429,0.0
400,2,161,3,50,53,1,7567.203,44,1533.445,MORE,-420,3358,2938,3,2,3.0,0.28122253820234633,3.0,-1.0476454436543674,-0.2383866467636475,-0.2347728624433777,103,50,53,0,-1.1368665664639415,-1.170500554541026,-1.0534504990869233,-0.40419788475477125,0.17633597986006963,0.17633597986006963,-1.0534504990869233,-1.170500554541026,0,0,1,0,-1.170500554541026,-1.0534504990869233
401,2,162,20,50,40,0,3128.203,64,1377.761,MORE,144,1734,1878,2,2,-10.0,-0.9374084606744876,10.0,0.17460757394239454,1.0108010218668186,-0.7253062298427007,90,50,40,1,-1.3961519237276474,-1.170500554541026,-1.5606674060547012,-0.6845663597291791,0.3200099152479481,0.3200099152479481,-1.5606674060547012,-1.170500554541026,1,0,1,0,-1.170500554541026,-1.5606674060547012
402,2,163,25,80,88,1,4282.243,44,1329.2520000000004,MORE,-336,2100,1764,3,2,8.0,0.7499267685395902,8.0,-0.17460757394239454,-0.2383866467636475,-0.5977786048565518,168,80,88,0,0.1595602198545883,0.0,0.31213348121094026,-0.40419788475477125,0.19773422555613665,0.19773422555613665,0.31213348121094026,0.0,0,0,1,1,0.31213348121094026,0.0
403,2,164,42,115,110,1,11387.791,34,1121.898,MORE,912,3980,4892,5,2,-5.0,-0.4687042303372438,5.0,-0.6984302957695783,-0.8629804810788805,0.18742265390837806,225,115,110,1,1.2964267863185297,1.3655839802978638,1.170500554541026,0.15653906519404445,0.5156510187548464,0.5156510187548464,1.170500554541026,1.3655839802978638,0,1,1,2,1.3655839802978638,1.170500554541026
404,2,165,53,103,110,1,6243.72,64,1364.308,MORE,408,2974,3382,5,2,7.0,0.6561859224721414,7.0,-0.34921514788478913,1.0108010218668186,-0.3810248499824085,213,103,110,0,1.0570864565366473,0.8973837584814532,1.170500554541026,0.15653906519404445,0.3872615445784444,0.3872615445784444,1.170500554541026,0.8973837584814532,1,1,1,2,1.170500554541026,0.8973837584814532
405,2,166,26,90,80,1,7674.5,44,1880.84,MORE,-384,3688,3304,5,2,-10.0,-0.9374084606744876,10.0,0.17460757394239454,-0.2383866467636475,-0.22291596703408614,170,90,80,1,0.19945027481823535,0.3901668515136753,0.0,0.15653906519404445,0.1855066565869555,0.1855066565869555,0.0,0.3901668515136753,0,1,1,1,0.3901668515136753,0.0
406,2,167,35,80,72,0,13351.711,24,1787.5870000000002,MORE,-1262,6590,5328,12,1,-8.0,-0.7499267685395902,8.0,-0.17460757394239454,-1.4875743153941137,0.4044463734179248,152,80,72,1,-0.1595602198545883,0.0,-0.31213348121094026,2.1191183900148993,-0.038155959140982965,0.038155959140982965,-0.31213348121094026,0.0,0,1,0,1,0.0,-0.31213348121094026
407,2,168,28,93,80,0,15023.755,14,1651.419,MORE,118,6602,6720,8,1,-13.0,-1.218630998876834,13.0,0.6984302957695783,-2.1121681497093467,0.5892162255827893,173,93,80,1,0.25928535726370594,0.5072169069677779,0.0,0.997644490117268,0.313386648722975,0.313386648722975,0.0,0.5072169069677779,0,1,1,1,0.5072169069677779,0.0
408,2,169,26,80,90,1,4556.762,34,1129.431,MORE,-702,2474,1772,3,2,10.0,0.9374084606744876,10.0,0.17460757394239454,-0.8629804810788805,-0.567442779336143,170,80,90,0,0.19945027481823535,0.0,0.3901668515136753,-0.40419788475477125,0.1044990121661304,0.1044990121661304,0.3901668515136753,0.0,0,0,0,1,0.3901668515136753,0.0
409,2,170,25,88,80,0,8987.876,34,1461.971,MORE,218,3802,4020,6,1,-8.0,-0.7499267685395902,8.0,-0.17460757394239454,-0.8629804810788805,-0.07778085733788134,168,88,80,1,0.1595602198545883,0.31213348121094026,0.0,0.4369075401684523,0.33886075074210237,0.33886075074210237,0.0,0.31213348121094026,0,1,1,1,0.31213348121094026,0.0
410,2,171,36,80,70,0,10619.167,34,1592.764,MORE,240,4480,4720,7,2,-10.0,-0.9374084606744876,10.0,0.17460757394239454,-0.8629804810788805,0.10248556920823457,150,80,70,1,-0.19945027481823535,0.0,-0.3901668515136753,0.7172760151428601,0.3444650531863104,0.3444650531863104,-0.3901668515136753,0.0,0,1,1,1,0.0,-0.3901668515136753
411,2,172,28,80,93,1,3456.776,64,1060.793,MORE,396,1676,2072,3,2,13.0,1.218630998876834,13.0,0.6984302957695783,1.0108010218668186,-0.6889971466873733,173,80,93,0,0.25928535726370594,0.0,0.5072169069677779,-0.40419788475477125,0.38420465233614914,0.38420465233614914,0.5072169069677779,0.0,1,0,1,1,0.5072169069677779,0.0
412,2,173,21,82,80,0,6730.993,24,1502.226,MORE,-2196,4254,2058,4,1,-2.0,-0.18748169213489754,2.0,-1.222253017596762,-1.4875743153941137,-0.3271785635366392,162,82,80,1,0.03989005496364707,0.07803337030273506,0.0,-0.1238294097803634,-0.27608407199963275,0.27608407199963275,0.0,0.07803337030273506,0,1,0,1,0.07803337030273506,0.0
413,2,174,19,50,41,0,6897.651999999999,44,2064.669,MORE,-852,3814,2962,5,2,-9.0,-0.8436676146070391,9.0,0.0,-0.2383866467636475,-0.30876184795263306,91,50,41,1,-1.376206896245824,-1.170500554541026,-1.5216507209033339,0.15653906519404445,0.06628785913743933,0.06628785913743933,-1.5216507209033339,-1.170500554541026,0,1,0,0,-1.170500554541026,-1.5216507209033339
414,2,175,56,96,110,1,7074.3719999999985,64,1301.852,MORE,-246,3104,2858,5,2,14.0,1.3123718449442827,14.0,0.8730378697119728,1.0108010218668186,-0.28923333777313137,206,96,110,0,0.9174712641638826,0.6242669624218805,1.170500554541026,0.15653906519404445,0.2206609173733513,0.2206609173733513,1.170500554541026,0.6242669624218805,1,1,1,2,1.170500554541026,0.6242669624218805
415,2,176,23,80,85,1,4346.168,64,1809.837,MORE,-464,2432,1968,3,2,5.0,0.4687042303372438,5.0,-0.6984302957695783,1.0108010218668186,-0.5907145486477205,165,80,85,0,0.09972513740911768,0.0,0.19508342575683765,-0.40419788475477125,0.16512737497165358,0.16512737497165358,0.19508342575683765,0.0,1,0,1,1,0.19508342575683765,0.0
416,2,177,10,60,50,0,15269.582,34,1646.819,MORE,-410,7206,6796,11,2,-10.0,-0.9374084606744876,10.0,0.17460757394239454,-0.8629804810788805,0.616381430833448,110,60,50,1,-0.9972513740911768,-0.7803337030273506,-1.170500554541026,1.8387499150404916,0.17888339006198237,0.17888339006198237,-1.170500554541026,-0.7803337030273506,0,1,1,0,-0.7803337030273506,-1.170500554541026
417,2,178,19,41,50,1,5680.574000000001,44,1678.5510000000004,MORE,-932,2710,1778,4,1,9.0,0.8436676146070391,9.0,0.0,-0.2383866467636475,-0.4432555108784344,91,41,50,0,-1.376206896245824,-1.5216507209033339,-1.170500554541026,-0.1238294097803634,0.045908577522137416,0.045908577522137416,-1.170500554541026,-1.5216507209033339,0,1,0,0,-1.5216507209033339,-1.170500554541026
418,2,179,56,110,96,0,6420.155,54,1306.589,MORE,-2052,4158,2106,4,1,-14.0,-1.3123718449442827,14.0,0.8730378697119728,0.3862071875515856,-0.361527833835281,206,110,96,1,0.9174712641638826,1.170500554541026,0.6242669624218805,-0.1238294097803634,-0.2394013650920893,0.2394013650920893,0.6242669624218805,1.170500554541026,1,1,0,2,1.170500554541026,0.6242669624218805
419,2,180,35,72,80,1,7512.655,54,2780.489,MORE,188,3574,3762,5,2,8.0,0.7499267685395902,8.0,-0.17460757394239454,0.3862071875515856,-0.24080070973441134,152,72,80,0,-0.1595602198545883,-0.31213348121094026,0.0,0.15653906519404445,0.33121852013636416,0.33121852013636416,0.0,-0.31213348121094026,1,1,1,1,-0.31213348121094026,0.0
420,2,181,11,49,50,1,4470.683,54,1448.036,MORE,864,2056,2920,3,2,1.0,0.09374084606744876,1.0,-1.3968605915391563,0.3862071875515856,-0.576954971661524,99,49,50,0,-1.2166466763912356,-1.2095172396923934,-1.170500554541026,-0.40419788475477125,0.5034234497856653,0.5034234497856653,-1.170500554541026,-1.2095172396923934,1,0,1,0,-1.2095172396923934,-1.170500554541026
421,2,182,17,43,50,0,15616.594,24,1045.636,MORE,-954,7230,6276,6,1,7.0,0.6561859224721414,7.0,-0.34921514788478913,-1.4875743153941137,0.6547281226306936,93,43,50,0,-1.3363168412821769,-1.4436173506005987,-1.170500554541026,0.4369075401684523,0.04030427507792939,0.04030427507792939,-1.170500554541026,-1.4436173506005987,0,1,0,0,-1.4436173506005987,-1.170500554541026
422,2,183,1,51,50,0,5593.92,54,1699.497,MORE,-1080,3150,2070,4,1,-1.0,-0.09374084606744876,1.0,-1.3968605915391563,0.3862071875515856,-0.4528312437954475,101,51,50,1,-1.1767566214275886,-1.1314838693896585,-1.170500554541026,-0.1238294097803634,0.00820690653382888,0.00820690653382888,-1.170500554541026,-1.1314838693896585,1,1,0,0,-1.1314838693896585,-1.170500554541026
423,2,184,41,112,110,1,7397.905,44,1633.376,MORE,-3206,5038,1832,3,2,-2.0,-0.18748169213489754,2.0,-1.222253017596762,-0.2383866467636475,-0.2534812017166309,222,112,110,1,1.2365917038730592,1.248533924843761,1.170500554541026,-0.40419788475477125,-0.5333725023928194,0.5333725023928194,1.170500554541026,1.248533924843761,0,0,0,2,1.248533924843761,1.170500554541026
424,2,185,20,40,50,1,4188.963,24,1771.9229999999998,MORE,468,1800,2268,3,2,10.0,0.9374084606744876,10.0,0.17460757394239454,-1.4875743153941137,-0.6080865463999194,90,40,50,0,-1.3961519237276474,-1.5606674060547012,-1.170500554541026,-0.40419788475477125,0.40254600578992084,0.40254600578992084,-1.170500554541026,-1.5606674060547012,0,0,1,0,-1.5606674060547012,-1.170500554541026
425,2,186,1,50,51,1,11009.734,54,1889.552,MORE,-1722,5472,3750,5,2,1.0,0.09374084606744876,1.0,-1.3968605915391563,0.3862071875515856,0.14564532268988625,101,50,51,0,-1.1767566214275886,-1.170500554541026,-1.1314838693896585,0.15653906519404445,-0.15533682842896895,0.15533682842896895,-1.1314838693896585,-1.170500554541026,1,1,0,0,-1.170500554541026,-1.1314838693896585
426,2,187,23,85,80,1,12227.283,14,1341.159,MORE,1324,5110,6434,11,1,-5.0,-0.4687042303372438,5.0,-0.6984302957695783,-2.1121681497093467,0.2801910336481376,165,85,80,1,0.09972513740911768,0.19508342575683765,0.0,1.8387499150404916,0.6206043190736513,0.6206043190736513,0.0,0.19508342575683765,0,1,1,1,0.19508342575683765,0.0
427,2,188,11,50,49,0,6611.683000000001,44,1258.425,MORE,-992,3896,2904,7,2,-1.0,-0.09374084606744876,1.0,-1.3968605915391563,-0.2383866467636475,-0.3403629600368448,99,50,49,1,-1.2166466763912356,-1.170500554541026,-1.2095172396923934,0.7172760151428601,0.030624116310660983,0.030624116310660983,-1.2095172396923934,-1.170500554541026,0,1,0,0,-1.170500554541026,-1.2095172396923934
428,2,189,17,50,43,0,6072.679,34,1209.646,MORE,-1668,3734,2066,6,1,-7.0,-0.6561859224721414,7.0,-0.34921514788478913,-0.8629804810788805,-0.3999258001273393,93,50,43,1,-1.3363168412821769,-1.170500554541026,-1.4436173506005987,0.4369075401684523,-0.14158081333864017,0.14158081333864017,-1.4436173506005987,-1.170500554541026,0,1,0,0,-1.170500554541026,-1.4436173506005987
429,2,190,21,80,82,1,6999.655,54,1150.075,MORE,504,2996,3500,4,2,2.0,0.18748169213489754,2.0,-1.222253017596762,0.3862071875515856,-0.2974899680078632,162,80,82,0,0.03989005496364707,0.0,0.07803337030273506,-0.1238294097803634,0.4117166825168067,0.4117166825168067,0.07803337030273506,0.0,1,1,1,1,0.07803337030273506,0.0
430,2,191,10,50,60,1,3228.329,44,1556.749,MORE,-18,1594,1576,3,2,10.0,0.9374084606744876,10.0,0.17460757394239454,-0.2383866467636475,-0.7142417684900931,110,50,60,0,-0.9972513740911768,-1.170500554541026,-0.7803337030273506,-0.40419788475477125,0.2787418699769617,0.2787418699769617,-0.7803337030273506,-1.170500554541026,0,0,1,0,-1.170500554541026,-0.7803337030273506
431,2,192,3,53,50,0,4967.049,44,1459.5179999999998,MORE,-1312,2980,1668,4,1,-3.0,-0.28122253820234633,3.0,-1.0476454436543674,-0.2383866467636475,-0.5221038598249544,103,53,50,1,-1.1368665664639415,-1.0534504990869233,-1.170500554541026,-0.1238294097803634,-0.05089301015054666,0.05089301015054666,-1.170500554541026,-1.0534504990869233,0,1,0,0,-1.0534504990869233,-1.170500554541026
432,2,193,45,122,110,1,12912.862,14,2235.743,MORE,-498,5646,5148,13,2,-12.0,-1.124890152809385,12.0,0.5238227218271837,-2.1121681497093467,0.3559511993359637,232,122,110,1,1.4360419786912946,1.6387007763574364,1.170500554541026,2.3994868649893073,0.15646618028515027,0.15646618028515027,1.170500554541026,1.6387007763574364,0,1,1,2,1.6387007763574364,1.170500554541026
433,2,194,38,67,80,1,5397.382,34,1108.579,MORE,-198,2578,2380,3,1,13.0,1.218630998876834,13.0,0.6984302957695783,-0.8629804810788805,-0.47454974953140794,147,67,80,0,-0.25928535726370594,-0.5072169069677779,0.0,-0.40419788475477125,0.23288848634253245,0.23288848634253245,0.0,-0.5072169069677779,0,0,1,1,-0.5072169069677779,0.0
434,2,195,38,80,67,0,9558.551,34,2063.309,MORE,-3332,5878,2546,6,1,-13.0,-1.218630998876834,13.0,0.6984302957695783,-0.8629804810788805,-0.014718201460294447,147,80,67,1,-0.25928535726370594,0.0,-0.5072169069677779,0.4369075401684523,-0.5654698709369199,0.5654698709369199,-0.5072169069677779,0.0,0,1,0,1,0.0,-0.5072169069677779
435,2,196,36,70,80,1,6003.087,54,1487.019,MORE,-1058,3280,2222,3,2,10.0,0.9374084606744876,10.0,0.17460757394239454,0.3862071875515856,-0.4076160903062205,150,70,80,0,-0.19945027481823535,-0.3901668515136753,0.0,-0.40419788475477125,0.013811208978036907,0.013811208978036907,0.0,-0.3901668515136753,1,0,0,1,-0.3901668515136753,0.0
436,2,197,45,110,122,1,18304.296,24,1284.804,MORE,-90,7862,7772,12,2,12.0,1.124890152809385,12.0,0.5238227218271837,-1.4875743153941137,0.9517336447360991,232,110,122,0,1.4360419786912946,1.170500554541026,1.6387007763574364,2.1191183900148993,0.26040051652319,0.26040051652319,1.6387007763574364,1.170500554541026,0,1,1,2,1.6387007763574364,1.170500554541026
437,2,198,42,110,115,1,4058.755,44,1207.067,MORE,-764,2288,1524,3,2,5.0,0.4687042303372438,5.0,-0.6984302957695783,-0.2383866467636475,-0.6224752304959615,225,110,115,0,1.2964267863185297,1.170500554541026,1.3655839802978638,-0.40419788475477125,0.08870506891427142,0.08870506891427142,1.3655839802978638,1.170500554541026,0,0,0,2,1.3655839802978638,1.170500554541026
438,2,199,41,110,112,1,23107.279,4,1648.195,MORE,1230,8836,10066,16,1,2.0,0.18748169213489754,2.0,-1.222253017596762,-2.73676198402458,1.4824890906815151,222,110,112,0,1.2365917038730592,1.170500554541026,1.248533924843761,3.240592289912531,0.5966586631756715,0.5966586631756715,1.248533924843761,1.170500554541026,0,1,1,2,1.248533924843761,1.170500554541026
439,2,200,53,110,103,0,7476.425,34,1024.117,MORE,-1526,3894,2368,3,1,-7.0,-0.6561859224721414,7.0,-0.34921514788478913,-0.8629804810788805,-0.24480431953411336,213,110,103,1,1.0570864565366473,1.170500554541026,0.8973837584814532,-0.40419788475477125,-0.10540758847147927,0.10540758847147927,0.8973837584814532,1.170500554541026,0,1,0,2,1.170500554541026,0.8973837584814532
440,2,201,3,50,53,0,7575.096,44,1030.752,LESS,-162,2970,2808,4,1,3.0,0.28122253820234633,3.0,-1.0476454436543674,-0.2383866467636475,-0.2339006435046792,103,50,53,1,-1.1368665664639415,-1.170500554541026,-1.0534504990869233,-0.1238294097803634,0.2420591630694183,0.2420591630694183,-1.0534504990869233,-1.170500554541026,0,0,1,0,-1.170500554541026,-1.0534504990869233
441,2,202,20,50,40,1,4658.442,44,1261.478,LESS,798,1774,2572,3,2,-10.0,-0.9374084606744876,10.0,0.17460757394239454,-0.2383866467636475,-0.5562065926280638,90,50,40,0,-1.3961519237276474,-1.170500554541026,-1.5606674060547012,-0.40419788475477125,0.4866105424530412,0.4866105424530412,-1.5606674060547012,-1.170500554541026,0,0,1,0,-1.170500554541026,-1.5606674060547012
442,2,203,25,80,88,0,7008.028,24,1411.5320000000004,LESS,-1900,4164,2264,4,1,8.0,0.7499267685395902,8.0,-0.17460757394239454,-1.4875743153941137,-0.2965647064883239,168,80,88,1,0.1595602198545883,0.0,0.31213348121094026,-0.1238294097803634,-0.2006807300230157,0.2006807300230157,0.31213348121094026,0.0,0,0,0,1,0.31213348121094026,0.0
443,2,204,42,115,110,0,13829.928,34,1767.4260000000004,LESS,-1408,7024,5616,17,2,-5.0,-0.4687042303372438,5.0,-0.6984302957695783,-0.8629804810788805,0.4572919231718339,225,115,110,0,1.2964267863185297,1.3655839802978638,1.170500554541026,3.5209607648869383,-0.07534814808890895,0.07534814808890895,1.170500554541026,1.3655839802978638,0,1,0,2,1.3655839802978638,1.170500554541026
444,2,205,53,103,110,0,2747.496,54,897.098999999,LESS,-874,1640,766,2,1,7.0,0.6561859224721414,7.0,-0.34921514788478913,0.3862071875515856,-0.7673764003095837,213,103,110,1,1.0570864565366473,0.8973837584814532,1.170500554541026,-0.6845663597291791,0.0606835566932313,0.0606835566932313,1.170500554541026,0.8973837584814532,1,0,0,2,1.170500554541026,0.8973837584814532
445,2,206,26,90,80,1,12428.383,14,1017.809,LESS,-212,5774,5562,8,1,-10.0,-0.9374084606744876,10.0,0.17460757394239454,-2.1121681497093467,0.3024136649128377,170,90,80,0,0.19945027481823535,0.3901668515136753,0.0,0.997644490117268,0.22932211205985462,0.22932211205985462,0.0,0.3901668515136753,0,1,1,1,0.3901668515136753,0.0
446,2,207,35,80,72,0,4775.54,54,1336.203,LESS,-938,2780,1842,5,2,-8.0,-0.7499267685395902,8.0,-0.17460757394239454,0.3862071875515856,-0.5432666340212322,152,80,72,0,-0.1595602198545883,0.0,-0.31213348121094026,0.15653906519404445,0.04438013140098977,0.04438013140098977,-0.31213348121094026,0.0,1,1,0,1,0.0,-0.31213348121094026
447,2,208,28,93,80,1,6153.953,24,1286.201,LESS,50,2856,2906,3,1,-13.0,-1.218630998876834,13.0,0.6984302957695783,-1.4875743153941137,-0.3909445861372486,173,93,80,0,0.25928535726370594,0.5072169069677779,0.0,-0.40419788475477125,0.2960642593499684,0.2960642593499684,0.0,0.5072169069677779,0,0,1,1,0.5072169069677779,0.0
448,2,209,26,80,90,0,5461.167,34,1180.818,LESS,-1368,3390,2022,4,1,10.0,0.9374084606744876,10.0,0.17460757394239454,-0.8629804810788805,-0.4675011640753219,170,80,90,1,0.19945027481823535,0.0,0.3901668515136753,-0.1238294097803634,-0.065158507281258,0.065158507281258,0.3901668515136753,0.0,0,0,0,1,0.3901668515136753,0.0
449,2,210,25,88,80,1,7037.482,34,1047.218,LESS,-24,3290,3266,5,2,-8.0,-0.7499267685395902,8.0,-0.17460757394239454,-0.8629804810788805,-0.29330988112148915,168,88,80,0,0.1595602198545883,0.31213348121094026,0.0,0.15653906519404445,0.2772134238558141,0.2772134238558141,0.0,0.31213348121094026,0,1,1,1,0.31213348121094026,0.0
450,2,211,36,80,70,1,15416.275,24,1488.2479999999996,LESS,-1306,7394,6088,9,2,-10.0,-0.9374084606744876,10.0,0.17460757394239454,-1.4875743153941137,0.6325917960652364,150,80,70,0,-0.19945027481823535,0.0,-0.3901668515136753,1.2780129650916758,-0.04936456402939902,0.04936456402939902,-0.3901668515136753,0.0,0,1,0,1,0.0,-0.3901668515136753
451,2,212,28,80,93,0,5270.916,64,1166.473,LESS,-1236,3076,1840,3,2,13.0,1.218630998876834,13.0,0.6984302957695783,1.0108010218668186,-0.4885249225076464,173,80,93,1,0.25928535726370594,0.0,0.5072169069677779,-0.40419788475477125,-0.03153269261600984,0.03153269261600984,0.5072169069677779,0.0,1,0,0,1,0.5072169069677779,0.0
452,2,213,21,82,80,1,5931.903,44,2847.458,LESS,-252,2740,2488,3,2,-2.0,-0.18748169213489754,2.0,-1.222253017596762,-0.2383866467636475,-0.41548230504488987,162,82,80,0,0.03989005496364707,0.07803337030273506,0.0,-0.40419788475477125,0.21913247125220364,0.21913247125220364,0.0,0.07803337030273506,0,0,1,1,0.07803337030273506,0.0
453,2,214,19,50,41,1,4572.768,54,1150.262,LESS,254,1826,2080,3,2,-9.0,-0.8436676146070391,9.0,0.0,0.3862071875515856,-0.5656740302758606,91,50,41,0,-1.376206896245824,-1.170500554541026,-1.5216507209033339,-0.40419788475477125,0.34803142746898824,0.34803142746898824,-1.5216507209033339,-1.170500554541026,1,0,1,0,-1.170500554541026,-1.5216507209033339
454,2,215,56,96,110,0,5824.12,54,1561.204,LESS,-406,3000,2594,3,2,14.0,1.3123718449442827,14.0,0.8730378697119728,0.3862071875515856,-0.42739290606728253,206,96,110,1,0.9174712641638826,0.6242669624218805,1.170500554541026,-0.40419788475477125,0.17990235414274747,0.17990235414274747,1.170500554541026,0.6242669624218805,1,0,1,2,1.170500554541026,0.6242669624218805
455,2,216,23,80,85,1,8615.398000000001,34,1549.4920000000004,LESS,-1462,4776,3314,1,1,5.0,0.4687042303372438,5.0,-0.6984302957695783,-0.8629804810788805,-0.11894167905947732,165,80,85,1,0.09972513740911768,0.0,0.19508342575683765,-0.9649348347035869,-0.08910416317923774,0.08910416317923774,0.19508342575683765,0.0,0,0,0,1,0.19508342575683765,0.0
456,2,217,10,60,50,1,8031.564,54,2373.862,LESS,-890,4518,3628,7,2,-10.0,-0.9374084606744876,10.0,0.17460757394239454,0.3862071875515856,-0.18345847518973565,110,60,50,0,-0.9972513740911768,-0.7803337030273506,-1.170500554541026,0.7172760151428601,0.05660770037017092,0.05660770037017092,-1.170500554541026,-0.7803337030273506,1,1,0,0,-0.7803337030273506,-1.170500554541026
457,2,218,19,41,50,0,2722.327,74,1037.644,LESS,-428,1780,1352,2,2,9.0,0.8436676146070391,9.0,0.0,1.6353948561820515,-0.7701577101370388,91,41,50,1,-1.376206896245824,-1.5216507209033339,-1.170500554541026,-0.6845663597291791,0.17429805169853946,0.17429805169853946,-1.170500554541026,-1.5216507209033339,1,0,1,0,-1.5216507209033339,-1.170500554541026
458,2,219,56,110,96,1,14101.24,24,1250.156,LESS,-554,5964,5410,6,2,-14.0,-1.3123718449442827,14.0,0.8730378697119728,-1.4875743153941137,0.487273357949001,206,110,96,0,0.9174712641638826,1.170500554541026,0.6242669624218805,0.4369075401684523,0.14220068315443893,0.14220068315443893,0.6242669624218805,1.170500554541026,0,1,1,2,1.170500554541026,0.6242669624218805
459,2,220,35,72,80,0,8237.123,44,2094.9120000000007,LESS,374,3212,3586,3,2,8.0,0.7499267685395902,8.0,-0.17460757394239454,-0.2383866467636475,-0.16074310045010126,152,72,80,1,-0.1595602198545883,-0.31213348121094026,0.0,-0.40419788475477125,0.3786003498919411,0.3786003498919411,0.0,-0.31213348121094026,0,0,1,1,-0.31213348121094026,0.0
460,2,221,11,49,50,0,5628.714,44,2480.792,LESS,-1736,3184,1448,3,2,1.0,0.09374084606744876,1.0,-1.3968605915391563,-0.2383866467636475,-0.4489863197167605,99,49,50,1,-1.2166466763912356,-1.2095172396923934,-1.170500554541026,-0.40419788475477125,-0.1589032027116468,0.1589032027116468,-1.170500554541026,-1.2095172396923934,0,0,0,0,-1.2095172396923934,-1.170500554541026
461,2,222,17,43,50,0,7812.105,64,1425.118,LESS,-1746,4616,2870,5,2,7.0,0.6561859224721414,7.0,-0.34921514788478913,1.0108010218668186,-0.2077098746662142,93,43,50,1,-1.3363168412821769,-1.4436173506005987,-1.170500554541026,0.15653906519404445,-0.16145061291355953,0.16145061291355953,-1.170500554541026,-1.4436173506005987,1,1,0,0,-1.4436173506005987,-1.170500554541026
462,2,223,1,51,50,0,13191.96,44,1584.338,LESS,-2464,7318,4854,13,2,-1.0,-0.09374084606744876,1.0,-1.3968605915391563,-0.2383866467636475,0.386793028976517,101,51,50,0,-1.1767566214275886,-1.1314838693896585,-1.170500554541026,2.3994868649893073,-0.34435466541089416,0.34435466541089416,-1.170500554541026,-1.1314838693896585,0,1,0,0,-1.1314838693896585,-1.170500554541026
463,2,224,41,112,110,0,7394.705,44,1160.77,LESS,-960,3946,2986,7,2,-2.0,-0.18748169213489754,2.0,-1.222253017596762,-0.2383866467636475,-0.2538348189222352,222,112,110,0,1.2365917038730592,1.248533924843761,1.170500554541026,0.7172760151428601,0.03877582895678175,0.03877582895678175,1.170500554541026,1.248533924843761,0,1,0,2,1.248533924843761,1.170500554541026
464,2,225,20,40,50,0,13209.633,54,1259.044,LESS,-2778,7456,4678,3,1,10.0,0.9374084606744876,10.0,0.17460757394239454,0.3862071875515856,0.388745990499844,90,40,50,1,-1.3961519237276474,-1.5606674060547012,-1.170500554541026,-0.40419788475477125,-0.42434334575095417,0.42434334575095417,-1.170500554541026,-1.5606674060547012,1,0,0,0,-1.5606674060547012,-1.170500554541026
465,2,226,1,50,51,0,9956.088,34,1204.728,LESS,-1024,4602,3578,9,1,1.0,0.09374084606744876,1.0,-1.3968605915391563,-0.8629804810788805,0.02921177449731419,101,50,51,1,-1.1767566214275886,-1.170500554541026,-1.1314838693896585,1.2780129650916758,0.022472403664540216,0.022472403664540216,-1.1314838693896585,-1.170500554541026,0,1,0,0,-1.170500554541026,-1.1314838693896585
466,2,227,23,85,80,0,11160.33,14,1258.591,LESS,-2834,6548,3714,8,1,-5.0,-0.4687042303372438,5.0,-0.6984302957695783,-2.1121681497093467,0.1622869904071352,165,85,80,0,0.09972513740911768,0.19508342575683765,0.0,0.997644490117268,-0.4386088428816655,0.4386088428816655,0.0,0.19508342575683765,0,1,0,1,0.19508342575683765,0.0
467,2,228,11,50,49,1,10567.69,64,1840.249,LESS,-1146,5246,4100,1,2,-1.0,-0.09374084606744876,1.0,-1.3968605915391563,1.0108010218668186,0.0967970839292045,99,50,49,0,-1.2166466763912356,-1.170500554541026,-1.2095172396923934,-0.9649348347035869,-0.008606000798795194,0.008606000798795194,-1.2095172396923934,-1.170500554541026,1,0,0,0,-1.170500554541026,-1.2095172396923934
468,2,229,17,50,43,1,3856.248,54,1227.17,LESS,854,1680,2534,3,2,-7.0,-0.6561859224721414,7.0,-0.34921514788478913,0.3862071875515856,-0.6448533428257509,93,50,43,0,-1.3363168412821769,-1.170500554541026,-1.4436173506005987,-0.40419788475477125,0.5008760395837526,0.5008760395837526,-1.4436173506005987,-1.170500554541026,1,0,1,0,-1.170500554541026,-1.4436173506005987
469,2,230,21,80,82,0,9273.443,44,1585.888,LESS,-1488,5022,3534,8,2,2.0,0.18748169213489754,2.0,-1.222253017596762,-0.2383866467636475,-0.04622416841512352,162,80,82,1,0.03989005496364707,0.0,0.07803337030273506,0.997644490117268,-0.09572742970421086,0.09572742970421086,0.07803337030273506,0.0,0,1,0,1,0.07803337030273506,0.0
470,2,231,10,50,60,0,2950.943,64,1224.711,LESS,-936,1904,968,2,2,10.0,0.9374084606744876,10.0,0.17460757394239454,1.0108010218668186,-0.7448944129256481,110,50,60,1,-0.9972513740911768,-1.170500554541026,-0.7803337030273506,-0.6845663597291791,0.04488961344137232,0.04488961344137232,-0.7803337030273506,-1.170500554541026,1,0,0,0,-1.170500554541026,-0.7803337030273506
471,2,232,3,53,50,0,13342.428,24,1103.06,LESS,-2072,6530,4458,11,1,-3.0,-0.28122253820234633,3.0,-1.0476454436543674,-1.4875743153941137,0.4034205520055419,103,53,50,0,-1.1368665664639415,-1.0534504990869233,-1.170500554541026,1.8387499150404916,-0.24449618549591481,0.24449618549591481,-1.170500554541026,-1.0534504990869233,0,1,0,0,-1.0534504990869233,-1.170500554541026
472,2,233,45,122,110,1,7723.314,34,1580.542,LESS,-1168,4268,3100,2,1,-12.0,-1.124890152809385,12.0,0.5238227218271837,-0.8629804810788805,-0.21752175757334485,232,122,110,0,1.4360419786912946,1.6387007763574364,1.170500554541026,-0.6845663597291791,-0.01421030324300322,0.01421030324300322,1.170500554541026,1.6387007763574364,0,0,0,2,1.6387007763574364,1.170500554541026
473,2,234,38,67,80,0,4339.511,54,1562.554,LESS,-1908,3014,1106,2,1,13.0,1.218630998876834,13.0,0.6984302957695783,0.3862071875515856,-0.5914501829407544,147,67,80,1,-0.25928535726370594,-0.5072169069677779,0.0,-0.6845663597291791,-0.20271865818454587,0.20271865818454587,0.0,-0.5072169069677779,1,0,0,1,-0.5072169069677779,0.0
474,2,235,38,80,67,1,5191.56,44,1596.7089999999996,LESS,-546,2698,2152,3,2,-13.0,-1.218630998876834,13.0,0.6984302957695783,-0.2383866467636475,-0.497294187185128,147,80,67,0,-0.25928535726370594,0.0,-0.5072169069677779,-0.40419788475477125,0.14423861131596913,0.14423861131596913,-0.5072169069677779,0.0,0,0,1,1,0.0,-0.5072169069677779
475,2,236,36,70,80,0,4657.154,54,1790.136,LESS,-818,2896,2078,5,2,10.0,0.9374084606744876,10.0,0.17460757394239454,0.3862071875515856,-0.5563489235533196,150,70,80,1,-0.19945027481823535,-0.3901668515136753,0.0,0.15653906519404445,0.07494905382394264,0.07494905382394264,0.0,-0.3901668515136753,1,1,0,1,-0.3901668515136753,0.0
476,2,237,45,110,122,0,5824.51,74,1387.2720000000004,LESS,-692,3428,2736,4,2,12.0,1.124890152809385,12.0,0.5238227218271837,1.6353948561820515,-0.4273498089703496,232,110,122,1,1.4360419786912946,1.170500554541026,1.6387007763574364,-0.1238294097803634,0.10704642236804314,0.10704642236804314,1.6387007763574364,1.170500554541026,1,0,1,2,1.6387007763574364,1.170500554541026
477,2,238,42,110,115,0,18900.494,14,1333.54,LESS,-5986,11370,5384,16,1,5.0,0.4687042303372438,5.0,-0.6984302957695783,-2.1121681497093467,1.017616729344511,225,110,115,1,1.2964267863185297,1.170500554541026,1.3655839802978638,3.240592289912531,-1.2415525385245607,1.2415525385245607,1.3655839802978638,1.170500554541026,0,1,0,2,1.3655839802978638,1.170500554541026
478,2,239,41,110,112,0,4334.927,34,1463.1,LESS,-2122,3016,894,1,1,2.0,0.18748169213489754,2.0,-1.222253017596762,-0.8629804810788805,-0.5919567395877827,222,110,112,1,1.2365917038730592,1.170500554541026,1.248533924843761,-0.9649348347035869,-0.2572332365054785,0.2572332365054785,1.248533924843761,1.170500554541026,0,0,0,2,1.248533924843761,1.170500554541026
479,2,240,53,110,103,0,8621.08,34,1427.842,LESS,-1614,4718,3104,6,1,-7.0,-0.6561859224721414,7.0,-0.34921514788478913,-0.8629804810788805,-0.11831378750877618,213,110,103,0,1.0570864565366473,1.170500554541026,0.8973837584814532,0.4369075401684523,-0.12782479824831136,0.12782479824831136,0.8973837584814532,1.170500554541026,0,1,0,2,1.170500554541026,0.8973837584814532
480,3,1,49,110,131,1,8280.333,64,2093.214,MORE,18,3296,3314,4,2,21.0,1.9685577674164243,21.0,2.0952908873087353,0.028021569222195543,2.8546702224654843,241,110,131,0,1.6155472260277064,1.170500554541026,1.9898509427197442,1.0898952158123527,-0.22660485975599753,0.22660485975599753,1.9898509427197442,1.170500554541026,0,1,0,2,1.9898509427197442,1.170500554541026
481,3,2,13,47,50,1,7167.467,34,1448.205,MORE,-292,2888,2596,3,1,3.0,0.28122253820234633,3.0,-1.0476454436543674,-1.599037288840775,2.1849011945625043,97,47,50,0,-1.2565367313548828,-1.2875506099951286,-1.170500554541026,0.3043851503620085,-0.5157586615233322,0.5157586615233322,-1.170500554541026,-1.2875506099951286,0,1,0,0,-1.2875506099951286,-1.170500554541026
482,3,3,16,50,44,1,8070.478,24,695.8839999999999,MORE,900,2506,3406,3,2,-6.0,-0.5624450764046927,6.0,-0.5238227218271837,-2.1413902415284314,2.7283707584234707,94,50,44,1,-1.3163718138003533,-1.170500554541026,-1.4046006654492311,0.3043851503620085,0.5960843439820322,0.5960843439820322,-1.4046006654492311,-1.170500554541026,0,1,1,0,-1.170500554541026,-1.4046006654492311
483,3,4,7,57,50,0,4998.854,64,2642.301,MORE,-1910,2998,1088,2,1,-7.0,-0.6561859224721414,7.0,-0.34921514788478913,0.028021569222195543,0.8797397277661739,107,57,50,1,-1.0570864565366473,-0.8973837584814532,-1.170500554541026,-0.48112491508833566,-2.0249549559089695,2.0249549559089695,-1.170500554541026,-0.8973837584814532,0,1,0,0,-0.8973837584814532,-1.170500554541026
484,3,5,18,42,50,1,7020.031,44,495.796,MORE,1330,1908,3238,2,2,8.0,0.7499267685395902,8.0,-0.17460757394239454,-1.056684336153118,2.0961680798857114,92,42,50,0,-1.3562618687640005,-1.4826340357519663,-1.170500554541026,-0.48112491508833566,0.997168649659303,0.997168649659303,-1.170500554541026,-1.4826340357519663,0,1,1,0,-1.4826340357519663,-1.170500554541026
485,3,6,51,108,110,1,5506.326,34,624.8380000000002,MORE,210,2122,2332,3,2,2.0,0.18748169213489754,2.0,-1.222253017596762,-1.599037288840775,1.185157476289339,218,108,110,0,1.156811593945765,1.092467184238291,1.170500554541026,0.3043851503620085,-0.047516053500099915,0.047516053500099915,1.170500554541026,1.092467184238291,0,1,0,2,1.170500554541026,1.092467184238291
486,3,7,31,78,80,1,5346.013000000001,64,2813.196,MORE,-208,2114,1906,2,2,2.0,0.18748169213489754,2.0,-1.222253017596762,0.028021569222195543,1.0886744476316124,158,78,80,0,-0.03989005496364707,-0.07803337030273506,0.0,-0.48112491508833566,-0.437407308786377,0.437407308786377,0.0,-0.07803337030273506,0,0,0,1,-0.07803337030273506,0.0
487,3,8,58,110,92,0,6129.209,64,1953.808,MORE,-256,2718,2462,4,2,-18.0,-1.6873352292140782,18.0,1.571468165481551,0.028021569222195543,1.5600343630010294,202,110,92,1,0.8376911542365885,1.170500554541026,0.4682002218164104,1.0898952158123527,-0.4821795103503514,0.4821795103503514,0.4682002218164104,1.170500554541026,0,1,0,2,1.170500554541026,0.4682002218164104
488,3,9,12,50,48,0,9167.056,14,1568.307,MORE,-1590,4804,3214,5,1,-2.0,-0.18748169213489754,2.0,-1.222253017596762,-2.6837431942160883,3.3883369907279834,98,50,48,1,-1.2365917038730592,-1.170500554541026,-1.248533924843761,1.875405281262697,-1.72647361214914,1.72647361214914,-1.248533924843761,-1.170500554541026,0,1,0,0,-1.170500554541026,-1.248533924843761
489,3,10,54,110,101,1,7253.443,74,2011.646,MORE,-150,2000,1850,1,2,-9.0,-0.8436676146070391,9.0,0.0,0.5703745219098523,2.236645125945965,211,110,101,1,1.0171964015730004,1.170500554541026,0.8193503881787182,-1.2666349805386798,-0.38330756522990794,0.38330756522990794,0.8193503881787182,1.170500554541026,1,0,0,2,1.170500554541026,0.8193503881787182
490,3,11,14,46,50,1,5005.184,54,2332.678,MORE,-898,2864,1966,3,1,4.0,0.3749633842697951,4.0,-0.8730378697119728,-0.5143313834654613,0.883549384945588,96,46,50,0,-1.2764817588367063,-1.3265672951464962,-1.170500554541026,0.3043851503620085,-1.081007706268509,1.081007706268509,-1.170500554541026,-1.3265672951464962,0,1,0,0,-1.3265672951464962,-1.170500554541026
491,3,12,22,80,83,1,5040.511,24,730.2669999999998,MORE,904,1734,2638,3,2,3.0,0.28122253820234633,3.0,-1.0476454436543674,-2.1413902415284314,0.9048106423195474,163,80,83,0,0.05983508244547061,0.0,0.1170500554541026,0.3043851503620085,0.5998153607790301,0.5998153607790301,0.1170500554541026,0.0,0,1,1,1,0.1170500554541026,0.0
492,3,13,6,50,56,0,7641.814,74,1677.6329999999996,MORE,-1182,3486,2304,6,1,6.0,0.5624450764046927,6.0,-0.5238227218271837,0.5703745219098523,2.4703829408632223,106,50,56,0,-1.077031484018471,-1.170500554541026,-0.9364004436328208,2.660915346713041,-1.3459098988553577,1.3459098988553577,-0.9364004436328208,-1.170500554541026,1,1,0,0,-1.170500554541026,-0.9364004436328208
493,3,14,13,50,47,1,3350.826,74,1996.401,MORE,1162,1110,2272,1,2,-3.0,-0.28122253820234633,3.0,-1.0476454436543674,0.5703745219098523,-0.11211204191399644,97,50,47,1,-1.2565367313548828,-1.170500554541026,-1.2875506099951286,-1.2666349805386798,0.8404659441853926,0.8404659441853926,-1.2875506099951286,-1.170500554541026,1,0,1,0,-1.170500554541026,-1.2875506099951286
494,3,15,46,110,124,1,3213.827,64,2802.476,MORE,-1592,2546,954,1,1,14.0,1.3123718449442827,14.0,0.8730378697119728,0.028021569222195543,-0.19456373605657984,234,110,124,0,1.4759320336549415,1.170500554541026,1.7167341466601715,-1.2666349805386798,-1.728339120547639,1.728339120547639,1.7167341466601715,1.170500554541026,0,0,0,2,1.7167341466601715,1.170500554541026
495,3,16,27,91,80,0,5841.773,24,1498.958,MORE,-1996,3898,1902,4,1,-11.0,-1.0311493067419364,11.0,0.34921514788478913,-2.1413902415284314,1.3870434276104966,171,91,80,1,0.21939530230005888,0.4291835366650429,0.0,1.0898952158123527,-2.1051718170444236,2.1051718170444236,0.0,0.4291835366650429,0,1,0,1,0.4291835366650429,0.0
496,3,17,40,64,80,1,2625.496,64,1514.057,MORE,504,1062,1566,1,2,16.0,1.4998535370791803,16.0,1.222253017596762,0.028021569222195543,-0.5486457926161191,144,64,80,0,-0.3191204397091766,-0.6242669624218805,0.0,-1.2666349805386798,0.2267136810792433,0.2267136810792433,0.0,-0.6242669624218805,0,0,0,1,-0.6242669624218805,0.0
497,3,18,22,83,80,1,4849.473,64,3237.113,MORE,-788,2846,2058,3,1,-3.0,-0.28122253820234633,3.0,-1.0476454436543674,0.028021569222195543,0.7898360312230365,163,83,80,1,0.05983508244547061,0.1170500554541026,0.0,0.3043851503620085,-0.9784047443510677,0.9784047443510677,0.0,0.1170500554541026,0,1,0,1,0.1170500554541026,0.0
498,3,19,54,101,110,1,3451.203,44,725.6060000000001,MORE,182,996,1178,1,2,9.0,0.8436676146070391,9.0,0.0,-1.056684336153118,-0.05170098998697433,211,101,110,0,1.0171964015730004,0.8193503881787182,1.170500554541026,-1.2666349805386798,-0.07363317107908499,0.07363317107908499,1.170500554541026,0.8193503881787182,0,0,0,2,1.170500554541026,0.8193503881787182
499,3,20,6,56,50,0,7469.588000000002,64,2444.55,MORE,-1608,3994,2386,2,1,-6.0,-0.5624450764046927,6.0,-0.5238227218271837,0.028021569222195543,2.3667301735043327,106,56,50,1,-1.077031484018471,-0.9364004436328208,-1.170500554541026,-0.48112491508833566,-1.7432631877356304,1.7432631877356304,-1.170500554541026,-0.9364004436328208,0,0,0,0,-0.9364004436328208,-1.170500554541026
500,3,21,18,50,42,0,3372.03,100,3686.445,MORE,1102,1362,2464,2,2,-8.0,-0.7499267685395902,8.0,-0.17460757394239454,1.98049219889776,-0.09935059312532386,92,50,42,1,-1.3562618687640005,-1.170500554541026,-1.4826340357519663,-0.48112491508833566,0.7845006922304245,0.7845006922304245,-1.4826340357519663,-1.170500554541026,1,0,1,0,-1.170500554541026,-1.4826340357519663
501,3,22,43,110,117,0,6138.022,74,3234.987,MORE,-1782,4238,2456,4,1,7.0,0.6561859224721414,7.0,-0.34921514788478913,0.5703745219098523,1.5653383928149596,227,110,117,0,1.3363168412821769,1.170500554541026,1.4436173506005987,1.0898952158123527,-1.9055624184050377,1.9055624184050377,1.4436173506005987,1.170500554541026,1,1,0,2,1.4436173506005987,1.170500554541026
502,3,23,32,77,80,0,6402.819,64,1929.011,MORE,-410,2906,2496,3,1,3.0,0.28122253820234633,3.0,-1.0476454436543674,0.028021569222195543,1.7247042367545045,157,77,80,0,-0.05983508244547061,-0.1170500554541026,0.0,0.3043851503620085,-0.6258236570347693,0.6258236570347693,0.0,-0.1170500554541026,0,1,0,1,-0.1170500554541026,0.0
503,3,24,27,80,91,1,4444.338,44,771.748,MORE,758,1500,2258,3,2,11.0,1.0311493067419364,11.0,0.34921514788478913,-1.056684336153118,0.5460089441168854,171,80,91,0,0.21939530230005888,0.0,0.4291835366650429,0.3043851503620085,0.46363324768860786,0.46363324768860786,0.4291835366650429,0.0,0,1,1,1,0.4291835366650429,0.0
504,3,25,16,44,50,1,2608.586,64,3031.079,MORE,-366,1402,1036,1,1,6.0,0.5624450764046927,6.0,-0.5238227218271837,0.028021569222195543,-0.5588229336751861,94,44,50,0,-1.3163718138003533,-1.4046006654492311,-1.170500554541026,-1.2666349805386798,-0.5847824722677927,0.5847824722677927,-1.170500554541026,-1.4046006654492311,0,0,0,0,-1.4046006654492311,-1.170500554541026
505,3,26,7,50,57,1,5440.031999999998,74,2403.739,MORE,1292,2226,3518,3,2,7.0,0.6561859224721414,7.0,-0.34921514788478913,0.5703745219098523,1.1452589908150759,107,50,57,0,-1.0570864565366473,-1.170500554541026,-0.8973837584814532,0.3043851503620085,0.9617239900878232,0.9617239900878232,-0.8973837584814532,-1.170500554541026,1,1,1,0,-1.170500554541026,-0.8973837584814532
506,3,27,14,50,46,0,5260.323,64,2340.049,MORE,-1358,2904,1546,4,1,-4.0,-0.3749633842697951,4.0,-0.8730378697119728,0.028021569222195543,1.0371026429390378,96,50,46,1,-1.2764817588367063,-1.170500554541026,-1.3265672951464962,1.0898952158123527,-1.5100746379232637,1.5100746379232637,-1.3265672951464962,-1.170500554541026,0,1,0,0,-1.170500554541026,-1.3265672951464962
507,3,28,51,110,108,1,2857.7,100,3203.394,MORE,1722,1028,2750,1,2,-2.0,-0.18748169213489754,2.0,-1.222253017596762,1.98049219889776,-0.4088957711803098,218,110,108,1,1.156811593945765,1.170500554541026,1.092467184238291,-1.2666349805386798,1.362808295765094,1.362808295765094,1.092467184238291,1.170500554541026,1,0,1,2,1.170500554541026,1.092467184238291
508,3,29,50,133,110,0,4622.699000000001,84,2694.95,MORE,414,1764,2178,2,2,-23.0,-2.1560394595513217,23.0,2.444506035193524,1.112727474597509,0.6533540095477679,243,133,110,1,1.6554372809913533,2.0678843130224793,1.170500554541026,-0.48112491508833566,0.1427658031467913,0.1427658031467913,1.170500554541026,2.0678843130224793,1,1,0,2,2.0678843130224793,1.170500554541026
509,3,30,49,131,110,0,4792.599,84,1396.167,MORE,-832,2770,1938,2,2,-21.0,-1.9685577674164243,21.0,2.0952908873087353,1.112727474597509,0.7556068933996561,241,131,110,1,1.6155472260277064,1.9898509427197442,1.170500554541026,-0.48112491508833566,-1.0194459291180442,1.0194459291180442,1.170500554541026,1.9898509427197442,1,1,0,2,1.9898509427197442,1.170500554541026
510,3,31,47,126,110,0,6148.765,64,1855.807,MORE,-58,2686,2628,4,2,-16.0,-1.4998535370791803,16.0,1.222253017596762,0.028021569222195543,1.571803976871586,236,126,110,1,1.5158220886185887,1.7947675169629065,1.170500554541026,1.0898952158123527,-0.297494178898957,0.297494178898957,1.170500554541026,1.7947675169629065,0,1,0,2,1.7947675169629065,1.170500554541026
511,3,32,50,110,133,1,4290.5,74,2130.272,MORE,-488,1778,1290,3,2,23.0,2.1560394595513217,23.0,2.444506035193524,0.5703745219098523,0.4534228396671686,243,110,133,0,1.6554372809913533,1.170500554541026,2.0678843130224793,0.3043851503620085,-0.6985784845762276,0.6985784845762276,2.0678843130224793,1.170500554541026,1,1,0,2,2.0678843130224793,1.170500554541026
512,3,33,47,110,126,0,5208.041,54,4222.279,MORE,190,2208,2398,3,2,16.0,1.4998535370791803,16.0,1.222253017596762,-0.5143313834654613,1.005637161635068,236,110,126,0,1.5158220886185887,1.170500554541026,1.7947675169629065,0.3043851503620085,-0.06617113748508925,0.06617113748508925,1.7947675169629065,1.170500554541026,0,1,0,2,1.7947675169629065,1.170500554541026
513,3,34,12,48,50,1,3034.445,74,2301.5460000000007,MORE,-36,1736,1700,1,1,2.0,0.18748169213489754,2.0,-1.222253017596762,0.5703745219098523,-0.3025232817370952,98,48,50,0,-1.2365917038730592,-1.248533924843761,-1.170500554541026,-1.2666349805386798,-0.2769735865154687,0.2769735865154687,-1.170500554541026,-1.248533924843761,1,0,0,0,-1.248533924843761,-1.170500554541026
514,3,35,32,80,77,0,3584.427,44,3358.849,MORE,-314,1486,1172,3,2,-3.0,-0.28122253820234633,3.0,-1.0476454436543674,-1.056684336153118,0.028478752204220945,157,80,77,1,-0.05983508244547061,0.0,-0.1170500554541026,0.3043851503620085,-0.5362792539068204,0.5362792539068204,-0.1170500554541026,0.0,0,1,0,1,0.0,-0.1170500554541026
515,3,36,43,117,110,0,6892.8690000000015,34,2022.415,MORE,-3180,4760,1580,3,1,-7.0,-0.6561859224721414,7.0,-0.34921514788478913,-1.599037288840775,2.0196367013314216,227,117,110,1,1.3363168412821769,1.4436173506005987,1.170500554541026,0.3043851503620085,-3.209552788955792,3.209552788955792,1.170500554541026,1.4436173506005987,0,1,0,2,1.4436173506005987,1.170500554541026
516,3,37,40,80,64,1,2476.989,64,1989.747,MORE,512,846,1358,1,2,-16.0,-1.4998535370791803,16.0,1.222253017596762,0.028021569222195543,-0.6380234796213722,144,80,64,1,-0.3191204397091766,0.0,-0.6242669624218805,-1.2666349805386798,0.23417571467323905,0.23417571467323905,-0.6242669624218805,0.0,0,0,1,1,0.0,-0.6242669624218805
517,3,38,31,80,78,0,5866.721,54,3422.9640000000004,MORE,-820,2724,1904,4,1,-2.0,-0.18748169213489754,2.0,-1.222253017596762,-0.5143313834654613,1.4020581712616846,158,80,78,1,-0.03989005496364707,0.0,-0.07803337030273506,1.0898952158123527,-1.0082528787270506,1.0082528787270506,-0.07803337030273506,0.0,0,1,0,1,0.0,-0.07803337030273506
518,3,39,46,124,110,1,7484.359,74,1121.826,MORE,632,2860,3492,4,2,-14.0,-1.3123718449442827,14.0,0.8730378697119728,0.5703745219098523,2.3756199754312086,234,124,110,1,1.4759320336549415,1.7167341466601715,1.170500554541026,1.0898952158123527,0.3461062185831751,0.3461062185831751,1.170500554541026,1.7167341466601715,1,1,1,2,1.7167341466601715,1.170500554541026
519,3,40,58,92,110,1,2500.835,84,2785.633,MORE,-486,2920,2434,1,1,18.0,1.6873352292140782,18.0,1.571468165481551,1.112727474597509,-0.623671965387516,202,92,110,0,0.8376911542365885,0.4682002218164104,1.170500554541026,-1.2666349805386798,-0.6967129761777288,0.6967129761777288,1.170500554541026,0.4682002218164104,1,0,0,2,1.170500554541026,0.4682002218164104
520,3,41,49,110,131,1,4612.844,54,2462.211,LESS,-438,2672,2234,4,1,21.0,1.9685577674164243,21.0,2.0952908873087353,-0.5143313834654613,0.6474228608110963,241,110,131,1,1.6155472260277064,1.170500554541026,1.9898509427197442,1.0898952158123527,-0.6519407746137543,0.6519407746137543,1.9898509427197442,1.170500554541026,0,1,0,2,1.9898509427197442,1.170500554541026
521,3,42,13,47,50,0,3098.9640000000004,74,2212.285,LESS,-502,1882,1380,2,2,3.0,0.28122253820234633,3.0,-1.0476454436543674,0.5703745219098523,-0.2636930650611679,97,47,50,1,-1.2565367313548828,-1.2875506099951286,-1.170500554541026,-0.48112491508833566,-0.7116370433657202,0.7116370433657202,-1.170500554541026,-1.2875506099951286,1,0,0,0,-1.2875506099951286,-1.170500554541026
522,3,43,16,50,44,0,3949.32,64,1554.12,LESS,-912,2184,1272,2,2,-6.0,-0.5624450764046927,6.0,-0.5238227218271837,0.028021569222195543,0.24808653058778385,94,50,44,0,-1.3163718138003533,-1.170500554541026,-1.4046006654492311,-0.48112491508833566,-1.0940662650580015,1.0940662650580015,-1.4046006654492311,-1.170500554541026,0,0,0,0,-1.170500554541026,-1.4046006654492311
523,3,44,7,57,50,1,3992.314,74,1978.8,LESS,1146,1526,2672,3,2,-7.0,-0.6561859224721414,7.0,-0.34921514788478913,0.5703745219098523,0.27396210732897325,107,57,50,0,-1.0570864565366473,-0.8973837584814532,-1.170500554541026,0.3043851503620085,0.825541876997401,0.825541876997401,-1.170500554541026,-0.8973837584814532,1,1,1,0,-0.8973837584814532,-1.170500554541026
524,3,45,18,42,50,0,3063.877,84,1990.023,LESS,810,1516,2326,2,2,8.0,0.7499267685395902,8.0,-0.17460757394239454,1.112727474597509,-0.28480988045676103,92,42,50,1,-1.3562618687640005,-1.4826340357519663,-1.170500554541026,-0.48112491508833566,0.5121364660495802,0.5121364660495802,-1.170500554541026,-1.4826340357519663,1,0,1,0,-1.4826340357519663,-1.170500554541026
525,3,46,51,108,110,1,6334.299,54,1883.484,LESS,300,2936,3236,5,2,2.0,0.18748169213489754,2.0,-1.222253017596762,-0.5143313834654613,1.6834660519308935,218,108,110,1,1.156811593945765,1.092467184238291,1.170500554541026,1.875405281262697,0.03643182443235209,0.03643182443235209,1.170500554541026,1.092467184238291,0,1,1,2,1.170500554541026,1.092467184238291
526,3,47,31,78,80,0,3503.5170000000007,34,1894.717,LESS,-2058,2898,840,2,1,2.0,0.18748169213489754,2.0,-1.222253017596762,-1.599037288840775,-0.02021624975255527,158,78,80,1,-0.03989005496364707,-0.07803337030273506,0.0,-0.48112491508833566,-2.1630025773978905,2.1630025773978905,0.0,-0.07803337030273506,0,0,0,1,-0.07803337030273506,0.0
527,3,48,58,110,92,1,5757.464,64,1905.616,LESS,1954,1690,3644,3,2,-18.0,-1.6873352292140782,18.0,1.571468165481551,0.028021569222195543,1.3363027661351057,202,110,92,0,0.8376911542365885,1.170500554541026,0.4682002218164104,0.3043851503620085,1.5792072699909703,1.5792072699909703,0.4682002218164104,1.170500554541026,0,1,1,2,1.170500554541026,0.4682002218164104
528,3,49,12,50,48,1,4202.759,74,1797.4979999999996,LESS,1674,1438,3112,3,2,-2.0,-0.18748169213489754,2.0,-1.222253017596762,0.5703745219098523,0.4006166579011381,98,50,48,0,-1.2365917038730592,-1.170500554541026,-1.248533924843761,0.3043851503620085,1.3180360942011196,1.3180360942011196,-1.248533924843761,-1.170500554541026,1,1,1,0,-1.170500554541026,-1.248533924843761
529,3,50,54,110,101,1,3362.251,34,2235.186,LESS,-246,2244,1998,3,1,-9.0,-0.8436676146070391,9.0,0.0,-1.599037288840775,-0.1052360019021786,211,110,101,0,1.0171964015730004,1.170500554541026,0.8193503881787182,0.3043851503620085,-0.47285196835785676,0.47285196835785676,0.8193503881787182,1.170500554541026,0,1,0,2,1.170500554541026,0.8193503881787182
530,3,51,14,46,50,0,4765.607,34,1568.435,LESS,-746,2338,1592,2,1,4.0,0.3749633842697951,4.0,-0.8730378697119728,-1.599037288840775,0.7393619855660469,96,46,50,1,-1.2764817588367063,-1.3265672951464962,-1.170500554541026,-0.48112491508833566,-0.9392290679825901,0.9392290679825901,-1.170500554541026,-1.3265672951464962,0,0,0,0,-1.3265672951464962,-1.170500554541026
531,3,52,22,80,83,0,4393.51,44,1769.991,LESS,-328,1530,1202,3,1,3.0,0.28122253820234633,3.0,-1.0476454436543674,-1.056684336153118,0.5154185404651858,163,80,83,1,0.05983508244547061,0.0,0.1170500554541026,0.3043851503620085,-0.549337812696313,0.549337812696313,0.1170500554541026,0.0,0,1,0,1,0.1170500554541026,0.0
532,3,53,6,50,56,0,2648.53,64,4160.237,LESS,-1542,2048,506,2,1,6.0,0.5624450764046927,6.0,-0.5238227218271837,0.028021569222195543,-0.5347829737424027,106,50,56,1,-1.077031484018471,-1.170500554541026,-0.9364004436328208,-0.48112491508833566,-1.6817014105851658,1.6817014105851658,-0.9364004436328208,-1.170500554541026,0,0,0,0,-1.170500554541026,-0.9364004436328208
533,3,54,13,50,47,1,3205.018,54,1604.865,LESS,110,1154,1264,2,2,-3.0,-0.28122253820234633,3.0,-1.0476454436543674,-0.5143313834654613,-0.1998653585042038,97,50,47,0,-1.2565367313548828,-1.170500554541026,-1.2875506099951286,-0.48112491508833566,-0.14079147342504658,0.14079147342504658,-1.2875506099951286,-1.170500554541026,0,0,1,0,-1.170500554541026,-1.2875506099951286
534,3,55,46,110,124,0,2249.129,44,2250.827,LESS,-558,1112,554,2,1,14.0,1.3123718449442827,14.0,0.8730378697119728,-1.056684336153118,-0.7751591012487496,234,110,124,1,1.4759320336549415,1.170500554541026,1.7167341466601715,-0.48112491508833566,-0.7638712785236903,0.7638712785236903,1.7167341466601715,1.170500554541026,0,0,0,2,1.7167341466601715,1.170500554541026
535,3,56,27,91,80,1,3368.7870000000007,64,2044.698,LESS,478,976,1454,3,2,-11.0,-1.0311493067419364,11.0,0.34921514788478913,0.028021569222195543,-0.10130236535799968,171,91,80,0,0.21939530230005888,0.4291835366650429,0.0,0.3043851503620085,0.20246207189875717,0.20246207189875717,0.0,0.4291835366650429,0,1,1,1,0.4291835366650429,0.0
536,3,57,40,64,80,0,1595.809,64,1788.87,LESS,-858,1178,320,2,1,16.0,1.4998535370791803,16.0,1.222253017596762,0.028021569222195543,-1.1683542400251836,144,64,80,1,-0.3191204397091766,-0.6242669624218805,0.0,-0.48112491508833566,-1.0436975382985303,1.0436975382985303,0.0,-0.6242669624218805,0,0,0,1,-0.6242669624218805,0.0
537,3,58,22,83,80,0,2598.623,74,2876.996,LESS,-990,1536,546,2,1,-3.0,-0.28122253820234633,3.0,-1.0476454436543674,0.5703745219098523,-0.5648190813021216,163,83,80,0,0.05983508244547061,0.1170500554541026,0.0,-0.48112491508833566,-1.16682109259946,1.16682109259946,0.0,0.1170500554541026,1,0,0,1,0.1170500554541026,0.0
538,3,59,54,101,110,1,3256.513,44,1213.877,LESS,472,1144,1616,3,2,9.0,0.8436676146070391,9.0,0.0,-1.056684336153118,-0.16887352652096066,211,101,110,1,1.0171964015730004,0.8193503881787182,1.170500554541026,0.3043851503620085,0.19686554670326037,0.19686554670326037,1.170500554541026,0.8193503881787182,0,1,1,2,1.170500554541026,0.8193503881787182
539,3,60,6,56,50,1,2950.898,74,2144.099,LESS,968,800,1768,3,2,-6.0,-0.5624450764046927,6.0,-0.5238227218271837,0.5703745219098523,-0.35280533993117275,106,56,50,0,-1.077031484018471,-0.9364004436328208,-1.170500554541026,0.3043851503620085,0.659511629530996,0.659511629530996,-1.170500554541026,-0.9364004436328208,1,1,1,0,-0.9364004436328208,-1.170500554541026
540,3,61,18,50,42,0,2088.328,64,2299.789,LESS,-1402,1866,464,2,1,-8.0,-0.7499267685395902,8.0,-0.17460757394239454,0.028021569222195543,-0.871935828595822,92,50,42,0,-1.3562618687640005,-1.170500554541026,-1.4826340357519663,-0.48112491508833566,-1.5511158226902404,1.5511158226902404,-1.4826340357519663,-1.170500554541026,1,0,0,0,-1.170500554541026,-1.4826340357519663
541,3,62,43,110,117,0,2892.78,34,1750.5079999999996,LESS,-814,1716,902,3,1,7.0,0.6561859224721414,7.0,-0.34921514788478913,-1.599037288840775,-0.3877831686757524,227,110,117,1,1.3363168412821769,1.170500554541026,1.4436173506005987,0.3043851503620085,-1.0026563535315538,1.0026563535315538,1.4436173506005987,1.170500554541026,0,1,0,2,1.4436173506005987,1.170500554541026
542,3,63,32,77,80,1,3153.39,64,1526.588,LESS,978,1088,2066,3,2,3.0,0.28122253820234633,3.0,-1.0476454436543674,0.028021569222195543,-0.2309372354171252,157,77,80,1,-0.05983508244547061,-0.1170500554541026,0.0,0.3043851503620085,0.6688391715234906,0.6688391715234906,0.0,-0.1170500554541026,1,1,1,1,-0.1170500554541026,0.0
543,3,64,27,80,91,0,3489.703,64,1926.183,LESS,-1156,2242,1086,4,1,11.0,1.0311493067419364,11.0,0.34921514788478913,0.028021569222195543,-0.028530089290695775,171,80,91,1,0.21939530230005888,0.0,0.4291835366650429,1.0898952158123527,-1.3216582896748714,1.3216582896748714,0.4291835366650429,0.0,1,1,0,1,0.4291835366650429,0.0
544,3,65,16,44,50,0,1597.213,64,1797.361,LESS,-688,1060,372,2,1,6.0,0.5624450764046927,6.0,-0.5238227218271837,0.028021569222195543,-1.16750925445174,94,44,50,1,-1.3163718138003533,-1.4046006654492311,-1.170500554541026,-0.48112491508833566,-0.885129324426121,0.885129324426121,-1.170500554541026,-1.4046006654492311,1,0,0,0,-1.4046006654492311,-1.170500554541026
545,3,66,7,50,57,0,2715.458,74,2136.612,LESS,-672,1294,622,2,1,7.0,0.6561859224721414,7.0,-0.34921514788478913,0.5703745219098523,-0.4945029207086227,107,50,57,1,-1.0570864565366473,-1.170500554541026,-0.8973837584814532,-0.48112491508833566,-0.8702052572381296,0.8702052572381296,-0.8973837584814532,-1.170500554541026,1,0,0,0,-1.170500554541026,-0.8973837584814532
546,3,67,14,50,46,1,3544.648,64,3482.712,LESS,-24,1412,1388,3,1,-4.0,-0.3749633842697951,4.0,-0.8730378697119728,0.028021569222195543,0.00453809613156472,96,50,46,0,-1.2764817588367063,-1.170500554541026,-1.3265672951464962,0.3043851503620085,-0.26578053612447516,0.26578053612447516,-1.3265672951464962,-1.170500554541026,1,1,1,0,-1.170500554541026,-1.3265672951464962
547,3,68,51,110,108,1,5488.943,64,2176.056,LESS,1046,1348,2394,2,1,-2.0,-0.18748169213489754,2.0,-1.222253017596762,0.028021569222195543,1.1746956641645756,218,110,108,0,1.156811593945765,1.170500554541026,1.092467184238291,-0.48112491508833566,0.7322664570724544,0.7322664570724544,1.092467184238291,1.170500554541026,1,0,1,2,1.170500554541026,1.092467184238291
548,3,69,50,133,110,1,2793.11,74,2037.879,LESS,1170,964,2134,3,2,-23.0,-2.1560394595513217,23.0,2.444506035193524,0.5703745219098523,-0.4477687186081702,243,133,110,0,1.6554372809913533,2.0678843130224793,1.170500554541026,0.3043851503620085,0.8479279777793882,0.8479279777793882,1.170500554541026,2.0678843130224793,1,1,1,2,2.0678843130224793,1.170500554541026
549,3,70,49,131,110,1,3888.358,64,713.33,LESS,-88,1246,1158,3,2,-21.0,-1.9685577674164243,21.0,2.0952908873087353,0.028021569222195543,0.2113970643995622,241,131,110,0,1.6155472260277064,1.9898509427197442,1.170500554541026,0.3043851503620085,-0.32547680487644104,0.32547680487644104,1.170500554541026,1.9898509427197442,1,1,0,2,1.9898509427197442,1.170500554541026
550,3,71,47,126,110,1,3968.847,64,2568.112,LESS,-176,1850,1674,3,2,-16.0,-1.4998535370791803,16.0,1.222253017596762,0.028021569222195543,0.25983869105262103,236,126,110,0,1.5158220886185887,1.7947675169629065,1.170500554541026,0.3043851503620085,-0.4075591744103941,0.4075591744103941,1.170500554541026,1.7947675169629065,1,1,0,2,1.7947675169629065,1.170500554541026
551,3,72,50,110,133,0,5034.733,74,1963.237,LESS,-1102,2552,1450,4,1,23.0,2.1560394595513217,23.0,2.444506035193524,0.5703745219098523,0.901333201690376,243,110,133,1,1.6554372809913533,1.170500554541026,2.0678843130224793,1.0898952158123527,-1.2712895629154002,1.2712895629154002,2.0678843130224793,1.170500554541026,1,1,0,2,2.0678843130224793,1.170500554541026
552,3,73,47,110,126,0,2112.499,74,1582.693,LESS,-314,790,476,2,1,16.0,1.4998535370791803,16.0,1.222253017596762,0.5703745219098523,-0.8573887158495949,236,110,126,1,1.5158220886185887,1.170500554541026,1.7947675169629065,-0.48112491508833566,-0.5362792539068204,0.5362792539068204,1.7947675169629065,1.170500554541026,1,0,0,2,1.7947675169629065,1.170500554541026
553,3,74,12,48,50,0,2296.6620000000007,100,2962.217,LESS,1076,1276,2352,2,2,2.0,0.18748169213489754,2.0,-1.222253017596762,1.98049219889776,-0.7465517655917048,98,48,50,1,-1.2365917038730592,-1.248533924843761,-1.170500554541026,-0.48112491508833566,0.7602490830499383,0.7602490830499383,-1.170500554541026,-1.248533924843761,1,0,1,0,-1.248533924843761,-1.170500554541026
554,3,75,32,80,77,0,3646.655,74,2014.852,LESS,-596,1720,1124,2,2,-3.0,-0.28122253820234633,3.0,-1.0476454436543674,0.5703745219098523,0.06593014982832544,157,80,77,0,-0.05983508244547061,0.0,-0.1170500554541026,-0.48112491508833566,-0.7993159380951701,0.7993159380951701,-0.1170500554541026,0.0,1,0,0,1,0.0,-0.1170500554541026
555,3,76,43,117,110,1,4058.004,74,2567.62,LESS,216,1396,1612,3,1,-7.0,-0.6561859224721414,7.0,-0.34921514788478913,0.5703745219098523,0.3134970804910133,227,117,110,0,1.3363168412821769,1.4436173506005987,1.170500554541026,0.3043851503620085,-0.04191952830460312,0.04191952830460312,1.170500554541026,1.4436173506005987,1,1,1,2,1.4436173506005987,1.170500554541026
556,3,77,40,80,64,1,4104.806,74,2524.782,LESS,1586,1138,2724,3,2,-16.0,-1.4998535370791803,16.0,1.222253017596762,0.5703745219098523,0.3416644699556164,144,80,64,0,-0.3191204397091766,0.0,-0.6242669624218805,0.3043851503620085,1.2359537246671664,1.2359537246671664,-0.6242669624218805,0.0,1,1,1,1,0.0,-0.6242669624218805
557,3,78,31,80,78,0,2157.565,64,1353.501,LESS,-410,912,502,2,1,-2.0,-0.18748169213489754,2.0,-1.222253017596762,0.028021569222195543,-0.8302661233618418,158,80,78,0,-0.03989005496364707,0.0,-0.07803337030273506,-0.48112491508833566,-0.6258236570347693,0.6258236570347693,-0.07803337030273506,0.0,0,0,0,1,0.0,-0.07803337030273506
558,3,79,46,124,110,1,5902.977,44,585.043,LESS,1246,1836,3082,5,2,-14.0,-1.3123718449442827,14.0,0.8730378697119728,-1.056684336153118,1.4238785394602376,234,124,110,0,1.4759320336549415,1.7167341466601715,1.170500554541026,1.875405281262697,0.9188172969223477,0.9188172969223477,1.170500554541026,1.7167341466601715,0,1,1,2,1.7167341466601715,1.170500554541026
559,3,80,58,92,110,0,3965.283,34,2883.59,LESS,-1384,2458,1074,2,1,18.0,1.6873352292140782,18.0,1.571468165481551,-1.599037288840775,0.2576937276738797,202,92,110,1,0.8376911542365885,0.4682002218164104,1.170500554541026,-0.48112491508833566,-1.53432624710375,1.53432624710375,1.170500554541026,0.4682002218164104,0,0,0,2,1.170500554541026,0.4682002218164104
560,3,81,48,128,110,0,3428.153,84,1380.24,MORE,-1710,2526,816,2,2,-18.0,-1.6873352292140782,18.0,1.571468165481551,1.112727474597509,-0.06557343832591524,238,128,110,1,1.5557121435822359,1.8728008872656416,1.170500554541026,-0.48112491508833566,-1.838404116059076,1.838404116059076,1.170500554541026,1.8728008872656416,1,1,0,2,1.8728008872656416,1.170500554541026
561,3,82,8,50,58,1,2432.49,84,1798.524,MORE,1666,922,2588,1,2,8.0,0.7499267685395902,8.0,-0.17460757394239454,1.112727474597509,-0.6648048279352347,108,50,58,0,-1.0371414290548238,-1.170500554541026,-0.8583670733300858,-1.2666349805386798,1.3105740606071237,1.3105740606071237,-0.8583670733300858,-1.170500554541026,1,0,1,0,-1.170500554541026,-0.8583670733300858
562,3,83,4,54,50,0,4460.86,34,1331.93,MORE,-682,2266,1584,4,1,-4.0,-0.3749633842697951,4.0,-0.8730378697119728,-1.599037288840775,0.5559525706442597,104,54,50,1,-1.116921538982118,-1.0144338139355558,-1.170500554541026,1.0898952158123527,-0.8795327992306242,0.8795327992306242,-1.170500554541026,-1.0144338139355558,0,1,0,0,-1.0144338139355558,-1.170500554541026
563,3,84,37,80,69,0,3493.201,64,1771.068,MORE,-860,1664,804,2,1,-11.0,-1.0311493067419364,11.0,0.34921514788478913,0.028021569222195543,-0.02642484745600529,149,80,69,1,-0.21939530230005888,0.0,-0.4291835366650429,-0.48112491508833566,-1.0455630466970294,1.0455630466970294,-0.4291835366650429,0.0,0,1,0,1,0.0,-0.4291835366650429
564,3,85,52,105,110,1,3374.0890000000004,100,2104.57,MORE,1774,1098,2872,3,2,5.0,0.4687042303372438,5.0,-0.6984302957695783,1.98049219889776,-0.09811140131925523,215,105,110,0,1.0969765115002945,0.9754171287841883,1.170500554541026,0.3043851503620085,1.4113115141260661,1.4113115141260661,1.170500554541026,0.9754171287841883,1,1,1,2,1.170500554541026,0.9754171287841883
565,3,86,5,55,50,0,2623.875,74,1835.011,MORE,-476,1114,638,2,1,-5.0,-0.4687042303372438,5.0,-0.6984302957695783,0.5703745219098523,-0.5496213778116691,105,55,50,1,-1.0969765115002945,-0.9754171287841883,-1.170500554541026,-0.48112491508833566,-0.6873854341852341,0.6873854341852341,-1.170500554541026,-0.9754171287841883,1,1,0,0,-0.9754171287841883,-1.170500554541026
566,3,87,30,96,80,0,4936.822,64,2353.125,MORE,-342,1510,1168,3,1,-16.0,-1.4998535370791803,16.0,1.222253017596762,0.028021569222195543,0.8424062910910687,176,96,80,1,0.3191204397091766,0.6242669624218805,0.0,0.3043851503620085,-0.5623963714858056,0.5623963714858056,0.0,0.6242669624218805,0,1,0,1,0.6242669624218805,0.0
567,3,88,33,80,75,0,6600.851,54,1804.855,MORE,-1336,3460,2124,6,1,-5.0,-0.4687042303372438,5.0,-0.6984302957695783,-0.5143313834654613,1.8438881278372423,155,80,75,1,-0.09972513740911768,0.0,-0.19508342575683765,2.660915346713041,-1.4895540455397756,1.4895540455397756,-0.19508342575683765,0.0,0,1,0,1,0.0,-0.19508342575683765
568,3,89,48,110,128,1,3039.455,74,2355.125,MORE,530,1438,1968,1,2,18.0,1.6873352292140782,18.0,1.571468165481551,0.5703745219098523,-0.2995080554386965,238,110,128,0,1.5557121435822359,1.170500554541026,1.8728008872656416,-1.2666349805386798,0.25096529025972947,0.25096529025972947,1.8728008872656416,1.170500554541026,1,0,1,2,1.8728008872656416,1.170500554541026
569,3,90,9,59,50,0,4171.929,54,2003.006,MORE,-1048,2398,1350,4,1,-9.0,-0.8436676146070391,9.0,0.0,-0.5143313834654613,0.38206188209681946,109,59,50,1,-1.0171964015730004,-0.8193503881787182,-1.170500554541026,1.0898952158123527,-1.2209208361559292,1.2209208361559292,-1.170500554541026,-0.8193503881787182,0,1,0,0,-0.8193503881787182,-1.170500554541026
570,3,91,44,110,119,1,2621.556,84,1079.648,MORE,1342,698,2040,1,2,9.0,0.8436676146070391,9.0,0.0,1.112727474597509,-0.5510170484276344,229,110,119,0,1.376206896245824,1.170500554541026,1.5216507209033339,-1.2666349805386798,1.0083617000502965,1.0083617000502965,1.5216507209033339,1.170500554541026,1,0,1,2,1.5216507209033339,1.170500554541026
571,3,92,2,52,50,0,4225.163,24,1745.3629999999996,MORE,-258,1688,1430,3,1,-2.0,-0.18748169213489754,2.0,-1.222253017596762,-2.1413902415284314,0.4141003165816423,102,52,50,1,-1.156811593945765,-1.092467184238291,-1.170500554541026,0.3043851503620085,-0.4840450187488503,0.4840450187488503,-1.170500554541026,-1.092467184238291,0,1,0,0,-1.092467184238291,-1.170500554541026
572,3,93,8,58,50,1,1730.156,74,1233.163,MORE,812,422,1234,1,2,-8.0,-0.7499267685395902,8.0,-0.17460757394239454,0.5703745219098523,-1.0874986297435492,108,58,50,1,-1.0371414290548238,-0.8583670733300858,-1.170500554541026,-1.2666349805386798,0.5140019744480792,0.5140019744480792,-1.170500554541026,-0.8583670733300858,1,0,1,0,-0.8583670733300858,-1.170500554541026
573,3,94,44,119,110,0,2161.17,74,2439.168,MORE,-716,1292,576,2,1,-9.0,-0.8436676146070391,9.0,0.0,0.5703745219098523,-0.8280964844784631,229,119,110,1,1.376206896245824,1.5216507209033339,1.170500554541026,-0.48112491508833566,-0.9112464420051061,0.9112464420051061,1.170500554541026,1.5216507209033339,1,1,0,2,1.5216507209033339,1.170500554541026
574,3,95,34,74,80,0,5793.635,74,957.006,MORE,-56,2004,1948,4,1,6.0,0.5624450764046927,6.0,-0.5238227218271837,0.5703745219098523,1.3580719777996535,154,74,80,0,-0.11967016489094122,-0.2341001109082052,0.0,1.0898952158123527,-0.2956286705004581,0.2956286705004581,0.0,-0.2341001109082052,1,1,0,1,-0.2341001109082052,0.0
575,3,96,24,86,80,0,6880.526,64,2708.0640000000008,MORE,-1168,3814,2646,6,1,-6.0,-0.5624450764046927,6.0,-0.5238227218271837,0.028021569222195543,2.012208170752352,166,86,80,1,0.11967016489094122,0.2341001109082052,0.0,2.660915346713041,-1.332851340065865,1.332851340065865,0.0,0.2341001109082052,0,1,0,1,0.2341001109082052,0.0
576,3,97,39,66,80,1,1503.644,100,2019.125,MORE,1486,476,1962,1,2,14.0,1.3123718449442827,14.0,0.8730378697119728,1.98049219889776,-1.2238229689257685,146,66,80,0,-0.2792303847455295,-0.5462335921191455,0.0,-1.2666349805386798,1.1426783047422198,1.1426783047422198,0.0,-0.5462335921191455,1,0,1,1,-0.5462335921191455,0.0
577,3,98,9,50,59,1,3599.021,84,2006.084,MORE,1912,424,2336,1,2,9.0,0.8436676146070391,9.0,0.0,1.112727474597509,0.03726202817205186,109,50,59,0,-1.0171964015730004,-1.170500554541026,-0.8193503881787182,-1.2666349805386798,1.5400315936224926,1.5400315936224926,-0.8193503881787182,-1.170500554541026,1,0,1,0,-1.170500554541026,-0.8193503881787182
578,3,99,57,94,110,1,4647.386,84,1317.4620000000002,MORE,1458,1258,2716,2,2,16.0,1.4998535370791803,16.0,1.222253017596762,1.112727474597509,0.6682116725474824,204,94,110,0,0.8775812092002355,0.5462335921191455,1.170500554541026,-0.48112491508833566,1.1165611871632346,1.1165611871632346,1.170500554541026,0.5462335921191455,1,0,1,2,1.170500554541026,0.5462335921191455
579,3,100,60,110,87,0,2104.608,74,1374.4520000000002,MORE,134,1244,1378,2,2,-23.0,-2.1560394595513217,23.0,2.444506035193524,0.5703745219098523,-0.8621378477299669,197,110,87,1,0.7379660168274708,1.170500554541026,0.27311679605957273,-0.48112491508833566,-0.11840537264305939,0.11840537264305939,0.27311679605957273,1.170500554541026,1,0,0,2,1.170500554541026,0.27311679605957273
580,3,101,33,75,80,1,3663.508,24,1678.636,MORE,520,1286,1806,3,2,5.0,0.4687042303372438,5.0,-0.6984302957695783,-2.1413902415284314,0.07607298591752995,155,75,80,0,-0.09972513740911768,-0.19508342575683765,0.0,0.3043851503620085,0.24163774826723478,0.24163774826723478,0.0,-0.19508342575683765,0,1,1,1,-0.19508342575683765,0.0
581,3,102,15,50,45,1,1428.75,64,1692.418,MORE,564,452,1016,1,2,-5.0,-0.4687042303372438,5.0,-0.6984302957695783,0.028021569222195543,-1.26889729195816,95,50,45,1,-1.2964267863185297,-1.170500554541026,-1.3655839802978638,-1.2666349805386798,0.2826789330342113,0.2826789330342113,-1.3655839802978638,-1.170500554541026,0,0,1,0,-1.170500554541026,-1.3655839802978638
582,3,103,59,89,110,1,1818.229,94,1936.556,MORE,2126,510,2636,1,2,21.0,1.9685577674164243,21.0,2.0952908873087353,1.6550804272851658,-1.0344926365741114,199,89,110,0,0.7778560717911179,0.3511501663623078,1.170500554541026,-1.2666349805386798,1.7396409922618785,1.7396409922618785,1.170500554541026,0.3511501663623078,1,0,1,2,1.170500554541026,0.3511501663623078
583,3,104,29,80,94,1,2621.649000000001,84,1159.634,MORE,1088,1060,2148,3,2,14.0,1.3123718449442827,14.0,0.8730378697119728,1.112727474597509,-0.5509610771610169,174,80,94,0,0.2792303847455295,0.0,0.5462335921191455,0.3043851503620085,0.7714421334409319,0.7714421334409319,0.5462335921191455,0.0,1,1,1,1,0.5462335921191455,0.0
584,3,105,55,110,98,0,1861.231,74,1896.784,MORE,504,798,1302,2,2,-12.0,-1.124890152809385,12.0,0.5238227218271837,0.5703745219098523,-1.0086122451003097,208,110,98,1,0.9573613191275298,1.170500554541026,0.7023003327246156,-0.48112491508833566,0.2267136810792433,0.2267136810792433,0.7023003327246156,1.170500554541026,1,0,1,2,1.170500554541026,0.7023003327246156
585,3,106,29,94,80,0,1986.401,84,3523.269,MORE,2630,906,3536,2,2,-14.0,-1.3123718449442827,14.0,0.8730378697119728,1.112727474597509,-0.9332797349664606,174,94,80,1,0.2792303847455295,0.5462335921191455,0.0,-0.48112491508833566,2.2097491086836096,2.2097491086836096,0.0,0.5462335921191455,1,0,1,1,0.5462335921191455,0.0
586,3,107,57,110,94,1,2072.406,84,2357.011,MORE,2132,554,2686,3,2,-16.0,-1.4998535370791803,16.0,1.222253017596762,1.112727474597509,-0.8815183501772804,204,110,94,1,0.8775812092002355,1.170500554541026,0.5462335921191455,0.3043851503620085,1.7452375174573753,1.7452375174573753,0.5462335921191455,1.170500554541026,1,1,1,2,1.170500554541026,0.5462335921191455
587,3,108,39,80,66,0,2149.11,64,1502.045,MORE,-410,1000,590,2,1,-14.0,-1.3123718449442827,14.0,0.8730378697119728,0.028021569222195543,-0.8353546938913751,146,80,66,1,-0.2792303847455295,0.0,-0.5462335921191455,-0.48112491508833566,-0.6258236570347693,0.6258236570347693,-0.5462335921191455,0.0,0,0,0,1,0.0,-0.5462335921191455
588,3,109,4,50,54,1,1708.406,34,434.293,MORE,764,186,950,1,2,4.0,0.3749633842697951,4.0,-0.8730378697119728,-1.599037288840775,-1.100588684033005,104,50,54,0,-1.116921538982118,-1.170500554541026,-1.0144338139355558,-1.2666349805386798,0.46922977288410467,0.46922977288410467,-1.0144338139355558,-1.170500554541026,0,0,1,0,-1.170500554541026,-1.0144338139355558
589,3,110,55,98,110,1,1849.511,74,1565.848,MORE,1596,386,1982,1,2,12.0,1.124890152809385,12.0,0.5238227218271837,0.5703745219098523,-1.0156658283772029,208,98,110,0,0.9573613191275298,0.7023003327246156,1.170500554541026,-1.2666349805386798,1.245281266659661,1.245281266659661,1.170500554541026,0.7023003327246156,1,0,1,2,1.170500554541026,0.7023003327246156
590,3,111,2,50,52,1,1632.089,74,2265.239,MORE,802,376,1178,1,2,2.0,0.18748169213489754,2.0,-1.222253017596762,0.5703745219098523,-1.1465194276287942,102,50,52,0,-1.156811593945765,-1.170500554541026,-1.092467184238291,-1.2666349805386798,0.5046744324555845,0.5046744324555845,-1.092467184238291,-1.170500554541026,1,0,1,0,-1.170500554541026,-1.092467184238291
591,3,112,59,110,89,0,1427.93,74,1739.304,MORE,-220,896,676,2,2,-21.0,-1.9685577674164243,21.0,2.0952908873087353,0.5703745219098523,-1.269390802050912,199,110,89,1,0.7778560717911179,1.170500554541026,0.3511501663623078,-0.48112491508833566,-0.4486003591773706,0.4486003591773706,0.3511501663623078,1.170500554541026,1,0,0,2,1.170500554541026,0.3511501663623078
592,3,113,60,87,110,1,2591.58,64,1398.915,MORE,1400,734,2134,3,2,23.0,2.1560394595513217,23.0,2.444506035193524,0.028021569222195543,-0.5690578515255993,197,87,110,0,0.7379660168274708,0.27311679605957273,1.170500554541026,0.3043851503620085,1.0624614436067656,1.0624614436067656,1.170500554541026,0.27311679605957273,0,1,1,2,1.170500554541026,0.27311679605957273
593,3,114,52,110,105,1,3163.686,34,565.7919999999998,MORE,546,924,1470,3,2,-5.0,-0.4687042303372438,5.0,-0.6984302957695783,-1.599037288840775,-0.22474067454520594,215,110,105,1,1.0969765115002945,1.170500554541026,0.9754171287841883,0.3043851503620085,0.2658893574477209,0.2658893574477209,0.9754171287841883,1.170500554541026,0,1,1,2,1.170500554541026,0.9754171287841883
594,3,115,30,80,96,1,2995.507,100,3384.773,MORE,3212,322,3534,1,2,16.0,1.4998535370791803,16.0,1.222253017596762,1.98049219889776,-0.3259577890438925,176,80,96,0,0.3191204397091766,0.0,0.6242669624218805,-1.2666349805386798,2.7526120526467994,2.7526120526467994,0.6242669624218805,0.0,1,0,1,1,0.6242669624218805,0.0
595,3,116,24,80,86,1,2408.271,44,2135.2960000000007,MORE,396,584,980,1,1,6.0,0.5624450764046927,6.0,-0.5238227218271837,-1.056684336153118,-0.6793808290771349,166,80,86,0,0.11967016489094122,0.0,0.2341001109082052,-1.2666349805386798,0.1259762275603009,0.1259762275603009,0.2341001109082052,0.0,0,0,0,1,0.2341001109082052,0.0
596,3,117,5,50,55,1,1715.706,74,490.818,MORE,526,404,930,1,2,5.0,0.4687042303372438,5.0,-0.6984302957695783,0.5703745219098523,-1.09619524052436,105,50,55,0,-1.0969765115002945,-1.170500554541026,-0.9754171287841883,-1.2666349805386798,0.24723427346273158,0.24723427346273158,-0.9754171287841883,-1.170500554541026,1,0,1,0,-1.170500554541026,-0.9754171287841883
597,3,118,34,80,74,0,4161.4940000000015,54,1424.305,MORE,-884,2220,1336,4,1,-6.0,-0.5624450764046927,6.0,-0.5238227218271837,-0.5143313834654613,0.37578166524576395,154,80,74,1,-0.11967016489094122,0.0,-0.2341001109082052,1.0898952158123527,-1.0679491474790166,1.0679491474790166,-0.2341001109082052,0.0,0,1,0,1,0.0,-0.2341001109082052
598,3,119,15,45,50,1,4250.03,74,1698.354,MORE,3926,438,4364,1,2,5.0,0.4687042303372438,5.0,-0.6984302957695783,0.5703745219098523,0.42906631106513227,95,45,50,0,-1.2964267863185297,-1.3655839802978638,-1.170500554541026,-1.2666349805386798,3.4185985509109185,3.4185985509109185,-1.170500554541026,-1.3655839802978638,1,0,1,0,-1.3655839802978638,-1.170500554541026
599,3,120,37,69,80,1,1883.502,44,686.689,MORE,1256,416,1672,1,2,11.0,1.0311493067419364,11.0,0.34921514788478913,-1.056684336153118,-0.9952086313494832,149,69,80,0,-0.21939530230005888,-0.4291835366650429,0.0,-1.2666349805386798,0.9281448389148423,0.9281448389148423,0.0,-0.4291835366650429,0,0,1,1,-0.4291835366650429,0.0
600,3,121,48,128,110,1,2874.212,74,2566.818,LESS,10,1122,1132,1,2,-18.0,-1.6873352292140782,18.0,1.571468165481551,0.5703745219098523,-0.3989581630687006,238,128,110,0,1.5557121435822359,1.8728008872656416,1.170500554541026,-1.2666349805386798,-0.23406689334999328,0.23406689334999328,1.170500554541026,1.8728008872656416,1,0,1,2,1.8728008872656416,1.170500554541026
601,3,122,8,50,58,0,1905.035,74,1705.2910000000004,LESS,-10,1086,1076,2,1,8.0,0.7499267685395902,8.0,-0.17460757394239454,0.5703745219098523,-0.9822491766821332,108,50,58,1,-1.0371414290548238,-1.170500554541026,-0.8583670733300858,-0.48112491508833566,-0.2527219773349826,0.2527219773349826,-0.8583670733300858,-1.170500554541026,1,0,1,0,-1.170500554541026,-0.8583670733300858
602,3,123,4,54,50,0,3598.0640000000008,54,1511.513,LESS,-262,1902,1640,2,2,-4.0,-0.3749633842697951,4.0,-0.8730378697119728,-0.5143313834654613,0.03668606578331614,104,54,50,0,-1.116921538982118,-1.0144338139355558,-1.170500554541026,-0.48112491508833566,-0.4877760355458482,0.4877760355458482,-1.170500554541026,-1.0144338139355558,0,0,0,0,-1.0144338139355558,-1.170500554541026
603,3,124,37,80,69,1,4363.497,20,2500.996,LESS,-1356,3222,1866,4,1,-11.0,-1.0311493067419364,11.0,0.34921514788478913,-2.358331422603494,0.4973554692288895,149,80,69,0,-0.21939530230005888,0.0,-0.4291835366650429,1.0898952158123527,-1.5082091295247648,1.5082091295247648,-0.4291835366650429,0.0,0,1,0,1,0.0,-0.4291835366650429
604,3,125,52,105,110,0,3112.865,34,1713.5320000000004,LESS,-940,1434,494,2,1,5.0,0.4687042303372438,5.0,-0.6984302957695783,-1.599037288840775,-0.2553268653058704,215,105,110,1,1.0969765115002945,0.9754171287841883,1.170500554541026,-0.48112491508833566,-1.1201833826369867,1.1201833826369867,1.170500554541026,0.9754171287841883,0,0,0,2,1.170500554541026,0.9754171287841883
605,3,126,5,55,50,0,1884.503,84,1365.648,LESS,242,482,724,2,2,-5.0,-0.4687042303372438,5.0,-0.6984302957695783,1.112727474597509,-0.99460618793138,105,55,50,0,-1.0969765115002945,-0.9754171287841883,-1.170500554541026,-0.48112491508833566,-0.01766791912411698,0.01766791912411698,-1.170500554541026,-0.9754171287841883,1,0,1,0,-0.9754171287841883,-1.170500554541026
606,3,127,30,96,80,0,1983.844,64,1289.754,LESS,88,924,1012,2,2,-16.0,-1.4998535370791803,16.0,1.222253017596762,0.028021569222195543,-0.9348186438776394,176,96,80,0,0.3191204397091766,0.6242669624218805,0.0,-0.48112491508833566,-0.16131206580853485,0.16131206580853485,0.0,0.6242669624218805,1,0,1,1,0.6242669624218805,0.0
607,3,128,33,80,75,1,3481.898,74,1122.545,LESS,992,1050,2042,2,2,-5.0,-0.4687042303372438,5.0,-0.6984302957695783,0.5703745219098523,-0.03322746279548669,155,80,75,0,-0.09972513740911768,0.0,-0.19508342575683765,-0.48112491508833566,0.6818977303129832,0.6818977303129832,-0.19508342575683765,0.0,1,0,1,1,0.0,-0.19508342575683765
608,3,129,48,110,128,0,1740.578,34,1259.018,LESS,-522,952,430,2,1,18.0,1.6873352292140782,18.0,1.571468165481551,-1.599037288840775,-1.0812262368329877,238,110,128,1,1.5557121435822359,1.170500554541026,1.8728008872656416,-0.48112491508833566,-0.7302921273507096,0.7302921273507096,1.8728008872656416,1.170500554541026,0,0,0,2,1.8728008872656416,1.170500554541026
609,3,130,9,59,50,1,2775.34,74,2039.082,LESS,998,912,1910,3,2,-9.0,-0.8436676146070391,9.0,0.0,0.5703745219098523,-0.4584634434230499,109,59,50,0,-1.0171964015730004,-0.8193503881787182,-1.170500554541026,0.3043851503620085,0.68749425550848,0.68749425550848,-1.170500554541026,-0.8193503881787182,1,1,1,0,-0.8193503881787182,-1.170500554541026
610,3,131,44,110,119,0,3192.21,24,1241.249,LESS,-58,1230,1172,4,1,9.0,0.8436676146070391,9.0,0.0,-2.1413902415284314,-0.207573745416358,229,110,119,1,1.376206896245824,1.170500554541026,1.5216507209033339,1.0898952158123527,-0.297494178898957,0.297494178898957,1.5216507209033339,1.170500554541026,0,1,1,2,1.5216507209033339,1.170500554541026
611,3,132,2,52,50,0,2788.262,64,1998.193,LESS,-122,1248,1126,4,1,-2.0,-0.18748169213489754,2.0,-1.222253017596762,0.028021569222195543,-0.4506864465711717,102,52,50,0,-1.156811593945765,-1.092467184238291,-1.170500554541026,1.0898952158123527,-0.3571904476509229,0.3571904476509229,-1.170500554541026,-1.092467184238291,1,1,0,0,-1.092467184238291,-1.170500554541026
612,3,133,8,58,50,0,2021.154,54,1230.317,LESS,-652,1154,502,2,1,-8.0,-0.7499267685395902,8.0,-0.17460757394239454,-0.5143313834654613,-0.9123639346574276,108,58,50,0,-1.0371414290548238,-0.8583670733300858,-1.170500554541026,-0.48112491508833566,-0.8515501732531402,0.8515501732531402,-1.170500554541026,-0.8583670733300858,0,0,0,0,-0.8583670733300858,-1.170500554541026
613,3,134,44,119,110,0,2046.904,44,1541.174,LESS,-102,912,810,2,1,-9.0,-0.8436676146070391,9.0,0.0,-1.056684336153118,-0.8968665140618647,229,119,110,0,1.376206896245824,1.5216507209033339,1.170500554541026,-0.48112491508833566,-0.33853536366593356,0.33853536366593356,1.170500554541026,1.5216507209033339,0,0,0,2,1.5216507209033339,1.170500554541026
614,3,135,34,74,80,0,2458.908,54,2183.71,LESS,-78,952,874,3,2,6.0,0.5624450764046927,6.0,-0.5238227218271837,-0.5143313834654613,-0.6489053771665517,154,74,80,1,-0.11967016489094122,-0.2341001109082052,0.0,0.3043851503620085,-0.31614926288394635,0.31614926288394635,0.0,-0.2341001109082052,0,1,1,1,-0.2341001109082052,0.0
615,3,136,24,86,80,0,11284.041,54,2586.765,LESS,-1900,3162,1262,5,1,-6.0,-0.5624450764046927,6.0,-0.5238227218271837,-0.5143313834654613,4.662426580611392,166,86,80,0,0.11967016489094122,0.2341001109082052,0.0,1.875405281262697,-2.0156274139164747,2.0156274139164747,0.0,0.2341001109082052,0,1,0,1,0.2341001109082052,0.0
616,3,137,39,66,80,0,2205.452,84,1902.58,LESS,548,1084,1632,2,2,14.0,1.3123718449442827,14.0,0.8730378697119728,1.112727474597509,-0.8014457357867069,146,66,80,1,-0.2792303847455295,-0.5462335921191455,0.0,-0.48112491508833566,0.2677548658462199,0.2677548658462199,0.0,-0.5462335921191455,1,0,1,1,-0.5462335921191455,0.0
617,3,138,9,50,59,1,2938.9590000000007,74,2685.0170000000007,LESS,-704,1814,1110,3,1,9.0,0.8436676146070391,9.0,0.0,0.5703745219098523,-0.3599907265133248,109,50,59,1,-1.0171964015730004,-1.170500554541026,-0.8193503881787182,0.3043851503620085,-0.9000533916141125,0.9000533916141125,-0.8193503881787182,-1.170500554541026,1,1,0,0,-1.170500554541026,-0.8193503881787182
618,3,139,57,94,110,0,2075.831,44,1203.137,LESS,-446,844,398,2,1,16.0,1.4998535370791803,16.0,1.222253017596762,-1.056684336153118,-0.8794570427776763,204,94,110,1,0.8775812092002355,0.5462335921191455,1.170500554541026,-0.48112491508833566,-0.6594028082077501,0.6594028082077501,1.170500554541026,0.5462335921191455,0,0,0,2,1.170500554541026,0.5462335921191455
619,3,140,60,110,87,1,6006.701,74,1325.269,LESS,628,1806,2434,2,2,-23.0,-2.1560394595513217,23.0,2.444506035193524,0.5703745219098523,1.4863039551438946,197,110,87,0,0.7379660168274708,1.170500554541026,0.27311679605957273,-0.48112491508833566,0.3423752017861772,0.3423752017861772,0.27311679605957273,1.170500554541026,1,0,1,2,1.170500554541026,0.27311679605957273
620,3,141,33,75,80,0,5185.448,64,2990.763,LESS,-476,2754,2278,6,2,5.0,0.4687042303372438,5.0,-0.6984302957695783,0.028021569222195543,0.9920397548965999,155,75,80,1,-0.09972513740911768,-0.19508342575683765,0.0,2.660915346713041,-0.6873854341852341,0.6873854341852341,0.0,-0.19508342575683765,1,1,0,1,-0.19508342575683765,0.0
621,3,142,15,50,45,0,2171.165,74,2199.569,LESS,-94,1346,1252,4,1,-5.0,-0.4687042303372438,5.0,-0.6984302957695783,0.5703745219098523,-0.8220810779210784,95,50,45,0,-1.2964267863185297,-1.170500554541026,-1.3655839802978638,1.0898952158123527,-0.33107333007193784,0.33107333007193784,-1.3655839802978638,-1.170500554541026,1,1,0,0,-1.170500554541026,-1.3655839802978638
622,3,143,59,89,110,0,2231.588,74,1318.379,LESS,-282,1378,1096,2,2,21.0,1.9685577674164243,21.0,2.0952908873087353,0.5703745219098523,-0.7857160043426046,199,89,110,1,0.7778560717911179,0.3511501663623078,1.170500554541026,-0.48112491508833566,-0.5064311195308375,0.5064311195308375,1.170500554541026,0.3511501663623078,1,0,0,2,1.170500554541026,0.3511501663623078
623,3,144,29,80,94,0,6749.729,34,2101.397,LESS,-1696,3744,2048,5,1,14.0,1.3123718449442827,14.0,0.8730378697119728,-1.599037288840775,1.9334890980673876,174,80,94,1,0.2792303847455295,0.0,0.5462335921191455,1.875405281262697,-1.8253455572695836,1.8253455572695836,0.5462335921191455,0.0,0,1,0,1,0.5462335921191455,0.0
624,3,145,55,110,98,1,1702.985,74,1857.417,LESS,1536,438,1974,1,2,-12.0,-1.124890152809385,12.0,0.5238227218271837,0.5703745219098523,-1.1038512672193563,208,110,98,0,0.9573613191275298,1.170500554541026,0.7023003327246156,-1.2666349805386798,1.189316014704693,1.189316014704693,0.7023003327246156,1.170500554541026,1,0,1,2,1.170500554541026,0.7023003327246156
625,3,146,29,94,80,1,4327.1,84,1458.464,LESS,1724,912,2636,3,2,-14.0,-1.3123718449442827,14.0,0.8730378697119728,1.112727474597509,0.4754502413680466,174,94,80,0,0.2792303847455295,0.5462335921191455,0.0,0.3043851503620085,1.3646738041635929,1.3646738041635929,0.0,0.5462335921191455,1,1,1,1,0.5462335921191455,0.0
626,3,147,57,110,94,1,2781.398,64,3004.275,LESS,326,730,1056,1,1,-16.0,-1.4998535370791803,16.0,1.222253017596762,0.028021569222195543,-0.4548174871524511,204,110,94,0,0.8775812092002355,1.170500554541026,0.5462335921191455,-1.2666349805386798,0.060683433612838227,0.060683433612838227,0.5462335921191455,1.170500554541026,1,0,1,2,1.170500554541026,0.5462335921191455
627,3,148,39,80,66,0,2153.141,74,1749.562,LESS,-126,852,726,2,2,-14.0,-1.3123718449442827,14.0,0.8730378697119728,0.5703745219098523,-0.832928670496396,146,80,66,0,-0.2792303847455295,0.0,-0.5462335921191455,-0.48112491508833566,-0.3609214644479207,0.3609214644479207,-0.5462335921191455,0.0,1,0,0,1,0.0,-0.5462335921191455
628,3,149,4,50,54,0,5509.326,34,1680.692,LESS,-560,2588,2028,6,1,4.0,0.3749633842697951,4.0,-0.8730378697119728,-1.599037288840775,1.1869630010189194,104,50,54,1,-1.116921538982118,-1.170500554541026,-1.0144338139355558,2.660915346713041,-0.7657367869221893,0.7657367869221893,-1.0144338139355558,-1.170500554541026,0,1,0,0,-1.170500554541026,-1.0144338139355558
629,3,150,55,98,110,0,3790.565,64,1435.275,LESS,-566,1872,1306,4,1,12.0,1.124890152809385,12.0,0.5238227218271837,0.028021569222195543,0.152541171106285,208,98,110,1,0.9573613191275298,0.7023003327246156,1.170500554541026,1.0898952158123527,-0.7713333121176861,0.7713333121176861,1.170500554541026,0.7023003327246156,0,1,0,2,1.170500554541026,0.7023003327246156
630,3,151,2,50,52,0,1935.545,64,1712.1989999999996,LESS,-174,1184,1010,2,2,2.0,0.18748169213489754,2.0,-1.222253017596762,0.028021569222195543,-0.9638869901823032,102,50,52,1,-1.156811593945765,-1.170500554541026,-1.092467184238291,-0.48112491508833566,-0.40569366601189516,0.40569366601189516,-1.092467184238291,-1.170500554541026,0,0,0,0,-1.170500554541026,-1.092467184238291
631,3,152,59,110,89,1,5071.439,74,2358.6020000000008,LESS,442,1892,2334,5,2,-21.0,-1.9685577674164243,21.0,2.0952908873087353,0.5703745219098523,0.9234243985983656,199,110,89,0,0.7778560717911179,1.170500554541026,0.3511501663623078,1.875405281262697,0.16888292072577638,0.16888292072577638,0.3511501663623078,1.170500554541026,1,1,1,2,1.170500554541026,0.3511501663623078
632,3,153,60,87,110,0,1970.037,34,1063.484,LESS,-174,754,580,2,1,23.0,2.1560394595513217,23.0,2.444506035193524,-1.599037288840775,-0.9431282705247436,197,87,110,1,0.7379660168274708,0.27311679605957273,1.170500554541026,-0.48112491508833566,-0.40569366601189516,0.40569366601189516,1.170500554541026,0.27311679605957273,0,0,0,2,1.170500554541026,0.27311679605957273
633,3,154,52,110,105,0,1915.188,74,1313.122,LESS,-342,818,476,2,2,-5.0,-0.4687042303372438,5.0,-0.6984302957695783,0.5703745219098523,-0.9761386791556576,215,110,105,0,1.0969765115002945,1.170500554541026,0.9754171287841883,-0.48112491508833566,-0.5623963714858056,0.5623963714858056,0.9754171287841883,1.170500554541026,1,0,0,2,1.170500554541026,0.9754171287841883
634,3,155,30,80,96,0,1806.863,84,1586.736,LESS,682,924,1606,2,2,16.0,1.4998535370791803,16.0,1.222253017596762,1.112727474597509,-1.041333167932914,176,80,96,1,0.3191204397091766,0.0,0.6242669624218805,-0.48112491508833566,0.3927439285456484,0.3927439285456484,0.6242669624218805,0.0,1,0,1,1,0.6242669624218805,0.0
635,3,156,24,80,86,0,3215.543,44,1895.31,LESS,288,1226,1514,4,2,6.0,0.5624450764046927,6.0,-0.5238227218271837,-1.056684336153118,-0.19353097591126006,166,80,86,1,0.11967016489094122,0.0,0.2341001109082052,1.0898952158123527,0.02523877404135849,0.02523877404135849,0.2341001109082052,0.0,0,1,1,1,0.2341001109082052,0.0
636,3,157,5,50,55,0,3040.316,44,2008.127,LESS,-526,1054,528,2,1,5.0,0.4687042303372438,5.0,-0.6984302957695783,-1.056684336153118,-0.2989898698413071,105,50,55,1,-1.0969765115002945,-1.170500554541026,-0.9754171287841883,-0.48112491508833566,-0.7340231441477074,0.7340231441477074,-0.9754171287841883,-1.170500554541026,0,0,0,0,-1.170500554541026,-0.9754171287841883
637,3,158,34,80,74,1,2795.6940000000004,44,514.9259999999998,LESS,204,1060,1264,3,2,-6.0,-0.5624450764046927,6.0,-0.5238227218271837,-1.056684336153118,-0.44621355997442497,154,80,74,0,-0.11967016489094122,0.0,-0.2341001109082052,0.3043851503620085,-0.05311257869559672,0.05311257869559672,-0.2341001109082052,0.0,0,1,1,1,0.0,-0.2341001109082052
638,3,159,15,45,50,0,2434.871,64,1658.349,LESS,-762,1248,486,2,1,5.0,0.4687042303372438,5.0,-0.6984302957695783,0.028021569222195543,-0.6633718431415243,95,45,50,1,-1.2964267863185297,-1.3655839802978638,-1.170500554541026,-0.48112491508833566,-0.9541531351705815,0.9541531351705815,-1.170500554541026,-1.3655839802978638,1,0,0,0,-1.3655839802978638,-1.170500554541026
639,3,160,37,69,80,0,2171.063,74,1331.854,LESS,-946,1526,580,2,1,11.0,1.0311493067419364,11.0,0.34921514788478913,0.5703745219098523,-0.8221424657618841,149,69,80,1,-0.21939530230005888,-0.4291835366650429,0.0,-0.48112491508833566,-1.1257799078324835,1.1257799078324835,0.0,-0.4291835366650429,1,0,0,1,-0.4291835366650429,0.0
640,3,161,3,50,53,1,3463.021,74,2280.503,MORE,1518,686,2204,1,2,3.0,0.28122253820234633,3.0,-1.0476454436543674,0.5703745219098523,-0.04458842623558148,103,50,53,0,-1.1368665664639415,-1.170500554541026,-1.0534504990869233,-1.2666349805386798,1.1725264391182026,1.1725264391182026,-1.0534504990869233,-1.170500554541026,1,0,1,0,-1.170500554541026,-1.0534504990869233
641,3,162,20,50,40,1,4614.063,64,2201.647,MORE,-88,1838,1750,4,2,-10.0,-0.9374084606744876,10.0,0.17460757394239454,0.028021569222195543,0.6481565056928824,90,50,40,1,-1.3961519237276474,-1.170500554541026,-1.5606674060547012,1.0898952158123527,-0.32547680487644104,0.32547680487644104,-1.5606674060547012,-1.170500554541026,0,1,0,0,-1.170500554541026,-1.5606674060547012
642,3,163,25,80,88,1,3670.417,54,1477.1229999999996,MORE,122,1190,1312,3,2,8.0,0.7499267685395902,8.0,-0.17460757394239454,-0.5143313834654613,0.0802311093697531,168,80,88,0,0.1595602198545883,0.0,0.31213348121094026,0.3043851503620085,-0.129598423034053,0.129598423034053,0.31213348121094026,0.0,0,1,0,1,0.31213348121094026,0.0
643,3,164,42,115,110,0,1955.291,74,1578.065,MORE,514,796,1310,2,2,-5.0,-0.4687042303372438,5.0,-0.6984302957695783,0.5703745219098523,-0.9520030264122068,225,115,110,1,1.2964267863185297,1.3655839802978638,1.170500554541026,-0.48112491508833566,0.23604122307173797,0.23604122307173797,1.170500554541026,1.3655839802978638,1,0,1,2,1.3655839802978638,1.170500554541026
644,3,165,53,103,110,1,2539.423,34,1759.713,MORE,1236,550,1786,1,2,7.0,0.6561859224721414,7.0,-0.34921514788478913,-1.599037288840775,-0.6004481026325034,213,103,110,0,1.0570864565366473,0.8973837584814532,1.170500554541026,-1.2666349805386798,0.9094897549298531,0.9094897549298531,1.170500554541026,0.8973837584814532,0,0,1,2,1.170500554541026,0.8973837584814532
645,3,166,26,90,80,0,2504.688,84,1093.269,MORE,398,1086,1484,2,1,-10.0,-0.9374084606744876,10.0,0.17460757394239454,1.112727474597509,-0.6213530697931586,170,90,80,1,0.19945027481823535,0.3901668515136753,0.0,-0.48112491508833566,0.12784173595879983,0.12784173595879983,0.0,0.3901668515136753,1,0,0,1,0.3901668515136753,0.0
646,3,167,35,80,72,0,2264.841,84,1741.521,MORE,770,1288,2058,2,1,-8.0,-0.7499267685395902,8.0,-0.17460757394239454,1.112727474597509,-0.7657029663983619,152,80,72,1,-0.1595602198545883,0.0,-0.31213348121094026,-0.48112491508833566,0.47482629807960147,0.47482629807960147,-0.31213348121094026,0.0,1,0,1,1,0.0,-0.31213348121094026
647,3,168,28,93,80,0,3871.268,74,1606.846,MORE,-258,1842,1584,4,2,-13.0,-1.218630998876834,13.0,0.6984302957695783,0.5703745219098523,0.20111159185672053,173,93,80,1,0.25928535726370594,0.5072169069677779,0.0,1.0898952158123527,-0.4840450187488503,0.4840450187488503,0.0,0.5072169069677779,0,1,0,1,0.5072169069677779,0.0
648,3,169,26,80,90,0,2988.316,74,1559.854,MORE,386,1152,1538,4,2,10.0,0.9374084606744876,10.0,0.17460757394239454,0.5703745219098523,-0.3302856318206963,170,80,90,0,0.19945027481823535,0.0,0.3901668515136753,1.0898952158123527,0.11664868556780623,0.11664868556780623,0.3901668515136753,0.0,0,1,0,1,0.3901668515136753,0.0
649,3,170,25,88,80,0,3182.992,54,1493.888,MORE,-668,1498,830,4,1,-8.0,-0.7499267685395902,8.0,-0.17460757394239454,-0.5143313834654613,-0.2131215210687812,168,88,80,1,0.1595602198545883,0.31213348121094026,0.0,1.0898952158123527,-0.8664742404411316,0.8664742404411316,0.0,0.31213348121094026,0,1,0,1,0.31213348121094026,0.0
650,3,171,36,80,70,1,2879.908,34,1709.7,MORE,370,1056,1426,3,2,-10.0,-0.9374084606744876,10.0,0.17460757394239454,-1.599037288840775,-0.3955300734488044,150,80,70,1,-0.19945027481823535,0.0,-0.3901668515136753,0.3043851503620085,0.10172461837981477,0.10172461837981477,-0.3901668515136753,0.0,0,1,0,1,0.0,-0.3901668515136753
651,3,172,28,80,93,1,3832.523,74,2177.333,MORE,1418,1566,2984,2,2,13.0,1.218630998876834,13.0,0.6984302957695783,0.5703745219098523,0.17779323997419297,173,80,93,0,0.25928535726370594,0.0,0.5072169069677779,-0.48112491508833566,1.079251019193256,1.079251019193256,0.5072169069677779,0.0,1,0,1,1,0.5072169069677779,0.0
652,3,173,21,82,80,0,3374.473,100,4651.848,MORE,1268,2042,3310,2,2,-2.0,-0.18748169213489754,2.0,-1.222253017596762,1.98049219889776,-0.09788029415386924,162,82,80,1,0.03989005496364707,0.07803337030273506,0.0,-0.48112491508833566,0.939337889305836,0.939337889305836,0.0,0.07803337030273506,1,0,1,1,0.07803337030273506,0.0
653,3,174,19,50,41,0,4296.539000000002,84,1582.231,MORE,1024,1548,2572,5,2,-9.0,-0.8436676146070391,9.0,0.0,1.112727474597509,0.4570573609478144,91,50,41,1,-1.376206896245824,-1.170500554541026,-1.5216507209033339,1.875405281262697,0.7117458646889661,0.7117458646889661,-1.5216507209033339,-1.170500554541026,1,1,1,0,-1.170500554541026,-1.5216507209033339
654,3,175,56,96,110,1,1664.744,54,2043.099,MORE,1326,446,1772,1,2,14.0,1.3123718449442827,14.0,0.8730378697119728,-0.5143313834654613,-1.1268662909473144,206,96,110,0,0.9174712641638826,0.6242669624218805,1.170500554541026,-1.2666349805386798,0.993437632862305,0.993437632862305,1.170500554541026,0.6242669624218805,0,0,1,2,1.170500554541026,0.6242669624218805
655,3,176,23,80,85,1,1615.953,84,1679.48,MORE,2236,378,2614,1,2,5.0,0.4687042303372438,5.0,-0.6984302957695783,1.112727474597509,-1.156230743307629,165,80,85,0,0.09972513740911768,0.0,0.19508342575683765,-1.2666349805386798,1.8422439541793199,1.8422439541793199,0.19508342575683765,0.0,1,0,1,1,0.19508342575683765,0.0
656,3,177,10,60,50,1,3923.588,64,587.925,MORE,1430,1124,2554,3,2,-10.0,-0.9374084606744876,10.0,0.17460757394239454,0.028021569222195543,0.2325999431405984,110,60,50,1,-0.9972513740911768,-0.7803337030273506,-1.170500554541026,0.3043851503620085,1.0904440695842497,1.0904440695842497,-1.170500554541026,-0.7803337030273506,0,1,1,0,-0.7803337030273506,-1.170500554541026
657,3,178,19,41,50,1,4026.835,64,2635.274000000001,MORE,1678,978,2656,2,2,9.0,0.8436676146070391,9.0,0.0,0.028021569222195543,0.2947382803922521,91,41,50,0,-1.376206896245824,-1.5216507209033339,-1.170500554541026,-0.48112491508833566,1.3217671109981173,1.3217671109981173,-1.170500554541026,-1.5216507209033339,0,0,1,0,-1.5216507209033339,-1.170500554541026
658,3,179,56,110,96,0,1902.077,80,1842.434,MORE,1032,772,1804,2,2,-14.0,-1.3123718449442827,14.0,0.8730378697119728,0.8957862935224463,-0.9840294240654992,206,110,96,1,0.9174712641638826,1.170500554541026,0.6242669624218805,-0.48112491508833566,0.7192078982829618,0.7192078982829618,0.6242669624218805,1.170500554541026,1,0,1,2,1.170500554541026,0.6242669624218805
659,3,180,35,72,80,1,5104.126,74,1437.154,MORE,1506,1544,3050,5,2,8.0,0.7499267685395902,8.0,-0.17460757394239454,0.5703745219098523,0.9430967942102944,152,72,80,0,-0.1595602198545883,-0.31213348121094026,0.0,1.875405281262697,1.161333388727209,1.161333388727209,0.0,-0.31213348121094026,1,1,1,1,-0.31213348121094026,0.0
660,3,181,11,49,50,1,2092.791,74,1386.898,MORE,682,438,1120,1,2,1.0,0.09374084606744876,1.0,-1.3968605915391563,0.5703745219098523,-0.8692498096397832,99,49,50,0,-1.2166466763912356,-1.2095172396923934,-1.170500554541026,-1.2666349805386798,0.3927439285456484,0.3927439285456484,-1.170500554541026,-1.2095172396923934,1,0,1,0,-1.2095172396923934,-1.170500554541026
661,3,182,17,43,50,1,1598.885,100,2419.735,MORE,1888,432,2320,1,2,7.0,0.6561859224721414,7.0,-0.34921514788478913,1.98049219889776,-1.1665029753357874,93,43,50,0,-1.3363168412821769,-1.4436173506005987,-1.170500554541026,-1.2666349805386798,1.5176454928405054,1.5176454928405054,-1.170500554541026,-1.4436173506005987,1,0,1,0,-1.4436173506005987,-1.170500554541026
662,3,183,1,51,50,0,3318.8720000000008,34,1467.4,MORE,-386,1384,998,4,1,-1.0,-0.09374084606744876,1.0,-1.3968605915391563,-1.599037288840775,-0.13134328765033068,101,51,50,1,-1.1767566214275886,-1.1314838693896585,-1.170500554541026,1.0898952158123527,-0.6034375562527821,0.6034375562527821,-1.170500554541026,-1.1314838693896585,0,1,0,0,-1.1314838693896585,-1.170500554541026
663,3,184,41,112,110,0,4246.255,74,1777.479,MORE,-62,1762,1700,4,2,-2.0,-0.18748169213489754,2.0,-1.222253017596762,0.5703745219098523,0.42679435911374414,222,112,110,1,1.2365917038730592,1.248533924843761,1.170500554541026,1.0898952158123527,-0.3012251956959549,0.3012251956959549,1.170500554541026,1.248533924843761,1,1,0,2,1.248533924843761,1.170500554541026
664,3,185,20,40,50,1,4098.269,84,2000.221,MORE,2356,764,3120,2,2,10.0,0.9374084606744876,10.0,0.17460757394239454,1.112727474597509,0.33773023156986165,90,40,50,0,-1.3961519237276474,-1.5606674060547012,-1.170500554541026,-0.48112491508833566,1.954174458089256,1.954174458089256,-1.170500554541026,-1.5606674060547012,1,0,1,0,-1.5606674060547012,-1.170500554541026
665,3,186,1,50,51,0,4183.0340000000015,74,2559.068,MORE,392,1538,1930,4,2,1.0,0.09374084606744876,1.0,-1.3968605915391563,0.5703745219098523,0.3887453328041495,101,50,51,0,-1.1767566214275886,-1.170500554541026,-1.1314838693896585,1.0898952158123527,0.12224521076330304,0.12224521076330304,-1.1314838693896585,-1.170500554541026,1,1,0,0,-1.170500554541026,-1.1314838693896585
666,3,187,23,85,80,1,1733.372,64,1625.6429999999998,MORE,468,452,920,1,2,-5.0,-0.4687042303372438,5.0,-0.6984302957695783,0.028021569222195543,-1.0855631072334389,165,85,80,1,0.09972513740911768,0.19508342575683765,0.0,-1.2666349805386798,0.1931345299062625,0.1931345299062625,0.0,0.19508342575683765,0,0,0,1,0.19508342575683765,0.0
667,3,188,11,50,49,1,4202.163,74,1909.819,MORE,1920,1210,3130,3,2,-1.0,-0.09374084606744876,1.0,-1.3968605915391563,0.5703745219098523,0.4002579603215279,99,50,49,1,-1.2166466763912356,-1.170500554541026,-1.2095172396923934,0.3043851503620085,1.5474936272164883,1.5474936272164883,-1.2095172396923934,-1.170500554541026,1,1,1,0,-1.170500554541026,-1.2095172396923934
668,3,189,17,50,43,0,2356.3,64,1376.661,MORE,30,818,848,2,1,-7.0,-0.6561859224721414,7.0,-0.34921514788478913,0.028021569222195543,-0.7106591376508048,93,50,43,1,-1.3363168412821769,-1.170500554541026,-1.4436173506005987,-0.48112491508833566,-0.21541180936500393,0.21541180936500393,-1.4436173506005987,-1.170500554541026,0,0,0,0,-1.170500554541026,-1.4436173506005987
669,3,190,21,80,82,1,1870.494,84,2322.063,MORE,1732,420,2152,1,2,2.0,0.18748169213489754,2.0,-1.222253017596762,1.112727474597509,-1.0030373865769426,162,80,82,0,0.03989005496364707,0.0,0.07803337030273506,-1.2666349805386798,1.3721358377575885,1.3721358377575885,0.07803337030273506,0.0,1,0,1,1,0.07803337030273506,0.0
670,3,191,10,50,60,1,1738.671,74,1528.101,MORE,572,414,986,1,2,10.0,0.9374084606744876,10.0,0.17460757394239454,0.5703745219098523,-1.0823739487194235,110,50,60,0,-0.9972513740911768,-1.170500554541026,-0.7803337030273506,-1.2666349805386798,0.29014096662820704,0.29014096662820704,-0.7803337030273506,-1.170500554541026,1,0,1,0,-1.170500554541026,-0.7803337030273506
671,3,192,3,53,50,1,2082.474,74,676.898,MORE,1618,466,2084,1,2,-3.0,-0.28122253820234633,3.0,-1.0476454436543674,0.5703745219098523,-0.8754590091848093,103,53,50,1,-1.1368665664639415,-1.0534504990869233,-1.170500554541026,-1.2666349805386798,1.2658018590431495,1.2658018590431495,-1.170500554541026,-1.0534504990869233,1,0,1,0,-1.0534504990869233,-1.170500554541026
672,3,193,45,122,110,1,2463.471,74,1944.794,MORE,694,820,1514,3,2,-12.0,-1.124890152809385,12.0,0.5238227218271837,0.5703745219098523,-0.6461591740528603,232,122,110,1,1.4360419786912946,1.6387007763574364,1.170500554541026,0.3043851503620085,0.403936978936642,0.403936978936642,1.170500554541026,1.6387007763574364,1,1,1,2,1.6387007763574364,1.170500554541026
673,3,194,38,67,80,1,1543.8870000000004,44,550.76,MORE,328,342,670,1,2,13.0,1.218630998876834,13.0,0.6984302957695783,-1.056684336153118,-1.1996030583616033,147,67,80,0,-0.25928535726370594,-0.5072169069677779,0.0,-1.2666349805386798,0.06254894201133716,0.06254894201133716,0.0,-0.5072169069677779,0,0,0,1,-0.5072169069677779,0.0
674,3,195,38,80,67,0,2664.14,64,2502.693,MORE,1194,988,2182,2,2,-13.0,-1.218630998876834,13.0,0.6984302957695783,0.028021569222195543,-0.5253882267328208,147,80,67,1,-0.25928535726370594,0.0,-0.5072169069677779,-0.48112491508833566,0.8703140785613754,0.8703140785613754,-0.5072169069677779,0.0,0,0,1,1,0.0,-0.5072169069677779
675,3,196,36,70,80,1,6240.445,74,1659.608,MORE,3326,1806,5132,7,2,10.0,0.9374084606744876,10.0,0.17460757394239454,0.5703745219098523,1.6269808126075551,150,70,80,0,-0.19945027481823535,-0.3901668515136753,0.0,3.4464254121633853,2.8589460313612385,2.8589460313612385,0.0,-0.3901668515136753,1,1,1,1,-0.3901668515136753,0.0
676,3,197,45,110,122,1,2168.694,74,1675.265,MORE,728,702,1430,1,2,12.0,1.124890152809385,12.0,0.5238227218271837,0.5703745219098523,-0.8235682284566759,232,110,122,0,1.4360419786912946,1.170500554541026,1.6387007763574364,-1.2666349805386798,0.4356506217111239,0.4356506217111239,1.6387007763574364,1.170500554541026,1,0,1,2,1.6387007763574364,1.170500554541026
677,3,198,42,110,115,0,2788.367,84,3251.119,MORE,168,1236,1404,2,2,5.0,0.4687042303372438,5.0,-0.6984302957695783,1.112727474597509,-0.4506232532056363,225,110,115,0,1.2964267863185297,1.170500554541026,1.3655839802978638,-0.48112491508833566,-0.08669172986857752,0.08669172986857752,1.3655839802978638,1.170500554541026,1,0,0,2,1.3655839802978638,1.170500554541026
678,3,199,41,110,112,1,1900.364,44,1973.901,MORE,864,556,1420,1,2,2.0,0.18748169213489754,2.0,-1.222253017596762,-1.056684336153118,-0.9850603786860896,222,110,112,0,1.2365917038730592,1.170500554541026,1.248533924843761,-1.2666349805386798,0.5625051928090514,0.5625051928090514,1.248533924843761,1.170500554541026,0,0,1,2,1.248533924843761,1.170500554541026
679,3,200,53,110,103,1,2711.223,24,794.877,MORE,1332,496,1828,1,2,-7.0,-0.6561859224721414,7.0,-0.34921514788478913,-2.1413902415284314,-0.4970517197852135,213,110,103,1,1.0570864565366473,1.170500554541026,0.8973837584814532,-1.2666349805386798,0.9990341580578018,0.9990341580578018,0.8973837584814532,1.170500554541026,0,0,1,2,1.170500554541026,0.8973837584814532
680,3,201,3,50,53,0,6490.153,4,2419.003,LESS,-1286,3734,2448,6,1,3.0,0.28122253820234633,3.0,-1.0476454436543674,-3.226096146903745,1.7772654689988885,103,50,53,1,-1.1368665664639415,-1.170500554541026,-1.0534504990869233,2.660915346713041,-1.4429163355773023,1.4429163355773023,-1.0534504990869233,-1.170500554541026,0,1,0,0,-1.170500554541026,-1.0534504990869233
681,3,202,20,50,40,1,2569.653,64,2289.132,LESS,828,864,1692,3,2,-10.0,-0.9374084606744876,10.0,0.17460757394239454,0.028021569222195543,-0.5822544317741006,90,50,40,0,-1.3961519237276474,-1.170500554541026,-1.5606674060547012,0.3043851503620085,0.5289260416360706,0.5289260416360706,-1.5606674060547012,-1.170500554541026,0,0,1,0,-1.170500554541026,-1.5606674060547012
682,3,203,25,80,88,1,1734.384,74,2104.83,LESS,646,292,938,1,2,8.0,0.7499267685395902,8.0,-0.17460757394239454,0.5703745219098523,-1.084954043557994,168,80,88,1,0.1595602198545883,0.0,0.31213348121094026,-1.2666349805386798,0.3591647773726676,0.3591647773726676,0.31213348121094026,0.0,1,0,1,1,0.31213348121094026,0.0
683,3,204,42,115,110,0,1816.44,74,2077.924,LESS,-708,1152,444,2,1,-5.0,-0.4687042303372438,5.0,-0.6984302957695783,0.5703745219098523,-1.0355693311545178,225,115,110,0,1.2964267863185297,1.3655839802978638,1.170500554541026,-0.48112491508833566,-0.9037844084111104,0.9037844084111104,1.170500554541026,1.3655839802978638,1,0,0,2,1.3655839802978638,1.170500554541026
684,3,205,53,103,110,1,3418.283,74,1528.432,LESS,1692,860,2552,3,2,7.0,0.6561859224721414,7.0,-0.34921514788478913,0.5703745219098523,-0.07151361468623385,213,103,110,1,1.0570864565366473,0.8973837584814532,1.170500554541026,0.3043851503620085,1.33482566978761,1.33482566978761,1.170500554541026,0.8973837584814532,1,1,1,2,1.170500554541026,0.8973837584814532
685,3,206,26,90,80,1,3388.941,74,2391.054,LESS,3004,928,3932,3,2,-10.0,-0.9374084606744876,10.0,0.17460757394239454,0.5703745219098523,-0.08917285022468081,170,90,80,0,0.19945027481823535,0.3901668515136753,0.0,0.3043851503620085,2.5585991792029104,2.5585991792029104,0.0,0.3901668515136753,1,1,1,1,0.3901668515136753,0.0
686,3,207,35,80,72,1,3212.035,64,2240.492,LESS,760,1050,1810,3,2,-8.0,-0.7499267685395902,8.0,-0.17460757394239454,0.028021569222195543,-0.19564223616171594,152,80,72,0,-0.1595602198545883,0.0,-0.31213348121094026,0.3043851503620085,0.46549875608710684,0.46549875608710684,-0.31213348121094026,0.0,0,1,1,1,0.0,-0.31213348121094026
687,3,208,28,93,80,1,4191.488,84,1339.696,LESS,1226,1530,2756,2,2,-13.0,-1.218630998876834,13.0,0.6984302957695783,1.112727474597509,0.3938333014921056,173,93,80,0,0.25928535726370594,0.5072169069677779,0.0,-0.48112491508833566,0.9001622129373584,0.9001622129373584,0.0,0.5072169069677779,1,0,1,1,0.5072169069677779,0.0
688,3,209,26,80,90,0,2193.673,84,3333.6620000000007,LESS,678,1268,1946,2,2,10.0,0.9374084606744876,10.0,0.17460757394239454,1.112727474597509,-0.8085348277166152,170,80,90,1,0.19945027481823535,0.0,0.3901668515136753,-0.48112491508833566,0.38901291174865055,0.38901291174865055,0.3901668515136753,0.0,1,0,1,1,0.3901668515136753,0.0
689,3,210,25,88,80,1,2866.639,74,2208.019,LESS,818,860,1678,3,2,-8.0,-0.7499267685395902,8.0,-0.17460757394239454,0.5703745219098523,-0.4035159093277373,168,88,80,0,0.1595602198545883,0.31213348121094026,0.0,0.3043851503620085,0.519598499643576,0.519598499643576,0.0,0.31213348121094026,1,1,1,1,0.31213348121094026,0.0
690,3,211,36,80,70,1,4461.154,24,1265.066,LESS,722,1442,2164,4,1,-10.0,-0.9374084606744876,10.0,0.17460757394239454,-2.1413902415284314,0.5561295120677591,150,80,70,0,-0.19945027481823535,0.0,-0.3901668515136753,1.0898952158123527,0.4300540965156271,0.4300540965156271,-0.3901668515136753,0.0,0,1,1,1,0.0,-0.3901668515136753
691,3,212,28,80,93,0,1790.7120000000002,34,1075.205,LESS,-180,722,542,2,1,13.0,1.218630998876834,13.0,0.6984302957695783,-1.599037288840775,-1.051053511235397,173,80,93,1,0.25928535726370594,0.0,0.5072169069677779,-0.48112491508833566,-0.41129019120739196,0.41129019120739196,0.5072169069677779,0.0,0,0,0,1,0.5072169069677779,0.0
692,3,213,21,82,80,1,3086.176,74,1783.226,LESS,2194,872,3066,3,2,-2.0,-0.18748169213489754,2.0,-1.222253017596762,0.5703745219098523,-0.2713894151417918,162,82,80,0,0.03989005496364707,0.07803337030273506,0.0,0.3043851503620085,1.8030682778108422,1.8030682778108422,0.0,0.07803337030273506,1,1,1,1,0.07803337030273506,0.0
693,3,214,19,50,41,1,2421.588,84,1955.117,LESS,912,492,1404,1,2,-9.0,-0.8436676146070391,9.0,0.0,1.112727474597509,-0.6713661048025286,91,50,41,0,-1.376206896245824,-1.170500554541026,-1.5216507209033339,-1.2666349805386798,0.6072773943730259,0.6072773943730259,-1.5216507209033339,-1.170500554541026,1,0,1,0,-1.170500554541026,-1.5216507209033339
694,3,215,56,96,110,0,5495.088000000002,74,694.074,LESS,-712,2462,1750,3,1,14.0,1.3123718449442827,14.0,0.8730378697119728,0.5703745219098523,1.1783939806523331,206,96,110,1,0.9174712641638826,0.6242669624218805,1.170500554541026,0.3043851503620085,-0.9075154252081082,0.9075154252081082,1.170500554541026,0.6242669624218805,1,1,0,2,1.170500554541026,0.6242669624218805
695,3,216,23,80,85,1,7992.571,54,1763.0379999999998,LESS,908,1574,2482,5,2,5.0,0.4687042303372438,5.0,-0.6984302957695783,-0.5143313834654613,2.6814830867210038,165,80,85,1,0.09972513740911768,0.0,0.19508342575683765,1.875405281262697,0.6035463775760279,0.6035463775760279,0.19508342575683765,0.0,0,1,1,1,0.19508342575683765,0.0
696,3,217,10,60,50,0,1895.259,100,1574.092,LESS,770,894,1664,2,2,-10.0,-0.9374084606744876,10.0,0.17460757394239454,1.98049219889776,-0.9881327799342584,110,60,50,0,-0.9972513740911768,-0.7803337030273506,-1.170500554541026,-0.48112491508833566,0.47482629807960147,0.47482629807960147,-1.170500554541026,-0.7803337030273506,1,0,1,0,-0.7803337030273506,-1.170500554541026
697,3,218,19,41,50,0,1717.5279999999998,84,2354.4410000000007,LESS,342,980,1322,2,1,9.0,0.8436676146070391,9.0,0.0,1.112727474597509,-1.0950986851719284,91,41,50,1,-1.376206896245824,-1.5216507209033339,-1.170500554541026,-0.48112491508833566,0.0756075008008297,0.0756075008008297,-1.170500554541026,-1.5216507209033339,1,0,1,0,-1.5216507209033339,-1.170500554541026
698,3,219,56,110,96,0,5673.799,34,2130.811,LESS,-344,2320,1976,5,1,-14.0,-1.3123718449442827,14.0,0.8730378697119728,-1.599037288840775,1.285949690634998,206,110,96,0,0.9174712641638826,1.170500554541026,0.6242669624218805,1.875405281262697,-0.5642618798843044,0.5642618798843044,0.6242669624218805,1.170500554541026,0,1,0,2,1.170500554541026,0.6242669624218805
699,3,220,35,72,80,0,1735.755,64,2372.104,LESS,-710,1188,478,2,1,8.0,0.7499267685395902,8.0,-0.17460757394239454,0.028021569222195543,-1.0841289187565757,152,72,80,1,-0.1595602198545883,-0.31213348121094026,0.0,-0.48112491508833566,-0.9056499168096093,0.9056499168096093,0.0,-0.31213348121094026,0,0,0,1,-0.31213348121094026,0.0
700,3,221,11,49,50,0,1521.761,74,2239.381,LESS,-378,744,366,1,1,1.0,0.09374084606744876,1.0,-1.3968605915391563,0.5703745219098523,-1.2129194050838337,99,49,50,1,-1.2166466763912356,-1.2095172396923934,-1.170500554541026,-1.2666349805386798,-0.5959755226587863,0.5959755226587863,-1.170500554541026,-1.2095172396923934,1,0,0,0,-1.2095172396923934,-1.170500554541026
701,3,222,17,43,50,0,1839.842,64,1914.332,LESS,-478,912,434,2,1,7.0,0.6561859224721414,7.0,-0.34921514788478913,0.028021569222195543,-1.0214850345806394,93,43,50,1,-1.3363168412821769,-1.4436173506005987,-1.170500554541026,-0.48112491508833566,-0.689250942583733,0.689250942583733,-1.170500554541026,-1.4436173506005987,0,0,0,0,-1.4436173506005987,-1.170500554541026
702,3,223,1,51,50,0,2040.446,64,2298.321,LESS,1302,778,2080,3,2,-1.0,-0.09374084606744876,1.0,-1.3968605915391563,0.028021569222195543,-0.9007532069630744,101,51,50,0,-1.1767566214275886,-1.1314838693896585,-1.170500554541026,0.3043851503620085,0.9710515320803178,0.9710515320803178,-1.170500554541026,-1.1314838693896585,0,1,1,0,-1.1314838693896585,-1.170500554541026
703,3,224,41,112,110,0,3775.151,64,2183.401,LESS,-786,1800,1014,4,1,-2.0,-0.18748169213489754,2.0,-1.222253017596762,0.028021569222195543,0.1432643850457021,222,112,110,0,1.2365917038730592,1.248533924843761,1.170500554541026,1.0898952158123527,-0.9765392359525688,0.9765392359525688,1.170500554541026,1.248533924843761,0,1,0,2,1.248533924843761,1.170500554541026
704,3,225,20,40,50,1,4915.3420000000015,74,1552.67,LESS,2028,1584,3612,5,2,10.0,0.9374084606744876,10.0,0.17460757394239454,0.5703745219098523,0.8294787340272756,90,40,50,1,-1.3961519237276474,-1.5606674060547012,-1.170500554541026,1.875405281262697,1.6482310807354308,1.6482310807354308,-1.170500554541026,-1.5606674060547012,1,1,1,0,-1.5606674060547012,-1.170500554541026
705,3,226,1,50,51,0,1945.35,64,1462.16,LESS,922,636,1558,2,2,1.0,0.09374084606744876,1.0,-1.3968605915391563,0.028021569222195543,-0.9579859335244588,101,50,51,1,-1.1767566214275886,-1.170500554541026,-1.1314838693896585,-0.48112491508833566,0.6166049363655205,0.6166049363655205,-1.1314838693896585,-1.170500554541026,0,0,1,0,-1.170500554541026,-1.1314838693896585
706,3,227,23,85,80,1,2987.0490000000004,34,438.105,LESS,1136,866,2002,3,2,-5.0,-0.4687042303372438,5.0,-0.6984302957695783,-1.599037288840775,-0.3310481650981553,165,85,80,0,0.09972513740911768,0.19508342575683765,0.0,0.3043851503620085,0.8162143350049064,0.8162143350049064,0.0,0.19508342575683765,0,1,1,1,0.19508342575683765,0.0
707,3,228,11,50,49,1,2836.683,64,2155.881,LESS,1208,638,1846,3,2,-1.0,-0.09374084606744876,1.0,-1.3968605915391563,0.028021569222195543,-0.4215446755941717,99,50,49,0,-1.2166466763912356,-1.170500554541026,-1.2095172396923934,0.3043851503620085,0.883372637350868,0.883372637350868,-1.2095172396923934,-1.170500554541026,0,1,1,0,-1.170500554541026,-1.2095172396923934
708,3,229,17,50,43,0,3238.171,64,2482.647,LESS,-254,1222,968,4,1,-7.0,-0.6561859224721414,7.0,-0.34921514788478913,0.028021569222195543,-0.17991250471761372,93,50,43,0,-1.3363168412821769,-1.170500554541026,-1.4436173506005987,1.0898952158123527,-0.4803140019518524,0.4803140019518524,-1.4436173506005987,-1.170500554541026,0,1,0,0,-1.170500554541026,-1.4436173506005987
709,3,230,21,80,82,0,3324.511,64,2010.851,LESS,-536,1066,530,2,1,2.0,0.18748169213489754,2.0,-1.222253017596762,0.028021569222195543,-0.127949503000297,162,80,82,1,0.03989005496364707,0.0,0.07803337030273506,-0.48112491508833566,-0.743350686140202,0.743350686140202,0.07803337030273506,0.0,0,0,0,1,0.07803337030273506,0.0
710,3,231,10,50,60,0,1673.779,64,2594.459,LESS,94,666,760,2,2,10.0,0.9374084606744876,10.0,0.17460757394239454,0.028021569222195543,-1.1214286523033954,110,50,60,1,-0.9972513740911768,-1.170500554541026,-0.7803337030273506,-0.48112491508833566,-0.15571554061303805,0.15571554061303805,-0.7803337030273506,-1.170500554541026,0,0,1,0,-1.170500554541026,-0.7803337030273506
711,3,232,3,53,50,1,4260.273,54,2178.278,LESS,1224,1474,2698,6,1,-3.0,-0.28122253820234633,3.0,-1.0476454436543674,-0.5143313834654613,0.4352309743334957,103,53,50,0,-1.1368665664639415,-1.0534504990869233,-1.170500554541026,2.660915346713041,0.8982967045388595,0.8982967045388595,-1.170500554541026,-1.0534504990869233,0,1,1,0,-1.0534504990869233,-1.170500554541026
712,3,233,45,122,110,1,3245.341,64,2896.612,LESS,854,788,1642,3,2,-12.0,-1.124890152809385,12.0,0.5238227218271837,0.028021569222195543,-0.17559730061391712,232,122,110,0,1.4360419786912946,1.6387007763574364,1.170500554541026,0.3043851503620085,0.5531776508165568,0.5531776508165568,1.170500554541026,1.6387007763574364,0,1,1,2,1.6387007763574364,1.170500554541026
713,3,234,38,67,80,0,2464.32,54,1865.773,LESS,-902,1430,528,2,1,13.0,1.218630998876834,13.0,0.6984302957695783,-0.5143313834654613,-0.645648210554389,147,67,80,1,-0.25928535726370594,-0.5072169069677779,0.0,-0.48112491508833566,-1.084738723065507,1.084738723065507,0.0,-0.5072169069677779,0,0,0,1,-0.5072169069677779,0.0
714,3,235,38,80,67,1,3971.055,74,1965.186,LESS,1282,756,2038,3,2,-13.0,-1.218630998876834,13.0,0.6984302957695783,0.5703745219098523,0.2611675572535918,147,80,67,0,-0.25928535726370594,0.0,-0.5072169069677779,0.3043851503620085,0.9523964480953285,0.9523964480953285,-0.5072169069677779,0.0,1,1,1,1,0.0,-0.5072169069677779
715,3,236,36,70,80,0,4124.874,44,2985.083,LESS,504,1674,2178,4,2,10.0,0.9374084606744876,10.0,0.17460757394239454,-1.056684336153118,0.35374222671335465,150,70,80,1,-0.19945027481823535,-0.3901668515136753,0.0,1.0898952158123527,0.2267136810792433,0.2267136810792433,0.0,-0.3901668515136753,0,1,1,1,-0.3901668515136753,0.0
716,3,237,45,110,122,0,3063.151,64,2776.515,LESS,-294,1234,940,4,1,12.0,1.124890152809385,12.0,0.5238227218271837,0.028021569222195543,-0.2852468174413195,232,110,122,1,1.4360419786912946,1.170500554541026,1.6387007763574364,1.0898952158123527,-0.5176241699218311,0.5176241699218311,1.6387007763574364,1.170500554541026,0,1,0,2,1.6387007763574364,1.170500554541026
717,3,238,42,110,115,0,2784.731,64,1489.454,LESS,268,1194,1462,4,2,5.0,0.4687042303372438,5.0,-0.6984302957695783,0.028021569222195543,-0.4528115491778874,225,110,115,1,1.2964267863185297,1.170500554541026,1.3655839802978638,1.0898952158123527,0.006583690056369156,0.006583690056369156,1.3655839802978638,1.170500554541026,1,1,1,2,1.3655839802978638,1.170500554541026
718,3,239,41,110,112,0,2274.323,34,1716.964,LESS,-90,810,720,1,2,2.0,0.18748169213489754,2.0,-1.222253017596762,-1.599037288840775,-0.7599963045697355,222,110,112,1,1.2365917038730592,1.170500554541026,1.248533924843761,-1.2666349805386798,-0.32734231327493996,0.32734231327493996,1.248533924843761,1.170500554541026,0,0,0,2,1.248533924843761,1.170500554541026
719,3,240,53,110,103,1,3210.26,44,2620.281,LESS,674,868,1542,3,2,-7.0,-0.6561859224721414,7.0,-0.34921514788478913,-1.056684336153118,-0.19671050496005066,213,110,103,0,1.0570864565366473,1.170500554541026,0.8973837584814532,0.3043851503620085,0.38528189495165266,0.38528189495165266,0.8973837584814532,1.170500554541026,0,1,1,2,1.170500554541026,0.8973837584814532
720,4,1,49,110,131,0,14824.897,44,1530.58,LESS,-1953,7328,5375,9,1,21.0,1.9685577674164243,21.0,2.0952908873087353,-1.4331881648574871,1.5148014302629296,241,110,131,1,1.6155472260277064,1.170500554541026,1.9898509427197442,1.6327519617069293,-1.9474808275125441,1.9474808275125441,1.9898509427197442,1.170500554541026,0,1,0,2,1.9898509427197442,1.170500554541026
721,4,2,13,47,50,1,2083.157,24,3022.3520000000008,LESS,-610,1601,991,1,1,3.0,0.28122253820234633,3.0,-1.0476454436543674,-2.3555940633981067,-0.7292298928918934,97,47,50,1,-1.2565367313548828,-1.2875506099951286,-1.170500554541026,-1.17628367133725,-0.745395707796881,0.745395707796881,-1.170500554541026,-1.2875506099951286,0,0,0,0,-1.2875506099951286,-1.170500554541026
722,4,3,16,50,44,0,9357.174,24,2561.157,LESS,-312,4269,3957,8,1,-6.0,-0.5624450764046927,6.0,-0.5238227218271837,-2.3555940633981067,0.5518449048328031,94,50,44,0,-1.3163718138003533,-1.170500554541026,-1.4046006654492311,1.281622507576407,-0.4786634921042022,0.4786634921042022,-1.4046006654492311,-1.170500554541026,0,1,0,0,-1.170500554541026,-1.4046006654492311
723,4,4,7,57,50,0,2825.048,24,1130.726,LESS,-482,1793,1311,4,1,-7.0,-0.6561859224721414,7.0,-0.34921514788478913,-2.3555940633981067,-0.5985706075535759,107,57,50,0,-1.0570864565366473,-0.8973837584814532,-1.170500554541026,-0.12289530894568271,-0.6308261654859317,0.6308261654859317,-1.170500554541026,-0.8973837584814532,0,0,0,0,-0.8973837584814532,-1.170500554541026
724,4,5,18,42,50,0,1900.572,94,1804.716,LESS,575,1174,1749,2,2,8.0,0.7499267685395902,8.0,-0.17460757394239454,0.8728265814940609,-0.7613861336516502,92,42,50,1,-1.3562618687640005,-1.4826340357519663,-1.170500554541026,-0.8251542172067275,0.31526763312870393,0.31526763312870393,-1.170500554541026,-1.4826340357519663,1,0,1,0,-1.4826340357519663,-1.170500554541026
725,4,6,51,108,110,0,4876.995,54,2334.397,LESS,10,2688,2698,5,2,2.0,0.18748169213489754,2.0,-1.222253017596762,-0.9719852155871778,-0.2371887757587372,218,108,110,1,1.156811593945765,1.092467184238291,1.170500554541026,0.22823414518483967,-0.19044948722822055,0.19044948722822055,1.170500554541026,1.092467184238291,0,1,1,2,1.170500554541026,1.092467184238291
726,4,7,31,78,80,0,1821.439,100,3741.038,LESS,-1175,2270,1095,2,2,2.0,0.18748169213489754,2.0,-1.222253017596762,1.1495483510562468,-0.7753227648099701,158,78,80,1,-0.03989005496364707,-0.07803337030273506,0.0,-0.8251542172067275,-1.2511128281538055,1.2511128281538055,0.0,-0.07803337030273506,1,0,0,1,-0.07803337030273506,0.0
727,4,8,58,110,92,1,7493.308000000001,34,2644.093,LESS,-553,3221,2668,4,1,-18.0,-1.6873352292140782,18.0,1.571468165481551,-1.8943911141277967,0.22358725037090965,202,110,92,0,0.8376911542365885,1.170500554541026,0.4682002218164104,-0.12289530894568271,-0.6943764584865364,0.6943764584865364,0.4682002218164104,1.170500554541026,0,0,0,2,1.170500554541026,0.4682002218164104
728,4,9,12,50,48,0,4593.317,54,2363.908,LESS,-620,2250,1630,6,1,-2.0,-0.18748169213489754,2.0,-1.222253017596762,-0.9719852155871778,-0.287149167172305,98,50,48,0,-1.2365917038730592,-1.170500554541026,-1.248533924843761,0.5793635993153621,-0.7543464532899239,0.7543464532899239,-1.248533924843761,-1.170500554541026,0,1,0,0,-1.170500554541026,-1.248533924843761
729,4,10,54,110,101,0,2388.264,54,3199.133,LESS,-387,1458,1071,3,1,-9.0,-0.8436676146070391,9.0,0.0,-0.9719852155871778,-0.6754954998722746,211,110,101,0,1.0171964015730004,1.170500554541026,0.8193503881787182,-0.4740247630762051,-0.5457940833020241,0.5457940833020241,0.8193503881787182,1.170500554541026,0,0,0,2,1.170500554541026,0.8193503881787182
730,4,11,14,46,50,0,4057.351,94,2576.55,LESS,-281,2393,2112,4,2,4.0,0.3749633842697951,4.0,-0.8730378697119728,0.8728265814940609,-0.38154165141276175,96,46,50,1,-1.2764817588367063,-1.3265672951464962,-1.170500554541026,-0.12289530894568271,-0.45091618107576925,0.45091618107576925,-1.170500554541026,-1.3265672951464962,1,0,0,0,-1.3265672951464962,-1.170500554541026
731,4,12,22,80,83,0,3000.593,44,1497.269,LESS,-1314,1982,668,2,1,3.0,0.28122253820234633,3.0,-1.0476454436543674,-1.4331881648574871,-0.5676542273242499,163,80,83,1,0.05983508244547061,0.0,0.1170500554541026,-0.8251542172067275,-1.375528190507102,1.375528190507102,0.1170500554541026,0.0,0,0,0,1,0.1170500554541026,0.0
732,4,13,6,50,56,0,3201.176,100,3448.166,LESS,463,1783,2246,2,2,6.0,0.5624450764046927,6.0,-0.5238227218271837,1.1495483510562468,-0.5323282408504744,106,50,56,1,-1.077031484018471,-1.170500554541026,-0.9364004436328208,-0.8251542172067275,0.2150192836066233,0.2150192836066233,-0.9364004436328208,-1.170500554541026,1,0,1,0,-1.170500554541026,-0.9364004436328208
733,4,14,13,50,47,0,8467.339,54,1834.319,LESS,531,3761,4292,7,2,-3.0,-0.28122253820234633,3.0,-1.0476454436543674,-0.9719852155871778,0.3951302322339687,97,50,47,0,-1.2565367313548828,-1.170500554541026,-1.2875506099951286,0.9304930534458845,0.2758843529593151,0.2758843529593151,-1.2875506099951286,-1.170500554541026,0,1,1,0,-1.170500554541026,-1.2875506099951286
734,4,15,46,110,124,0,15422.37,100,1283.064,LESS,57,6739,6796,8,2,14.0,1.3123718449442827,14.0,0.8730378697119728,1.1495483510562468,1.620026315305261,234,110,124,1,1.4759320336549415,1.170500554541026,1.7167341466601715,1.281622507576407,-0.14838098341091888,0.14838098341091888,1.7167341466601715,1.170500554541026,1,1,1,2,1.7167341466601715,1.170500554541026
735,4,16,27,91,80,0,22416.61,54,1533.115,LESS,-2411,10582,8171,7,2,-11.0,-1.0311493067419364,11.0,0.34921514788478913,-0.9719852155871778,2.8518277522881528,171,91,80,0,0.21939530230005888,0.4291835366650429,0.0,0.9304930534458845,-2.3574249710939092,2.3574249710939092,0.0,0.4291835366650429,0,1,0,1,0.4291835366650429,0.0
736,4,17,40,64,80,0,2357.467,100,1297.533,LESS,-301,1493,1192,2,2,16.0,1.4998535370791803,16.0,1.222253017596762,1.1495483510562468,-0.680919361343251,144,64,80,1,-0.3191204397091766,-0.6242669624218805,0.0,-0.8251542172067275,-0.46881767206185504,0.46881767206185504,0.0,-0.6242669624218805,1,0,0,1,-0.6242669624218805,0.0
737,4,18,22,83,80,1,19852.526,4,1919.425,LESS,-228,8911,8683,14,1,-3.0,-0.28122253820234633,3.0,-1.0476454436543674,-3.2779999619387263,2.400250117585192,163,83,80,0,0.05983508244547061,0.1170500554541026,0.0,3.388399232359541,-0.4034772299626418,0.4034772299626418,0.0,0.1170500554541026,0,1,0,1,0.1170500554541026,0.0
738,4,19,54,101,110,1,14929.605,44,1996.82,LESS,1529,5437,6966,8,2,9.0,0.8436676146070391,9.0,0.0,-1.4331881648574871,1.5332422422544545,211,101,110,1,1.0171964015730004,0.8193503881787182,1.170500554541026,1.281622507576407,1.1691687531649975,1.1691687531649975,1.170500554541026,0.8193503881787182,0,1,1,2,1.170500554541026,0.8193503881787182
739,4,20,6,56,50,1,6802.71,54,1100.304,LESS,669,2482,3151,5,2,-6.0,-0.5624450764046927,6.0,-0.5238227218271837,-0.9719852155871778,0.10196151136602677,106,56,50,0,-1.077031484018471,-0.9364004436328208,-1.170500554541026,0.22823414518483967,0.39940464076330734,0.39940464076330734,-1.170500554541026,-0.9364004436328208,0,1,1,0,-0.9364004436328208,-1.170500554541026
740,4,21,18,50,42,1,5623.276,64,1561.025,LESS,89,2407,2496,7,2,-8.0,-0.7499267685395902,8.0,-0.17460757394239454,-0.5107822663168681,-0.1057563387544266,92,50,42,0,-1.3562618687640005,-1.170500554541026,-1.4826340357519663,0.9304930534458845,-0.11973859783318155,0.11973859783318155,-1.4826340357519663,-1.170500554541026,0,1,1,0,-1.170500554541026,-1.4826340357519663
741,4,22,43,110,117,0,8088.222,54,2527.484,LESS,-186,3518,3332,6,1,7.0,0.6561859224721414,7.0,-0.34921514788478913,-0.9719852155871778,0.32836145315509185,227,110,117,1,1.3363168412821769,1.170500554541026,1.4436173506005987,0.5793635993153621,-0.3658840988918616,0.3658840988918616,1.4436173506005987,1.170500554541026,0,1,0,2,1.4436173506005987,1.170500554541026
742,4,23,32,77,80,0,8348.753,44,1847.758,LESS,2973,1988,4961,3,1,3.0,0.28122253820234633,3.0,-1.0476454436543674,-1.4331881648574871,0.3742452747252111,157,77,80,1,-0.05983508244547061,-0.1170500554541026,0.0,-0.4740247630762051,2.461656402360394,2.461656402360394,0.0,-0.1170500554541026,0,0,1,1,-0.1170500554541026,0.0
743,4,24,27,80,91,0,2068.719,94,2033.362,LESS,-827,1386,559,2,1,11.0,1.0311493067419364,11.0,0.34921514788478913,0.8728265814940609,-0.7317726636785921,171,80,91,1,0.21939530230005888,0.0,0.4291835366650429,-0.8251542172067275,-0.9396268849959123,0.9396268849959123,0.4291835366650429,0.0,1,0,0,1,0.4291835366650429,0.0
744,4,25,16,44,50,0,2864.606,74,1149.124,LESS,-261,1344,1083,3,1,6.0,0.5624450764046927,6.0,-0.5238227218271837,-0.04957931704655842,-0.5916037889651132,94,44,50,1,-1.3163718138003533,-1.4046006654492311,-1.170500554541026,-0.4740247630762051,-0.4330146900896834,0.4330146900896834,-1.170500554541026,-1.4046006654492311,1,0,0,0,-1.4046006654492311,-1.170500554541026
745,4,26,7,50,57,0,1555.129,74,1582.205,LESS,-144,866,722,2,2,7.0,0.6561859224721414,7.0,-0.34921514788478913,-0.04957931704655842,-0.8222243639376686,107,50,57,1,-1.0570864565366473,-1.170500554541026,-0.8973837584814532,-0.8251542172067275,-0.32829096782108136,0.32829096782108136,-0.8973837584814532,-1.170500554541026,1,0,0,0,-1.170500554541026,-0.8973837584814532
746,4,27,14,50,46,0,2010.556,74,1388.0739999999996,LESS,-781,1318,537,2,1,-4.0,-0.3749633842697951,4.0,-0.8730378697119728,-0.04957931704655842,-0.7420161307285127,96,50,46,0,-1.2764817588367063,-1.170500554541026,-1.3265672951464962,-0.8251542172067275,-0.8984534557279148,0.8984534557279148,-1.3265672951464962,-1.170500554541026,1,0,0,0,-1.170500554541026,-1.3265672951464962
747,4,28,51,110,108,0,25299.521,84,1577.0929999999996,LESS,1691,9624,11315,15,1,-2.0,-0.18748169213489754,2.0,-1.222253017596762,0.4116236322237513,3.359556099112652,218,110,108,0,1.156811593945765,1.170500554541026,1.092467184238291,3.7395286864900634,1.3141708301522927,1.3141708301522927,1.092467184238291,1.170500554541026,1,1,1,2,1.170500554541026,1.092467184238291
748,4,29,50,133,110,0,1996.359,64,1357.119,LESS,-329,1355,1026,2,2,-23.0,-2.1560394595513217,23.0,2.444506035193524,-0.5107822663168681,-0.7445164574260303,243,133,110,0,1.6554372809913533,2.0678843130224793,1.170500554541026,-0.8251542172067275,-0.4938797594423752,0.4938797594423752,1.170500554541026,2.0678843130224793,0,0,0,2,2.0678843130224793,1.170500554541026
749,4,30,49,131,110,1,15235.493,74,2031.344,LESS,-13,6354,6341,14,1,-21.0,-1.9685577674164243,21.0,2.0952908873087353,-0.04957931704655842,1.5871141823016677,241,131,110,0,1.6155472260277064,1.9898509427197442,1.170500554541026,3.388399232359541,-0.21103620186221925,0.21103620186221925,1.170500554541026,1.9898509427197442,1,1,1,2,1.9898509427197442,1.170500554541026
750,4,31,47,126,110,1,9458.254,94,1320.76,LESS,687,3570,4257,6,2,-16.0,-1.4998535370791803,16.0,1.222253017596762,0.8728265814940609,0.5696467659714302,236,126,110,0,1.5158220886185887,1.7947675169629065,1.170500554541026,0.5793635993153621,0.41551598265078454,0.41551598265078454,1.170500554541026,1.7947675169629065,1,1,1,2,1.7947675169629065,1.170500554541026
751,4,32,50,110,133,0,1876.74,84,2989.532,LESS,-887,1551,664,2,2,23.0,2.1560394595513217,23.0,2.444506035193524,0.4116236322237513,-0.7655833433336424,243,110,133,1,1.6554372809913533,1.170500554541026,2.0678843130224793,-0.8251542172067275,-0.9933313579541697,0.9933313579541697,2.0678843130224793,1.170500554541026,1,0,0,2,2.0678843130224793,1.170500554541026
752,4,33,47,110,126,0,6732.502,84,1920.56,LESS,-985,3398,2413,4,2,16.0,1.4998535370791803,16.0,1.222253017596762,0.4116236322237513,0.0895967204398226,236,110,126,1,1.5158220886185887,1.170500554541026,1.7947675169629065,-0.12289530894568271,-1.0810486637859902,1.0810486637859902,1.7947675169629065,1.170500554541026,1,1,0,2,1.7947675169629065,1.170500554541026
753,4,34,12,48,50,0,1564.586,100,1156.133,LESS,-63,862,799,2,2,2.0,0.18748169213489754,2.0,-1.222253017596762,1.1495483510562468,-0.8205588296995602,98,48,50,1,-1.2365917038730592,-1.248533924843761,-1.170500554541026,-0.8251542172067275,-0.2557899293274338,0.2557899293274338,-1.170500554541026,-1.248533924843761,1,0,1,0,-1.248533924843761,-1.170500554541026
754,4,35,32,80,77,0,10629.362,24,1964.181,LESS,-389,4885,4496,10,1,-3.0,-0.28122253820234633,3.0,-1.0476454436543674,-2.3555940633981067,0.7758982696747858,157,80,77,0,-0.05983508244547061,0.0,-0.1170500554541026,1.9838814158374516,-0.5475842324006327,0.5475842324006327,-0.1170500554541026,0.0,0,1,0,1,0.0,-0.1170500554541026
755,4,36,43,117,110,1,9460.517,54,1720.961,LESS,1802,3080,4882,7,2,-7.0,-0.6561859224721414,7.0,-0.34921514788478913,-0.9719852155871778,0.5700453177300046,227,117,110,0,1.3363168412821769,1.4436173506005987,1.170500554541026,0.9304930534458845,1.413524105125069,1.413524105125069,1.170500554541026,1.4436173506005987,0,1,1,2,1.4436173506005987,1.170500554541026
756,4,37,40,80,64,1,7210.473000000001,74,846.1289999999998,LESS,-570,3105,2535,6,2,-16.0,-1.4998535370791803,16.0,1.222253017596762,-0.04957931704655842,0.1737753252111988,144,80,64,0,-0.3191204397091766,0.0,-0.6242669624218805,0.5793635993153621,-0.7095927258247093,0.7095927258247093,-0.6242669624218805,0.0,0,1,0,1,0.0,-0.6242669624218805
757,4,38,31,80,78,0,6251.048000000002,14,469.319,LESS,-1528,3165,1637,5,2,-2.0,-0.18748169213489754,2.0,-1.222253017596762,-2.8167970126684163,0.004804701715678221,158,80,78,0,-0.03989005496364707,0.0,-0.07803337030273506,0.22823414518483967,-1.5670741440582203,1.5670741440582203,-0.07803337030273506,0.0,0,1,0,1,0.0,-0.07803337030273506
758,4,39,46,124,110,0,6443.423000000002,74,859.105,LESS,-478,2547,2069,3,1,-14.0,-1.3123718449442827,14.0,0.8730378697119728,-0.04957931704655842,0.038685123525565177,234,124,110,0,1.4759320336549415,1.7167341466601715,1.170500554541026,-0.4740247630762051,-0.6272458672887146,0.6272458672887146,1.170500554541026,1.7167341466601715,0,0,0,2,1.7167341466601715,1.170500554541026
759,4,40,58,92,110,0,2842.802,64,2023.994,LESS,-2295,3459,1164,2,1,18.0,1.6873352292140782,18.0,1.571468165481551,-0.5107822663168681,-0.595443834278396,202,92,110,1,0.8376911542365885,0.4682002218164104,1.170500554541026,-0.8251542172067275,-2.2535963233746115,2.2535963233746115,1.170500554541026,0.4682002218164104,0,0,0,2,1.170500554541026,0.4682002218164104
760,4,41,49,110,131,1,3753.06,94,2603.975,MORE,578,1521,2099,3,2,21.0,1.9685577674164243,21.0,2.0952908873087353,0.8728265814940609,-0.4351323333254443,241,110,131,0,1.6155472260277064,1.170500554541026,1.9898509427197442,-0.4740247630762051,0.31795285677661683,0.31795285677661683,1.9898509427197442,1.170500554541026,1,0,1,2,1.9898509427197442,1.170500554541026
761,4,42,13,47,50,1,2852.768,74,2179.56,MORE,-306,1519,1213,3,1,3.0,0.28122253820234633,3.0,-1.0476454436543674,-0.04957931704655842,-0.593688656715005,97,47,50,0,-1.2565367313548828,-1.2875506099951286,-1.170500554541026,-0.4740247630762051,-0.47329304480837653,0.47329304480837653,-1.170500554541026,-1.2875506099951286,0,1,0,0,-1.2875506099951286,-1.170500554541026
762,4,43,16,50,44,1,7578.4540000000015,64,1990.795,MORE,-417,3789,3372,9,2,-6.0,-0.5624450764046927,6.0,-0.5238227218271837,-0.5107822663168681,0.23858287036012166,94,50,44,1,-1.3163718138003533,-1.170500554541026,-1.4046006654492311,1.6327519617069293,-0.5726463197811528,0.5726463197811528,-1.4046006654492311,-1.170500554541026,0,1,0,0,-1.170500554541026,-1.4046006654492311
763,4,44,7,57,50,0,19368.146,44,2046.833,MORE,638,8096,8734,18,1,-7.0,-0.6561859224721414,7.0,-0.34921514788478913,-1.4331881648574871,2.3149427818280865,107,57,50,1,-1.0570864565366473,-0.8973837584814532,-1.170500554541026,4.79291704888163,0.3716573297348743,0.3716573297348743,-1.170500554541026,-0.8973837584814532,0,1,1,0,-0.8973837584814532,-1.170500554541026
764,4,45,18,42,50,1,3215.312,94,1982.622,MORE,732,1194,1926,3,2,8.0,0.7499267685395902,8.0,-0.17460757394239454,0.8728265814940609,-0.5298386572626664,92,42,50,0,-1.3562618687640005,-1.4826340357519663,-1.170500554541026,-0.4740247630762051,0.45579433736947766,0.45579433736947766,-1.170500554541026,-1.4826340357519663,1,0,1,0,-1.4826340357519663,-1.170500554541026
765,4,46,51,108,110,1,1942.017,94,1754.971,MORE,331,945,1276,3,2,2.0,0.18748169213489754,2.0,-1.222253017596762,0.8728265814940609,-0.7540869831283975,218,108,110,0,1.156811593945765,1.092467184238291,1.170500554541026,-0.4740247630762051,0.0968694430984569,0.0968694430984569,1.170500554541026,1.092467184238291,1,0,0,2,1.170500554541026,1.092467184238291
766,4,47,31,78,80,1,1587.571,94,2189.131,MORE,603,667,1270,2,2,2.0,0.18748169213489754,2.0,-1.222253017596762,0.8728265814940609,-0.8165107907376357,158,78,80,0,-0.03989005496364707,-0.07803337030273506,0.0,-0.8251542172067275,0.3403297205092241,0.3403297205092241,0.0,-0.07803337030273506,1,0,1,1,-0.07803337030273506,0.0
767,4,48,58,110,92,0,2246.732,94,1705.271,MORE,94,1278,1372,2,2,-18.0,-1.6873352292140782,18.0,1.571468165481551,0.8728265814940609,-0.7004216277974048,202,110,92,1,0.8376911542365885,1.170500554541026,0.4682002218164104,-0.8251542172067275,-0.11526322508666009,0.11526322508666009,0.4682002218164104,1.170500554541026,1,0,0,2,1.170500554541026,0.4682002218164104
768,4,49,12,50,48,0,2550.21,84,1317.8010000000004,MORE,-55,1322,1267,4,2,-2.0,-0.18748169213489754,2.0,-1.222253017596762,0.4116236322237513,-0.6469741286420007,98,50,48,1,-1.2365917038730592,-1.170500554541026,-1.248533924843761,-0.12289530894568271,-0.24862933293299944,0.24862933293299944,-1.248533924843761,-1.170500554541026,0,1,0,0,-1.170500554541026,-1.248533924843761
769,4,50,54,110,101,1,5602.05,34,1297.772,MORE,654,2152,2806,5,2,-9.0,-0.8436676146070391,9.0,0.0,-1.8943911141277967,-0.10949458870029613,211,110,101,1,1.0171964015730004,1.170500554541026,0.8193503881787182,0.22823414518483967,0.38597852252374293,0.38597852252374293,0.8193503881787182,1.170500554541026,0,1,1,2,1.170500554541026,0.8193503881787182
770,4,51,14,46,50,1,1793.4820000000002,74,1285.286,MORE,291,939,1230,3,2,4.0,0.3749633842697951,4.0,-0.8730378697119728,-0.04957931704655842,-0.7802464552715115,96,46,50,0,-1.2764817588367063,-1.3265672951464962,-1.170500554541026,-0.4740247630762051,0.061066461126285256,0.061066461126285256,-1.170500554541026,-1.3265672951464962,0,0,0,0,-1.3265672951464962,-1.170500554541026
771,4,52,22,80,83,1,5781.335,84,981.986,MORE,-1898,3696,1798,5,2,3.0,0.28122253820234633,3.0,-1.0476454436543674,0.4116236322237513,-0.07791953256417875,163,80,83,0,0.05983508244547061,0.0,0.1170500554541026,0.22823414518483967,-1.898251727300808,1.898251727300808,0.1170500554541026,0.0,0,1,0,1,0.1170500554541026,0.0
772,4,53,6,50,56,1,1880.978,94,2257.368,MORE,306,921,1227,3,2,6.0,0.5624450764046927,6.0,-0.5238227218271837,0.8728265814940609,-0.7648369613836473,106,50,56,0,-1.077031484018471,-1.170500554541026,-0.9364004436328208,-0.4740247630762051,0.07449257936584962,0.07449257936584962,-0.9364004436328208,-1.170500554541026,1,1,0,0,-1.170500554541026,-0.9364004436328208
773,4,54,13,50,47,1,3078.1020000000008,94,6016.719,MORE,1702,1244,2946,4,2,-3.0,-0.28122253820234633,3.0,-1.0476454436543674,0.8728265814940609,-0.5540036094473815,97,50,47,1,-1.2565367313548828,-1.170500554541026,-1.2875506099951286,-0.12289530894568271,1.32401665019464,1.32401665019464,-1.2875506099951286,-1.170500554541026,1,1,1,0,-1.170500554541026,-1.2875506099951286
774,4,55,46,110,124,1,9843.826,84,7314.723000000001,MORE,2191,4780,6971,7,2,14.0,1.3123718449442827,14.0,0.8730378697119728,0.4116236322237513,0.6375523773974557,234,110,124,0,1.4759320336549415,1.170500554541026,1.7167341466601715,0.9304930534458845,1.7617081048044383,1.7617081048044383,1.7167341466601715,1.170500554541026,1,1,1,2,1.7167341466601715,1.170500554541026
775,4,56,27,91,80,0,11180.726,84,2796.48,MORE,1237,3926,5163,8,2,-11.0,-1.0311493067419364,11.0,0.34921514788478913,0.4116236322237513,0.8730025965924547,171,91,80,1,0.21939530230005888,0.4291835366650429,0.0,1.281622507576407,0.9078069847681447,0.9078069847681447,0.0,0.4291835366650429,1,1,1,1,0.4291835366650429,0.0
776,4,57,40,64,80,1,1902.12,100,3156.962,MORE,550,1410,1960,1,2,16.0,1.4998535370791803,16.0,1.222253017596762,1.1495483510562468,-0.7611135052281977,144,64,80,0,-0.3191204397091766,-0.6242669624218805,0.0,-1.17628367133725,0.29289076939609665,0.29289076939609665,0.0,-0.6242669624218805,1,0,0,1,-0.6242669624218805,0.0
777,4,58,22,83,80,1,1910.42,100,1640.964,MORE,602,967,1569,3,2,-3.0,-0.28122253820234633,3.0,-1.0476454436543674,1.1495483510562468,-0.7596517378414682,163,83,80,1,0.05983508244547061,0.1170500554541026,0.0,-0.4740247630762051,0.3394346459599198,0.3394346459599198,0.0,0.1170500554541026,1,0,1,1,0.1170500554541026,0.0
778,4,59,54,101,110,1,2634.23,94,804.1260000000002,MORE,931,1037,1968,3,2,9.0,0.8436676146070391,9.0,0.0,0.8728265814940609,-0.6321768158910367,211,101,110,0,1.0171964015730004,0.8193503881787182,1.170500554541026,-0.4740247630762051,0.6339141726810316,0.6339141726810316,1.170500554541026,0.8193503881787182,1,0,1,2,1.170500554541026,0.8193503881787182
779,4,60,6,56,50,1,2586.458,100,1813.426,MORE,988,969,1957,3,2,-6.0,-0.5624450764046927,6.0,-0.5238227218271837,1.1495483510562468,-0.6405902558427036,106,56,50,1,-1.077031484018471,-0.9364004436328208,-1.170500554541026,-0.4740247630762051,0.6849334219913762,0.6849334219913762,-1.170500554541026,-0.9364004436328208,1,0,1,0,-0.9364004436328208,-1.170500554541026
780,4,61,18,50,42,1,4955.317,84,2101.278,MORE,172,2008,2180,5,2,-8.0,-0.7499267685395902,8.0,-0.17460757394239454,0.4116236322237513,-0.22339497512459047,92,50,42,1,-1.3562618687640005,-1.170500554541026,-1.4826340357519663,0.22823414518483967,-0.045447410240925384,0.045447410240925384,-1.4826340357519663,-1.170500554541026,1,1,0,0,-1.170500554541026,-1.4826340357519663
781,4,62,43,110,117,1,2957.897,64,1684.5410000000004,MORE,210,1240,1450,3,2,7.0,0.6561859224721414,7.0,-0.34921514788478913,-0.5107822663168681,-0.5751736996548278,227,110,117,0,1.3363168412821769,1.170500554541026,1.4436173506005987,-0.4740247630762051,-0.011434577367362324,0.011434577367362324,1.4436173506005987,1.170500554541026,0,0,0,2,1.4436173506005987,1.170500554541026
782,4,63,32,77,80,1,11515.408,84,920.84,MORE,1722,4138,5860,7,2,3.0,0.28122253820234633,3.0,-1.0476454436543674,0.4116236322237513,0.9319456366557506,157,77,80,0,-0.05983508244547061,-0.1170500554541026,0.0,0.9304930534458845,1.3419181411807257,1.3419181411807257,0.0,-0.1170500554541026,1,1,1,1,-0.1170500554541026,0.0
783,4,64,27,80,91,1,2351.575,94,2240.988,MORE,992,1071,2063,3,2,11.0,1.0311493067419364,11.0,0.34921514788478913,0.8728265814940609,-0.6819570400712763,171,80,91,0,0.21939530230005888,0.0,0.4291835366650429,-0.4740247630762051,0.6885137201885934,0.6885137201885934,0.4291835366650429,0.0,1,0,1,1,0.4291835366650429,0.0
784,4,65,16,44,50,1,3137.373,94,706.637,MORE,436,1125,1561,2,2,6.0,0.5624450764046927,6.0,-0.5238227218271837,0.8728265814940609,-0.5435650052571603,94,44,50,0,-1.3163718138003533,-1.4046006654492311,-1.170500554541026,-0.8251542172067275,0.19085227077540748,0.19085227077540748,-1.170500554541026,-1.4046006654492311,1,0,0,0,-1.4046006654492311,-1.170500554541026
785,4,66,7,50,57,1,1736.937,94,1224.269,MORE,815,678,1493,1,2,7.0,0.6561859224721414,7.0,-0.34921514788478913,0.8728265814940609,-0.7902049657392959,107,50,57,0,-1.0570864565366473,-1.170500554541026,-0.8973837584814532,-1.17628367133725,0.5300855249617338,0.5300855249617338,-0.8973837584814532,-1.170500554541026,1,0,1,0,-1.170500554541026,-0.8973837584814532
786,4,67,14,50,46,1,2057.448,94,1469.114,MORE,1188,647,1835,1,2,-4.0,-0.3749633842697951,4.0,-0.8730378697119728,0.8728265814940609,-0.7337576733431497,96,50,46,1,-1.2764817588367063,-1.170500554541026,-1.3265672951464962,-1.17628367133725,0.8639483318522344,0.8639483318522344,-1.3265672951464962,-1.170500554541026,1,0,1,0,-1.170500554541026,-1.3265672951464962
787,4,68,51,110,108,1,11483.744,94,991.242,MORE,-176,5353,5177,6,2,-2.0,-0.18748169213489754,2.0,-1.222253017596762,0.8728265814940609,0.9263690821336544,218,110,108,1,1.156811593945765,1.170500554541026,1.092467184238291,0.5793635993153621,-0.35693335339881865,0.35693335339881865,1.092467184238291,1.170500554541026,1,1,0,2,1.170500554541026,1.092467184238291
788,4,69,50,133,110,0,1873.12,94,1847.734,MORE,-440,1303,863,2,2,-23.0,-2.1560394595513217,23.0,2.444506035193524,0.8728265814940609,-0.7662208852541195,243,133,110,1,1.6554372809913533,2.0678843130224793,1.170500554541026,-0.8251542172067275,-0.5932330344151515,0.5932330344151515,1.170500554541026,2.0678843130224793,1,0,0,2,2.0678843130224793,1.170500554541026
789,4,70,49,131,110,0,3187.65,74,1602.521,MORE,484,1493,1977,4,2,-21.0,-1.9685577674164243,21.0,2.0952908873087353,-0.04957931704655842,-0.5347103933411854,241,131,110,1,1.6155472260277064,1.9898509427197442,1.170500554541026,-0.12289530894568271,0.23381584914201348,0.23381584914201348,1.170500554541026,1.9898509427197442,0,1,0,2,1.9898509427197442,1.170500554541026
790,4,71,47,126,110,0,5174.183,44,1965.527,MORE,-865,2785,1920,6,1,-16.0,-1.4998535370791803,16.0,1.222253017596762,-1.4331881648574871,-0.1848490497193002,236,126,110,1,1.5158220886185887,1.7947675169629065,1.170500554541026,0.5793635993153621,-0.9736397178694753,0.9736397178694753,1.170500554541026,1.7947675169629065,0,1,0,2,1.7947675169629065,1.170500554541026
791,4,72,50,110,133,1,6284.96,24,519.911,MORE,284,1853,2137,4,2,23.0,2.1560394595513217,23.0,2.444506035193524,-2.3555940633981067,0.010777166248059423,243,110,133,0,1.6554372809913533,1.170500554541026,2.0678843130224793,-0.12289530894568271,0.05480093928115522,0.05480093928115522,2.0678843130224793,1.170500554541026,0,1,0,2,2.0678843130224793,1.170500554541026
792,4,73,47,110,126,1,2648.8920000000007,84,1566.5510000000004,MORE,735,1444,2179,3,2,16.0,1.4998535370791803,16.0,1.222253017596762,0.4116236322237513,-0.6295945949965515,236,110,126,0,1.5158220886185887,1.170500554541026,1.7947675169629065,-0.4740247630762051,0.4584795610173905,0.4584795610173905,1.7947675169629065,1.170500554541026,1,0,1,2,1.7947675169629065,1.170500554541026
793,4,74,12,48,50,1,3745.233,64,1301.346,MORE,527,1448,1975,3,2,2.0,0.18748169213489754,2.0,-1.222253017596762,-0.5107822663168681,-0.4365107975827854,98,48,50,0,-1.2365917038730592,-1.248533924843761,-1.170500554541026,-0.4740247630762051,0.27230405476209796,0.27230405476209796,-1.170500554541026,-1.248533924843761,0,0,0,0,-1.248533924843761,-1.170500554541026
794,4,75,32,80,77,1,5846.379,74,1524.609,MORE,-833,3111,2278,5,2,-3.0,-0.28122253820234633,3.0,-1.0476454436543674,-0.04957931704655842,-0.06646420751569385,157,80,77,1,-0.05983508244547061,0.0,-0.1170500554541026,0.22823414518483967,-0.944997332291738,0.944997332291738,-0.1170500554541026,0.0,0,1,0,1,0.0,-0.1170500554541026
795,4,76,43,117,110,1,2244.629,74,1463.2520000000004,MORE,-576,1320,744,3,2,-7.0,-0.6561859224721414,7.0,-0.34921514788478913,-0.04957931704655842,-0.7007920009075604,227,117,110,1,1.3363168412821769,1.4436173506005987,1.170500554541026,-0.4740247630762051,-0.7149631731205351,0.7149631731205351,1.170500554541026,1.4436173506005987,0,0,0,2,1.4436173506005987,1.170500554541026
796,4,77,40,80,64,0,4492.143,44,2184.407,MORE,-870,2463,1593,4,1,-16.0,-1.4998535370791803,16.0,1.222253017596762,-1.4331881648574871,-0.3049675832668781,144,80,64,1,-0.3191204397091766,0.0,-0.6242669624218805,-0.12289530894568271,-0.9781150906159968,0.9781150906159968,-0.6242669624218805,0.0,0,1,0,1,0.0,-0.6242669624218805
797,4,78,31,80,78,1,2831.068,90,1461.321,MORE,1054,1180,2234,3,2,-2.0,-0.18748169213489754,2.0,-1.222253017596762,0.6883454017859371,-0.5975103859068156,158,80,78,1,-0.03989005496364707,0.0,-0.07803337030273506,-0.4740247630762051,0.7440083422454594,0.7440083422454594,-0.07803337030273506,0.0,1,0,1,1,0.0,-0.07803337030273506
798,4,79,46,124,110,1,5841.602,44,1923.178,MORE,-602,2799,2197,4,1,-14.0,-1.3123718449442827,14.0,0.8730378697119728,-1.4331881648574871,-0.06730551628755002,234,124,110,1,1.4759320336549415,1.7167341466601715,1.170500554541026,-0.12289530894568271,-0.7382351114024467,0.7382351114024467,1.170500554541026,1.7167341466601715,0,1,0,2,1.7167341466601715,1.170500554541026
799,4,80,58,92,110,1,2507.425,94,1276.304,MORE,300,1484,1784,3,1,18.0,1.6873352292140782,18.0,1.571468165481551,0.8728265814940609,-0.6545092753457616,202,92,110,0,0.8376911542365885,0.4682002218164104,1.170500554541026,-0.4740247630762051,0.06912213207002388,0.06912213207002388,1.170500554541026,0.4682002218164104,1,0,0,2,1.170500554541026,0.4682002218164104
800,4,81,48,128,110,1,5514.536,64,3310.606,LESS,-122,2589,2467,4,1,-18.0,-1.6873352292140782,18.0,1.571468165481551,-0.5107822663168681,-0.12490725268610745,238,128,110,0,1.5557121435822359,1.8728008872656416,1.170500554541026,-0.12289530894568271,-0.30859932773638693,0.30859932773638693,1.170500554541026,1.8728008872656416,0,1,1,2,1.8728008872656416,1.170500554541026
801,4,82,8,50,58,0,1932.558,74,2132.206,LESS,-600,1128,528,2,1,8.0,0.7499267685395902,8.0,-0.17460757394239454,-0.04957931704655842,-0.7557528695996111,108,50,58,1,-1.0371414290548238,-1.170500554541026,-0.8583670733300858,-0.8251542172067275,-0.736444962303838,0.736444962303838,-0.8583670733300858,-1.170500554541026,1,0,0,0,-1.170500554541026,-0.8583670733300858
802,4,83,4,54,50,0,9801.449,74,1936.535,LESS,1458,3591,5049,8,1,-4.0,-0.3749633842697951,4.0,-0.8730378697119728,-0.04957931704655842,0.6300890862471632,104,54,50,0,-1.116921538982118,-1.0144338139355558,-1.170500554541026,1.281622507576407,1.1056184601643928,1.1056184601643928,-1.170500554541026,-1.0144338139355558,1,1,1,0,-1.0144338139355558,-1.170500554541026
803,4,84,37,80,69,1,5940.8690000000015,44,2208.389,LESS,-649,3168,2519,5,1,-11.0,-1.0311493067419364,11.0,0.34921514788478913,-1.4331881648574871,-0.04982295445881914,149,80,69,0,-0.21939530230005888,0.0,-0.4291835366650429,0.22823414518483967,-0.7803036152197483,0.7803036152197483,-0.4291835366650429,0.0,0,1,0,1,0.0,-0.4291835366650429
804,4,85,52,105,110,0,3591.975,74,1821.57,LESS,24,2142,2166,5,2,5.0,0.4687042303372438,5.0,-0.6984302957695783,-0.04957931704655842,-0.4635020682039142,215,105,110,1,1.0969765115002945,0.9754171287841883,1.170500554541026,0.22823414518483967,-0.17791844353796046,0.17791844353796046,1.170500554541026,0.9754171287841883,0,1,1,2,1.170500554541026,0.9754171287841883
805,4,86,5,55,50,0,2463.779,84,2162.893,LESS,-831,1747,916,2,2,-5.0,-0.4687042303372438,5.0,-0.6984302957695783,0.4116236322237513,-0.6621960584013267,105,55,50,0,-1.0969765115002945,-0.9754171287841883,-1.170500554541026,-0.8251542172067275,-0.9432071831931295,0.9432071831931295,-1.170500554541026,-0.9754171287841883,1,0,0,0,-0.9754171287841883,-1.170500554541026
806,4,87,30,96,80,0,4914.518,74,1479.838,LESS,-179,2422,2243,5,2,-16.0,-1.4998535370791803,16.0,1.222253017596762,-0.04957931704655842,-0.2305803543548521,176,96,80,0,0.3191204397091766,0.6242669624218805,0.0,0.22823414518483967,-0.35961857704673156,0.35961857704673156,0.0,0.6242669624218805,1,1,0,1,0.6242669624218805,0.0
807,4,88,33,80,75,0,3861.1540000000014,84,879.331,LESS,-136,1844,1708,4,2,-5.0,-0.4687042303372438,5.0,-0.6984302957695783,0.4116236322237513,-0.4160951906867544,155,80,75,0,-0.09972513740911768,0.0,-0.19508342575683765,-0.12289530894568271,-0.321130371426647,0.321130371426647,-0.19508342575683765,0.0,1,0,1,1,0.0,-0.19508342575683765
808,4,89,48,110,128,0,1810.596,94,1170.014,LESS,397,967,1364,1,2,18.0,1.6873352292140782,18.0,1.571468165481551,0.8728265814940609,-0.7772323965900071,238,110,128,1,1.5557121435822359,1.170500554541026,1.8728008872656416,-1.17628367133725,0.1559443633525401,0.1559443633525401,1.8728008872656416,1.170500554541026,1,0,1,2,1.8728008872656416,1.170500554541026
809,4,90,9,59,50,1,6114.863,84,744.31,LESS,919,2383,3302,5,2,-9.0,-0.8436676146070391,9.0,0.0,0.4116236322237513,-0.019179731002603773,109,59,50,0,-1.0171964015730004,-0.8193503881787182,-1.170500554541026,0.22823414518483967,0.6231732780893801,0.6231732780893801,-1.170500554541026,-0.8193503881787182,1,1,1,0,-0.8193503881787182,-1.170500554541026
810,4,91,44,110,119,0,2444.855,74,2185.069,LESS,704,1479,2183,2,2,9.0,0.8436676146070391,9.0,0.0,-0.04957931704655842,-0.6655288880430696,229,110,119,1,1.376206896245824,1.170500554541026,1.5216507209033339,-0.8251542172067275,0.4307322499889575,0.4307322499889575,1.5216507209033339,1.170500554541026,1,0,1,2,1.5216507209033339,1.170500554541026
811,4,92,2,52,50,0,3256.276,44,3182.235,LESS,-494,1880,1386,4,1,-2.0,-0.18748169213489754,2.0,-1.222253017596762,-1.4331881648574871,-0.5226242188012228,102,52,50,0,-1.156811593945765,-1.092467184238291,-1.170500554541026,-0.12289530894568271,-0.6415670600775832,0.6415670600775832,-1.170500554541026,-1.092467184238291,0,0,0,0,-1.092467184238291,-1.170500554541026
812,4,93,8,58,50,0,15007.925,84,1693.974,LESS,-1553,7201,5648,11,2,-8.0,-0.7499267685395902,8.0,-0.17460757394239454,0.4116236322237513,1.5470356906554958,108,58,50,0,-1.0371414290548238,-0.8583670733300858,-1.170500554541026,2.335010869967974,-1.5894510077908277,1.5894510077908277,-1.170500554541026,-0.8583670733300858,1,1,0,0,-0.8583670733300858,-1.170500554541026
813,4,94,44,119,110,1,14697.957,74,1801.644,LESS,2866,5088,7954,10,2,-9.0,-0.8436676146070391,9.0,0.0,-0.04957931704655842,1.4924451950736008,229,119,110,0,1.376206896245824,1.5216507209033339,1.170500554541026,1.9838814158374516,2.3658834255848347,2.3658834255848347,1.170500554541026,1.5216507209033339,1,1,1,2,1.5216507209033339,1.170500554541026
814,4,95,34,74,80,0,1860.584,84,2868.871,LESS,650,875,1525,2,2,6.0,0.5624450764046927,6.0,-0.5238227218271837,0.4116236322237513,-0.7684286823577388,154,74,80,1,-0.11967016489094122,-0.2341001109082052,0.0,-0.8251542172067275,0.38239822432652576,0.38239822432652576,0.0,-0.2341001109082052,1,0,1,1,-0.2341001109082052,0.0
815,4,96,24,86,80,0,5034.29,24,1765.131,LESS,48,1903,1951,1,1,-6.0,-0.5624450764046927,6.0,-0.5238227218271837,-2.3555940633981067,-0.2094865226146895,166,86,80,0,0.11967016489094122,0.2341001109082052,0.0,-1.17628367133725,-0.15643665435465748,0.15643665435465748,0.0,0.2341001109082052,0,0,1,1,0.2341001109082052,0.0
816,4,97,39,66,80,0,7942.371,84,2051.71,LESS,260,3337,3597,6,2,14.0,1.3123718449442827,14.0,0.8730378697119728,0.4116236322237513,0.3026746778392046,146,66,80,1,-0.2792303847455295,-0.5462335921191455,0.0,0.5793635993153621,0.03331915009785223,0.03331915009785223,0.0,-0.5462335921191455,1,1,1,1,-0.5462335921191455,0.0
817,4,98,9,50,59,0,1541.675,100,1136.526,LESS,-26,842,816,2,2,9.0,0.8436676146070391,9.0,0.0,1.1495483510562468,-0.8245938360365911,109,50,59,1,-1.0171964015730004,-1.170500554541026,-0.8193503881787182,-0.8251542172067275,-0.22267217100317502,0.22267217100317502,-0.8193503881787182,-1.170500554541026,1,0,1,0,-1.170500554541026,-0.8193503881787182
818,4,99,57,94,110,0,1639.813,100,1921.683,LESS,1145,749,1894,1,2,16.0,1.4998535370791803,16.0,1.222253017596762,1.1495483510562468,-0.8073101097957662,204,94,110,1,0.8775812092002355,0.5462335921191455,1.170500554541026,-1.17628367133725,0.8254601262321499,0.8254601262321499,1.170500554541026,0.5462335921191455,1,0,1,2,1.170500554541026,0.5462335921191455
819,4,100,60,110,87,1,3309.907,74,1269.867,LESS,42,1390,1432,5,2,-23.0,-2.1560394595513217,23.0,2.444506035193524,-0.04957931704655842,-0.513178911967767,197,110,87,0,0.7379660168274708,1.170500554541026,0.27311679605957273,0.22823414518483967,-0.16180710165048323,0.16180710165048323,0.27311679605957273,1.170500554541026,0,1,1,2,1.170500554541026,0.27311679605957273
820,4,101,33,75,80,0,1652.721,94,1256.019,LESS,662,565,1227,1,2,5.0,0.4687042303372438,5.0,-0.6984302957695783,0.8728265814940609,-0.8050367973345731,155,75,80,1,-0.09972513740911768,-0.19508342575683765,0.0,-1.17628367133725,0.39313911891817727,0.39313911891817727,0.0,-0.19508342575683765,1,0,1,1,-0.19508342575683765,0.0
821,4,102,15,50,45,0,2686.6540000000005,94,747.7310000000001,LESS,188,1222,1410,3,2,-5.0,-0.4687042303372438,5.0,-0.6984302957695783,0.8728265814940609,-0.6229440817365908,95,50,45,0,-1.2964267863185297,-1.170500554541026,-1.3655839802978638,-0.4740247630762051,-0.031126217452056727,0.031126217452056727,-1.3655839802978638,-1.170500554541026,1,0,1,0,-1.170500554541026,-1.3655839802978638
822,4,103,59,89,110,0,1650.025,94,1374.265,LESS,361,934,1295,2,2,21.0,1.9685577674164243,21.0,2.0952908873087353,0.8728265814940609,-0.8055116075604312,199,89,110,1,0.7778560717911179,0.3511501663623078,1.170500554541026,-0.8251542172067275,0.12372167957758563,0.12372167957758563,1.170500554541026,0.3511501663623078,1,0,1,2,1.170500554541026,0.3511501663623078
823,4,104,29,80,94,0,2717.362,84,2032.601,LESS,-638,1774,1136,2,2,14.0,1.3123718449442827,14.0,0.8730378697119728,0.4116236322237513,-0.6175358946387974,174,80,94,1,0.2792303847455295,0.0,0.5462335921191455,-0.8251542172067275,-0.7704577951774012,0.7704577951774012,0.5462335921191455,0.0,1,0,0,1,0.5462335921191455,0.0
824,4,105,55,110,98,0,1869.81,44,3062.782,LESS,-492,959,467,2,1,-12.0,-1.124890152809385,12.0,0.5238227218271837,-1.4331881648574871,-0.766803831043285,208,110,98,0,0.9573613191275298,1.170500554541026,0.7023003327246156,-0.8251542172067275,-0.6397769109789746,0.6397769109789746,0.7023003327246156,1.170500554541026,0,0,0,2,1.170500554541026,0.7023003327246156
825,4,106,29,94,80,1,8438.741,34,2214.246,LESS,-38,3742,3704,7,2,-14.0,-1.3123718449442827,14.0,0.8730378697119728,-1.8943911141277967,0.3900936510621992,174,94,80,0,0.2792303847455295,0.5462335921191455,0.0,0.9304930534458845,-0.2334130655948265,0.2334130655948265,0.0,0.5462335921191455,0,1,1,1,0.5462335921191455,0.0
826,4,107,57,110,94,0,1844.599,54,1104.464,LESS,-484,1070,586,2,1,-16.0,-1.4998535370791803,16.0,1.222253017596762,-0.9719852155871778,-0.7712439054513374,204,110,94,0,0.8775812092002355,1.170500554541026,0.5462335921191455,-0.8251542172067275,-0.6326163145845404,0.6326163145845404,0.5462335921191455,1.170500554541026,0,0,0,2,1.170500554541026,0.5462335921191455
827,4,108,39,80,66,0,3257.386,64,1974.123,LESS,731,1564,2295,5,2,-14.0,-1.3123718449442827,14.0,0.8730378697119728,-0.5107822663168681,-0.5224287294278168,146,80,66,0,-0.2792303847455295,0.0,-0.5462335921191455,0.22823414518483967,0.45489926282017334,0.45489926282017334,-0.5462335921191455,0.0,0,1,1,1,0.0,-0.5462335921191455
828,4,109,4,50,54,0,1544.7620000000004,100,2619.878,LESS,248,793,1041,2,2,4.0,0.3749633842697951,4.0,-0.8730378697119728,1.1495483510562468,-0.8240501642386593,104,50,54,1,-1.116921538982118,-1.170500554541026,-1.0144338139355558,-0.8251542172067275,0.02257825550620074,0.02257825550620074,-1.0144338139355558,-1.170500554541026,1,0,1,0,-1.170500554541026,-1.0144338139355558
829,4,110,55,98,110,0,1977.232,84,2593.056,LESS,68,1151,1219,2,2,12.0,1.124890152809385,12.0,0.5238227218271837,0.4116236322237513,-0.7478850387279548,208,98,110,1,0.9573613191275298,0.7023003327246156,1.170500554541026,-0.8251542172067275,-0.13853516336857166,0.13853516336857166,1.170500554541026,0.7023003327246156,1,0,1,2,1.170500554541026,0.7023003327246156
830,4,111,2,50,52,0,5245.960999999998,84,2753.649000000001,LESS,317,2422,2739,4,2,2.0,0.18748169213489754,2.0,-1.222253017596762,0.4116236322237513,-0.17220775580548595,102,50,52,1,-1.156811593945765,-1.170500554541026,-1.092467184238291,-0.12289530894568271,0.08433839940819682,0.08433839940819682,-1.092467184238291,-1.170500554541026,1,0,1,0,-1.170500554541026,-1.092467184238291
831,4,112,59,110,89,1,10697.016,64,964.72,LESS,1483,3647,5130,7,2,-21.0,-1.9685577674164243,21.0,2.0952908873087353,-0.5107822663168681,0.7878132589256037,199,110,89,0,0.7778560717911179,1.170500554541026,0.3511501663623078,0.9304930534458845,1.1279953238970002,1.1279953238970002,0.3511501663623078,1.170500554541026,0,1,1,2,1.170500554541026,0.3511501663623078
832,4,113,60,87,110,0,5721.714,94,2594.5370000000007,LESS,-73,2690,2617,2,2,23.0,2.1560394595513217,23.0,2.444506035193524,0.8728265814940609,-0.0884197775478163,197,87,110,1,0.7379660168274708,0.27311679605957273,1.170500554541026,-0.8251542172067275,-0.2647406748204767,0.2647406748204767,1.170500554541026,0.27311679605957273,1,0,1,2,1.170500554541026,0.27311679605957273
833,4,114,52,110,105,0,7035.153,74,1582.319,LESS,1313,2796,4109,6,2,-5.0,-0.4687042303372438,5.0,-0.6984302957695783,-0.04957931704655842,0.14289857120621166,215,110,105,0,1.0969765115002945,1.170500554541026,0.9754171287841883,0.5793635993153621,0.9758326505152707,0.9758326505152707,0.9754171287841883,1.170500554541026,0,1,1,2,1.170500554541026,0.9754171287841883
834,4,115,30,80,96,0,1696.698,94,1457.7979999999998,LESS,471,790,1261,2,2,16.0,1.4998535370791803,16.0,1.222253017596762,0.8728265814940609,-0.7972917197000915,176,80,96,1,0.3191204397091766,0.0,0.6242669624218805,-0.8251542172067275,0.22217988000105765,0.22217988000105765,0.6242669624218805,0.0,1,0,1,1,0.6242669624218805,0.0
835,4,116,24,80,86,0,5437.186,100,2168.817,LESS,-1051,2972,1921,3,2,6.0,0.5624450764046927,6.0,-0.5238227218271837,1.1495483510562468,-0.13852986803110948,166,80,86,1,0.11967016489094122,0.0,0.2341001109082052,-0.4740247630762051,-1.1401235840400734,1.1401235840400734,0.2341001109082052,0.0,1,0,0,1,0.2341001109082052,0.0
836,4,117,5,50,55,0,1864.389,100,1405.434,LESS,-139,1122,983,2,2,5.0,0.4687042303372438,5.0,-0.6984302957695783,1.1495483510562468,-0.7677585588750272,105,50,55,1,-1.0969765115002945,-1.170500554541026,-0.9754171287841883,-0.8251542172067275,-0.32381559507455987,0.32381559507455987,-0.9754171287841883,-1.170500554541026,1,0,1,0,-1.170500554541026,-0.9754171287841883
837,4,118,34,80,74,0,6701.093000000002,54,1933.619,LESS,966,2670,3636,5,2,-6.0,-0.5624450764046927,6.0,-0.5238227218271837,-0.9719852155871778,0.08406507563864417,154,80,74,0,-0.11967016489094122,0.0,-0.2341001109082052,0.22823414518483967,0.6652417819066818,0.6652417819066818,-0.2341001109082052,0.0,0,1,1,1,0.0,-0.2341001109082052
838,4,119,15,45,50,0,1591.685,54,2323.0660000000007,LESS,-430,1112,682,2,2,5.0,0.4687042303372438,5.0,-0.6984302957695783,-0.9719852155871778,-0.8157862472401651,95,45,50,1,-1.2964267863185297,-1.3655839802978638,-1.170500554541026,-0.8251542172067275,-0.5842822889221087,0.5842822889221087,-1.170500554541026,-1.3655839802978638,0,0,0,0,-1.3655839802978638,-1.170500554541026
839,4,120,37,69,80,0,3241.106,44,1387.661,LESS,-729,1814,1085,4,1,11.0,1.0311493067419364,11.0,0.34921514788478913,-1.4331881648574871,-0.5252959069044377,149,69,80,1,-0.21939530230005888,-0.4291835366650429,0.0,-0.12289530894568271,-0.8519095791640916,0.8519095791640916,0.0,-0.4291835366650429,0,0,0,1,-0.4291835366650429,0.0
840,4,121,48,128,110,0,17445.725,74,3053.301,MORE,1311,7595,8906,11,2,-18.0,-1.6873352292140782,18.0,1.571468165481551,-0.04957931704655842,1.976372622627646,238,128,110,1,1.5557121435822359,1.8728008872656416,1.170500554541026,2.335010869967974,0.9740425014166622,0.9740425014166622,1.170500554541026,1.8728008872656416,0,1,1,2,1.8728008872656416,1.170500554541026
841,4,122,8,50,58,1,1605.944,84,2052.862,MORE,951,563,1514,1,2,8.0,0.7499267685395902,8.0,-0.17460757394239454,0.4116236322237513,-0.8132750013163851,108,50,58,0,-1.0371414290548238,-1.170500554541026,-0.8583670733300858,-1.17628367133725,0.6518156636671174,0.6518156636671174,-0.8583670733300858,-1.170500554541026,0,0,1,0,-1.170500554541026,-0.8583670733300858
842,4,123,4,54,50,0,4883.308,74,2761.139,MORE,-897,2689,1792,4,1,-4.0,-0.3749633842697951,4.0,-0.8730378697119728,-0.04957931704655842,-0.2360769519620597,104,54,50,1,-1.116921538982118,-1.0144338139355558,-1.170500554541026,-0.12289530894568271,-1.0022821034472127,1.0022821034472127,-1.170500554541026,-1.0144338139355558,0,1,0,0,-1.0144338139355558,-1.170500554541026
843,4,124,37,80,69,1,1537.096,100,1027.048,MORE,1179,501,1680,1,2,-11.0,-1.0311493067419364,11.0,0.34921514788478913,1.1495483510562468,-0.8254002737310289,149,80,69,1,-0.21939530230005888,0.0,-0.4291835366650429,-1.17628367133725,0.8558926609084958,0.8558926609084958,-0.4291835366650429,0.0,1,0,1,1,0.0,-0.4291835366650429
844,4,125,52,105,110,1,2097.817,94,1719.974,MORE,544,1224,1768,3,2,5.0,0.4687042303372438,5.0,-0.6984302957695783,0.8728265814940609,-0.7266480242305137,215,105,110,0,1.0969765115002945,0.9754171287841883,1.170500554541026,-0.4740247630762051,0.28752032210027095,0.28752032210027095,1.170500554541026,0.9754171287841883,1,1,0,2,1.170500554541026,0.9754171287841883
845,4,126,5,55,50,1,6545.8409999999985,34,1734.2879999999998,MORE,341,2609,2950,5,2,-5.0,-0.4687042303372438,5.0,-0.6984302957695783,-1.8943911141277967,0.056722628611594536,105,55,50,1,-1.0969765115002945,-0.9754171287841883,-1.170500554541026,0.22823414518483967,0.10582018859149982,0.10582018859149982,-1.170500554541026,-0.9754171287841883,0,1,0,0,-0.9754171287841883,-1.170500554541026
846,4,127,30,96,80,0,5068.047000000001,64,1370.384,MORE,-715,2439,1724,4,1,-16.0,-1.4998535370791803,16.0,1.222253017596762,-0.5107822663168681,-0.20354135614796354,176,96,80,1,0.3191204397091766,0.6242669624218805,0.0,-0.12289530894568271,-0.8393785354738316,0.8393785354738316,0.0,0.6242669624218805,0,1,0,1,0.6242669624218805,0.0
847,4,128,33,80,75,1,10908.364,84,1238.404,MORE,1786,3764,5550,2,2,-5.0,-0.4687042303372438,5.0,-0.6984302957695783,0.4116236322237513,0.8250351400883119,155,80,75,1,-0.09972513740911768,0.0,-0.19508342575683765,-0.8251542172067275,1.3992029123362004,1.3992029123362004,-0.19508342575683765,0.0,1,0,1,1,0.0,-0.19508342575683765
848,4,129,48,110,128,1,4783.775,94,1156.103,MORE,37,2030,2067,2,2,18.0,1.6873352292140782,18.0,1.571468165481551,0.8728265814940609,-0.2536063607937868,238,110,128,0,1.5557121435822359,1.170500554541026,1.8728008872656416,-0.8251542172067275,-0.1662824743970047,0.1662824743970047,1.8728008872656416,1.170500554541026,1,0,0,2,1.8728008872656416,1.170500554541026
849,4,130,9,59,50,1,5229.633,74,1301.781,MORE,1256,1690,2946,5,2,-9.0,-0.8436676146070391,9.0,0.0,-0.04957931704655842,-0.17508338687663236,109,59,50,1,-1.0171964015730004,-0.8193503881787182,-1.170500554541026,0.22823414518483967,0.924813401204926,0.924813401204926,-1.170500554541026,-0.8193503881787182,0,1,1,0,-0.8193503881787182,-1.170500554541026
850,4,131,44,110,119,1,3058.329,84,1971.817,MORE,1081,1092,2173,3,2,9.0,0.8436676146070391,9.0,0.0,0.4116236322237513,-0.5574859620422972,229,110,119,0,1.376206896245824,1.170500554541026,1.5216507209033339,-0.4740247630762051,0.7681753550766752,0.7681753550766752,1.5216507209033339,1.170500554541026,0,0,1,2,1.5216507209033339,1.170500554541026
851,4,132,2,52,50,1,6826.916,64,1442.612,MORE,-767,3318,2551,5,2,-2.0,-0.18748169213489754,2.0,-1.222253017596762,-0.5107822663168681,0.10622458863869802,102,52,50,1,-1.156811593945765,-1.092467184238291,-1.170500554541026,0.22823414518483967,-0.8859224120376548,0.8859224120376548,-1.170500554541026,-1.092467184238291,0,1,0,0,-1.092467184238291,-1.170500554541026
852,4,133,8,58,50,0,3045.3459999999995,84,865.6669999999998,MORE,428,1384,1812,2,2,-8.0,-0.7499267685395902,8.0,-0.17460757394239454,0.4116236322237513,-0.5597724832449368,108,58,50,1,-1.0371414290548238,-0.8583670733300858,-1.170500554541026,-0.8251542172067275,0.18369167438097314,0.18369167438097314,-1.170500554541026,-0.8583670733300858,1,0,0,0,-0.8583670733300858,-1.170500554541026
853,4,134,44,119,110,1,3269.93,64,1932.937,MORE,1490,1262,2752,3,2,-9.0,-0.8436676146070391,9.0,0.0,-0.5107822663168681,-0.5202195233917767,229,119,110,1,1.376206896245824,1.5216507209033339,1.170500554541026,-0.4740247630762051,1.1342608457421302,1.1342608457421302,1.170500554541026,1.5216507209033339,0,0,1,2,1.5216507209033339,1.170500554541026
854,4,135,34,74,80,1,1471.687,84,2007.49,MORE,812,549,1361,1,2,6.0,0.5624450764046927,6.0,-0.5238227218271837,0.4116236322237513,-0.8369198813212194,154,74,80,0,-0.11967016489094122,-0.2341001109082052,0.0,-1.17628367133725,0.527400301313821,0.527400301313821,0.0,-0.2341001109082052,0,0,1,1,-0.2341001109082052,0.0
855,4,136,24,86,80,1,4238.808,74,1244.525,MORE,1149,1822,2971,5,2,-6.0,-0.5624450764046927,6.0,-0.5238227218271837,-0.04957931704655842,-0.3495840701243581,166,86,80,1,0.11967016489094122,0.2341001109082052,0.0,0.22823414518483967,0.8290404244293671,0.8290404244293671,0.0,0.2341001109082052,0,1,1,1,0.2341001109082052,0.0
856,4,137,39,66,80,1,1535.682,94,2529.697,MORE,374,1111,1485,4,2,14.0,1.3123718449442827,14.0,0.8730378697119728,0.8728265814940609,-0.8256493025364309,146,66,80,0,-0.2792303847455295,-0.5462335921191455,0.0,-0.12289530894568271,0.13535764871854142,0.13535764871854142,0.0,-0.5462335921191455,1,1,0,1,-0.5462335921191455,0.0
857,4,138,9,50,59,1,1519.3570000000002,94,1011.304,MORE,1363,470,1833,1,2,9.0,0.8436676146070391,9.0,0.0,0.8728265814940609,-0.8285244052579196,109,50,59,0,-1.0171964015730004,-1.170500554541026,-0.8193503881787182,-1.17628367133725,1.0205863779804853,1.0205863779804853,-0.8193503881787182,-1.170500554541026,1,0,1,0,-1.170500554541026,-0.8193503881787182
858,4,139,57,94,110,1,2981.751,84,1972.525,MORE,605,1305,1910,3,2,16.0,1.4998535370791803,16.0,1.222253017596762,0.4116236322237513,-0.5709726154086779,204,94,110,0,0.8775812092002355,0.5462335921191455,1.170500554541026,-0.4740247630762051,0.3421198696078327,0.3421198696078327,1.170500554541026,0.5462335921191455,0,0,1,2,1.170500554541026,0.5462335921191455
859,4,140,60,110,87,0,4321.7829999999985,64,1519.537,MORE,-584,2373,1789,4,1,-23.0,-2.1560394595513217,23.0,2.444506035193524,-0.5107822663168681,-0.3349707991708801,197,110,87,1,0.7379660168274708,1.170500554541026,0.27311679605957273,-0.12289530894568271,-0.7221237695149695,0.7221237695149695,0.27311679605957273,1.170500554541026,0,1,0,2,1.170500554541026,0.27311679605957273
860,4,141,33,75,80,1,1608.882,74,1690.144,MORE,419,601,1020,1,2,5.0,0.4687042303372438,5.0,-0.6984302957695783,-0.04957931704655842,-0.8127575708847934,155,75,80,0,-0.09972513740911768,-0.19508342575683765,0.0,-1.17628367133725,0.1756360034372345,0.1756360034372345,0.0,-0.19508342575683765,0,0,0,1,-0.19508342575683765,0.0
861,4,142,15,50,45,0,9537.109,24,1331.3370000000002,MORE,-2515,5878,3363,5,1,-5.0,-0.4687042303372438,5.0,-0.6984302957695783,-2.3555940633981067,0.5835344367281221,95,50,45,1,-1.2964267863185297,-1.170500554541026,-1.3655839802978638,0.22823414518483967,-2.450512724221556,2.450512724221556,-1.3655839802978638,-1.170500554541026,0,1,0,0,-1.170500554541026,-1.3655839802978638
862,4,143,59,89,110,1,1774.399,84,1497.556,MORE,552,743,1295,1,2,21.0,1.9685577674164243,21.0,2.0952908873087353,0.4116236322237513,-0.7836072874451206,199,89,110,0,0.7778560717911179,0.3511501663623078,1.170500554541026,-1.17628367133725,0.29468091849470524,0.29468091849470524,1.170500554541026,0.3511501663623078,0,0,0,2,1.170500554541026,0.3511501663623078
863,4,144,29,80,94,1,3304.423,100,1707.999,MORE,990,1525,2515,3,2,14.0,1.3123718449442827,14.0,0.8730378697119728,1.1495483510562468,-0.5141447351423242,174,80,94,0,0.2792303847455295,0.0,0.5462335921191455,-0.4740247630762051,0.6867235710899847,0.6867235710899847,0.5462335921191455,0.0,1,0,1,1,0.5462335921191455,0.0
864,4,145,55,110,98,0,3033.366,74,1314.099,MORE,354,1223,1577,4,2,-12.0,-1.124890152809385,12.0,0.5238227218271837,-0.04957931704655842,-0.5618823595453003,208,110,98,1,0.9573613191275298,1.170500554541026,0.7023003327246156,-0.12289530894568271,0.1174561577324556,0.1174561577324556,0.7023003327246156,1.170500554541026,0,1,0,2,1.170500554541026,0.7023003327246156
865,4,146,29,94,80,0,6061.712,74,2336.464,MORE,-1162,3316,2154,3,1,-14.0,-1.3123718449442827,14.0,0.8730378697119728,-0.04957931704655842,-0.02854050189080285,174,94,80,1,0.2792303847455295,0.5462335921191455,0.0,-0.4740247630762051,-1.2394768590128498,1.2394768590128498,0.0,0.5462335921191455,0,0,0,1,0.5462335921191455,0.0
866,4,147,57,110,94,1,2043.157,100,1473.285,MORE,774,995,1769,3,2,-16.0,-1.4998535370791803,16.0,1.222253017596762,1.1495483510562468,-0.7362745549966133,204,110,94,1,0.8775812092002355,1.170500554541026,0.5462335921191455,-0.4740247630762051,0.4933874684402579,0.4933874684402579,0.5462335921191455,1.170500554541026,1,0,1,2,1.170500554541026,0.5462335921191455
867,4,148,39,80,66,0,2237.002,74,1753.936,MORE,-822,1511,689,2,1,-14.0,-1.3123718449442827,14.0,0.8730378697119728,-0.04957931704655842,-0.7021352418543779,146,80,66,1,-0.2792303847455295,0.0,-0.5462335921191455,-0.8251542172067275,-0.9351515122493909,0.9351515122493909,-0.5462335921191455,0.0,0,0,0,1,0.0,-0.5462335921191455
868,4,149,4,50,54,1,1632.804,100,1948.105,MORE,1077,609,1686,1,2,4.0,0.3749633842697951,4.0,-0.8730378697119728,1.1495483510562468,-0.8085445107130658,104,50,54,0,-1.116921538982118,-1.170500554541026,-1.0144338139355558,-1.17628367133725,0.7645950568794581,0.7645950568794581,-1.0144338139355558,-1.170500554541026,1,0,1,0,-1.170500554541026,-1.0144338139355558
869,4,150,55,98,110,1,1772.698,94,2106.611,MORE,618,996,1614,3,2,12.0,1.124890152809385,12.0,0.5238227218271837,0.8728265814940609,-0.7839068617011238,208,98,110,0,0.9573613191275298,0.7023003327246156,1.170500554541026,-0.4740247630762051,0.35375583874878846,0.35375583874878846,1.170500554541026,0.7023003327246156,1,0,1,2,1.170500554541026,0.7023003327246156
870,4,151,2,50,52,1,4730.624,74,1669.864,MORE,175,2008,2183,5,2,2.0,0.18748169213489754,2.0,-1.222253017596762,-0.04957931704655842,-0.2629671316819859,102,50,52,0,-1.156811593945765,-1.170500554541026,-1.092467184238291,0.22823414518483967,-0.042762186593012515,0.042762186593012515,-1.092467184238291,-1.170500554541026,0,1,0,0,-1.170500554541026,-1.092467184238291
871,4,152,59,110,89,1,12463.602,84,1198.06,MORE,1471,4002,5473,5,2,-21.0,-1.9685577674164243,21.0,2.0952908873087353,0.4116236322237513,1.0989382951488191,199,110,89,1,0.7778560717911179,1.170500554541026,0.3511501663623078,0.22823414518483967,1.1172544293053486,1.1172544293053486,0.3511501663623078,1.170500554541026,0,1,1,2,1.170500554541026,0.3511501663623078
872,4,153,60,87,110,1,1735.195,4,430.34,MORE,556,689,1245,1,2,23.0,2.1560394595513217,23.0,2.444506035193524,-3.2779999619387263,-0.7905117607739566,197,87,110,0,0.7379660168274708,0.27311679605957273,1.170500554541026,-1.17628367133725,0.2982612166919224,0.2982612166919224,1.170500554541026,0.27311679605957273,0,0,1,2,1.170500554541026,0.27311679605957273
873,4,154,52,110,105,1,3602.502,54,2005.134,MORE,-202,1677,1475,3,2,-5.0,-0.4687042303372438,5.0,-0.6984302957695783,-0.9719852155871778,-0.4616480892545046,215,110,105,1,1.0969765115002945,1.170500554541026,0.9754171287841883,-0.4740247630762051,-0.38020529168073025,0.38020529168073025,0.9754171287841883,1.170500554541026,0,0,0,2,1.170500554541026,0.9754171287841883
874,4,155,30,80,96,1,1572.06,100,937.675,MORE,1047,634,1681,1,2,16.0,1.4998535370791803,16.0,1.222253017596762,1.1495483510562468,-0.8192425345852933,176,80,96,0,0.3191204397091766,0.0,0.6242669624218805,-1.17628367133725,0.7377428204003293,0.7377428204003293,0.6242669624218805,0.0,1,0,1,1,0.6242669624218805,0.0
875,4,156,24,80,86,1,2244.141,94,2591.103,MORE,1180,1063,2243,0,2,6.0,0.5624450764046927,6.0,-0.5238227218271837,0.8728265814940609,-0.7008779457852379,166,80,86,0,0.11967016489094122,0.0,0.2341001109082052,-1.5274131254677723,0.8567877354578001,0.8567877354578001,0.2341001109082052,0.0,1,0,1,1,0.2341001109082052,0.0
876,4,157,5,50,55,1,2891.789,94,1074.157,MORE,968,1166,2134,3,2,5.0,0.4687042303372438,5.0,-0.6984302957695783,0.8728265814940609,-0.5868164127152983,105,50,55,0,-1.0969765115002945,-1.170500554541026,-0.9754171287841883,-0.4740247630762051,0.6670319310052903,0.6670319310052903,-0.9754171287841883,-1.170500554541026,1,0,1,0,-1.170500554541026,-0.9754171287841883
877,4,158,34,80,74,0,26075.23,44,2000.168,MORE,-332,10316,9984,12,2,-6.0,-0.5624450764046927,6.0,-0.5238227218271837,-1.4331881648574871,3.496171294027405,154,80,74,1,-0.11967016489094122,0.0,-0.2341001109082052,2.6861403240984965,-0.49656498309028807,0.49656498309028807,-0.2341001109082052,0.0,0,1,0,1,0.0,-0.2341001109082052
878,4,159,15,45,50,1,1549.096,84,2659.5959999999995,MORE,1124,383,1507,1,2,5.0,0.4687042303372438,5.0,-0.6984302957695783,0.4116236322237513,-0.823286875099613,95,45,50,0,-1.2964267863185297,-1.3655839802978638,-1.170500554541026,-1.17628367133725,0.8066635606967598,0.8066635606967598,-1.170500554541026,-1.3655839802978638,0,0,1,0,-1.3655839802978638,-1.170500554541026
879,4,160,37,69,80,1,1694.063,100,1265.452,MORE,1004,887,1891,1,1,11.0,1.0311493067419364,11.0,0.34921514788478913,1.1495483510562468,-0.7977557868162399,149,69,80,0,-0.21939530230005888,-0.4291835366650429,0.0,-1.17628367133725,0.6992546147802449,0.6992546147802449,0.0,-0.4291835366650429,1,0,1,1,-0.4291835366650429,0.0
880,4,161,3,50,53,0,7326.800999999998,100,1558.4260000000004,LESS,500,3657,4157,6,2,3.0,0.28122253820234633,3.0,-1.0476454436543674,1.1495483510562468,0.19426261154414445,103,50,53,1,-1.1368665664639415,-1.170500554541026,-1.0534504990869233,0.5793635993153621,0.24813704193088212,0.24813704193088212,-1.0534504990869233,-1.170500554541026,1,1,1,0,-1.170500554541026,-1.0534504990869233
881,4,162,20,50,40,0,10370.944,54,3904.349,LESS,-782,5450,4668,5,2,-10.0,-0.9374084606744876,10.0,0.17460757394239454,-0.9719852155871778,0.7303865823803486,90,50,40,0,-1.3961519237276474,-1.170500554541026,-1.5606674060547012,0.22823414518483967,-0.8993485302772191,0.8993485302772191,-1.5606674060547012,-1.170500554541026,0,1,0,0,-1.170500554541026,-1.5606674060547012
882,4,163,25,80,88,0,6994.066,64,1313.7879999999998,LESS,108,3317,3425,6,1,8.0,0.7499267685395902,8.0,-0.17460757394239454,-0.5107822663168681,0.13566247040879598,168,80,88,1,0.1595602198545883,0.0,0.31213348121094026,0.5793635993153621,-0.10273218139640002,0.10273218139640002,0.31213348121094026,0.0,0,1,1,1,0.31213348121094026,0.0
883,4,164,42,115,110,0,20801.538,74,1803.007,LESS,3649,7642,11291,11,2,-5.0,-0.4687042303372438,5.0,-0.6984302957695783,-0.04957931704655842,2.5673868394183006,225,115,110,0,1.2964267863185297,1.3655839802978638,1.170500554541026,2.335010869967974,3.0667267976900945,3.0667267976900945,1.170500554541026,1.3655839802978638,0,1,1,2,1.3655839802978638,1.170500554541026
884,4,165,53,103,110,0,3869.451,64,2247.818,LESS,-539,2022,1483,4,1,7.0,0.6561859224721414,7.0,-0.34921514788478913,-0.5107822663168681,-0.4146339516496832,213,103,110,1,1.0570864565366473,0.8973837584814532,1.170500554541026,-0.12289530894568271,-0.6818454147962764,0.6818454147962764,1.170500554541026,0.8973837584814532,0,0,0,2,1.170500554541026,0.8973837584814532
885,4,166,26,90,80,0,10888.107,74,1448.341,LESS,2699,3831,6530,8,2,-10.0,-0.9374084606744876,10.0,0.17460757394239454,-0.04957931704655842,0.8214675470819293,170,90,80,0,0.19945027481823535,0.3901668515136753,0.0,1.281622507576407,2.216405975851018,2.216405975851018,0.0,0.3901668515136753,0,1,1,1,0.3901668515136753,0.0
886,4,167,35,80,72,1,15326.428,84,1285.388,LESS,1231,6354,7585,6,2,-8.0,-0.7499267685395902,8.0,-0.17460757394239454,0.4116236322237513,1.6031293410139855,152,80,72,0,-0.1595602198545883,0.0,-0.31213348121094026,0.5793635993153621,0.9024365374723189,0.9024365374723189,-0.31213348121094026,0.0,1,1,1,1,0.0,-0.31213348121094026
887,4,168,28,93,80,1,3698.599,64,1498.22,LESS,-319,1849,1530,3,2,-13.0,-1.218630998876834,13.0,0.6984302957695783,-0.5107822663168681,-0.44472381689757295,173,93,80,0,0.25928535726370594,0.5072169069677779,0.0,-0.4740247630762051,-0.4849290139493323,0.4849290139493323,0.0,0.5072169069677779,0,0,0,1,0.5072169069677779,0.0
888,4,169,26,80,90,0,1644.716,94,1592.405,LESS,582,840,1422,2,2,10.0,0.9374084606744876,10.0,0.17460757394239454,0.8728265814940609,-0.8064466103382804,170,80,90,1,0.19945027481823535,0.0,0.3901668515136753,-0.8251542172067275,0.321533154973834,0.321533154973834,0.3901668515136753,0.0,1,0,1,1,0.3901668515136753,0.0
889,4,170,25,88,80,1,5217.47,94,1230.066,LESS,1189,1827,3016,4,2,-8.0,-0.7499267685395902,8.0,-0.17460757394239454,0.8728265814940609,-0.17722549250612496,168,88,80,0,0.1595602198545883,0.31213348121094026,0.0,-0.12289530894568271,0.8648434064015387,0.8648434064015387,0.0,0.31213348121094026,1,1,1,1,0.31213348121094026,0.0
890,4,171,36,80,70,1,7844.8319999999985,84,852.3530000000002,LESS,1317,2997,4314,7,2,-10.0,-0.9374084606744876,10.0,0.17460757394239454,0.4116236322237513,0.28549644541339764,150,80,70,0,-0.19945027481823535,0.0,-0.3901668515136753,0.9304930534458845,0.9794129487124879,0.9794129487124879,-0.3901668515136753,0.0,1,1,1,1,0.0,-0.3901668515136753
891,4,172,28,80,93,0,1715.8470000000002,94,1562.8429999999996,LESS,420,980,1400,2,2,13.0,1.218630998876834,13.0,0.6984302957695783,0.8728265814940609,-0.7939192638340095,173,80,93,1,0.25928535726370594,0.0,0.5072169069677779,-0.8251542172067275,0.1765310779865388,0.1765310779865388,0.5072169069677779,0.0,1,0,1,1,0.5072169069677779,0.0
892,4,173,21,82,80,0,2732.0370000000007,74,2427.542,LESS,-754,1525,771,3,2,-2.0,-0.18748169213489754,2.0,-1.222253017596762,-0.04957931704655842,-0.6149513842291282,162,82,80,0,0.03989005496364707,0.07803337030273506,0.0,-0.4740247630762051,-0.8742864428966989,0.8742864428966989,0.0,0.07803337030273506,0,0,0,1,0.07803337030273506,0.0
893,4,174,19,50,41,0,19264.999,74,1256.026,LESS,-1404,8579,7175,10,1,-9.0,-0.8436676146070391,9.0,0.0,-0.04957931704655842,2.296776887775198,91,50,41,0,-1.376206896245824,-1.170500554541026,-1.5216507209033339,1.9838814158374516,-1.4560848999444882,1.4560848999444882,-1.5216507209033339,-1.170500554541026,0,1,0,0,-1.170500554541026,-1.5216507209033339
894,4,175,56,96,110,0,2416.989,84,1398.906,LESS,-693,1754,1061,2,2,14.0,1.3123718449442827,14.0,0.8730378697119728,0.4116236322237513,-0.6704365518983227,206,96,110,1,0.9174712641638826,0.6242669624218805,1.170500554541026,-0.8251542172067275,-0.8196868953891372,0.8196868953891372,1.170500554541026,0.6242669624218805,1,0,0,2,1.170500554541026,0.6242669624218805
895,4,176,23,80,85,0,17362.41,34,1329.615,LESS,-1627,8035,6408,11,1,5.0,0.4687042303372438,5.0,-0.6984302957695783,-1.8943911141277967,1.9616994720462781,165,80,85,1,0.09972513740911768,0.0,0.19508342575683765,2.335010869967974,-1.655686524439345,1.655686524439345,0.19508342575683765,0.0,0,1,0,1,0.19508342575683765,0.0
896,4,177,10,60,50,1,8393.032,84,932.879,LESS,-710,3892,3182,5,2,-10.0,-0.9374084606744876,10.0,0.17460757394239454,0.4116236322237513,0.3820435395585831,110,60,50,0,-0.9972513740911768,-0.7803337030273506,-1.170500554541026,0.22823414518483967,-0.8349031627273101,0.8349031627273101,-1.170500554541026,-0.7803337030273506,1,1,0,0,-0.7803337030273506,-1.170500554541026
897,4,178,19,41,50,0,4098.332,100,2606.828,LESS,513,2070,2583,2,2,9.0,0.8436676146070391,9.0,0.0,1.1495483510562468,-0.3743242189699236,91,41,50,1,-1.376206896245824,-1.5216507209033339,-1.170500554541026,-0.8251542172067275,0.2597730110718379,0.2597730110718379,-1.170500554541026,-1.5216507209033339,1,0,1,0,-1.5216507209033339,-1.170500554541026
898,4,179,56,110,96,0,10515.086,64,1833.034,LESS,1829,3846,5675,7,2,-14.0,-1.3123718449442827,14.0,0.8730378697119728,-0.5107822663168681,0.7557723745078118,206,110,96,0,0.9174712641638826,1.170500554541026,0.6242669624218805,0.9304930534458845,1.4376911179562848,1.4376911179562848,0.6242669624218805,1.170500554541026,0,1,1,2,1.170500554541026,0.6242669624218805
899,4,180,35,72,80,0,31663.561,34,1804.845,LESS,-834,13069,12235,8,1,8.0,0.7499267685395902,8.0,-0.17460757394239454,-1.8943911141277967,4.4803688846356815,152,72,80,1,-0.1595602198545883,-0.31213348121094026,0.0,1.281622507576407,-0.9458924068410424,0.9458924068410424,0.0,-0.31213348121094026,0,1,0,1,-0.31213348121094026,0.0
900,4,181,11,49,50,0,13825.959,44,1351.529,LESS,-3297,7786,4489,8,1,1.0,0.09374084606744876,1.0,-1.3968605915391563,-1.4331881648574871,1.3388719134238138,99,49,50,1,-1.2166466763912356,-1.2095172396923934,-1.170500554541026,1.281622507576407,-3.1504610217775113,3.1504610217775113,-1.170500554541026,-1.2095172396923934,0,1,0,0,-1.2095172396923934,-1.170500554541026
901,4,182,17,43,50,0,3532.394,54,1421.12,LESS,-876,1958,1082,4,1,7.0,0.6561859224721414,7.0,-0.34921514788478913,-0.9719852155871778,-0.473995268525447,93,43,50,1,-1.3363168412821769,-1.4436173506005987,-1.170500554541026,-0.12289530894568271,-0.9834855379118226,0.9834855379118226,-1.170500554541026,-1.4436173506005987,0,1,0,0,-1.4436173506005987,-1.170500554541026
902,4,183,1,51,50,0,6932.071999999999,74,1164.222,LESS,409,2992,3401,6,1,-1.0,-0.09374084606744876,1.0,-1.3968605915391563,-0.04957931704655842,0.12474430084579582,101,51,50,0,-1.1767566214275886,-1.1314838693896585,-1.170500554541026,0.5793635993153621,0.16668525794419162,0.16668525794419162,-1.170500554541026,-1.1314838693896585,0,1,1,0,-1.1314838693896585,-1.170500554541026
903,4,184,41,112,110,0,4322.377,64,1126.478,LESS,-713,2326,1613,4,1,-2.0,-0.18748169213489754,2.0,-1.222253017596762,-0.5107822663168681,-0.3348661859386247,222,112,110,0,1.2365917038730592,1.248533924843761,1.170500554541026,-0.12289530894568271,-0.837588386375223,0.837588386375223,1.170500554541026,1.248533924843761,0,1,0,2,1.248533924843761,1.170500554541026
904,4,185,20,40,50,0,1712.77,94,2224.272,LESS,260,982,1242,2,2,10.0,0.9374084606744876,10.0,0.17460757394239454,0.8728265814940609,-0.7944611744664152,90,40,50,1,-1.3961519237276474,-1.5606674060547012,-1.170500554541026,-0.8251542172067275,0.03331915009785223,0.03331915009785223,-1.170500554541026,-1.5606674060547012,1,0,1,0,-1.5606674060547012,-1.170500554541026
905,4,186,1,50,51,0,8741.851999999999,84,2383.411,LESS,-1625,4556,2931,6,2,1.0,0.09374084606744876,1.0,-1.3968605915391563,0.4116236322237513,0.4434765154427924,101,50,51,1,-1.1767566214275886,-1.170500554541026,-1.1314838693896585,0.5793635993153621,-1.6538963753407365,1.6538963753407365,-1.1314838693896585,-1.170500554541026,1,1,0,0,-1.170500554541026,-1.1314838693896585
906,4,187,23,85,80,0,18617.121,34,1863.061,LESS,708,7112,7820,10,1,-5.0,-0.4687042303372438,5.0,-0.6984302957695783,-1.8943911141277967,2.182674847898156,165,85,80,0,0.09972513740911768,0.19508342575683765,0.0,1.9838814158374516,0.43431254818617465,0.43431254818617465,0.0,0.19508342575683765,0,1,1,1,0.19508342575683765,0.0
907,4,188,11,50,49,0,7029.46,64,2016.111,LESS,2168,1863,4031,5,1,-1.0,-0.09374084606744876,1.0,-1.3968605915391563,-0.5107822663168681,0.14189593967215736,99,50,49,0,-1.2166466763912356,-1.170500554541026,-1.2095172396923934,0.22823414518483967,1.7411213901704397,1.7411213901704397,-1.2095172396923934,-1.170500554541026,0,1,1,0,-1.170500554541026,-1.2095172396923934
908,4,189,17,50,43,0,17355.536,84,1470.056,LESS,-2358,8008,5650,7,2,-7.0,-0.6561859224721414,7.0,-0.34921514788478913,0.4116236322237513,1.960488846863582,93,50,43,0,-1.3363168412821769,-1.170500554541026,-1.4436173506005987,0.9304930534458845,-2.309986019980782,2.309986019980782,-1.4436173506005987,-1.170500554541026,1,1,0,0,-1.170500554541026,-1.4436173506005987
909,4,190,21,80,82,0,1770.037,84,1164.903,LESS,-155,1074,919,1,2,2.0,0.18748169213489754,2.0,-1.222253017596762,0.4116236322237513,-0.7843755078476403,162,80,82,1,0.03989005496364707,0.0,0.07803337030273506,-1.17628367133725,-0.33813678786342855,0.33813678786342855,0.07803337030273506,0.0,1,0,0,1,0.07803337030273506,0.0
910,4,191,10,50,60,0,5798.199000000001,94,2559.67,LESS,-549,3244,2695,6,2,10.0,0.9374084606744876,10.0,0.17460757394239454,0.8728265814940609,-0.07494950302082863,110,50,60,1,-0.9972513740911768,-1.170500554541026,-0.7803337030273506,0.5793635993153621,-0.6907961602893192,0.6907961602893192,-0.7803337030273506,-1.170500554541026,1,1,0,0,-1.170500554541026,-0.7803337030273506
911,4,192,3,53,50,0,2808.845,84,750.0260000000002,LESS,165,1435,1600,4,2,-3.0,-0.28122253820234633,3.0,-1.0476454436543674,0.4116236322237513,-0.6014242240556453,103,53,50,0,-1.1368665664639415,-1.0534504990869233,-1.170500554541026,-0.12289530894568271,-0.05171293208605542,0.05171293208605542,-1.170500554541026,-1.0534504990869233,1,0,1,0,-1.0534504990869233,-1.170500554541026
912,4,193,45,122,110,1,8212.237,54,1251.279,LESS,497,3407,3904,6,2,-12.0,-1.124890152809385,12.0,0.5238227218271837,-0.9719852155871778,0.3502025474280125,232,122,110,0,1.4360419786912946,1.6387007763574364,1.170500554541026,0.5793635993153621,0.24545181828296925,0.24545181828296925,1.170500554541026,1.6387007763574364,0,1,1,2,1.6387007763574364,1.170500554541026
913,4,194,38,67,80,0,2293.854,94,1013.764,LESS,-654,1678,1024,2,2,13.0,1.218630998876834,13.0,0.6984302957695783,0.8728265814940609,-0.6921226636049397,147,67,80,1,-0.25928535726370594,-0.5072169069677779,0.0,-0.8251542172067275,-0.7847789879662698,0.7847789879662698,0.0,-0.5072169069677779,1,0,0,1,-0.5072169069677779,0.0
914,4,195,38,80,67,1,8415.61,84,1051.495,LESS,2751,2594,5345,5,2,-13.0,-1.218630998876834,13.0,0.6984302957695783,0.4116236322237513,0.3860198990835924,147,80,67,0,-0.25928535726370594,0.0,-0.5072169069677779,0.22823414518483967,2.2629498524148413,2.2629498524148413,-0.5072169069677779,0.0,1,1,1,1,0.0,-0.5072169069677779
915,4,196,36,70,80,0,2697.0170000000007,74,812.1030000000002,LESS,-1339,1936,597,2,1,10.0,0.9374084606744876,10.0,0.17460757394239454,-0.04957931704655842,-0.6211189859018105,150,70,80,1,-0.19945027481823535,-0.3901668515136753,0.0,-0.8251542172067275,-1.3979050542397093,1.3979050542397093,0.0,-0.3901668515136753,0,0,0,1,-0.3901668515136753,0.0
916,4,197,45,110,122,0,2157.263,94,1847.89,LESS,-177,1185,1008,2,2,12.0,1.124890152809385,12.0,0.5238227218271837,0.8728265814940609,-0.7161785996435843,232,110,122,1,1.4360419786912946,1.170500554541026,1.6387007763574364,-0.8251542172067275,-0.357828427948123,0.357828427948123,1.6387007763574364,1.170500554541026,1,0,0,2,1.6387007763574364,1.170500554541026
917,4,198,42,110,115,0,2450.887,94,722.905,LESS,-382,1544,1162,3,2,5.0,0.4687042303372438,5.0,-0.6984302957695783,0.8728265814940609,-0.6644665529976779,225,110,115,1,1.2964267863185297,1.170500554541026,1.3655839802978638,-0.4740247630762051,-0.5413187105555026,0.5413187105555026,1.3655839802978638,1.170500554541026,1,0,0,2,1.3655839802978638,1.170500554541026
918,4,199,41,110,112,0,3564.241,70,1603.7979999999998,LESS,-201,2263,2062,5,2,2.0,0.18748169213489754,2.0,-1.222253017596762,-0.2340604967546823,-0.4683864846742217,222,110,112,1,1.2365917038730592,1.170500554541026,1.248533924843761,0.22823414518483967,-0.37931021713142593,0.37931021713142593,1.248533924843761,1.170500554541026,0,1,0,2,1.248533924843761,1.170500554541026
919,4,200,53,110,103,0,2070.507,74,1764.473,LESS,-1171,1873,702,2,1,-7.0,-0.6561859224721414,7.0,-0.34921514788478913,-0.04957931704655842,-0.7314577672825111,213,110,103,0,1.0570864565366473,1.170500554541026,0.8973837584814532,-0.8251542172067275,-1.2475325299565885,1.2475325299565885,0.8973837584814532,1.170500554541026,0,0,0,2,1.170500554541026,0.8973837584814532
920,4,201,3,50,53,1,24275.208,44,1272.221,MORE,2717,8525,11242,10,1,3.0,0.28122253820234633,3.0,-1.0476454436543674,-1.4331881648574871,3.1791576247508537,103,50,53,0,-1.1368665664639415,-1.170500554541026,-1.0534504990869233,1.9838814158374516,2.2325173177384956,2.2325173177384956,-1.0534504990869233,-1.170500554541026,0,1,1,0,-1.170500554541026,-1.0534504990869233
921,4,202,20,50,40,0,28694.544,84,4965.2,MORE,5631,7162,12793,6,2,-10.0,-0.9374084606744876,10.0,0.17460757394239454,0.4116236322237513,3.9574758459314574,90,50,40,1,-1.3961519237276474,-1.170500554541026,-1.5606674060547012,0.5793635993153621,4.8407645544112,4.8407645544112,-1.5606674060547012,-1.170500554541026,0,1,1,0,-1.170500554541026,-1.5606674060547012
922,4,203,25,80,88,1,9090.346,94,1104.882,MORE,-1088,4415,3327,4,2,8.0,0.7499267685395902,8.0,-0.17460757394239454,0.8728265814940609,0.5048520773308484,168,80,88,0,0.1595602198545883,0.0,0.31213348121094026,-0.12289530894568271,-1.1732413423643322,1.1732413423643322,0.31213348121094026,0.0,1,1,0,1,0.31213348121094026,0.0
923,4,204,42,115,110,0,2248.756,84,1327.852,MORE,150,1528,1678,4,2,-5.0,-0.4687042303372438,5.0,-0.6984302957695783,0.4116236322237513,-0.7000651678949059,225,115,110,1,1.2964267863185297,1.3655839802978638,1.170500554541026,-0.12289530894568271,-0.06513905032561979,0.06513905032561979,1.170500554541026,1.3655839802978638,1,1,0,2,1.3655839802978638,1.170500554541026
924,4,205,53,103,110,1,6266.904,94,1491.438,MORE,1271,2352,3623,4,1,7.0,0.6561859224721414,7.0,-0.34921514788478913,0.8728265814940609,0.0075972057739889624,213,103,110,0,1.0570864565366473,0.8973837584814532,1.170500554541026,-0.12289530894568271,0.9382395194444905,0.9382395194444905,1.170500554541026,0.8973837584814532,1,1,1,2,1.170500554541026,0.8973837584814532
925,4,206,26,90,80,0,2477.286,80,1640.219,MORE,657,1504,2161,2,2,-10.0,-0.9374084606744876,10.0,0.17460757394239454,0.22714245251562734,-0.6598172521251154,170,90,80,1,0.19945027481823535,0.3901668515136753,0.0,-0.8251542172067275,0.38866374617165583,0.38866374617165583,0.0,0.3901668515136753,0,0,1,1,0.3901668515136753,0.0
926,4,207,35,80,72,1,3713.833,94,1300.195,MORE,1015,1343,2358,3,2,-8.0,-0.7499267685395902,8.0,-0.17460757394239454,0.8728265814940609,-0.4420408573349904,152,80,72,1,-0.1595602198545883,0.0,-0.31213348121094026,-0.4740247630762051,0.709100434822592,0.709100434822592,-0.31213348121094026,0.0,1,0,1,1,0.0,-0.31213348121094026
927,4,208,28,93,80,0,3301.402,74,1015.732,MORE,145,1420,1565,4,1,-13.0,-1.218630998876834,13.0,0.6984302957695783,-0.04957931704655842,-0.5146767832477831,173,93,80,1,0.25928535726370594,0.5072169069677779,0.0,-0.12289530894568271,-0.06961442307214125,0.06961442307214125,0.0,0.5072169069677779,0,1,0,1,0.5072169069677779,0.0
928,4,209,26,80,90,1,4661.243,84,1549.132,MORE,1159,1430,2589,4,2,10.0,0.9374084606744876,10.0,0.17460757394239454,0.4116236322237513,-0.2751862742191749,170,80,90,0,0.19945027481823535,0.0,0.3901668515136753,-0.12289530894568271,0.83799116992241,0.83799116992241,0.3901668515136753,0.0,0,1,1,1,0.3901668515136753,0.0
929,4,210,25,88,80,0,7973.228,84,874.623,MORE,1595,2771,4366,7,2,-8.0,-0.7499267685395902,8.0,-0.17460757394239454,0.4116236322237513,0.3081091063033381,168,88,80,1,0.1595602198545883,0.31213348121094026,0.0,0.9304930534458845,1.2282436734190807,1.2282436734190807,0.0,0.31213348121094026,0,1,1,1,0.31213348121094026,0.0
930,4,211,36,80,70,0,23899.959,54,1707.359,MORE,-901,10086,9185,7,2,-10.0,-0.9374084606744876,10.0,0.17460757394239454,-0.9719852155871778,3.113070064497504,150,80,70,1,-0.19945027481823535,0.0,-0.3901668515136753,0.9304930534458845,-1.0058624016444297,1.0058624016444297,-0.3901668515136753,0.0,0,1,0,1,0.0,-0.3901668515136753
931,4,212,28,80,93,1,9832.332,94,868.877,MORE,1322,3741,5063,4,2,13.0,1.218630998876834,13.0,0.6984302957695783,0.8728265814940609,0.6355280937416647,173,80,93,0,0.25928535726370594,0.0,0.5072169069677779,-0.12289530894568271,0.9838883214590093,0.9838883214590093,0.5072169069677779,0.0,1,1,1,1,0.5072169069677779,0.0
932,4,213,21,82,80,1,8348.35,84,895.7189999999998,MORE,1622,3073,4695,5,2,-2.0,-0.18748169213489754,2.0,-1.222253017596762,0.4116236322237513,0.37417429975450606,162,82,80,1,0.03989005496364707,0.07803337030273506,0.0,0.22823414518483967,1.2524106862502966,1.2524106862502966,0.0,0.07803337030273506,0,1,1,1,0.07803337030273506,0.0
933,4,214,19,50,41,1,6603.464,74,1542.974,MORE,1091,2584,3675,5,2,-9.0,-0.8436676146070391,9.0,0.0,-0.04957931704655842,0.06687099272310157,91,50,41,1,-1.376206896245824,-1.170500554541026,-1.5216507209033339,0.22823414518483967,0.7771261005697182,0.7771261005697182,-1.5216507209033339,-1.170500554541026,0,1,1,0,-1.170500554541026,-1.5216507209033339
934,4,215,56,96,110,1,1956.746,74,2460.617,MORE,1026,511,1537,1,2,14.0,1.3123718449442827,14.0,0.8730378697119728,-0.04957931704655842,-0.7514929624248872,206,96,110,0,0.9174712641638826,0.6242669624218805,1.170500554541026,-1.17628367133725,0.7189462548649392,0.7189462548649392,1.170500554541026,0.6242669624218805,0,0,1,2,1.170500554541026,0.6242669624218805
935,4,216,23,80,85,1,7123.875,94,1315.515,MORE,352,3368,3720,5,2,5.0,0.4687042303372438,5.0,-0.6984302957695783,0.8728265814940609,0.15852398398758544,165,80,85,0,0.09972513740911768,0.0,0.19508342575683765,0.22823414518483967,0.11566600863384702,0.11566600863384702,0.19508342575683765,0.0,1,1,0,1,0.19508342575683765,0.0
936,4,217,10,60,50,0,4671.155,64,1529.473,MORE,465,1244,1709,3,1,-10.0,-0.9374084606744876,10.0,0.17460757394239454,-0.5107822663168681,-0.27344060694962546,110,60,50,1,-0.9972513740911768,-0.7803337030273506,-1.170500554541026,-0.4740247630762051,0.2168094327052319,0.2168094327052319,-1.170500554541026,-0.7803337030273506,0,0,0,0,-0.7803337030273506,-1.170500554541026
937,4,218,19,41,50,1,2589.862,94,1512.231,MORE,589,996,1585,3,2,9.0,0.8436676146070391,9.0,0.0,0.8728265814940609,-0.6399907550975918,91,41,50,0,-1.376206896245824,-1.5216507209033339,-1.170500554541026,-0.4740247630762051,0.327798676818964,0.327798676818964,-1.170500554541026,-1.5216507209033339,1,0,1,0,-1.5216507209033339,-1.170500554541026
938,4,219,56,110,96,0,2795.518,84,2422.467,MORE,-750,1576,826,2,1,-14.0,-1.3123718449442827,14.0,0.8730378697119728,0.4116236322237513,-0.6037713293523853,206,110,96,1,0.9174712641638826,1.170500554541026,0.6242669624218805,-0.8251542172067275,-0.8707061446994817,0.8707061446994817,0.6242669624218805,1.170500554541026,1,0,0,2,1.170500554541026,0.6242669624218805
939,4,220,35,72,80,1,10457.271,94,789.193,MORE,-220,4410,4190,5,2,8.0,0.7499267685395902,8.0,-0.17460757394239454,0.8728265814940609,0.7455901960182025,152,72,80,0,-0.1595602198545883,-0.31213348121094026,0.0,0.22823414518483967,-0.39631663356820745,0.39631663356820745,0.0,-0.31213348121094026,1,1,0,1,-0.31213348121094026,0.0
940,4,221,11,49,50,1,19451.716,74,1977.379,MORE,2458,6317,8775,11,2,1.0,0.09374084606744876,1.0,-1.3968605915391563,-0.04957931704655842,2.3296608421303726,99,49,50,0,-1.2166466763912356,-1.2095172396923934,-1.170500554541026,2.335010869967974,2.000693009468684,2.000693009468684,-1.170500554541026,-1.2095172396923934,0,1,1,0,-1.2095172396923934,-1.170500554541026
941,4,222,17,43,50,1,3254.627,94,2336.704,MORE,1181,1262,2443,3,2,7.0,0.6561859224721414,7.0,-0.34921514788478913,0.8728265814940609,-0.5229146349964898,93,43,50,0,-1.3363168412821769,-1.4436173506005987,-1.170500554541026,-0.4740247630762051,0.8576828100071043,0.8576828100071043,-1.170500554541026,-1.4436173506005987,1,0,1,0,-1.4436173506005987,-1.170500554541026
942,4,223,1,51,50,1,3079.733,84,2434.106,MORE,-504,1769,1265,3,1,-1.0,-0.09374084606744876,1.0,-1.3968605915391563,0.4116236322237513,-0.5537163633500616,101,51,50,1,-1.1767566214275886,-1.1314838693896585,-1.170500554541026,-0.4740247630762051,-0.6505178055706261,0.6505178055706261,-1.170500554541026,-1.1314838693896585,1,0,0,0,-1.1314838693896585,-1.170500554541026
943,4,224,41,112,110,1,3459.986,94,1680.285,MORE,1204,1038,2242,3,2,-2.0,-0.18748169213489754,2.0,-1.222253017596762,0.8728265814940609,-0.4867475158674109,222,112,110,1,1.2365917038730592,1.248533924843761,1.170500554541026,-0.4740247630762051,0.8782695246411031,0.8782695246411031,1.170500554541026,1.248533924843761,1,0,1,2,1.248533924843761,1.170500554541026
944,4,225,20,40,50,1,15340.949,100,3601.285,MORE,-1931,7003,5072,9,2,10.0,0.9374084606744876,10.0,0.17460757394239454,1.1495483510562468,1.6056867294745516,90,40,50,0,-1.3961519237276474,-1.5606674060547012,-1.170500554541026,1.6327519617069293,-1.9277891874278497,1.9277891874278497,-1.170500554541026,-1.5606674060547012,1,1,0,0,-1.5606674060547012,-1.170500554541026
945,4,226,1,50,51,1,19093.958,44,1942.265,MORE,2136,6912,9048,8,1,1.0,0.09374084606744876,1.0,-1.3968605915391563,-1.4331881648574871,2.2666537364988635,101,50,51,0,-1.1767566214275886,-1.170500554541026,-1.1314838693896585,1.281622507576407,1.7124790045927023,1.7124790045927023,-1.1314838693896585,-1.170500554541026,0,1,1,0,-1.170500554541026,-1.1314838693896585
946,4,227,23,85,80,1,13427.761,94,2238.684,MORE,-925,6123,5198,8,2,-5.0,-0.4687042303372438,5.0,-0.6984302957695783,0.8728265814940609,1.2687426544044331,165,85,80,1,0.09972513740911768,0.19508342575683765,0.0,1.281622507576407,-1.0273441908277328,1.0273441908277328,0.0,0.19508342575683765,1,1,0,1,0.19508342575683765,0.0
947,4,228,11,50,49,1,6109.62,94,2826.025,MORE,-177,2683,2506,5,2,-1.0,-0.09374084606744876,1.0,-1.3968605915391563,0.8728265814940609,-0.02010311008798,99,50,49,1,-1.2166466763912356,-1.170500554541026,-1.2095172396923934,0.22823414518483967,-0.357828427948123,0.357828427948123,-1.2095172396923934,-1.170500554541026,1,1,0,0,-1.170500554541026,-1.2095172396923934
948,4,229,17,50,43,0,8288.198,54,2579.258,MORE,-904,4219,3315,6,1,-7.0,-0.6561859224721414,7.0,-0.34921514788478913,-0.9719852155871778,0.3635805368814283,93,50,43,1,-1.3363168412821769,-1.170500554541026,-1.4436173506005987,0.5793635993153621,-1.0085476252923427,1.0085476252923427,-1.4436173506005987,-1.170500554541026,0,1,0,0,-1.170500554541026,-1.4436173506005987
949,4,230,21,80,82,1,1916.633,100,1835.514,MORE,519,610,1129,2,1,2.0,0.18748169213489754,2.0,-1.222253017596762,1.1495483510562468,-0.7585575257000526,162,80,82,0,0.03989005496364707,0.0,0.07803337030273506,-0.8251542172067275,0.2651434583676637,0.2651434583676637,0.07803337030273506,0.0,1,0,0,1,0.07803337030273506,0.0
950,4,231,10,50,60,1,7507.571999999999,94,2338.874,MORE,1030,2693,3723,5,2,10.0,0.9374084606744876,10.0,0.17460757394239454,0.8728265814940609,0.22609937687745246,110,50,60,0,-0.9972513740911768,-1.170500554541026,-0.7803337030273506,0.22823414518483967,0.7225265530621564,0.7225265530621564,-0.7803337030273506,-1.170500554541026,1,1,1,0,-1.170500554541026,-0.7803337030273506
951,4,232,3,53,50,0,13232.992,54,2339.615,MORE,1189,5276,6465,6,1,-3.0,-0.28122253820234633,3.0,-1.0476454436543674,-0.9719852155871778,1.2344406095675786,103,53,50,1,-1.1368665664639415,-1.0534504990869233,-1.170500554541026,0.5793635993153621,0.8648434064015387,0.8648434064015387,-1.170500554541026,-1.0534504990869233,0,1,1,0,-1.0534504990869233,-1.170500554541026
952,4,233,45,122,110,0,11606.772,54,2165.651,MORE,1968,4044,6012,8,1,-12.0,-1.124890152809385,12.0,0.5238227218271837,-0.9719852155871778,0.9480363493691414,232,122,110,1,1.4360419786912946,1.6387007763574364,1.170500554541026,1.281622507576407,1.5621064803095814,1.5621064803095814,1.170500554541026,1.6387007763574364,0,1,1,2,1.6387007763574364,1.170500554541026
953,4,234,38,67,80,1,12451.409,94,968.813999999,MORE,-770,5552,4782,6,2,13.0,1.218630998876834,13.0,0.6984302957695783,0.8728265814940609,1.0967909060227474,147,67,80,0,-0.25928535726370594,-0.5072169069677779,0.0,0.5793635993153621,-0.8886076356855676,0.8886076356855676,0.0,-0.5072169069677779,1,1,0,1,-0.5072169069677779,0.0
954,4,235,38,80,67,0,18886.015,84,1100.562,MORE,-2794,8438,5644,10,2,-13.0,-1.218630998876834,13.0,0.6984302957695783,0.4116236322237513,2.2300315321978195,147,80,67,1,-0.25928535726370594,0.0,-0.5072169069677779,1.9838814158374516,-2.700238523477453,2.700238523477453,-0.5072169069677779,0.0,0,1,0,1,0.0,-0.5072169069677779
955,4,236,36,70,80,1,1614.061,14,502.289,MORE,395,516,911,1,2,10.0,0.9374084606744876,10.0,0.17460757394239454,-2.8167970126684163,-0.8118454632587849,150,70,80,0,-0.19945027481823535,-0.3901668515136753,0.0,-1.17628367133725,0.15415421425393153,0.15415421425393153,0.0,-0.3901668515136753,0,0,0,1,-0.3901668515136753,0.0
956,4,237,45,110,122,0,7399.05,84,2198.369,MORE,-1433,3892,2459,6,1,12.0,1.124890152809385,12.0,0.5238227218271837,0.4116236322237513,0.20698685635424247,232,110,122,0,1.4360419786912946,1.170500554541026,1.6387007763574364,0.5793635993153621,-1.4820420618743126,1.4820420618743126,1.6387007763574364,1.170500554541026,0,1,0,2,1.6387007763574364,1.170500554541026
957,4,238,42,110,115,1,1900.737,94,3477.038,MORE,427,755,1182,1,2,5.0,0.4687042303372438,5.0,-0.6984302957695783,0.8728265814940609,-0.7613570744204683,225,110,115,0,1.2964267863185297,1.170500554541026,1.3655839802978638,-1.17628367133725,0.18279659983166885,0.18279659983166885,1.3655839802978638,1.170500554541026,1,0,0,2,1.3655839802978638,1.170500554541026
958,4,239,41,110,112,1,3355.031,100,1088.039,MORE,879,1088,1967,3,2,2.0,0.18748169213489754,2.0,-1.222253017596762,1.1495483510562468,-0.5052318286474327,222,110,112,0,1.2365917038730592,1.170500554541026,1.248533924843761,-0.4740247630762051,0.5873702961172085,0.5873702961172085,1.248533924843761,1.170500554541026,1,0,1,2,1.248533924843761,1.170500554541026
959,4,240,53,110,103,1,3006.93,100,2546.3,MORE,1135,1047,2182,3,2,-7.0,-0.6561859224721414,7.0,-0.34921514788478913,1.1495483510562468,-0.5665381767303096,213,110,103,1,1.0570864565366473,1.170500554541026,0.8973837584814532,-0.4740247630762051,0.816509380739107,0.816509380739107,0.8973837584814532,1.170500554541026,1,0,1,2,1.170500554541026,0.8973837584814532
960,5,1,49,110,131,0,7222.438,64,1544.631,LESS,-294,3310,3016,8,1,21.0,1.9685577674164243,21.0,2.0952908873087353,-0.9173286442120084,1.051231771124287,241,110,131,1,1.6155472260277064,1.170500554541026,1.9898509427197442,1.5055579497809068,-0.895369797284916,0.895369797284916,1.9898509427197442,1.170500554541026,0,1,0,2,1.9898509427197442,1.170500554541026
961,5,2,13,47,50,0,4765.239000000001,54,936.432,LESS,-192,2140,1948,6,1,3.0,0.28122253820234633,3.0,-1.0476454436543674,-1.400133193797276,-0.042278417069183616,97,47,50,1,-1.2565367313548828,-1.2875506099951286,-1.170500554541026,0.5496481403962042,-0.7511206848299324,0.7511206848299324,-1.170500554541026,-1.2875506099951286,0,1,0,0,-1.2875506099951286,-1.170500554541026
962,5,3,16,50,44,1,3295.646,94,1258.302,LESS,564,1528,2092,3,2,-6.0,-0.5624450764046927,6.0,-0.5238227218271837,0.5310850045437943,-0.6962811730518327,94,50,44,0,-1.3163718138003533,-1.170500554541026,-1.4046006654492311,-0.8842165736808498,0.31801979571876876,0.31801979571876876,-1.4046006654492311,-1.170500554541026,1,0,1,0,-1.170500554541026,-1.4046006654492311
963,5,4,7,57,50,1,2944.05,74,724.291,LESS,124,1310,1434,3,2,-7.0,-0.6561859224721414,7.0,-0.34921514788478913,-0.4345240946267408,-0.8527494965893531,107,57,50,0,-1.0570864565366473,-0.8973837584814532,-1.170500554541026,-0.8842165736808498,-0.3042312776164542,0.3042312776164542,-1.170500554541026,-0.8973837584814532,0,0,0,0,-0.8973837584814532,-1.170500554541026
964,5,5,18,42,50,0,4044.965,84,1578.6070000000002,LESS,194,1670,1864,4,2,8.0,0.7499267685395902,8.0,-0.17460757394239454,0.048280454958526765,-0.3628169478478733,92,42,50,1,-1.3562618687640005,-1.4826340357519663,-1.170500554541026,-0.40626166898849847,-0.2052367886767596,0.2052367886767596,-1.170500554541026,-1.4826340357519663,1,0,0,0,-1.4826340357519663,-1.170500554541026
965,5,6,51,108,110,1,5083.667,64,1344.185,LESS,802,2152,2954,4,2,2.0,0.18748169213489754,2.0,-1.222253017596762,-0.9173286442120084,0.0994293820167144,218,108,110,1,1.156811593945765,1.092467184238291,1.170500554541026,-0.40626166898849847,0.6546010581137303,0.6546010581137303,1.170500554541026,1.092467184238291,0,0,1,2,1.170500554541026,1.092467184238291
966,5,7,31,78,80,0,2478.845,94,1848.898,LESS,238,1438,1676,2,2,2.0,0.18748169213489754,2.0,-1.222253017596762,0.5310850045437943,-1.0597764435718906,158,78,80,1,-0.03989005496364707,-0.07803337030273506,0.0,-1.3621714783732013,-0.1430116813432373,0.1430116813432373,0.0,-0.07803337030273506,1,0,0,1,-0.07803337030273506,0.0
967,5,8,58,110,92,0,6831.774,84,1540.628,LESS,188,3190,3378,5,2,-18.0,-1.6873352292140782,18.0,1.571468165481551,0.048280454958526765,0.8773772871527348,202,110,92,0,0.8376911542365885,1.170500554541026,0.4682002218164104,0.07169323570385287,-0.21372203058587627,0.21372203058587627,0.4682002218164104,1.170500554541026,1,1,0,2,1.170500554541026,0.4682002218164104
968,5,9,12,50,48,0,7215.97,84,1853.52,LESS,1224,3128,4352,7,2,-2.0,-0.18748169213489754,2.0,-1.222253017596762,0.048280454958526765,1.0483533620506893,98,50,48,0,-1.2365917038730592,-1.170500554541026,-1.248533924843761,1.0276030450885556,1.2513964057216032,1.2513964057216032,-1.248533924843761,-1.170500554541026,1,1,1,0,-1.170500554541026,-1.248533924843761
969,5,10,54,110,101,0,7304.288,54,1411.2679999999998,LESS,-264,3270,3006,6,1,-9.0,-0.8436676146070391,9.0,0.0,-1.400133193797276,1.087656907592125,211,110,101,0,1.0171964015730004,1.170500554541026,0.8193503881787182,0.5496481403962042,-0.8529435877393325,0.8529435877393325,0.8193503881787182,1.170500554541026,0,1,0,2,1.170500554541026,0.8193503881787182
970,5,11,14,46,50,1,7185.6,74,1168.595,LESS,2036,2352,4388,7,2,4.0,0.3749633842697951,4.0,-0.8730378697119728,-0.4345240946267408,1.0348380120869969,96,46,50,1,-1.2764817588367063,-1.3265672951464962,-1.170500554541026,1.0276030450885556,2.39973247742206,2.39973247742206,-1.170500554541026,-1.3265672951464962,0,1,1,0,-1.3265672951464962,-1.170500554541026
971,5,12,22,80,83,1,9791.269,64,2653.804,LESS,3056,3516,6572,9,2,3.0,0.28122253820234633,3.0,-1.0476454436543674,-0.9173286442120084,2.194420772197144,163,80,83,1,0.05983508244547061,0.0,0.1170500554541026,1.9835128544732583,3.842223601971895,3.842223601971895,0.1170500554541026,0.0,0,1,1,1,0.1170500554541026,0.0
972,5,13,6,50,56,0,5181.088,84,1051.945,LESS,348,2350,2698,6,2,6.0,0.5624450764046927,6.0,-0.5238227218271837,0.048280454958526765,0.14278397236287502,106,50,56,1,-1.077031484018471,-1.170500554541026,-0.9364004436328208,0.5496481403962042,0.012551086990568417,0.012551086990568417,-0.9364004436328208,-1.170500554541026,0,1,1,0,-1.170500554541026,-0.9364004436328208
973,5,14,13,50,47,1,6220.18,94,1815.246,LESS,1098,2502,3600,5,2,-3.0,-0.28122253820234633,3.0,-1.0476454436543674,0.5310850045437943,0.6052038612161307,97,50,47,0,-1.2565367313548828,-1.170500554541026,-1.2875506099951286,0.07169323570385287,1.073206325630153,1.073206325630153,-1.2875506099951286,-1.170500554541026,1,1,1,0,-1.170500554541026,-1.2875506099951286
974,5,15,46,110,124,0,4647.5920000000015,74,1324.261,LESS,-72,2394,2322,4,2,14.0,1.3123718449442827,14.0,0.8730378697119728,-0.4345240946267408,-0.0946340435814837,234,110,124,1,1.4759320336549415,1.170500554541026,1.7167341466601715,-0.40626166898849847,-0.5814158466475989,0.5814158466475989,1.7167341466601715,1.170500554541026,0,0,0,2,1.7167341466601715,1.170500554541026
975,5,16,27,91,80,0,8988.713,64,1316.476,LESS,-488,3920,3432,7,2,-11.0,-1.0311493067419364,11.0,0.34921514788478913,-0.9173286442120084,1.837264854993938,171,91,80,0,0.21939530230005888,0.4291835366650429,0.0,1.0276030450885556,-1.1697259523463552,1.1697259523463552,0.0,0.4291835366650429,0,1,0,1,0.4291835366650429,0.0
976,5,17,40,64,80,0,3464.902,100,1387.95,LESS,454,1732,2186,4,2,16.0,1.4998535370791803,16.0,1.222253017596762,0.8207677342949549,-0.6209583520622124,144,64,80,1,-0.3191204397091766,-0.6242669624218805,0.0,-0.40626166898849847,0.16245702738496304,0.16245702738496304,0.0,-0.6242669624218805,1,0,1,1,-0.6242669624218805,0.0
977,5,18,22,83,80,0,10276.159,74,2298.076,LESS,-248,4700,4452,8,2,-3.0,-0.28122253820234633,3.0,-1.0476454436543674,-0.4345240946267408,2.4102079978769244,163,83,80,0,0.05983508244547061,0.1170500554541026,0.0,1.5055579497809068,-0.8303162759816881,0.8303162759816881,0.0,0.1170500554541026,0,1,0,1,0.1170500554541026,0.0
978,5,19,54,101,110,0,5499.5030000000015,74,1250.655,LESS,466,2330,2796,6,2,9.0,0.8436676146070391,9.0,0.0,-0.4345240946267408,0.284485986149152,211,101,110,1,1.0171964015730004,0.8193503881787182,1.170500554541026,0.5496481403962042,0.1794275112031964,0.1794275112031964,1.170500554541026,0.8193503881787182,0,1,1,2,1.170500554541026,0.8193503881787182
979,5,20,6,56,50,1,6396.53,84,1882.386,LESS,1716,2336,4052,6,2,-6.0,-0.5624450764046927,6.0,-0.5238227218271837,0.048280454958526765,0.6836836757073127,106,56,50,0,-1.077031484018471,-0.9364004436328208,-1.170500554541026,0.5496481403962042,1.9471862422691706,1.9471862422691706,-1.170500554541026,-0.9364004436328208,1,1,1,0,-0.9364004436328208,-1.170500554541026
980,5,21,18,50,42,0,3607.382,84,1577.839,LESS,430,1782,2212,4,2,-8.0,-0.7499267685395902,8.0,-0.17460757394239454,0.048280454958526765,-0.557551468202254,92,50,42,0,-1.3562618687640005,-1.170500554541026,-1.4826340357519663,-0.40626166898849847,0.12851605974849634,0.12851605974849634,-1.4826340357519663,-1.170500554541026,1,0,1,0,-1.170500554541026,-1.4826340357519663
981,5,22,43,110,117,0,4718.766,94,1782.365,LESS,28,2580,2608,4,2,7.0,0.6561859224721414,7.0,-0.34921514788478913,0.5310850045437943,-0.06295997317266451,227,110,117,1,1.3363168412821769,1.170500554541026,1.4436173506005987,-0.40626166898849847,-0.439995148162321,0.439995148162321,1.4436173506005987,1.170500554541026,1,0,0,2,1.4436173506005987,1.170500554541026
982,5,23,32,77,80,0,6240.307,100,1423.497,LESS,302,3126,3428,6,2,3.0,0.28122253820234633,3.0,-1.0476454436543674,0.8207677342949549,0.614160840100531,157,77,80,1,-0.05983508244547061,-0.1170500554541026,0.0,0.5496481403962042,-0.052502434312659434,0.052502434312659434,0.0,-0.1170500554541026,1,1,1,1,-0.1170500554541026,0.0
983,5,24,27,80,91,0,3710.405,100,2037.012,LESS,490,1854,2344,4,2,11.0,1.0311493067419364,11.0,0.34921514788478913,0.8207677342949549,-0.5117038587419473,171,80,91,1,0.21939530230005888,0.0,0.4291835366650429,-0.40626166898849847,0.2133684788396631,0.2133684788396631,0.4291835366650429,0.0,1,0,1,1,0.4291835366650429,0.0
984,5,25,16,44,50,0,4812.778,90,1891.045,LESS,324,2618,2942,4,2,6.0,0.5624450764046927,6.0,-0.5238227218271837,0.3379631847096873,-0.0211224663966788,94,44,50,1,-1.3163718138003533,-1.4046006654492311,-1.170500554541026,-0.40626166898849847,-0.021389880645898286,0.021389880645898286,-1.170500554541026,-1.4046006654492311,1,0,1,0,-1.4046006654492311,-1.170500554541026
985,5,26,7,50,57,0,3689.549,100,1099.108,LESS,-230,2138,1908,4,2,7.0,0.6561859224721414,7.0,-0.34921514788478913,0.8207677342949549,-0.5209852594282423,107,50,57,1,-1.0570864565366473,-1.170500554541026,-0.8973837584814532,-0.40626166898849847,-0.804860550254338,0.804860550254338,-0.8973837584814532,-1.170500554541026,1,0,0,0,-1.170500554541026,-0.8973837584814532
986,5,27,14,50,46,0,7967.58,90,1302.56,LESS,826,3218,4044,8,2,-4.0,-0.3749633842697951,4.0,-0.8730378697119728,0.3379631847096873,1.3828371350573097,96,50,46,0,-1.2764817588367063,-1.170500554541026,-1.3265672951464962,1.5055579497809068,0.688542025750197,0.688542025750197,-1.3265672951464962,-1.170500554541026,1,1,1,0,-1.170500554541026,-1.3265672951464962
987,5,28,51,110,108,1,6837.9659999999985,74,1694.565,LESS,252,3008,3260,7,2,-2.0,-0.18748169213489754,2.0,-1.222253017596762,-0.4345240946267408,0.8801328698651207,218,110,108,0,1.156811593945765,1.170500554541026,1.092467184238291,1.0276030450885556,-0.1232127835552984,0.1232127835552984,1.092467184238291,1.170500554541026,0,1,0,2,1.170500554541026,1.092467184238291
988,5,29,50,133,110,1,3779.256,74,1478.918,LESS,286,1268,1554,3,2,-23.0,-2.1560394595513217,23.0,2.444506035193524,-0.4345240946267408,-0.4810635768733204,243,133,110,0,1.6554372809913533,2.0678843130224793,1.170500554541026,-0.8842165736808498,-0.0751297460703039,0.0751297460703039,1.170500554541026,2.0678843130224793,0,0,0,2,2.0678843130224793,1.170500554541026
989,5,30,49,131,110,1,3215.512,84,764.005,LESS,750,1238,1988,3,2,-21.0,-1.9685577674164243,21.0,2.0952908873087353,0.048280454958526765,-0.7319426499695327,241,131,110,0,1.6155472260277064,1.9898509427197442,1.170500554541026,-0.8842165736808498,0.5810622949013857,0.5810622949013857,1.170500554541026,1.9898509427197442,0,0,1,2,1.9898509427197442,1.170500554541026
990,5,31,47,126,110,1,3665.191,80,1426.142,LESS,1262,1486,2748,3,2,-16.0,-1.4998535370791803,16.0,1.222253017596762,-0.14484136487558028,-0.5318251308281642,236,126,110,0,1.5158220886185887,1.7947675169629065,1.170500554541026,-0.8842165736808498,1.3051362711460088,1.3051362711460088,1.170500554541026,1.7947675169629065,0,0,1,2,1.7947675169629065,1.170500554541026
991,5,32,50,110,133,0,6854.611999999999,64,1179.632,LESS,204,3166,3370,6,2,23.0,2.1560394595513217,23.0,2.444506035193524,-0.9173286442120084,0.8875407235198998,243,110,133,1,1.6554372809913533,1.170500554541026,2.0678843130224793,0.5496481403962042,-0.1910947188282318,0.1910947188282318,2.0678843130224793,1.170500554541026,0,1,0,2,2.0678843130224793,1.170500554541026
992,5,33,47,110,126,0,4058.527,14,1981.72,LESS,-962,2374,1412,4,1,16.0,1.4998535370791803,16.0,1.222253017596762,-3.3313513921383464,-0.3567815452727137,236,110,126,1,1.5158220886185887,1.170500554541026,1.7947675169629065,-0.40626166898849847,-1.8400600631665724,1.8400600631665724,1.7947675169629065,1.170500554541026,0,0,0,2,1.7947675169629065,1.170500554541026
993,5,34,12,48,50,0,9497.24,44,1082.924,LESS,38,3864,3902,8,1,2.0,0.18748169213489754,2.0,-1.222253017596762,-1.8829377433825436,2.0635710904561297,98,48,50,1,-1.2365917038730592,-1.248533924843761,-1.170500554541026,1.5055579497809068,-0.4258530783137932,0.4258530783137932,-1.170500554541026,-1.248533924843761,0,1,0,0,-1.248533924843761,-1.170500554541026
994,5,35,32,80,77,0,5471.917,74,1513.739,LESS,150,2362,2512,5,2,-3.0,-0.28122253820234633,3.0,-1.0476454436543674,-0.4345240946267408,0.272209580350718,157,80,77,0,-0.05983508244547061,0.0,-0.1170500554541026,0.07169323570385287,-0.2674618960102819,0.2674618960102819,-0.1170500554541026,0.0,0,1,0,1,0.0,-0.1170500554541026
995,5,36,43,117,110,1,2581.39,94,1520.381,LESS,1032,1014,2046,3,2,-7.0,-0.6561859224721414,7.0,-0.34921514788478913,0.5310850045437943,-1.0141415551284638,227,117,110,0,1.3363168412821769,1.4436173506005987,1.170500554541026,-0.8842165736808498,0.9798686646298695,0.9798686646298695,1.170500554541026,1.4436173506005987,1,0,1,2,1.4436173506005987,1.170500554541026
996,5,37,40,80,64,1,2750.297,100,824.22,LESS,400,1206,1606,3,2,-16.0,-1.4998535370791803,16.0,1.222253017596762,0.8207677342949549,-0.9389740471825488,144,80,64,0,-0.3191204397091766,0.0,-0.6242669624218805,-0.8842165736808498,0.08608985020291295,0.08608985020291295,-0.6242669624218805,0.0,1,0,1,1,0.0,-0.6242669624218805
997,5,38,31,80,78,0,6351.305,84,879.607,LESS,784,2550,3334,7,2,-2.0,-0.18748169213489754,2.0,-1.222253017596762,0.048280454958526765,0.6635575083675697,158,80,78,0,-0.03989005496364707,0.0,-0.07803337030273506,1.0276030450885556,0.6291453323863803,0.6291453323863803,-0.07803337030273506,0.0,1,1,1,1,0.0,-0.07803337030273506
998,5,39,46,124,110,1,1710.409,84,1649.001,LESS,768,736,1504,1,2,-14.0,-1.3123718449442827,14.0,0.8730378697119728,0.048280454958526765,-1.4017481743819056,234,124,110,0,1.4759320336549415,1.7167341466601715,1.170500554541026,-1.8401263830655525,0.6065180206287357,0.6065180206287357,1.170500554541026,1.7167341466601715,1,0,1,2,1.7167341466601715,1.170500554541026
999,5,40,58,92,110,0,5981.896,74,2039.069,LESS,388,3204,3592,6,2,18.0,1.6873352292140782,18.0,1.571468165481551,-0.4345240946267408,0.4991619892784106,202,92,110,1,0.8376911542365885,0.4682002218164104,1.170500554541026,0.5496481403962042,0.0691193663846796,0.0691193663846796,1.170500554541026,0.4682002218164104,0,1,1,2,1.170500554541026,0.4682002218164104
1000,5,41,49,110,131,1,2956.698,100,1062.088,MORE,738,1080,1818,3,2,21.0,1.9685577674164243,21.0,2.0952908873087353,0.8207677342949549,-0.8471208450799431,241,110,131,0,1.6155472260277064,1.170500554541026,1.9898509427197442,-0.8842165736808498,0.5640918110831523,0.5640918110831523,1.9898509427197442,1.170500554541026,1,0,1,2,1.9898509427197442,1.170500554541026
1001,5,42,13,47,50,0,3701.877,100,1361.938,MORE,454,1828,2282,4,2,3.0,0.28122253820234633,3.0,-1.0476454436543674,0.8207677342949549,-0.5154990152941493,97,47,50,0,-1.2565367313548828,-1.2875506099951286,-1.170500554541026,-0.40626166898849847,0.16245702738496304,0.16245702738496304,-1.170500554541026,-1.2875506099951286,1,1,1,0,-1.2875506099951286,-1.170500554541026
1002,5,43,16,50,44,0,3152.05,0,3701.378,MORE,-160,2544,2384,4,1,-6.0,-0.5624450764046927,6.0,-0.5238227218271837,-4.007277761557721,-0.7601847026332095,94,50,44,1,-1.3163718138003533,-1.170500554541026,-1.4046006654492311,-0.40626166898849847,-0.7058660613146435,0.7058660613146435,-1.4046006654492311,-1.170500554541026,0,1,0,0,-1.170500554541026,-1.4046006654492311
1003,5,44,7,57,50,0,3153.11,84,816.4019999999998,MORE,-152,1542,1390,4,2,-7.0,-0.6561859224721414,7.0,-0.34921514788478913,0.048280454958526765,-0.7597129782024715,107,57,50,1,-1.0570864565366473,-0.8973837584814532,-1.170500554541026,-0.40626166898849847,-0.6945524054358213,0.6945524054358213,-1.170500554541026,-0.8973837584814532,0,1,0,0,-0.8973837584814532,-1.170500554541026
1004,5,45,18,42,50,1,2396.847,84,929.394,MORE,658,1072,1730,3,2,8.0,0.7499267685395902,8.0,-0.17460757394239454,0.048280454958526765,-1.0962674434508128,92,42,50,0,-1.3562618687640005,-1.4826340357519663,-1.170500554541026,-0.8842165736808498,0.45095525229493,0.45095525229493,-1.170500554541026,-1.4826340357519663,0,0,1,0,-1.4826340357519663,-1.170500554541026
1005,5,46,51,108,110,0,4489.472,64,1426.064,MORE,-640,2286,1646,4,2,2.0,0.18748169213489754,2.0,-1.222253017596762,-0.9173286442120084,-0.1650010879100682,218,108,110,0,1.156811593945765,1.092467184238291,1.170500554541026,-0.40626166898849847,-1.3846854140439775,1.3846854140439775,1.170500554541026,1.092467184238291,0,1,0,2,1.170500554541026,1.092467184238291
1006,5,47,31,78,80,1,3855.439,84,2873.1040000000007,MORE,1186,1744,2930,3,2,2.0,0.18748169213489754,2.0,-1.222253017596762,0.048280454958526765,-0.4471603860177392,158,78,80,0,-0.03989005496364707,-0.07803337030273506,0.0,-0.8842165736808498,1.1976565402971975,1.1976565402971975,0.0,-0.07803337030273506,0,0,1,1,-0.07803337030273506,0.0
1007,5,48,58,110,92,0,4038.037,100,1776.229,MORE,238,2000,2238,4,2,-18.0,-1.6873352292140782,18.0,1.571468165481551,0.8207677342949549,-0.3659000675234896,202,110,92,1,0.8376911542365885,1.170500554541026,0.4682002218164104,-0.40626166898849847,-0.1430116813432373,0.1430116813432373,0.4682002218164104,1.170500554541026,1,0,0,2,1.170500554541026,0.4682002218164104
1008,5,49,12,50,48,1,4217.473,74,1237.2,MORE,970,1776,2746,5,2,-2.0,-0.18748169213489754,2.0,-1.222253017596762,-0.4345240946267408,-0.2860469119065926,98,50,48,1,-1.2365917038730592,-1.170500554541026,-1.248533924843761,0.07169323570385287,0.8921878315689972,0.8921878315689972,-1.248533924843761,-1.170500554541026,0,1,1,0,-1.170500554541026,-1.248533924843761
1009,5,50,54,110,101,0,3315.376,80,1091.207,MORE,422,1532,1954,3,2,-9.0,-0.8436676146070391,9.0,0.0,-0.14484136487558028,-0.6875008683174351,211,110,101,1,1.0171964015730004,1.170500554541026,0.8193503881787182,-0.8842165736808498,0.1172024038696741,0.1172024038696741,0.8193503881787182,1.170500554541026,0,0,1,2,1.170500554541026,0.8193503881787182
1010,5,51,14,46,50,0,3757.45,64,1166.957,MORE,320,1836,2156,3,2,4.0,0.3749633842697951,4.0,-0.8730378697119728,-0.9173286442120084,-0.49076774945508794,96,46,50,0,-1.2764817588367063,-1.3265672951464962,-1.170500554541026,-0.8842165736808498,-0.027046708585309404,0.027046708585309404,-1.170500554541026,-1.3265672951464962,0,0,0,0,-1.3265672951464962,-1.170500554541026
1011,5,52,22,80,83,0,6773.183000000001,84,1800.97,MORE,-70,3732,3662,6,2,3.0,0.28122253820234633,3.0,-1.0476454436543674,0.048280454958526765,0.8513029417552139,163,80,83,0,0.05983508244547061,0.0,0.1170500554541026,0.5496481403962042,-0.5785874326778934,0.5785874326778934,0.1170500554541026,0.0,0,1,0,1,0.1170500554541026,0.0
1012,5,53,6,50,56,1,3177.4640000000004,94,1122.828,MORE,856,1306,2162,3,2,6.0,0.5624450764046927,6.0,-0.5238227218271837,0.5310850045437943,-0.7488748868947409,106,50,56,0,-1.077031484018471,-1.170500554541026,-0.9364004436328208,-0.8842165736808498,0.7309682352957804,0.7309682352957804,-0.9364004436328208,-1.170500554541026,0,0,1,0,-1.170500554541026,-0.9364004436328208
1013,5,54,13,50,47,0,3303.463,84,2254.048,MORE,750,1672,2422,4,2,-3.0,-0.28122253820234633,3.0,-1.0476454436543674,0.048280454958526765,-0.6928024278866636,97,50,47,1,-1.2565367313548828,-1.170500554541026,-1.2875506099951286,-0.40626166898849847,0.5810622949013857,0.5810622949013857,-1.2875506099951286,-1.170500554541026,0,1,1,0,-1.170500554541026,-1.2875506099951286
1014,5,55,46,110,124,1,2960.213,94,1147.15,MORE,954,1292,2246,3,2,14.0,1.3123718449442827,14.0,0.8730378697119728,0.5310850045437943,-0.8455565890666937,234,110,124,0,1.4759320336549415,1.170500554541026,1.7167341466601715,-0.8842165736808498,0.8695605198113527,0.8695605198113527,1.7167341466601715,1.170500554541026,0,0,1,2,1.7167341466601715,1.170500554541026
1015,5,56,27,91,80,0,15960.826,84,1694.7279999999996,MORE,-2190,6976,4786,10,2,-11.0,-1.0311493067419364,11.0,0.34921514788478913,0.048280454958526765,4.94001583232062,171,91,80,1,0.21939530230005888,0.4291835366650429,0.0,2.46146775916561,-3.5767062405657857,3.5767062405657857,0.0,0.4291835366650429,0,1,0,1,0.4291835366650429,0.0
1016,5,57,40,64,80,1,4419.742,100,1070.099,MORE,1154,1788,2942,4,2,16.0,1.4998535370791803,16.0,1.222253017596762,0.8207677342949549,-0.1960325450377694,144,64,80,0,-0.3191204397091766,-0.6242669624218805,0.0,-0.40626166898849847,1.1524019167819086,1.1524019167819086,0.0,-0.6242669624218805,1,1,1,1,-0.6242669624218805,0.0
1017,5,58,22,83,80,1,4347.116,84,2187.104,MORE,1000,1686,2686,5,2,-3.0,-0.28122253820234633,3.0,-1.0476454436543674,0.048280454958526765,-0.22835278891209104,163,83,80,1,0.05983508244547061,0.1170500554541026,0.0,0.07169323570385287,0.9346140411145806,0.9346140411145806,0.0,0.1170500554541026,0,1,1,1,0.1170500554541026,0.0
1018,5,59,54,101,110,0,5359.5909999999985,64,1381.453,MORE,346,2510,2856,5,2,9.0,0.8436676146070391,9.0,0.0,-0.9173286442120084,0.2222219214761124,211,101,110,0,1.0171964015730004,0.8193503881787182,1.170500554541026,0.07169323570385287,0.009722673020862858,0.009722673020862858,1.170500554541026,0.8193503881787182,0,1,0,2,1.170500554541026,0.8193503881787182
1019,5,60,6,56,50,0,2847.962,84,1045.647,MORE,290,1480,1770,5,2,-6.0,-0.5624450764046927,6.0,-0.5238227218271837,0.048280454958526765,-0.8955108712127086,106,56,50,1,-1.077031484018471,-0.9364004436328208,-1.170500554541026,0.07169323570385287,-0.06947291813089279,0.06947291813089279,-1.170500554541026,-0.9364004436328208,0,1,0,0,-0.9364004436328208,-1.170500554541026
1020,5,61,18,50,42,0,3925.857,100,893.5,MORE,1018,1472,2490,4,2,-8.0,-0.7499267685395902,8.0,-0.17460757394239454,0.8207677342949549,-0.41582275303310573,92,50,42,1,-1.3562618687640005,-1.170500554541026,-1.4826340357519663,-0.40626166898849847,0.9600697668419306,0.9600697668419306,-1.4826340357519663,-1.170500554541026,1,0,1,0,-1.170500554541026,-1.4826340357519663
1021,5,62,43,110,117,1,5172.947,80,957.907,MORE,1220,2052,3272,5,2,7.0,0.6561859224721414,7.0,-0.34921514788478913,-0.14484136487558028,0.13916103973019744,227,110,117,0,1.3363168412821769,1.170500554541026,1.4436173506005987,0.07169323570385287,1.245739577782192,1.245739577782192,1.4436173506005987,1.170500554541026,0,1,1,2,1.4436173506005987,1.170500554541026
1022,5,63,32,77,80,1,5052.259,94,752.1619999999998,MORE,1146,2016,3162,5,2,3.0,0.28122253820234633,3.0,-1.0476454436543674,0.5310850045437943,0.08545209812933656,157,77,80,0,-0.05983508244547061,-0.1170500554541026,0.0,0.07169323570385287,1.1410882609030863,1.1410882609030863,0.0,-0.1170500554541026,0,1,1,1,-0.1170500554541026,0.0
1023,5,64,27,80,91,1,5466.552,100,1011.834,MORE,370,2724,3094,5,2,11.0,1.0311493067419364,11.0,0.34921514788478913,0.8207677342949549,0.26982203169891616,171,80,91,0,0.21939530230005888,0.0,0.4291835366650429,0.07169323570385287,0.04366364065732956,0.04366364065732956,0.4291835366650429,0.0,1,1,0,1,0.4291835366650429,0.0
1024,5,65,16,44,50,1,3752.296,100,1101.102,MORE,204,2038,2242,3,2,6.0,0.5624450764046927,6.0,-0.5238227218271837,0.8207677342949549,-0.4930613982437898,94,44,50,0,-1.3163718138003533,-1.4046006654492311,-1.170500554541026,-0.8842165736808498,-0.1910947188282318,0.1910947188282318,-1.170500554541026,-1.4046006654492311,1,0,0,0,-1.4046006654492311,-1.170500554541026
1025,5,66,7,50,57,1,2538.419,100,1870.621,MORE,1120,1020,2140,3,2,7.0,0.6561859224721414,7.0,-0.34921514788478913,0.8207677342949549,-1.033264640518317,107,50,57,0,-1.0570864565366473,-1.170500554541026,-0.8973837584814532,-0.8842165736808498,1.104318879296914,1.104318879296914,-0.8973837584814532,-1.170500554541026,1,0,1,0,-1.170500554541026,-0.8973837584814532
1026,5,67,14,50,46,1,3357.547,84,2118.042,MORE,1178,1518,2696,3,2,-4.0,-0.3749633842697951,4.0,-0.8730378697119728,0.048280454958526765,-0.6687338013658748,96,50,46,1,-1.2764817588367063,-1.170500554541026,-1.3265672951464962,-0.8842165736808498,1.1863428844183752,1.1863428844183752,-1.3265672951464962,-1.170500554541026,0,0,1,0,-1.170500554541026,-1.3265672951464962
1027,5,68,51,110,108,1,5031.74,100,755.0369999999998,MORE,448,2200,2648,5,2,-2.0,-0.18748169213489754,2.0,-1.222253017596762,0.8207677342949549,0.07632067021017247,218,110,108,1,1.156811593945765,1.170500554541026,1.092467184238291,0.07169323570385287,0.15397178547584636,0.15397178547584636,1.092467184238291,1.170500554541026,1,1,1,2,1.170500554541026,1.092467184238291
1028,5,69,50,133,110,0,3503.936,100,872.44,MORE,-98,1846,1748,4,2,-23.0,-2.1560394595513217,23.0,2.444506035193524,0.8207677342949549,-0.6035873224118079,243,133,110,1,1.6554372809913533,2.0678843130224793,1.170500554541026,-0.40626166898849847,-0.6181852282537712,0.6181852282537712,1.170500554541026,2.0678843130224793,1,1,0,2,2.0678843130224793,1.170500554541026
1029,5,70,49,131,110,0,1993.824,100,612.242,MORE,-312,1226,914,2,2,-21.0,-1.9685577674164243,21.0,2.0952908873087353,0.8207677342949549,-1.2756219672709421,241,131,110,1,1.6155472260277064,1.9898509427197442,1.170500554541026,-1.3621714783732013,-0.920825523012266,0.920825523012266,1.170500554541026,1.9898509427197442,1,0,0,2,1.9898509427197442,1.170500554541026
1030,5,71,47,126,110,0,2816.126,84,806.5219999999998,MORE,36,1516,1552,2,2,-16.0,-1.4998535370791803,16.0,1.222253017596762,0.048280454958526765,-0.9096786249645727,236,126,110,1,1.5158220886185887,1.7947675169629065,1.170500554541026,-1.3621714783732013,-0.4286814922834987,0.4286814922834987,1.170500554541026,1.7947675169629065,0,0,0,2,1.7947675169629065,1.170500554541026
1031,5,72,50,110,133,1,2861.582000000001,94,1935.895,MORE,756,1364,2120,3,2,23.0,2.1560394595513217,23.0,2.444506035193524,0.5310850045437943,-0.8894496573007723,243,110,133,0,1.6554372809913533,1.170500554541026,2.0678843130224793,-0.8842165736808498,0.5895475368105024,0.5895475368105024,2.0678843130224793,1.170500554541026,0,0,1,2,2.0678843130224793,1.170500554541026
1032,5,73,47,110,126,1,2965.652,94,1520.4779999999996,MORE,1190,1184,2374,3,2,16.0,1.4998535370791803,16.0,1.222253017596762,0.5310850045437943,-0.8431361087093502,236,110,126,0,1.5158220886185887,1.170500554541026,1.7947675169629065,-0.8842165736808498,1.2033133682366086,1.2033133682366086,1.7947675169629065,1.170500554541026,0,0,1,2,1.7947675169629065,1.170500554541026
1033,5,74,12,48,50,1,4486.102,84,767.75,MORE,178,2064,2242,5,2,2.0,0.18748169213489754,2.0,-1.222253017596762,0.048280454958526765,-0.16650081558137686,98,48,50,0,-1.2365917038730592,-1.248533924843761,-1.170500554541026,0.07169323570385287,-0.22786410043440408,0.22786410043440408,-1.170500554541026,-1.248533924843761,0,1,0,0,-1.248533924843761,-1.170500554541026
1034,5,75,32,80,77,1,2822.192,84,993.453,MORE,948,1074,2022,3,2,-3.0,-0.28122253820234633,3.0,-1.0476454436543674,0.048280454958526765,-0.9069791151562172,157,80,77,1,-0.05983508244547061,0.0,-0.1170500554541026,-0.8842165736808498,0.861075277902236,0.861075277902236,-0.1170500554541026,0.0,0,0,1,1,0.0,-0.1170500554541026
1035,5,76,43,117,110,1,8519.964,84,2118.826,MORE,2128,3174,5302,8,2,-7.0,-0.6561859224721414,7.0,-0.34921514788478913,0.048280454958526765,1.6286607463297635,227,117,110,1,1.3363168412821769,1.4436173506005987,1.170500554541026,1.5055579497809068,2.5298395200285158,2.5298395200285158,1.170500554541026,1.4436173506005987,0,1,1,2,1.4436173506005987,1.170500554541026
1036,5,77,40,80,64,0,4165.882000000001,84,1609.565,MORE,708,1660,2368,3,2,-16.0,-1.4998535370791803,16.0,1.222253017596762,0.048280454958526765,-0.3090060959690506,144,80,64,1,-0.3191204397091766,0.0,-0.6242669624218805,-0.8842165736808498,0.521665601537569,0.521665601537569,-0.6242669624218805,0.0,0,0,1,1,0.0,-0.6242669624218805
1037,5,78,31,80,78,0,5106.462,100,688.987,MORE,470,2136,2606,6,2,-2.0,-0.18748169213489754,2.0,-1.222253017596762,0.8207677342949549,0.1095736823928216,158,80,78,1,-0.03989005496364707,0.0,-0.07803337030273506,0.5496481403962042,0.1850843391426075,0.1850843391426075,-0.07803337030273506,0.0,1,1,1,1,0.0,-0.07803337030273506
1038,5,79,46,124,110,0,5412.254,64,1815.64,MORE,-62,2240,2178,6,2,-14.0,-1.3123718449442827,14.0,0.8730378697119728,-0.9173286442120084,0.2456581702458841,234,124,110,1,1.4759320336549415,1.7167341466601715,1.170500554541026,0.5496481403962042,-0.5672737767990711,0.5672737767990711,1.170500554541026,1.7167341466601715,0,1,0,2,1.7167341466601715,1.170500554541026
1039,5,80,58,92,110,1,2672.4709999999995,94,644.867,MORE,564,1250,1814,3,2,18.0,1.6873352292140782,18.0,1.571468165481551,0.5310850045437943,-0.973608410905774,202,92,110,0,0.8376911542365885,0.4682002218164104,1.170500554541026,-0.8842165736808498,0.31801979571876876,0.31801979571876876,1.170500554541026,0.4682002218164104,0,0,1,2,1.170500554541026,0.4682002218164104
1040,5,81,48,128,110,1,4242.301,54,1752.835,LESS,228,1650,1878,5,2,-18.0,-1.6873352292140782,18.0,1.571468165481551,-1.400133193797276,-0.2749978796741735,238,128,110,0,1.5557121435822359,1.8728008872656416,1.170500554541026,0.07169323570385287,-0.1571537511917651,0.1571537511917651,1.170500554541026,1.8728008872656416,0,1,0,2,1.8728008872656416,1.170500554541026
1041,5,82,8,50,58,0,6513.653,44,1117.119,LESS,-1154,3510,2356,7,1,8.0,0.7499267685395902,8.0,-0.17460757394239454,-1.8829377433825436,0.7358061101425312,108,50,58,1,-1.0371414290548238,-1.170500554541026,-0.8583670733300858,1.0276030450885556,-2.1115878042583063,2.1115878042583063,-0.8583670733300858,-1.170500554541026,0,1,0,0,-1.170500554541026,-0.8583670733300858
1042,5,83,4,54,50,1,4276.049,4,793.846,LESS,-144,2156,2012,5,1,-4.0,-0.3749633842697951,4.0,-0.8730378697119728,-3.8141559417236137,-0.2599792418547894,104,54,50,0,-1.116921538982118,-1.0144338139355558,-1.170500554541026,0.07169323570385287,-0.683238749556999,0.683238749556999,-1.170500554541026,-1.0144338139355558,0,1,0,0,-1.0144338139355558,-1.170500554541026
1043,5,84,37,80,69,1,4416.106,74,1345.495,LESS,256,1890,2146,5,2,-11.0,-1.0311493067419364,11.0,0.34921514788478913,-0.4345240946267408,-0.19765064883981065,149,80,69,0,-0.21939530230005888,0.0,-0.4291835366650429,0.07169323570385287,-0.11755595561588729,0.11755595561588729,-0.4291835366650429,0.0,0,1,0,1,0.0,-0.4291835366650429
1044,5,85,52,105,110,0,3549.203,74,782.841,LESS,-772,1948,1176,4,1,5.0,0.4687042303372438,5.0,-0.6984302957695783,-0.4345240946267408,-0.5834424641040544,215,105,110,1,1.0969765115002945,0.9754171287841883,1.170500554541026,-0.40626166898849847,-1.5713607360445445,1.5713607360445445,1.170500554541026,0.9754171287841883,0,0,0,2,1.170500554541026,0.9754171287841883
1045,5,86,5,55,50,0,5117.803,64,1933.325,LESS,-898,2590,1692,6,2,-5.0,-0.4687042303372438,5.0,-0.6984302957695783,-0.9173286442120084,0.1146206887786705,105,55,50,0,-1.0969765115002945,-0.9754171287841883,-1.170500554541026,0.5496481403962042,-1.7495508161359947,1.7495508161359947,-1.170500554541026,-0.9754171287841883,0,1,0,0,-0.9754171287841883,-1.170500554541026
1046,5,87,30,96,80,0,10385.769,54,935.635,LESS,-842,4708,3866,11,1,-16.0,-1.4998535370791803,16.0,1.222253017596762,-1.400133193797276,2.4589869741535253,176,96,80,0,0.3191204397091766,0.6242669624218805,0.0,2.939422663857961,-1.670355224984239,1.670355224984239,0.0,0.6242669624218805,0,1,0,1,0.6242669624218805,0.0
1047,5,88,33,80,75,1,5970.382,84,811.043,LESS,962,2378,3340,7,2,-5.0,-0.4687042303372438,5.0,-0.6984302957695783,0.048280454958526765,0.4940379939052806,155,80,75,0,-0.09972513740911768,0.0,-0.19508342575683765,1.0276030450885556,0.8808741756901749,0.8808741756901749,-0.19508342575683765,0.0,1,1,1,1,0.0,-0.19508342575683765
1048,5,89,48,110,128,0,4631.856,74,1730.658,LESS,562,2172,2734,6,2,18.0,1.6873352292140782,18.0,1.571468165481551,-0.4345240946267408,-0.10163692626270501,238,110,128,1,1.5557121435822359,1.170500554541026,1.8728008872656416,0.5496481403962042,0.3151913817490632,0.3151913817490632,1.8728008872656416,1.170500554541026,0,1,1,2,1.8728008872656416,1.170500554541026
1049,5,90,9,59,50,1,3194.466,100,691.635,LESS,234,1580,1814,3,2,-9.0,-0.8436676146070391,9.0,0.0,0.8207677342949549,-0.7413086050349222,109,59,50,0,-1.0171964015730004,-0.8193503881787182,-1.170500554541026,-0.8842165736808498,-0.14866850928264844,0.14866850928264844,-1.170500554541026,-0.8193503881787182,1,0,0,0,-0.8193503881787182,-1.170500554541026
1050,5,91,44,110,119,0,3151.831,100,690.841,LESS,-12,1634,1622,4,2,9.0,0.8436676146070391,9.0,0.0,0.8207677342949549,-0.7602821626806923,229,110,119,1,1.376206896245824,1.170500554541026,1.5216507209033339,-0.40626166898849847,-0.4965634275564322,0.4965634275564322,1.5216507209033339,1.170500554541026,1,0,0,2,1.5216507209033339,1.170500554541026
1051,5,92,2,52,50,0,5548.877,74,949.569,LESS,346,2666,3012,6,2,-2.0,-0.18748169213489754,2.0,-1.222253017596762,-0.4345240946267408,0.3064585541144911,102,52,50,0,-1.156811593945765,-1.092467184238291,-1.170500554541026,0.5496481403962042,0.009722673020862858,0.009722673020862858,-1.170500554541026,-1.092467184238291,0,1,1,0,-1.092467184238291,-1.170500554541026
1052,5,93,8,58,50,0,5032.219,100,1705.2679999999998,LESS,312,2778,3090,6,2,-8.0,-0.7499267685395902,8.0,-0.17460757394239454,0.8207677342949549,0.07653383625010042,108,58,50,0,-1.0371414290548238,-0.8583670733300858,-1.170500554541026,0.5496481403962042,-0.038360364464131644,0.038360364464131644,-1.170500554541026,-0.8583670733300858,1,1,1,0,-0.8583670733300858,-1.170500554541026
1053,5,94,44,119,110,0,11801.06,24,2039.73,LESS,-122,5256,5134,14,2,-9.0,-0.8436676146070391,9.0,0.0,-2.8485468425530787,3.0888240885909504,229,119,110,0,1.376206896245824,1.5216507209033339,1.170500554541026,4.373287377935015,-0.6521261958902379,0.6521261958902379,1.170500554541026,1.5216507209033339,0,1,0,2,1.5216507209033339,1.170500554541026
1054,5,95,34,74,80,0,2841.384,100,1401.6170000000004,LESS,586,1390,1976,4,2,6.0,0.5624450764046927,6.0,-0.5238227218271837,0.8207677342949549,-0.8984382328215716,154,74,80,1,-0.11967016489094122,-0.2341001109082052,0.0,-0.40626166898849847,0.3491323493855299,0.3491323493855299,0.0,-0.2341001109082052,1,0,1,1,-0.2341001109082052,0.0
1055,5,96,24,86,80,1,6339.866999999998,64,1051.996,LESS,858,2554,3412,7,2,-6.0,-0.5624450764046927,6.0,-0.5238227218271837,-0.9173286442120084,0.6584673347460767,166,86,80,0,0.11967016489094122,0.2341001109082052,0.0,1.0276030450885556,0.7337966492654859,0.7337966492654859,0.0,0.2341001109082052,0,1,1,1,0.2341001109082052,0.0
1056,5,97,39,66,80,0,3893.338,100,733.29,LESS,-298,2142,1844,4,2,14.0,1.3123718449442827,14.0,0.8730378697119728,0.8207677342949549,-0.4302944575266627,146,66,80,1,-0.2792303847455295,-0.5462335921191455,0.0,-0.40626166898849847,-0.9010266252243271,0.9010266252243271,0.0,-0.5462335921191455,1,0,0,1,-0.5462335921191455,0.0
1057,5,98,9,50,59,0,1974.536,100,1093.626,LESS,200,1266,1466,3,2,9.0,0.8436676146070391,9.0,0.0,0.8207677342949549,-1.2842055718181828,109,50,59,1,-1.0171964015730004,-1.170500554541026,-0.8193503881787182,-0.8842165736808498,-0.19675154676764292,0.19675154676764292,-0.8193503881787182,-1.170500554541026,1,0,0,0,-1.170500554541026,-0.8193503881787182
1058,5,99,57,94,110,0,1955.173,100,670.568,LESS,-230,1336,1106,3,2,16.0,1.4998535370791803,16.0,1.222253017596762,0.8207677342949549,-1.2928225530940138,204,94,110,1,0.8775812092002355,0.5462335921191455,1.170500554541026,-0.8842165736808498,-0.804860550254338,0.804860550254338,1.170500554541026,0.5462335921191455,1,0,0,2,1.170500554541026,0.5462335921191455
1059,5,100,60,110,87,1,4986.021,84,1420.438,LESS,1776,2024,3800,5,2,-23.0,-2.1560394595513217,23.0,2.444506035193524,0.048280454958526765,0.05597466148478337,197,110,87,0,0.7379660168274708,1.170500554541026,0.27311679605957273,0.07169323570385287,2.032038661360337,2.032038661360337,0.27311679605957273,1.170500554541026,1,1,1,2,1.170500554541026,0.27311679605957273
1060,5,101,33,75,80,1,11520.602,64,1659.206,LESS,824,5268,6092,11,2,5.0,0.4687042303372438,5.0,-0.6984302957695783,-0.9173286442120084,2.9640138146325268,155,75,80,1,-0.09972513740911768,-0.19508342575683765,0.0,2.939422663857961,0.6857136117804914,0.6857136117804914,0.0,-0.19508342575683765,0,1,1,1,-0.19508342575683765,0.0
1061,5,102,15,50,45,1,4560.314,94,1782.764,LESS,994,1932,2926,5,2,-5.0,-0.4687042303372438,5.0,-0.6984302957695783,0.5310850045437943,-0.1334747651531395,95,50,45,0,-1.2964267863185297,-1.170500554541026,-1.3655839802978638,0.07169323570385287,0.9261287992054639,0.9261287992054639,-1.3655839802978638,-1.170500554541026,1,1,1,0,-1.170500554541026,-1.3655839802978638
1062,5,103,59,89,110,0,3483.968,100,699.956,LESS,76,1696,1772,4,2,21.0,1.9685577674164243,21.0,2.0952908873087353,0.8207677342949549,-0.6124735426315978,199,89,110,1,0.7778560717911179,0.3511501663623078,1.170500554541026,-0.40626166898849847,-0.3721132128893876,0.3721132128893876,1.170500554541026,0.3511501663623078,1,0,0,2,1.170500554541026,0.3511501663623078
1063,5,104,29,80,94,0,1815.661,100,699.5830000000002,LESS,66,1028,1094,3,2,14.0,1.3123718449442827,14.0,0.8730378697119728,0.8207677342949549,-1.3549086085479054,174,80,94,1,0.2792303847455295,0.0,0.5462335921191455,-0.8842165736808498,-0.3862552827379154,0.3862552827379154,0.5462335921191455,0.0,1,0,0,1,0.5462335921191455,0.0
1064,5,105,55,110,98,1,2644.911,84,745.8889999999999,LESS,814,1228,2042,3,2,-12.0,-1.124890152809385,12.0,0.5238227218271837,0.048280454958526765,-0.9858732461049629,208,110,98,0,0.9573613191275298,1.170500554541026,0.7023003327246156,-0.8842165736808498,0.6715715419319636,0.6715715419319636,0.7023003327246156,1.170500554541026,1,0,1,2,1.170500554541026,0.7023003327246156
1065,5,106,29,94,80,1,5958.765,0,1675.749,LESS,-1418,3686,2268,6,1,-14.0,-1.3123718449442827,14.0,0.8730378697119728,-4.007277761557721,0.4888681611582208,174,94,80,0,0.2792303847455295,0.5462335921191455,0.0,0.5496481403962042,-2.48493844825944,2.48493844825944,0.0,0.5462335921191455,0,1,0,1,0.5462335921191455,0.0
1066,5,107,57,110,94,0,3971.287,100,622.38,LESS,-252,2134,1882,5,2,-16.0,-1.4998535370791803,16.0,1.222253017596762,0.8207677342949549,-0.3956053559685502,204,110,94,0,0.8775812092002355,1.170500554541026,0.5462335921191455,0.07169323570385287,-0.8359731039210992,0.8359731039210992,0.5462335921191455,1.170500554541026,1,0,0,2,1.170500554541026,0.5462335921191455
1067,5,108,39,80,66,0,4262.166,84,995.469,LESS,436,2092,2528,7,2,-14.0,-1.3123718449442827,14.0,0.8730378697119728,0.048280454958526765,-0.26615749682831397,146,80,66,0,-0.2792303847455295,0.0,-0.5462335921191455,1.0276030450885556,0.137001301657613,0.137001301657613,-0.5462335921191455,0.0,1,1,1,1,0.0,-0.5462335921191455
1068,5,109,4,50,54,1,4680.479,100,1253.783,LESS,1758,1606,3364,5,2,4.0,0.3749633842697951,4.0,-0.8730378697119728,0.8207677342949549,-0.07999857060631263,104,50,54,1,-1.116921538982118,-1.170500554541026,-1.0144338139355558,0.07169323570385287,2.0065829356329874,2.0065829356329874,-1.0144338139355558,-1.170500554541026,1,0,1,0,-1.170500554541026,-1.0144338139355558
1069,5,110,55,98,110,1,2555.67,100,811.945,LESS,630,1244,1874,3,2,12.0,1.124890152809385,12.0,0.5238227218271837,0.8207677342949549,-1.0255875479195793,208,98,110,1,0.9573613191275298,0.7023003327246156,1.170500554541026,-0.8842165736808498,0.4113574567190522,0.4113574567190522,1.170500554541026,0.7023003327246156,1,0,1,2,1.170500554541026,0.7023003327246156
1070,5,111,2,50,52,1,4514.502,100,2371.508,LESS,1316,2086,3402,5,2,2.0,0.18748169213489754,2.0,-1.222253017596762,0.8207677342949549,-0.15386216102198005,102,50,52,1,-1.156811593945765,-1.170500554541026,-1.092467184238291,0.07169323570385287,1.3815034483280588,1.3815034483280588,-1.092467184238291,-1.170500554541026,1,1,1,0,-1.170500554541026,-1.092467184238291
1071,5,112,59,110,89,0,4200.33,84,1166.305,LESS,410,1934,2344,4,2,-21.0,-1.9685577674164243,21.0,2.0952908873087353,0.048280454958526765,-0.2936759420161607,199,110,89,0,0.7778560717911179,1.170500554541026,0.3511501663623078,-0.40626166898849847,0.10023192005144074,0.10023192005144074,0.3511501663623078,1.170500554541026,0,0,1,2,1.170500554541026,0.3511501663623078
1072,5,113,60,87,110,1,3215.42,100,2420.137,LESS,1612,1306,2918,3,2,23.0,2.1560394595513217,23.0,2.444506035193524,0.8207677342949549,-0.7319835920899365,197,87,110,1,0.7379660168274708,0.27311679605957273,1.170500554541026,-0.8842165736808498,1.8001087158444815,1.8001087158444815,1.170500554541026,0.27311679605957273,1,0,1,2,1.170500554541026,0.27311679605957273
1073,5,114,52,110,105,0,5822.605,94,964.014,LESS,-368,2906,2538,6,2,-5.0,-0.4687042303372438,5.0,-0.6984302957695783,0.5310850045437943,0.4282738229607757,215,110,105,0,1.0969765115002945,1.170500554541026,0.9754171287841883,0.5496481403962042,-1.0000211141640216,1.0000211141640216,0.9754171287841883,1.170500554541026,1,1,0,2,1.170500554541026,0.9754171287841883
1074,5,115,30,80,96,1,7330.548000000002,100,699.569,LESS,578,3098,3676,6,2,16.0,1.4998535370791803,16.0,1.222253017596762,0.8207677342949549,1.0993432128290892,176,80,96,1,0.3191204397091766,0.0,0.6242669624218805,0.5496481403962042,0.3378186935067077,0.3378186935067077,0.6242669624218805,0.0,1,1,1,1,0.6242669624218805,0.0
1075,5,116,24,80,86,1,4100.559,100,684.273,LESS,690,1792,2482,3,2,6.0,0.5624450764046927,6.0,-0.5238227218271837,0.8207677342949549,-0.3380763365248068,166,80,86,1,0.11967016489094122,0.0,0.2341001109082052,-0.8842165736808498,0.49620987581021897,0.49620987581021897,0.2341001109082052,0.0,1,0,1,1,0.2341001109082052,0.0
1076,5,117,5,50,55,1,4450.724,100,1028.633,LESS,784,1912,2696,5,2,5.0,0.4687042303372438,5.0,-0.6984302957695783,0.8207677342949549,-0.18224484096878268,105,50,55,1,-1.0969765115002945,-1.170500554541026,-0.9754171287841883,0.07169323570385287,0.6291453323863803,0.6291453323863803,-0.9754171287841883,-1.170500554541026,1,0,1,0,-1.170500554541026,-0.9754171287841883
1077,5,118,34,80,74,1,7381.719,74,1592.385,LESS,1368,3116,4484,7,2,-6.0,-0.5624450764046927,6.0,-0.5238227218271837,-0.4345240946267408,1.1221154872114432,154,80,74,0,-0.11967016489094122,0.0,-0.2341001109082052,1.0276030450885556,1.4550422115404034,1.4550422115404034,-0.2341001109082052,0.0,0,1,1,1,0.0,-0.2341001109082052
1078,5,119,15,45,50,1,4154.848,100,591.653,LESS,366,1916,2282,5,2,5.0,0.4687042303372438,5.0,-0.6984302957695783,0.8207677342949549,-0.31391648027920555,95,45,50,1,-1.2964267863185297,-1.3655839802978638,-1.170500554541026,0.07169323570385287,0.03800681271791845,0.03800681271791845,-1.170500554541026,-1.3655839802978638,1,0,1,0,-1.3655839802978638,-1.170500554541026
1079,5,120,37,69,80,1,7643.315,100,1766.94,LESS,-552,4306,3754,5,2,11.0,1.0311493067419364,11.0,0.34921514788478913,0.8207677342949549,1.2385317364410169,149,69,80,1,-0.21939530230005888,-0.4291835366650429,0.0,0.07169323570385287,-1.260235199376933,1.260235199376933,0.0,-0.4291835366650429,1,0,0,1,-0.4291835366650429,0.0
1080,5,121,48,128,110,0,2240.432,100,1203.945,MORE,332,1300,1632,3,2,-18.0,-1.6873352292140782,18.0,1.571468165481551,0.8207677342949549,-1.165875723482785,238,128,110,1,1.5557121435822359,1.8728008872656416,1.170500554541026,-0.8842165736808498,-0.010076224767076054,0.010076224767076054,1.170500554541026,1.8728008872656416,1,0,0,2,1.8728008872656416,1.170500554541026
1081,5,122,8,50,58,1,2874.8390000000004,100,1296.077,MORE,890,1286,2176,3,2,8.0,0.7499267685395902,8.0,-0.17460757394239454,0.8207677342949549,-0.8835499867552119,108,50,58,0,-1.0371414290548238,-1.170500554541026,-0.8583670733300858,-0.8842165736808498,0.7790512727807748,0.7790512727807748,-0.8583670733300858,-1.170500554541026,1,0,1,0,-1.170500554541026,-0.8583670733300858
1082,5,123,4,54,50,0,3298.259,100,1887.346,MORE,206,1886,2092,4,2,-4.0,-0.3749633842697951,4.0,-0.8730378697119728,0.8207677342949549,-0.6951183278277586,104,54,50,1,-1.116921538982118,-1.0144338139355558,-1.170500554541026,-0.40626166898849847,-0.18826630485852625,0.18826630485852625,-1.170500554541026,-1.0144338139355558,1,0,0,0,-1.0144338139355558,-1.170500554541026
1083,5,124,37,80,69,0,3386.571,64,1871.556,MORE,-646,1902,1256,4,2,-11.0,-1.0311493067419364,11.0,0.34921514788478913,-0.9173286442120084,-0.6558174524246099,149,80,69,1,-0.21939530230005888,0.0,-0.4291835366650429,-0.40626166898849847,-1.3931706559530943,1.3931706559530943,-0.4291835366650429,0.0,0,1,0,1,0.0,-0.4291835366650429
1084,5,125,52,105,110,1,5788.203,100,1439.221,MORE,976,2398,3374,7,2,5.0,0.4687042303372438,5.0,-0.6984302957695783,0.8207677342949549,0.4129641400680873,215,105,110,0,1.0969765115002945,0.9754171287841883,1.170500554541026,1.0276030450885556,0.9006730734781139,0.9006730734781139,1.170500554541026,0.9754171287841883,1,1,1,2,1.170500554541026,0.9754171287841883
1085,5,126,5,55,50,0,3221.33,100,2063.893,MORE,402,1774,2176,4,2,-5.0,-0.4687042303372438,5.0,-0.6984302957695783,0.8207677342949549,-0.729353505877048,105,55,50,1,-1.0969765115002945,-0.9754171287841883,-1.170500554541026,-0.40626166898849847,0.0889182641726185,0.0889182641726185,-1.170500554541026,-0.9754171287841883,1,1,1,0,-0.9754171287841883,-1.170500554541026
1086,5,127,30,96,80,0,4298.562,84,1400.015,MORE,70,2178,2248,4,2,-16.0,-1.4998535370791803,16.0,1.222253017596762,0.048280454958526765,-0.2499604379781805,176,96,80,1,0.3191204397091766,0.6242669624218805,0.0,-0.40626166898849847,-0.38059845479850424,0.38059845479850424,0.0,0.6242669624218805,0,1,0,1,0.6242669624218805,0.0
1087,5,128,33,80,75,0,5391.25,100,582.9169999999998,MORE,-184,2606,2422,6,2,-5.0,-0.4687042303372438,5.0,-0.6984302957695783,0.8207677342949549,0.2363109061485051,155,80,75,1,-0.09972513740911768,0.0,-0.19508342575683765,0.5496481403962042,-0.7398070289511102,0.7398070289511102,-0.19508342575683765,0.0,1,1,0,1,0.0,-0.19508342575683765
1088,5,129,48,110,128,1,4248.572,100,1514.937,MORE,1148,1888,3036,3,2,18.0,1.6873352292140782,18.0,1.571468165481551,0.8207677342949549,-0.27220714014100544,238,110,128,0,1.5557121435822359,1.170500554541026,1.8728008872656416,-0.8842165736808498,1.1439166748727918,1.1439166748727918,1.8728008872656416,1.170500554541026,1,0,1,2,1.8728008872656416,1.170500554541026
1089,5,130,9,59,50,1,3983.248,100,673.297,MORE,284,1760,2044,4,2,-9.0,-0.8436676146070391,9.0,0.0,0.8207677342949549,-0.3902824352930239,109,59,50,1,-1.0171964015730004,-0.8193503881787182,-1.170500554541026,-0.40626166898849847,-0.07795816004000947,0.07795816004000947,-1.170500554541026,-0.8193503881787182,1,0,0,0,-0.8193503881787182,-1.170500554541026
1090,5,131,44,110,119,1,4782.524,74,1025.4489999999996,MORE,342,2296,2638,5,2,9.0,0.8436676146070391,9.0,0.0,-0.4345240946267408,-0.03458619368681898,229,110,119,0,1.376206896245824,1.170500554541026,1.5216507209033339,0.07169323570385287,0.0040658450814517405,0.0040658450814517405,1.5216507209033339,1.170500554541026,0,1,0,2,1.5216507209033339,1.170500554541026
1091,5,132,2,52,50,1,2972.6020000000008,100,1355.7910000000004,MORE,940,1272,2212,3,2,-2.0,-0.18748169213489754,2.0,-1.222253017596762,0.8207677342949549,-0.8400431985266806,102,52,50,1,-1.156811593945765,-1.092467184238291,-1.170500554541026,-0.8842165736808498,0.8497616220234138,0.8497616220234138,-1.170500554541026,-1.092467184238291,1,0,1,0,-1.092467184238291,-1.170500554541026
1092,5,133,8,58,50,0,2512.02,100,1939.118,MORE,-62,1520,1458,2,2,-8.0,-0.7499267685395902,8.0,-0.17460757394239454,0.8207677342949549,-1.0450128039589337,108,58,50,1,-1.0371414290548238,-0.8583670733300858,-1.170500554541026,-1.3621714783732013,-0.5672737767990711,0.5672737767990711,-1.170500554541026,-0.8583670733300858,1,0,0,0,-0.8583670733300858,-1.170500554541026
1093,5,134,44,119,110,0,5967.203,84,1419.1989999999996,MORE,1236,2652,3888,6,2,-9.0,-0.8436676146070391,9.0,0.0,0.048280454958526765,0.4926232656361147,229,119,110,1,1.376206896245824,1.5216507209033339,1.170500554541026,0.5496481403962042,1.2683668895398366,1.2683668895398366,1.170500554541026,1.5216507209033339,0,1,1,2,1.5216507209033339,1.170500554541026
1094,5,135,34,74,80,1,2562.18,100,1692.536,MORE,1006,1090,2096,3,2,6.0,0.5624450764046927,6.0,-0.5238227218271837,0.8207677342949549,-1.0226904478779713,154,74,80,0,-0.11967016489094122,-0.2341001109082052,0.0,-0.8842165736808498,0.9430992830236973,0.9430992830236973,0.0,-0.2341001109082052,1,0,1,1,-0.2341001109082052,0.0
1095,5,136,24,86,80,0,4803.215,74,2414.092,MORE,632,2120,2752,5,2,-6.0,-0.5624450764046927,6.0,-0.5238227218271837,-0.4345240946267408,-0.02537822180342212,166,86,80,1,0.11967016489094122,0.2341001109082052,0.0,0.07169323570385287,0.4141858706887578,0.4141858706887578,0.0,0.2341001109082052,0,1,1,1,0.2341001109082052,0.0
1096,5,137,39,66,80,1,2434.068,100,2024.193,MORE,1224,974,2198,3,2,14.0,1.3123718449442827,14.0,0.8730378697119728,0.8207677342949549,-1.0797032405861895,146,66,80,0,-0.2792303847455295,-0.5462335921191455,0.0,-0.8842165736808498,1.2513964057216032,1.2513964057216032,0.0,-0.5462335921191455,1,0,1,1,-0.5462335921191455,0.0
1097,5,138,9,50,59,1,2408.256,100,1739.869,MORE,592,1156,1748,3,2,9.0,0.8436676146070391,9.0,0.0,0.8207677342949549,-1.0911901754977091,109,50,59,0,-1.0171964015730004,-1.170500554541026,-0.8193503881787182,-0.8842165736808498,0.3576175912946466,0.3576175912946466,-0.8193503881787182,-1.170500554541026,1,0,1,0,-1.170500554541026,-0.8193503881787182
1098,5,139,57,94,110,1,2687.139,100,954.733,MORE,538,1256,1794,3,2,16.0,1.4998535370791803,16.0,1.222253017596762,0.8207677342949549,-0.9670808128396744,204,94,110,0,0.8775812092002355,0.5462335921191455,1.170500554541026,-0.8842165736808498,0.2812504141125965,0.2812504141125965,1.170500554541026,0.5462335921191455,1,0,1,2,1.170500554541026,0.5462335921191455
1099,5,140,60,110,87,0,2855.139,100,825.3539999999998,MORE,-644,1994,1350,3,2,-23.0,-2.1560394595513217,23.0,2.444506035193524,0.8207677342949549,-0.8923169407981737,197,110,87,1,0.7379660168274708,1.170500554541026,0.27311679605957273,-0.8842165736808498,-1.3903422419833886,1.3903422419833886,0.27311679605957273,1.170500554541026,1,0,0,2,1.170500554541026,0.27311679605957273
1100,5,141,33,75,80,1,4525.585999999998,100,1437.257,MORE,1044,2036,3080,5,2,5.0,0.4687042303372438,5.0,-0.6984302957695783,0.8207677342949549,-0.14892952555943334,155,75,80,0,-0.09972513740911768,-0.19508342575683765,0.0,0.07169323570385287,0.9968391484481028,0.9968391484481028,0.0,-0.19508342575683765,1,1,1,1,-0.19508342575683765,0.0
1101,5,142,15,50,45,0,2420.489,100,929.26,MORE,-366,1604,1238,2,2,-5.0,-0.4687042303372438,5.0,-0.6984302957695783,0.8207677342949549,-1.085746208553163,95,50,45,1,-1.2964267863185297,-1.170500554541026,-1.3655839802978638,-1.3621714783732013,-0.997192700194316,0.997192700194316,-1.3655839802978638,-1.170500554541026,1,0,0,0,-1.170500554541026,-1.3655839802978638
1102,5,143,59,89,110,1,4451.694,100,785.9730000000002,MORE,8,2324,2332,5,2,21.0,1.9685577674164243,21.0,2.0952908873087353,0.8207677342949549,-0.18181316861235247,199,89,110,0,0.7778560717911179,0.3511501663623078,1.170500554541026,0.07169323570385287,-0.46827928785937656,0.46827928785937656,1.170500554541026,0.3511501663623078,1,1,0,2,1.170500554541026,0.3511501663623078
1103,5,144,29,80,94,1,4451.385,100,1472.457,MORE,756,2042,2798,5,2,14.0,1.3123718449442827,14.0,0.8730378697119728,0.8207677342949549,-0.1819506807341432,174,80,94,0,0.2792303847455295,0.0,0.5462335921191455,0.07169323570385287,0.5895475368105024,0.5895475368105024,0.5462335921191455,0.0,1,1,1,1,0.5462335921191455,0.0
1104,5,145,55,110,98,1,10142.36,74,1286.581,MORE,1654,4094,5748,9,2,-12.0,-1.124890152809385,12.0,0.5238227218271837,-0.4345240946267408,2.3506643590954917,208,110,98,1,0.9573613191275298,1.170500554541026,0.7023003327246156,1.9835128544732583,1.8595054092082983,1.8595054092082983,0.7023003327246156,1.170500554541026,0,1,1,2,1.170500554541026,0.7023003327246156
1105,5,146,29,94,80,0,1995.119,100,713.6489999999999,MORE,-234,1348,1114,3,2,-14.0,-1.3123718449442827,14.0,0.8730378697119728,0.8207677342949549,-1.2750456624239557,174,94,80,1,0.2792303847455295,0.5462335921191455,0.0,-0.8842165736808498,-0.8105173781937491,0.8105173781937491,0.0,0.5462335921191455,1,0,0,1,0.5462335921191455,0.0
1106,5,147,57,110,94,0,7315.8409999999985,84,1396.739,MORE,-536,4004,3468,6,2,-16.0,-1.4998535370791803,16.0,1.222253017596762,0.048280454958526765,1.0927982588641212,204,110,94,1,0.8775812092002355,1.170500554541026,0.5462335921191455,0.5496481403962042,-1.2376078876192886,1.2376078876192886,0.5462335921191455,1.170500554541026,0,1,0,2,1.170500554541026,0.5462335921191455
1107,5,148,39,80,66,1,7825.448,74,1310.081,MORE,1312,3202,4514,7,2,-14.0,-1.3123718449442827,14.0,0.8730378697119728,-0.4345240946267408,1.3195851192180088,146,80,66,1,-0.2792303847455295,0.0,-0.5462335921191455,1.0276030450885556,1.3758466203886477,1.3758466203886477,-0.5462335921191455,0.0,0,1,1,1,0.0,-0.5462335921191455
1108,5,149,4,50,54,0,5077.025,94,2046.099,MORE,1380,2172,3552,5,2,4.0,0.3749633842697951,4.0,-0.8730378697119728,0.5310850045437943,0.0964735389327876,104,50,54,0,-1.116921538982118,-1.170500554541026,-1.0144338139355558,0.07169323570385287,1.4720126953586368,1.4720126953586368,-1.0144338139355558,-1.170500554541026,0,1,1,0,-1.170500554541026,-1.0144338139355558
1109,5,150,55,98,110,0,7236.550999999998,64,1679.38,MORE,-1080,3686,2606,8,1,12.0,1.124890152809385,12.0,0.5238227218271837,-0.9173286442120084,1.05751238139882,208,98,110,0,0.9573613191275298,0.7023003327246156,1.170500554541026,1.5055579497809068,-2.0069364873792006,2.0069364873792006,1.170500554541026,0.7023003327246156,0,1,0,2,1.170500554541026,0.7023003327246156
1110,5,151,2,50,52,1,4429.96,100,693.557,MORE,796,1650,2446,4,2,2.0,0.18748169213489754,2.0,-1.222253017596762,0.8207677342949549,-0.19148529953467391,102,50,52,0,-1.156811593945765,-1.170500554541026,-1.092467184238291,-0.40626166898849847,0.6461158162046136,0.6461158162046136,-1.092467184238291,-1.170500554541026,1,0,1,0,-1.170500554541026,-1.092467184238291
1111,5,152,59,110,89,0,3060.255,100,1065.114,MORE,10,1760,1770,4,2,-21.0,-1.9685577674164243,21.0,2.0952908873087353,0.8207677342949549,-0.8010355933120759,199,110,89,1,0.7778560717911179,1.170500554541026,0.3511501663623078,-0.40626166898849847,-0.465450873889671,0.465450873889671,0.3511501663623078,1.170500554541026,1,0,0,2,1.170500554541026,0.3511501663623078
1112,5,153,60,87,110,1,4307.453,100,1658.557,MORE,1740,1632,3372,3,2,23.0,2.1560394595513217,23.0,2.444506035193524,0.8207677342949549,-0.24600373805960296,197,87,110,0,0.7379660168274708,0.27311679605957273,1.170500554541026,-0.8842165736808498,1.9811272099056374,1.9811272099056374,1.170500554541026,0.27311679605957273,1,0,1,2,1.170500554541026,0.27311679605957273
1113,5,154,52,110,105,0,6352.37,74,965.853,MORE,-1482,3780,2298,5,2,-5.0,-0.4687042303372438,5.0,-0.6984302957695783,-0.4345240946267408,0.6640314579135469,215,110,105,1,1.0969765115002945,1.170500554541026,0.9754171287841883,0.07169323570385287,-2.575447695290018,2.575447695290018,0.9754171287841883,1.170500554541026,0,1,0,2,1.170500554541026,0.9754171287841883
1114,5,155,30,80,96,1,3454.677,100,758.7139999999998,MORE,1194,1364,2558,3,2,16.0,1.4998535370791803,16.0,1.222253017596762,0.8207677342949549,-0.6255087127266429,176,80,96,0,0.3191204397091766,0.0,0.6242669624218805,-0.8842165736808498,1.2089701961760198,1.2089701961760198,0.6242669624218805,0.0,1,0,1,1,0.6242669624218805,0.0
1115,5,156,24,80,86,1,7417.97,64,1686.31,MORE,102,3398,3500,7,2,6.0,0.5624450764046927,6.0,-0.5238227218271837,-0.9173286442120084,1.1382480177196364,166,80,86,0,0.11967016489094122,0.0,0.2341001109082052,1.0276030450885556,-0.3353438312832153,0.3353438312832153,0.2341001109082052,0.0,0,1,0,1,0.2341001109082052,0.0
1116,5,157,5,50,55,1,2525.835,100,745.189,MORE,764,1024,1788,3,2,5.0,0.4687042303372438,5.0,-0.6984302957695783,0.8207677342949549,-1.0388648105526637,105,50,55,0,-1.0969765115002945,-1.170500554541026,-0.9754171287841883,-0.8842165736808498,0.6008611926893246,0.6008611926893246,-0.9754171287841883,-1.170500554541026,1,0,1,0,-1.170500554541026,-0.9754171287841883
1117,5,158,34,80,74,0,3980.034,84,1797.92,MORE,-440,2276,1836,4,2,-6.0,-0.5624450764046927,6.0,-0.5238227218271837,0.048280454958526765,-0.3917127393688655,154,80,74,1,-0.11967016489094122,0.0,-0.2341001109082052,-0.40626166898849847,-1.1018440170734218,1.1018440170734218,-0.2341001109082052,0.0,0,0,0,1,0.0,-0.2341001109082052
1118,5,159,15,45,50,1,7475.688,44,1661.606,MORE,160,3078,3238,7,2,5.0,0.4687042303372438,5.0,-0.6984302957695783,-1.8829377433825436,1.1639338579963705,95,45,50,0,-1.2964267863185297,-1.3655839802978638,-1.170500554541026,1.0276030450885556,-0.2533198261617541,0.2533198261617541,-1.170500554541026,-1.3655839802978638,0,1,0,0,-1.3655839802978638,-1.170500554541026
1119,5,160,37,69,80,1,3418.941,84,1574.044,MORE,962,1566,2528,3,2,11.0,1.0311493067419364,11.0,0.34921514788478913,0.048280454958526765,-0.6414120563651852,149,69,80,0,-0.21939530230005888,-0.4291835366650429,0.0,-0.8842165736808498,0.8808741756901749,0.8808741756901749,0.0,-0.4291835366650429,0,0,1,1,-0.4291835366650429,0.0
1120,5,161,3,50,53,0,4333.5,84,1142.034,LESS,-144,2110,1966,4,2,3.0,0.28122253820234633,3.0,-1.0476454436543674,0.048280454958526765,-0.2344122227318355,103,50,53,1,-1.1368665664639415,-1.170500554541026,-1.0534504990869233,-0.40626166898849847,-0.683238749556999,0.683238749556999,-1.0534504990869233,-1.170500554541026,0,0,0,0,-1.170500554541026,-1.0534504990869233
1121,5,162,20,50,40,0,7113.265,44,1002.993,LESS,-634,3192,2558,8,1,-10.0,-0.9374084606744876,10.0,0.17460757394239454,-1.8829377433825436,1.002647269919604,90,50,40,0,-1.3961519237276474,-1.170500554541026,-1.5606674060547012,1.5055579497809068,-1.376200172134861,1.376200172134861,-1.5606674060547012,-1.170500554541026,0,1,0,0,-1.170500554541026,-1.5606674060547012
1122,5,163,25,80,88,0,2821.7990000000004,100,2071.688,LESS,38,1522,1560,4,2,8.0,0.7499267685395902,8.0,-0.17460757394239454,0.8207677342949549,-0.9071540092140284,168,80,88,1,0.1595602198545883,0.0,0.31213348121094026,-0.40626166898849847,-0.4258530783137932,0.4258530783137932,0.31213348121094026,0.0,1,0,0,1,0.31213348121094026,0.0
1123,5,164,42,115,110,0,6692.084,54,1552.03,LESS,-328,3206,2878,8,2,-5.0,-0.4687042303372438,5.0,-0.6984302957695783,-1.400133193797276,0.8152120175963226,225,115,110,0,1.2964267863185297,1.3655839802978638,1.170500554541026,1.5055579497809068,-0.9434528347699105,0.9434528347699105,1.170500554541026,1.3655839802978638,0,1,0,2,1.3655839802978638,1.170500554541026
1124,5,165,53,103,110,1,5363.299,64,1453.355,LESS,460,2410,2870,5,2,7.0,0.6561859224721414,7.0,-0.34921514788478913,-0.9173286442120084,0.22387206693760045,213,103,110,1,1.0570864565366473,0.8973837584814532,1.170500554541026,0.07169323570385287,0.1709422692940797,0.1709422692940797,1.170500554541026,0.8973837584814532,0,0,1,2,1.170500554541026,0.8973837584814532
1125,5,166,26,90,80,1,7395.46,34,1025.451,LESS,-8,3120,3112,6,2,-10.0,-0.9374084606744876,10.0,0.17460757394239454,-2.365742292967811,1.128230548912171,170,90,80,0,0.19945027481823535,0.3901668515136753,0.0,0.5496481403962042,-0.49090659961702104,0.49090659961702104,0.0,0.3901668515136753,0,1,0,1,0.3901668515136753,0.0
1126,5,167,35,80,72,0,7097.294,84,700.959,LESS,-424,3458,3034,8,2,-8.0,-0.7499267685395902,8.0,-0.17460757394239454,0.048280454958526765,0.9955398068221348,152,80,72,0,-0.1595602198545883,0.0,-0.31213348121094026,1.5055579497809068,-1.0792167053157773,1.0792167053157773,-0.31213348121094026,0.0,0,1,0,1,0.0,-0.31213348121094026
1127,5,168,28,93,80,1,4372.559,84,1090.035,LESS,356,1802,2158,5,2,-13.0,-1.218630998876834,13.0,0.6984302957695783,0.048280454958526765,-0.2170300675052344,173,93,80,0,0.25928535726370594,0.5072169069677779,0.0,0.07169323570385287,0.02386474286939065,0.02386474286939065,0.0,0.5072169069677779,0,0,1,1,0.5072169069677779,0.0
1128,5,169,26,80,90,0,5583.156999999998,100,709.492,LESS,-422,2976,2554,7,2,10.0,0.9374084606744876,10.0,0.17460757394239454,0.8207677342949549,0.3217139441953392,170,80,90,1,0.19945027481823535,0.0,0.3901668515136753,1.0276030450885556,-1.0763882913460716,1.0763882913460716,0.3901668515136753,0.0,1,1,0,1,0.3901668515136753,0.0
1129,5,170,25,88,80,1,4584.432,84,922.806,LESS,1152,1746,2898,5,2,-8.0,-0.7499267685395902,8.0,-0.17460757394239454,0.048280454958526765,-0.12274169928470573,168,88,80,0,0.1595602198545883,0.31213348121094026,0.0,0.07169323570385287,1.149573502812203,1.149573502812203,0.0,0.31213348121094026,1,0,1,1,0.31213348121094026,0.0
1130,5,171,36,80,70,0,5412.8780000000015,64,1726.767,LESS,-832,2848,2016,6,1,-10.0,-0.9374084606744876,10.0,0.17460757394239454,-0.9173286442120084,0.2459358646277533,150,80,70,0,-0.19945027481823535,0.0,-0.3901668515136753,0.5496481403962042,-1.6562131551357113,1.6562131551357113,-0.3901668515136753,0.0,0,1,0,1,0.0,-0.3901668515136753
1131,5,172,28,80,93,0,2244.948,100,908.756,LESS,-138,1434,1296,3,2,13.0,1.218630998876834,13.0,0.6984302957695783,0.8207677342949549,-1.1638659993986218,173,80,93,1,0.25928535726370594,0.0,0.5072169069677779,-0.8842165736808498,-0.6747535076478823,0.6747535076478823,0.5072169069677779,0.0,1,0,0,1,0.5072169069677779,0.0
1132,5,173,21,82,80,1,5185.66,64,1226.923,LESS,440,2376,2816,5,2,-2.0,-0.18748169213489754,2.0,-1.222253017596762,-0.9173286442120084,0.14481861773771873,162,82,80,0,0.03989005496364707,0.07803337030273506,0.0,0.07169323570385287,0.14265812959702412,0.14265812959702412,0.0,0.07803337030273506,0,0,1,1,0.07803337030273506,0.0
1133,5,174,19,50,41,1,2717.711,84,1141.777,LESS,474,1060,1534,3,2,-9.0,-0.8436676146070391,9.0,0.0,0.048280454958526765,-0.9534755682203128,91,50,41,0,-1.376206896245824,-1.170500554541026,-1.5216507209033339,-0.8842165736808498,0.19074116708201863,0.19074116708201863,-1.5216507209033339,-1.170500554541026,0,0,1,0,-1.170500554541026,-1.5216507209033339
1134,5,175,56,96,110,0,7714.071,64,1190.64,LESS,-646,3710,3064,7,1,14.0,1.3123718449442827,14.0,0.8730378697119728,-0.9173286442120084,1.2700197872158288,206,96,110,1,0.9174712641638826,0.6242669624218805,1.170500554541026,1.0276030450885556,-1.3931706559530943,1.3931706559530943,1.170500554541026,0.6242669624218805,0,1,0,2,1.170500554541026,0.6242669624218805
1135,5,176,23,80,85,0,8222.693000000001,84,991.797,LESS,310,3700,4010,8,2,5.0,0.4687042303372438,5.0,-0.6984302957695783,0.048280454958526765,1.496368299867568,165,80,85,1,0.09972513740911768,0.0,0.19508342575683765,1.5055579497809068,-0.0411887784338372,0.0411887784338372,0.19508342575683765,0.0,0,1,1,1,0.19508342575683765,0.0
1136,5,177,10,60,50,0,7420.1309999999985,94,1541.1989999999996,LESS,100,3388,3488,7,2,-10.0,-0.9374084606744876,10.0,0.17460757394239454,0.5310850045437943,1.1392097125260745,110,60,50,0,-0.9972513740911768,-0.7803337030273506,-1.170500554541026,1.0276030450885556,-0.3381722452529209,0.3381722452529209,-1.170500554541026,-0.7803337030273506,1,1,0,0,-0.7803337030273506,-1.170500554541026
1137,5,178,19,41,50,0,10990.016,64,1108.161,LESS,-70,4986,4916,12,2,9.0,0.8436676146070391,9.0,0.0,-0.9173286442120084,2.727890815757457,91,41,50,1,-1.376206896245824,-1.5216507209033339,-1.170500554541026,3.4173775685503123,-0.5785874326778934,0.5785874326778934,-1.170500554541026,-1.5216507209033339,0,1,0,0,-1.5216507209033339,-1.170500554541026
1138,5,179,56,110,96,1,4468.544,84,1174.832,LESS,604,1958,2562,5,2,-14.0,-1.3123718449442827,14.0,0.8730378697119728,0.048280454958526765,-0.17431453025580934,206,110,96,0,0.9174712641638826,1.170500554541026,0.6242669624218805,0.07169323570385287,0.37458807511287995,0.37458807511287995,0.6242669624218805,1.170500554541026,0,0,1,2,1.170500554541026,0.6242669624218805
1139,5,180,35,72,80,1,2355.682,94,540.7280000000002,LESS,310,1246,1556,3,2,8.0,0.7499267685395902,8.0,-0.17460757394239454,0.5310850045437943,-1.11458681721622,152,72,80,1,-0.1595602198545883,-0.31213348121094026,0.0,-0.8842165736808498,-0.0411887784338372,0.0411887784338372,0.0,-0.31213348121094026,1,0,1,1,-0.31213348121094026,0.0
1140,5,181,11,49,50,1,4612.005,84,1393.404,LESS,1346,1926,3272,5,2,1.0,0.09374084606744876,1.0,-1.3968605915391563,0.048280454958526765,-0.1104710787858943,99,49,50,1,-1.2166466763912356,-1.2095172396923934,-1.170500554541026,0.07169323570385287,1.4239296578736422,1.4239296578736422,-1.170500554541026,-1.2095172396923934,1,0,1,0,-1.2095172396923934,-1.170500554541026
1141,5,182,17,43,50,0,9865.907,94,759.9830000000002,LESS,284,4196,4480,9,2,7.0,0.6561859224721414,7.0,-0.34921514788478913,0.5310850045437943,2.227636402443772,93,43,50,1,-1.3363168412821769,-1.4436173506005987,-1.170500554541026,1.9835128544732583,-0.07795816004000947,0.07795816004000947,-1.170500554541026,-1.4436173506005987,1,1,0,0,-1.4436173506005987,-1.170500554541026
1142,5,183,1,51,50,1,3959.668,94,1024.46,LESS,718,1804,2522,5,2,-1.0,-0.09374084606744876,1.0,-1.3968605915391563,0.5310850045437943,-0.400776078761706,101,51,50,0,-1.1767566214275886,-1.1314838693896585,-1.170500554541026,0.07169323570385287,0.5358076713860968,0.5358076713860968,-1.170500554541026,-1.1314838693896585,1,0,1,0,-1.1314838693896585,-1.170500554541026
1143,5,184,41,112,110,1,11031.357,94,622.631,LESS,834,4482,5316,9,2,-2.0,-0.18748169213489754,2.0,-1.222253017596762,0.5310850045437943,2.7462885135792887,222,112,110,0,1.2365917038730592,1.248533924843761,1.170500554541026,1.9835128544732583,0.6998556816290192,0.6998556816290192,1.170500554541026,1.248533924843761,1,1,1,2,1.248533924843761,1.170500554541026
1144,5,185,20,40,50,0,2095.772,100,726.6139999999998,LESS,-196,1394,1198,3,2,10.0,0.9374084606744876,10.0,0.17460757394239454,0.8207677342949549,-1.2302527575870914,90,40,50,1,-1.3961519237276474,-1.5606674060547012,-1.170500554541026,-0.8842165736808498,-0.7567775127693436,0.7567775127693436,-1.170500554541026,-1.5606674060547012,1,0,0,0,-1.5606674060547012,-1.170500554541026
1145,5,186,1,50,51,0,3203.825,100,1398.917,LESS,396,1580,1976,4,2,1.0,0.09374084606744876,1.0,-1.3968605915391563,0.8207677342949549,-0.7371436343299437,101,50,51,1,-1.1767566214275886,-1.170500554541026,-1.1314838693896585,-0.40626166898849847,0.08043302226350182,0.08043302226350182,-1.1314838693896585,-1.170500554541026,1,0,1,0,-1.170500554541026,-1.1314838693896585
1146,5,187,23,85,80,1,4205.344,34,1315.713,LESS,-60,1852,1792,5,2,-5.0,-0.4687042303372438,5.0,-0.6984302957695783,-2.365742292967811,-0.2914445964541601,165,85,80,0,0.09972513740911768,0.19508342575683765,0.0,0.07169323570385287,-0.5644453628293655,0.5644453628293655,0.0,0.19508342575683765,0,0,0,1,0.19508342575683765,0.0
1147,5,188,11,50,49,0,5260.121,84,1270.134,LESS,374,2568,2942,7,2,-1.0,-0.09374084606744876,1.0,-1.3968605915391563,0.048280454958526765,0.17795547890487465,99,50,49,0,-1.2166466763912356,-1.170500554541026,-1.2095172396923934,1.0276030450885556,0.049320468596740684,0.049320468596740684,-1.2095172396923934,-1.170500554541026,1,1,1,0,-1.170500554541026,-1.2095172396923934
1148,5,189,17,50,43,0,3668.326,94,597.773,LESS,-178,1774,1596,4,2,-7.0,-0.6561859224721414,7.0,-0.34921514788478913,0.5310850045437943,-0.530429983573104,93,50,43,0,-1.3363168412821769,-1.170500554541026,-1.4436173506005987,-0.40626166898849847,-0.7313217870419936,0.7313217870419936,-1.4436173506005987,-1.170500554541026,1,0,0,0,-1.170500554541026,-1.4436173506005987
1149,5,190,21,80,82,1,5770.312,44,1396.63,LESS,-662,2816,2154,5,2,2.0,0.18748169213489754,2.0,-1.222253017596762,-1.8829377433825436,0.4050022327187151,162,80,82,1,0.03989005496364707,0.0,0.07803337030273506,0.07169323570385287,-1.4157979677107388,1.4157979677107388,0.07803337030273506,0.0,0,0,0,1,0.07803337030273506,0.0
1150,5,191,10,50,60,0,3339.557,100,2259.945,LESS,172,1898,2070,4,2,10.0,0.9374084606744876,10.0,0.17460757394239454,0.8207677342949549,-0.6767397659969856,110,50,60,1,-0.9972513740911768,-1.170500554541026,-0.7803337030273506,-0.40626166898849847,-0.23634934234352076,0.23634934234352076,-0.7803337030273506,-1.170500554541026,1,0,0,0,-1.170500554541026,-0.7803337030273506
1151,5,192,3,53,50,1,13106.934,14,1814.85,LESS,-990,6282,5292,14,1,-3.0,-0.28122253820234633,3.0,-1.0476454436543674,-3.3313513921383464,3.669968116200012,103,53,50,0,-1.1368665664639415,-1.0534504990869233,-1.170500554541026,4.373287377935015,-1.8796578587424504,1.8796578587424504,-1.170500554541026,-1.0534504990869233,0,1,0,0,-1.0534504990869233,-1.170500554541026
1152,5,193,45,122,110,1,2748.2490000000007,100,1735.95,LESS,1460,1150,2610,3,2,-12.0,-1.124890152809385,12.0,0.5238227218271837,0.8207677342949549,-0.9398854543845782,232,122,110,0,1.4360419786912946,1.6387007763574364,1.170500554541026,-0.8842165736808498,1.585149254146859,1.585149254146859,1.170500554541026,1.6387007763574364,1,0,1,2,1.6387007763574364,1.170500554541026
1153,5,194,38,67,80,1,2600.832000000001,64,710.2560000000002,LESS,540,1166,1706,3,2,13.0,1.218630998876834,13.0,0.6984302957695783,-0.9173286442120084,-1.0054894170318514,147,67,80,1,-0.25928535726370594,-0.5072169069677779,0.0,-0.8842165736808498,0.28407882808230206,0.28407882808230206,0.0,-0.5072169069677779,0,0,1,1,-0.5072169069677779,0.0
1154,5,195,38,80,67,0,7194.944,44,1442.306,LESS,-646,3504,2858,8,2,-13.0,-1.218630998876834,13.0,0.6984302957695783,-1.8829377433825436,1.0389963074462572,147,80,67,0,-0.25928535726370594,0.0,-0.5072169069677779,1.5055579497809068,-1.3931706559530943,1.3931706559530943,-0.5072169069677779,0.0,0,1,0,1,0.0,-0.5072169069677779
1155,5,196,36,70,80,0,6219.5340000000015,34,742.9580000000002,LESS,14,2640,2654,7,1,10.0,0.9374084606744876,10.0,0.17460757394239454,-2.365742292967811,0.6049163763272097,150,70,80,1,-0.19945027481823535,-0.3901668515136753,0.0,1.0276030450885556,-0.4597940459502599,0.4597940459502599,0.0,-0.3901668515136753,0,1,0,1,-0.3901668515136753,0.0
1156,5,197,45,110,122,0,6192.639,74,1745.134,LESS,18,3112,3130,6,2,12.0,1.124890152809385,12.0,0.5238227218271837,-0.4345240946267408,0.5929474814548511,232,110,122,1,1.4360419786912946,1.170500554541026,1.6387007763574364,0.5496481403962042,-0.4541372180108488,0.4541372180108488,1.6387007763574364,1.170500554541026,0,1,0,2,1.6387007763574364,1.170500554541026
1157,5,198,42,110,115,1,4581.567,64,1151.857,LESS,508,1790,2298,4,2,5.0,0.4687042303372438,5.0,-0.6984302957695783,-0.9173286442120084,-0.12401669031684193,225,110,115,1,1.2964267863185297,1.170500554541026,1.3655839802978638,-0.40626166898849847,0.23882420456701312,0.23882420456701312,1.3655839802978638,1.170500554541026,0,0,1,2,1.3655839802978638,1.170500554541026
1158,5,199,41,110,112,0,3802.61,74,1959.12,LESS,296,1840,2136,4,2,2.0,0.18748169213489754,2.0,-1.222253017596762,-0.4345240946267408,-0.470670508613456,222,110,112,1,1.2365917038730592,1.170500554541026,1.248533924843761,-0.40626166898849847,-0.06098767622177611,0.06098767622177611,1.248533924843761,1.170500554541026,0,0,0,2,1.248533924843761,1.170500554541026
1159,5,200,53,110,103,1,5948.0819999999985,0,1805.659,LESS,714,3080,3794,5,2,-7.0,-0.6561859224721414,7.0,-0.34921514788478913,-4.007277761557721,0.4841139799378666,213,110,103,0,1.0570864565366473,1.170500554541026,0.8973837584814532,0.07169323570385287,0.5301508434466856,0.5301508434466856,0.8973837584814532,1.170500554541026,0,1,1,2,1.170500554541026,0.8973837584814532
1160,5,201,3,50,53,1,10750.35,74,1101.378,MORE,1812,4002,5814,12,2,3.0,0.28122253820234633,3.0,-1.0476454436543674,-0.4345240946267408,2.621233921967587,103,50,53,0,-1.1368665664639415,-1.170500554541026,-1.0534504990869233,3.4173775685503123,2.0829501128150376,2.0829501128150376,-1.0534504990869233,-1.170500554541026,0,1,1,0,-1.170500554541026,-1.0534504990869233
1161,5,202,20,50,40,0,1967.113,100,1793.263,MORE,532,1062,1594,3,2,-10.0,-0.9374084606744876,10.0,0.17460757394239454,0.8207677342949549,-1.2875089779024926,90,50,40,1,-1.3961519237276474,-1.170500554541026,-1.5606674060547012,-0.8842165736808498,0.27276517220347984,0.27276517220347984,-1.5606674060547012,-1.170500554541026,1,0,1,0,-1.170500554541026,-1.5606674060547012
1162,5,203,25,80,88,1,4202.552,74,2475.376,MORE,1570,1828,3398,5,2,8.0,0.7499267685395902,8.0,-0.17460757394239454,-0.4345240946267408,-0.29268710080380245,168,80,88,0,0.1595602198545883,0.0,0.31213348121094026,0.07169323570385287,1.7407120224806647,1.7407120224806647,0.31213348121094026,0.0,0,1,1,1,0.31213348121094026,0.0
1163,5,204,42,115,110,1,5729.013000000001,74,743.13,MORE,628,2392,3020,7,2,-5.0,-0.4687042303372438,5.0,-0.6984302957695783,-0.4345240946267408,0.3866232258648945,225,115,110,1,1.2964267863185297,1.3655839802978638,1.170500554541026,1.0276030450885556,0.40852904274934665,0.40852904274934665,1.170500554541026,1.3655839802978638,0,1,1,2,1.3655839802978638,1.170500554541026
1164,5,205,53,103,110,1,6468.345,74,1613.658,MORE,426,3018,3444,7,2,7.0,0.6561859224721414,7.0,-0.34921514788478913,-0.4345240946267408,0.7156430058898151,213,103,110,0,1.0570864565366473,0.8973837584814532,1.170500554541026,1.0276030450885556,0.1228592318090852,0.1228592318090852,1.170500554541026,0.8973837584814532,0,1,1,2,1.170500554541026,0.8973837584814532
1165,5,206,26,90,80,0,3401.716,94,1279.867,MORE,160,1808,1968,4,2,-10.0,-0.9374084606744876,10.0,0.17460757394239454,0.5310850045437943,-0.6490775783646782,170,90,80,1,0.19945027481823535,0.3901668515136753,0.0,-0.40626166898849847,-0.2533198261617541,0.2533198261617541,0.0,0.3901668515136753,0,1,0,1,0.3901668515136753,0.0
1166,5,207,35,80,72,0,5120.399,100,1639.793,MORE,402,2494,2896,6,2,-8.0,-0.7499267685395902,8.0,-0.17460757394239454,0.8207677342949549,0.11577596861093105,152,80,72,1,-0.1595602198545883,0.0,-0.31213348121094026,0.5496481403962042,0.0889182641726185,0.0889182641726185,-0.31213348121094026,0.0,1,1,0,1,0.0,-0.31213348121094026
1167,5,208,28,93,80,0,3429.894,100,1167.644,MORE,332,1862,2194,4,2,-13.0,-1.218630998876834,13.0,0.6984302957695783,0.8207677342949549,-0.636537718921908,173,93,80,1,0.25928535726370594,0.5072169069677779,0.0,-0.40626166898849847,-0.010076224767076054,0.010076224767076054,0.0,0.5072169069677779,1,1,0,1,0.5072169069677779,0.0
1168,5,209,26,80,90,1,2685.014,100,1827.085,MORE,1132,1148,2280,3,2,10.0,0.9374084606744876,10.0,0.17460757394239454,0.8207677342949549,-0.9680264868163896,170,80,90,0,0.19945027481823535,0.0,0.3901668515136753,-0.8842165736808498,1.1212893631151475,1.1212893631151475,0.3901668515136753,0.0,1,0,1,1,0.3901668515136753,0.0
1169,5,210,25,88,80,0,3295.057,100,1815.741,MORE,-202,2176,1974,4,2,-8.0,-0.7499267685395902,8.0,-0.17460757394239454,0.8207677342949549,-0.6965432916270259,168,88,80,1,0.1595602198545883,0.31213348121094026,0.0,-0.40626166898849847,-0.7652627546784603,0.7652627546784603,0.0,0.31213348121094026,1,1,0,1,0.31213348121094026,0.0
1170,5,211,36,80,70,0,2767.752,100,795.3989999999999,MORE,-920,2116,1196,3,2,-10.0,-0.9374084606744876,10.0,0.17460757394239454,0.8207677342949549,-0.9312061698820464,150,80,70,1,-0.19945027481823535,0.0,-0.3901668515136753,-0.8842165736808498,-1.7806633698027559,1.7806633698027559,-0.3901668515136753,0.0,1,0,0,1,0.0,-0.3901668515136753
1171,5,212,28,80,93,1,6210.28,100,1524.8429999999996,MORE,206,3284,3490,5,2,13.0,1.218630998876834,13.0,0.6984302957695783,0.8207677342949549,0.6007981330422563,173,80,93,0,0.25928535726370594,0.0,0.5072169069677779,0.07169323570385287,-0.18826630485852625,0.18826630485852625,0.5072169069677779,0.0,1,1,0,1,0.5072169069677779,0.0
1172,5,213,21,82,80,1,6286.696,74,2159.858,MORE,20,3118,3138,5,2,-2.0,-0.18748169213489754,2.0,-1.222253017596762,-0.4345240946267408,0.6348050142679903,162,82,80,1,0.03989005496364707,0.07803337030273506,0.0,0.07169323570385287,-0.4513088040411432,0.4513088040411432,0.0,0.07803337030273506,0,1,0,1,0.07803337030273506,0.0
1173,5,214,19,50,41,0,2773.192,100,1302.099,MORE,-620,1948,1328,2,2,-9.0,-0.8436676146070391,9.0,0.0,0.8207677342949549,-0.9287852445016551,91,50,41,1,-1.376206896245824,-1.170500554541026,-1.5216507209033339,-1.3621714783732013,-1.356401274346922,1.356401274346922,-1.5216507209033339,-1.170500554541026,1,0,0,0,-1.170500554541026,-1.5216507209033339
1174,5,215,56,96,110,1,5131.492,100,1204.252,MORE,564,2406,2970,5,2,14.0,1.3123718449442827,14.0,0.8730378697119728,0.8207677342949549,0.12071260928090935,206,96,110,0,0.9174712641638826,0.6242669624218805,1.170500554541026,0.07169323570385287,0.31801979571876876,0.31801979571876876,1.170500554541026,0.6242669624218805,1,1,1,2,1.170500554541026,0.6242669624218805
1175,5,216,23,80,85,1,5182.951,100,1726.0510000000004,MORE,582,2568,3150,3,2,5.0,0.4687042303372438,5.0,-0.6984302957695783,0.8207677342949549,0.14361305030104962,165,80,85,0,0.09972513740911768,0.0,0.19508342575683765,-0.8842165736808498,0.3434755214461188,0.3434755214461188,0.19508342575683765,0.0,1,0,1,1,0.19508342575683765,0.0
1176,5,217,10,60,50,0,3509.371,100,1561.938,MORE,-404,2182,1778,4,2,-10.0,-0.9374084606744876,10.0,0.17460757394239454,0.8207677342949549,-0.6011686221466559,110,60,50,1,-0.9972513740911768,-0.7803337030273506,-1.170500554541026,-0.40626166898849847,-1.0509325656187216,1.0509325656187216,-1.170500554541026,-0.7803337030273506,1,1,0,0,-0.7803337030273506,-1.170500554541026
1177,5,218,19,41,50,1,5524.318,74,980.147,MORE,298,2474,2772,5,2,9.0,0.8436676146070391,9.0,0.0,-0.4345240946267408,0.2955292330819481,91,41,50,0,-1.376206896245824,-1.5216507209033339,-1.170500554541026,0.07169323570385287,-0.05815926225207055,0.05815926225207055,-1.170500554541026,-1.5216507209033339,0,1,0,0,-1.5216507209033339,-1.170500554541026
1178,5,219,56,110,96,0,3216.242,100,1853.984,MORE,-570,2494,1924,3,2,-14.0,-1.3123718449442827,14.0,0.8730378697119728,0.8207677342949549,-0.7316177831445905,206,110,96,1,0.9174712641638826,1.170500554541026,0.6242669624218805,-0.8842165736808498,-1.285690925104283,1.285690925104283,0.6242669624218805,1.170500554541026,1,0,0,2,1.170500554541026,0.6242669624218805
1179,5,220,35,72,80,0,4535.487,74,1445.72,MORE,86,2432,2518,3,2,8.0,0.7499267685395902,8.0,-0.17460757394239454,-0.4345240946267408,-0.14452335236251065,152,72,80,0,-0.1595602198545883,-0.31213348121094026,0.0,-0.8842165736808498,-0.35797114304085975,0.35797114304085975,0.0,-0.31213348121094026,0,0,0,1,-0.31213348121094026,0.0
1180,5,221,11,49,50,0,3339.644,100,708.188,MORE,-780,2220,1440,5,2,1.0,0.09374084606744876,1.0,-1.3968605915391563,0.8207677342949549,-0.6767010489918213,99,49,50,0,-1.2166466763912356,-1.2095172396923934,-1.170500554541026,0.07169323570385287,-1.5826743919233668,1.5826743919233668,-1.170500554541026,-1.2095172396923934,1,1,0,0,-1.2095172396923934,-1.170500554541026
1181,5,222,17,43,50,1,3696.722,84,1602.881,MORE,600,1914,2514,3,2,7.0,0.6561859224721414,7.0,-0.34921514788478913,0.048280454958526765,-0.5177931091058988,93,43,50,0,-1.3363168412821769,-1.4436173506005987,-1.170500554541026,-0.8842165736808498,0.3689312471734688,0.3689312471734688,-1.170500554541026,-1.4436173506005987,0,0,1,0,-1.4436173506005987,-1.170500554541026
1182,5,223,1,51,50,1,9921.861,44,1453.737,MORE,-984,4618,3634,9,2,-1.0,-0.09374084606744876,1.0,-1.3968605915391563,-1.8829377433825436,2.2525372220640705,101,51,50,1,-1.1767566214275886,-1.1314838693896585,-1.170500554541026,1.9835128544732583,-1.8711726168333338,1.8711726168333338,-1.170500554541026,-1.1314838693896585,0,1,0,0,-1.1314838693896585,-1.170500554541026
1183,5,224,41,112,110,0,4966.261,80,1377.971,MORE,-406,2880,2474,3,2,-2.0,-0.18748169213489754,2.0,-1.222253017596762,-0.14484136487558028,0.04718100605895004,222,112,110,1,1.2365917038730592,1.248533924843761,1.170500554541026,-0.8842165736808498,-1.0537609795884273,1.0537609795884273,1.170500554541026,1.248533924843761,0,0,0,2,1.248533924843761,1.170500554541026
1184,5,225,20,40,50,1,3274.713,84,679.312,MORE,164,1734,1898,3,2,10.0,0.9374084606744876,10.0,0.17460757394239454,0.048280454958526765,-0.7055968405128131,90,40,50,0,-1.3961519237276474,-1.5606674060547012,-1.170500554541026,-0.8842165736808498,-0.247662998222343,0.247662998222343,-1.170500554541026,-1.5606674060547012,0,0,0,0,-1.5606674060547012,-1.170500554541026
1185,5,226,1,50,51,0,3353.705,100,1021.074,MORE,-644,2128,1484,2,2,1.0,0.09374084606744876,1.0,-1.3968605915391563,0.8207677342949549,-0.6704435799157763,101,50,51,0,-1.1767566214275886,-1.170500554541026,-1.1314838693896585,-1.3621714783732013,-1.3903422419833886,1.3903422419833886,-1.1314838693896585,-1.170500554541026,1,0,0,0,-1.170500554541026,-1.1314838693896585
1186,5,227,23,85,80,1,2880.1620000000007,100,793.045,MORE,662,1370,2032,3,2,-5.0,-0.4687042303372438,5.0,-0.6984302957695783,0.8207677342949549,-0.8811811290714207,165,85,80,1,0.09972513740911768,0.19508342575683765,0.0,-0.8842165736808498,0.45661208023434113,0.45661208023434113,0.0,0.19508342575683765,1,0,1,1,0.19508342575683765,0.0
1187,5,228,11,50,49,1,5744.953,100,1658.069,MORE,982,2558,3540,4,2,-1.0,-0.09374084606744876,1.0,-1.3968605915391563,0.8207677342949549,0.3937168932478796,99,50,49,1,-1.2166466763912356,-1.170500554541026,-1.2095172396923934,-0.40626166898849847,0.9091583153872306,0.9091583153872306,-1.2095172396923934,-1.170500554541026,1,0,1,0,-1.170500554541026,-1.2095172396923934
1188,5,229,17,50,43,0,7705.144,44,1761.267,MORE,-1526,4280,2754,4,1,-7.0,-0.6561859224721414,7.0,-0.34921514788478913,-1.8829377433825436,1.2660470664675283,93,50,43,1,-1.3363168412821769,-1.170500554541026,-1.4436173506005987,-0.40626166898849847,-2.6376728026235403,2.6376728026235403,-1.4436173506005987,-1.170500554541026,0,0,0,0,-1.170500554541026,-1.4436173506005987
1189,5,230,21,80,82,0,5349.143,84,1673.566,MORE,-208,3284,3076,4,2,2.0,0.18748169213489754,2.0,-1.222253017596762,0.048280454958526765,0.21757232067200832,162,80,82,0,0.03989005496364707,0.0,0.07803337030273506,-0.40626166898849847,-0.7737479965875769,0.7737479965875769,0.07803337030273506,0.0,0,1,0,1,0.07803337030273506,0.0
1190,5,231,10,50,60,1,1684.1270000000004,100,1996.049,MORE,1458,698,2156,1,2,10.0,0.9374084606744876,10.0,0.17460757394239454,0.8207677342949549,-1.4134442701259216,110,50,60,0,-0.9972513740911768,-1.170500554541026,-0.7803337030273506,-1.8401263830655525,1.5823208401771536,1.5823208401771536,-0.7803337030273506,-1.170500554541026,1,0,1,0,-1.170500554541026,-0.7803337030273506
1191,5,232,3,53,50,1,8920.318000000001,74,1111.603,MORE,692,3814,4506,7,2,-3.0,-0.28122253820234633,3.0,-1.0476454436543674,-0.4345240946267408,1.8068275036351384,103,53,50,1,-1.1368665664639415,-1.0534504990869233,-1.170500554541026,1.0276030450885556,0.49903828977992454,0.49903828977992454,-1.170500554541026,-1.0534504990869233,0,1,1,0,-1.0534504990869233,-1.170500554541026
1192,5,233,45,122,110,0,3929.479,100,1413.256,MORE,-144,2320,2176,5,2,-12.0,-1.124890152809385,12.0,0.5238227218271837,0.8207677342949549,-0.41421087955373503,232,122,110,1,1.4360419786912946,1.6387007763574364,1.170500554541026,0.07169323570385287,-0.683238749556999,0.683238749556999,1.170500554541026,1.6387007763574364,1,1,0,2,1.6387007763574364,1.170500554541026
1193,5,234,38,67,80,1,4745.499,100,2040.082,MORE,240,2702,2942,5,2,13.0,1.218630998876834,13.0,0.6984302957695783,0.8207677342949549,-0.05106317203406065,147,67,80,0,-0.25928535726370594,-0.5072169069677779,0.0,0.07169323570385287,-0.14018326737353176,0.14018326737353176,0.0,-0.5072169069677779,1,1,0,1,-0.5072169069677779,0.0
1194,5,235,38,80,67,1,7090.406999999998,84,1431.5079999999996,MORE,-8,3482,3474,5,2,-13.0,-1.218630998876834,13.0,0.6984302957695783,0.048280454958526765,0.9924749330914804,147,80,67,1,-0.25928535726370594,0.0,-0.5072169069677779,0.07169323570385287,-0.49090659961702104,0.49090659961702104,-0.5072169069677779,0.0,0,1,0,1,0.0,-0.5072169069677779
1195,5,236,36,70,80,1,2844.463,100,1301.156,MORE,1102,1276,2378,3,2,10.0,0.9374084606744876,10.0,0.17460757394239454,0.8207677342949549,-0.8970680068571919,150,70,80,0,-0.19945027481823535,-0.3901668515136753,0.0,-0.8842165736808498,1.078863153569564,1.078863153569564,0.0,-0.3901668515136753,1,0,1,1,-0.3901668515136753,0.0
1196,5,237,45,110,122,1,3887.278,100,755.967,MORE,82,2012,2094,3,2,12.0,1.124890152809385,12.0,0.5238227218271837,0.8207677342949549,-0.4329912971967312,232,110,122,0,1.4360419786912946,1.170500554541026,1.6387007763574364,-0.8842165736808498,-0.3636279709802709,0.3636279709802709,1.6387007763574364,1.170500554541026,1,0,0,2,1.6387007763574364,1.170500554541026
1197,5,238,42,110,115,1,3029.146,100,627.125,MORE,652,1336,1988,3,2,5.0,0.4687042303372438,5.0,-0.6984302957695783,0.8207677342949549,-0.8148798153081416,225,110,115,0,1.2964267863185297,1.170500554541026,1.3655839802978638,-0.8842165736808498,0.44247001038581335,0.44247001038581335,1.3655839802978638,1.170500554541026,1,0,1,2,1.3655839802978638,1.170500554541026
1198,5,239,41,110,112,1,4561.733,100,763.9169999999998,MORE,26,2312,2338,3,2,2.0,0.18748169213489754,2.0,-1.222253017596762,0.8207677342949549,-0.13284327744821758,222,110,112,0,1.2365917038730592,1.170500554541026,1.248533924843761,-0.8842165736808498,-0.44282356213202656,0.44282356213202656,1.248533924843761,1.170500554541026,1,0,0,2,1.248533924843761,1.170500554541026
1199,5,240,53,110,103,0,3030.526,74,1640.106,MORE,44,2018,2062,2,2,-7.0,-0.6561859224721414,7.0,-0.34921514788478913,-0.4345240946267408,-0.8142656835020865,213,110,103,1,1.0570864565366473,1.170500554541026,0.8973837584814532,-1.3621714783732013,-0.4173678364046765,0.4173678364046765,0.8973837584814532,1.170500554541026,0,0,0,2,1.170500554541026,0.8973837584814532
1200,6,1,49,110,131,1,4851.797000000001,44,1770.088,MORE,1012,1602,2614,2,1,21.0,1.9685577674164243,21.0,2.0952908873087353,-0.6584369312235226,2.058508817308621,241,110,131,0,1.6155472260277064,1.170500554541026,1.9898509427197442,-0.6999646281271542,0.9708955487419565,0.9708955487419565,1.9898509427197442,1.170500554541026,0,0,1,2,1.9898509427197442,1.170500554541026
1201,6,2,13,47,50,1,3312.908,54,1638.924,MORE,-68,1286,1218,3,2,3.0,0.28122253820234633,3.0,-1.0476454436543674,-0.20822364491684048,0.6450312498883098,97,47,50,0,-1.2565367313548828,-1.2875506099951286,-1.170500554541026,0.02413671131472937,-0.4975488439029595,0.4975488439029595,-1.170500554541026,-1.2875506099951286,0,1,0,0,-1.2875506099951286,-1.170500554541026
1202,6,3,16,50,44,0,4002.002,44,933.921,MORE,-620,1698,1078,3,1,-6.0,-0.5624450764046927,6.0,-0.5238227218271837,-0.6584369312235226,1.2779676805496054,94,50,44,1,-1.3163718138003533,-1.170500554541026,-1.4046006654492311,0.02413671131472937,-1.2480870890325835,1.2480870890325835,-1.4046006654492311,-1.170500554541026,0,1,0,0,-1.170500554541026,-1.4046006654492311
1203,6,4,7,57,50,1,3162.02,4,507.562,MORE,-24,1468,1444,3,1,-7.0,-0.6561859224721414,7.0,-0.34921514788478913,-2.459290076450251,0.5064398354374199,107,57,50,1,-1.0570864565366473,-0.8973837584814532,-1.170500554541026,0.02413671131472937,-0.43772333161001853,0.43772333161001853,-1.170500554541026,-0.8973837584814532,0,1,0,0,-0.8973837584814532,-1.170500554541026
1204,6,5,18,42,50,1,2004.751,74,1477.236,MORE,492,790,1282,1,2,8.0,0.7499267685395902,8.0,-0.17460757394239454,0.6922029276965238,-0.5565177729222044,92,42,50,0,-1.3562618687640005,-1.4826340357519663,-1.170500554541026,-1.424065967569038,0.2638667670981081,0.2638667670981081,-1.170500554541026,-1.4826340357519663,1,0,1,0,-1.4826340357519663,-1.170500554541026
1205,6,6,51,108,110,1,4362.118,34,974.686,MORE,-156,1906,1750,3,2,2.0,0.18748169213489754,2.0,-1.222253017596762,-1.1086502175302049,1.6087361035282168,218,108,110,0,1.156811593945765,1.092467184238291,1.170500554541026,0.02413671131472937,-0.6171998684888416,0.6171998684888416,1.170500554541026,1.092467184238291,0,1,0,2,1.170500554541026,1.092467184238291
1206,6,7,31,78,80,1,3420.4,54,1641.365,MORE,-356,1352,996,1,2,2.0,0.18748169213489754,2.0,-1.222253017596762,-0.20822364491684048,0.7437632121527383,158,78,80,0,-0.03989005496364707,-0.07803337030273506,0.0,-1.424065967569038,-0.8891340152749372,0.8891340152749372,0.0,-0.07803337030273506,0,0,0,1,-0.07803337030273506,0.0
1207,6,8,58,110,92,0,2673.063,44,2328.276,MORE,-496,1498,1002,2,2,-18.0,-1.6873352292140782,18.0,1.571468165481551,-0.6584369312235226,0.057330282420189976,202,110,92,1,0.8376911542365885,1.170500554541026,0.4682002218164104,-0.6999646281271542,-1.0794879180252042,1.0794879180252042,0.4682002218164104,1.170500554541026,0,0,0,2,1.170500554541026,0.4682002218164104
1208,6,9,12,50,48,1,7952.5,34,1684.152,MORE,728,3128,3856,7,1,-2.0,-0.18748169213489754,2.0,-1.222253017596762,-1.1086502175302049,4.906520684137776,98,50,48,1,-1.2365917038730592,-1.170500554541026,-1.248533924843761,2.9205420690822637,0.5847490603057008,0.5847490603057008,-1.248533924843761,-1.170500554541026,0,1,1,0,-1.170500554541026,-1.248533924843761
1209,6,10,54,110,101,1,3058.378,44,1336.316,MORE,4,1264,1268,3,2,-9.0,-0.8436676146070391,9.0,0.0,-0.6584369312235226,0.4112441182397693,211,110,101,1,1.0171964015730004,1.170500554541026,0.8193503881787182,0.02413671131472937,-0.3996525510599651,0.3996525510599651,0.8193503881787182,1.170500554541026,0,0,0,2,1.170500554541026,0.8193503881787182
1210,6,11,14,46,50,1,1738.02,54,1861.731,MORE,46,742,788,2,1,4.0,0.3749633842697951,4.0,-0.8730378697119728,-0.20822364491684048,-0.8015115866641873,96,46,50,0,-1.2764817588367063,-1.3265672951464962,-1.170500554541026,-0.6999646281271542,-0.34254638023488504,0.34254638023488504,-1.170500554541026,-1.3265672951464962,0,0,0,0,-1.3265672951464962,-1.170500554541026
1211,6,12,22,80,83,1,5138.1579999999985,44,1426.773,MORE,230,2178,2408,5,2,3.0,0.28122253820234633,3.0,-1.0476454436543674,-0.6584369312235226,2.3215328883651054,163,80,83,0,0.05983508244547061,0.0,0.1170500554541026,1.4723393901984967,-0.09236696519167713,0.09236696519167713,0.1170500554541026,0.0,0,1,0,1,0.1170500554541026,0.0
1212,6,13,6,50,56,1,1388.854,74,2020.012,MORE,448,682,1130,3,2,6.0,0.5624450764046927,6.0,-0.5238227218271837,0.6922029276965238,-1.122222377569756,106,50,56,0,-1.077031484018471,-1.170500554541026,-0.9364004436328208,0.02413671131472937,0.20404125480516705,0.20404125480516705,-0.9364004436328208,-1.170500554541026,1,0,1,0,-1.170500554541026,-0.9364004436328208
1213,6,14,13,50,47,1,6180.061,54,2205.455,MORE,-482,2874,2392,5,2,-3.0,-0.28122253820234633,3.0,-1.0476454436543674,-0.20822364491684048,3.2785262244198328,97,50,47,1,-1.2565367313548828,-1.170500554541026,-1.2875506099951286,1.4723393901984967,-1.0604525277501775,1.0604525277501775,-1.2875506099951286,-1.170500554541026,0,1,0,0,-1.170500554541026,-1.2875506099951286
1214,6,15,46,110,124,1,2672.362,74,2979.225,MORE,478,1288,1766,4,2,14.0,1.3123718449442827,14.0,0.8730378697119728,0.6922029276965238,0.0566864102664728,234,110,124,0,1.4759320336549415,1.170500554541026,1.7167341466601715,0.748238050756613,0.24483137682308137,0.24483137682308137,1.7167341466601715,1.170500554541026,1,1,1,2,1.7167341466601715,1.170500554541026
1215,6,16,27,91,80,0,3024.093,54,1974.745,MORE,-790,1834,1044,4,1,-11.0,-1.0311493067419364,11.0,0.34921514788478913,-0.20822364491684048,0.3797531670412061,171,91,80,1,0.21939530230005888,0.4291835366650429,0.0,0.748238050756613,-1.4792311138007646,1.4792311138007646,0.0,0.4291835366650429,1,1,0,1,0.4291835366650429,0.0
1216,6,17,40,64,80,1,3066.804,54,1270.355,MORE,572,1234,1806,3,2,16.0,1.4998535370791803,16.0,1.222253017596762,-0.20822364491684048,0.4189834431573452,144,64,80,0,-0.3191204397091766,-0.6242669624218805,0.0,0.02413671131472937,0.3726404258125463,0.3726404258125463,0.0,-0.6242669624218805,0,0,1,1,-0.6242669624218805,0.0
1217,6,18,22,83,80,0,3916.881,54,2322.837,MORE,-176,1822,1646,4,2,-3.0,-0.28122253820234633,3.0,-1.0476454436543674,-0.20822364491684048,1.1997835983861849,163,83,80,1,0.05983508244547061,0.1170500554541026,0.0,0.748238050756613,-0.6443932831674511,0.6443932831674511,0.0,0.1170500554541026,0,1,0,1,0.1170500554541026,0.0
1218,6,19,54,101,110,0,3402.134,34,1644.1989999999996,MORE,-372,1648,1276,4,1,9.0,0.8436676146070391,9.0,0.0,-1.1086502175302049,0.7269857959476063,211,101,110,0,1.0171964015730004,0.8193503881787182,1.170500554541026,0.748238050756613,-0.9108887470178249,0.9108887470178249,1.170500554541026,0.8193503881787182,0,1,0,2,1.170500554541026,0.8193503881787182
1219,6,20,6,56,50,0,3214.156,34,2032.674,MORE,-952,2008,1056,4,1,-6.0,-0.5624450764046927,6.0,-0.5238227218271837,-1.1086502175302049,0.5543270231780726,106,56,50,1,-1.077031484018471,-0.9364004436328208,-1.170500554541026,0.748238050756613,-1.699497772697502,1.699497772697502,-1.170500554541026,-0.9364004436328208,0,1,0,0,-0.9364004436328208,-1.170500554541026
1220,6,21,18,50,42,0,2321.735,74,1341.6370000000004,MORE,330,1110,1440,2,2,-8.0,-0.7499267685395902,8.0,-0.17460757394239454,0.6922029276965238,-0.26536631675404704,92,50,42,1,-1.3562618687640005,-1.170500554541026,-1.4826340357519663,-0.6999646281271542,0.04360010820137065,0.04360010820137065,-1.4826340357519663,-1.170500554541026,1,0,0,0,-1.170500554541026,-1.4826340357519663
1221,6,22,43,110,117,0,5081.537,54,2934.6940000000004,MORE,-528,2092,1564,3,2,7.0,0.6561859224721414,7.0,-0.34921514788478913,-0.20822364491684048,2.2695262047479616,227,110,117,0,1.3363168412821769,1.170500554541026,1.4436173506005987,0.02413671131472937,-1.1229973815109795,1.1229973815109795,1.4436173506005987,1.170500554541026,0,0,0,2,1.4436173506005987,1.170500554541026
1222,6,23,32,77,80,0,2524.934,54,2612.962,MORE,-250,1154,904,1,2,3.0,0.28122253820234633,3.0,-1.0476454436543674,-0.20822364491684048,-0.07872697615037805,157,77,80,0,-0.05983508244547061,-0.1170500554541026,0.0,-1.424065967569038,-0.7450089174783066,0.7450089174783066,0.0,-0.1170500554541026,0,0,0,1,-0.1170500554541026,0.0
1223,6,24,27,80,91,1,3137.088,74,1545.239,MORE,1170,1350,2520,3,2,11.0,1.0311493067419364,11.0,0.34921514788478913,0.6922029276965238,0.4835396634880962,171,80,91,0,0.21939530230005888,0.0,0.4291835366650429,0.02413671131472937,1.185723524702972,1.185723524702972,0.4291835366650429,0.0,1,1,1,1,0.4291835366650429,0.0
1224,6,25,16,44,50,1,2415.087,74,1024.678,MORE,916,930,1846,3,2,6.0,0.5624450764046927,6.0,-0.5238227218271837,0.6922029276965238,-0.17962201818941986,94,44,50,0,-1.3163718138003533,-1.4046006654492311,-1.170500554541026,0.02413671131472937,0.8403671582846306,0.8403671582846306,-1.170500554541026,-1.4046006654492311,1,1,1,0,-1.4046006654492311,-1.170500554541026
1225,6,26,7,50,57,1,3210.695,94,1348.275,MORE,528,1558,2086,3,2,7.0,0.6561859224721414,7.0,-0.34921514788478913,1.592629500309888,0.5511480766388216,107,50,57,0,-1.0570864565366473,-1.170500554541026,-0.8973837584814532,0.02413671131472937,0.3128149135196053,0.3128149135196053,-0.8973837584814532,-1.170500554541026,1,1,1,0,-1.170500554541026,-0.8973837584814532
1226,6,27,14,50,46,0,2546.444,84,1508.721,MORE,472,1398,1870,2,2,-4.0,-0.3749633842697951,4.0,-0.8730378697119728,1.1424162140032061,-0.05896992903703165,96,50,46,1,-1.2764817588367063,-1.170500554541026,-1.3265672951464962,-0.6999646281271542,0.2366733524194985,0.2366733524194985,-1.3265672951464962,-1.170500554541026,1,0,1,0,-1.170500554541026,-1.3265672951464962
1227,6,28,51,110,108,1,2899.148,100,2561.548,MORE,1734,1334,3068,3,2,-2.0,-0.18748169213489754,2.0,-1.222253017596762,1.8627574720938973,0.2649905333091239,218,110,108,1,1.156811593945765,1.170500554541026,1.092467184238291,0.02413671131472937,1.9525778186397615,1.9525778186397615,1.092467184238291,1.170500554541026,1,1,1,2,1.170500554541026,1.092467184238291
1228,6,29,50,133,110,0,5130.035,44,3109.239,MORE,-520,2590,2070,6,2,-23.0,-2.1560394595513217,23.0,2.444506035193524,-0.6584369312235226,2.314071870526812,243,133,110,1,1.6554372809913533,2.0678843130224793,1.170500554541026,2.19644072964038,-1.1121200156395357,1.1121200156395357,1.170500554541026,2.0678843130224793,0,1,0,2,2.0678843130224793,1.170500554541026
1229,6,30,49,131,110,0,2914.8,84,3205.875,MORE,1204,1380,2584,0,2,-21.0,-1.9685577674164243,21.0,2.0952908873087353,1.1424162140032061,0.27936697688969586,241,131,110,1,1.6155472260277064,1.9898509427197442,1.170500554541026,-2.1481673070109215,1.2319523296566082,1.2319523296566082,1.170500554541026,1.9898509427197442,1,0,1,2,1.9898509427197442,1.170500554541026
1230,6,31,47,126,110,0,4271.251,54,1918.465,MORE,-924,1964,1040,3,2,-16.0,-1.4998535370791803,16.0,1.222253017596762,-0.20822364491684048,1.5252742904157823,236,126,110,1,1.5158220886185887,1.7947675169629065,1.170500554541026,0.02413671131472937,-1.6614269921474487,1.6614269921474487,1.170500554541026,1.7947675169629065,0,1,0,2,1.7947675169629065,1.170500554541026
1231,6,32,50,110,133,1,3288.96,84,2009.277,MORE,1148,1572,2720,2,2,23.0,2.1560394595513217,23.0,2.444506035193524,1.1424162140032061,0.6230348870677416,243,110,133,0,1.6554372809913533,1.170500554541026,2.0678843130224793,-0.6999646281271542,1.1558107685565016,1.1558107685565016,2.0678843130224793,1.170500554541026,1,0,1,2,2.0678843130224793,1.170500554541026
1232,6,33,47,110,126,0,2520.065,44,1418.918,MORE,-210,1294,1084,3,2,16.0,1.4998535370791803,16.0,1.222253017596762,-0.6584369312235226,-0.08319917802833655,236,110,126,0,1.5158220886185887,1.170500554541026,1.7947675169629065,0.02413671131472937,-0.6906220881210874,0.6906220881210874,1.7947675169629065,1.170500554541026,0,1,0,2,1.7947675169629065,1.170500554541026
1233,6,34,12,48,50,1,2498.831,64,1870.417,MORE,512,956,1468,3,2,2.0,0.18748169213489754,2.0,-1.222253017596762,0.24198964138984164,-0.10270271770312968,98,48,50,0,-1.2365917038730592,-1.248533924843761,-1.170500554541026,0.02413671131472937,0.2910601817767176,0.2910601817767176,-1.170500554541026,-1.248533924843761,1,0,1,0,-1.248533924843761,-1.170500554541026
1234,6,35,32,80,77,0,4839.608,44,1288.559,MORE,-1150,2736,1586,4,1,-3.0,-0.28122253820234633,3.0,-1.0476454436543674,-0.6584369312235226,2.0473131572777232,157,80,77,1,-0.05983508244547061,0.0,-0.1170500554541026,0.748238050756613,-1.9687125780157366,1.9687125780157366,-0.1170500554541026,0.0,0,1,0,1,0.0,-0.1170500554541026
1235,6,36,43,117,110,0,2739.551,54,1828.172,MORE,462,1164,1626,2,2,-7.0,-0.6561859224721414,7.0,-0.34921514788478913,-0.20822364491684048,0.11839985696561935,227,117,110,1,1.3363168412821769,1.4436173506005987,1.170500554541026,-0.6999646281271542,0.22307664508019373,0.22307664508019373,1.170500554541026,1.4436173506005987,0,0,1,2,1.4436173506005987,1.170500554541026
1236,6,37,40,80,64,0,2809.3920000000007,64,1959.702,MORE,-820,1344,524,1,2,-16.0,-1.4998535370791803,16.0,1.222253017596762,0.24198964138984164,0.1825491794873886,144,80,64,1,-0.3191204397091766,0.0,-0.6242669624218805,-1.424065967569038,-1.5200212358186789,1.5200212358186789,-0.6242669624218805,0.0,1,0,0,1,0.0,-0.6242669624218805
1237,6,38,31,80,78,1,3378.269,44,2012.59,MORE,-94,1420,1326,3,2,-2.0,-0.18748169213489754,2.0,-1.222253017596762,-0.6584369312235226,0.7050656690596462,158,80,78,1,-0.03989005496364707,0.0,-0.07803337030273506,0.02413671131472937,-0.5329002829851519,0.5329002829851519,-0.07803337030273506,0.0,0,1,0,1,0.0,-0.07803337030273506
1238,6,39,46,124,110,1,2938.868,64,1693.006,MORE,766,1296,2062,3,2,-14.0,-1.3123718449442827,14.0,0.8730378697119728,0.24198964138984164,0.3014735603357219,234,124,110,1,1.4759320336549415,1.7167341466601715,1.170500554541026,0.02413671131472937,0.636416548195059,0.636416548195059,1.170500554541026,1.7167341466601715,1,1,1,2,1.7167341466601715,1.170500554541026
1239,6,40,58,92,110,1,2794.449,84,2922.6620000000007,MORE,1920,1390,3310,2,2,18.0,1.6873352292140782,18.0,1.571468165481551,1.1424162140032061,0.16882395610223047,202,92,110,0,0.8376911542365885,0.4682002218164104,1.170500554541026,-0.6999646281271542,2.2054765751508305,2.2054765751508305,1.170500554541026,0.4682002218164104,1,0,1,2,1.170500554541026,0.4682002218164104
1240,6,41,49,110,131,0,2260.55,64,969.613,LESS,-382,1512,1130,2,2,21.0,1.9685577674164243,21.0,2.0952908873087353,0.24198964138984164,-0.321565058159445,241,110,131,1,1.6155472260277064,1.170500554541026,1.9898509427197442,-0.6999646281271542,-0.9244854543571297,0.9244854543571297,1.9898509427197442,1.170500554541026,1,0,0,2,1.9898509427197442,1.170500554541026
1241,6,42,13,47,50,0,1843.156,64,892.812,LESS,-320,1028,708,1,2,3.0,0.28122253820234633,3.0,-1.0476454436543674,0.24198964138984164,-0.7049436226795844,97,47,50,1,-1.2565367313548828,-1.2875506099951286,-1.170500554541026,-1.424065967569038,-0.84018586885344,0.84018586885344,-1.170500554541026,-1.2875506099951286,1,0,0,0,-1.2875506099951286,-1.170500554541026
1242,6,43,16,50,44,0,2730.824,54,2105.529,LESS,112,922,1034,3,2,-6.0,-0.5624450764046927,6.0,-0.5238227218271837,-0.20822364491684048,0.1103840619791864,94,50,44,0,-1.3163718138003533,-1.170500554541026,-1.4046006654492311,0.02413671131472937,-0.2528081117954735,0.2528081117954735,-1.4046006654492311,-1.170500554541026,0,1,0,0,-1.170500554541026,-1.4046006654492311
1243,6,44,7,57,50,1,2591.599,44,1935.642,LESS,108,1082,1190,3,2,-7.0,-0.6561859224721414,7.0,-0.34921514788478913,-0.6584369312235226,-0.017494826182397987,107,57,50,0,-1.0570864565366473,-0.8973837584814532,-1.170500554541026,0.02413671131472937,-0.25824679473119544,0.25824679473119544,-1.170500554541026,-0.8973837584814532,0,1,0,0,-0.8973837584814532,-1.170500554541026
1244,6,45,18,42,50,0,2012.687,94,1188.056,LESS,2,1124,1126,2,2,8.0,0.7499267685395902,8.0,-0.17460757394239454,1.592629500309888,-0.549228515558582,92,42,50,1,-1.3562618687640005,-1.4826340357519663,-1.170500554541026,-0.6999646281271542,-0.40237189252782607,0.40237189252782607,-1.170500554541026,-1.4826340357519663,1,0,0,0,-1.4826340357519663,-1.170500554541026
1245,6,46,51,108,110,1,4287.015,14,1523.29,LESS,102,1644,1746,5,2,2.0,0.18748169213489754,2.0,-1.222253017596762,-2.009076790143569,1.5397536065801152,218,108,110,1,1.156811593945765,1.092467184238291,1.170500554541026,1.4723393901984967,-0.2664048191347783,0.2664048191347783,1.170500554541026,1.092467184238291,0,1,0,2,1.170500554541026,1.092467184238291
1246,6,47,31,78,80,1,5723.241,0,2844.485,LESS,-620,3146,2526,6,1,2.0,0.18748169213489754,2.0,-1.222253017596762,-2.639375390972924,2.8589346734054684,158,78,80,1,-0.03989005496364707,-0.07803337030273506,0.0,2.19644072964038,-1.2480870890325835,1.2480870890325835,0.0,-0.07803337030273506,0,1,0,1,-0.07803337030273506,0.0
1247,6,48,58,110,92,1,2819.185,24,1347.1270000000004,LESS,388,1030,1418,3,2,-18.0,-1.6873352292140782,18.0,1.571468165481551,-1.5588635038368868,0.19154410102997288,202,110,92,0,0.8376911542365885,1.170500554541026,0.4682002218164104,0.02413671131472937,0.12246101076933837,0.12246101076933837,0.4682002218164104,1.170500554541026,0,1,1,2,1.170500554541026,0.4682002218164104
1248,6,49,12,50,48,0,2436.317,74,1256.585,LESS,206,1174,1380,2,2,-2.0,-0.18748169213489754,2.0,-1.222253017596762,0.6922029276965238,-0.1601221525354752,98,50,48,0,-1.2365917038730592,-1.170500554541026,-1.248533924843761,-0.6999646281271542,-0.1249990628060086,0.1249990628060086,-1.248533924843761,-1.170500554541026,1,0,1,0,-1.170500554541026,-1.248533924843761
1249,6,50,54,110,101,0,2697.941,44,1054.908,LESS,-1044,1524,480,1,1,-9.0,-0.8436676146070391,9.0,0.0,-0.6584369312235226,0.08018085508805753,211,110,101,0,1.0171964015730004,1.170500554541026,0.8193503881787182,-1.424065967569038,-1.824587480219106,1.824587480219106,0.8193503881787182,1.170500554541026,0,0,0,2,1.170500554541026,0.8193503881787182
1250,6,51,14,46,50,0,1706.21,84,2012.951,LESS,1194,526,1720,1,2,4.0,0.3749633842697951,4.0,-0.8730378697119728,1.1424162140032061,-0.8307292374626791,96,46,50,1,-1.2764817588367063,-1.3265672951464962,-1.170500554541026,-1.424065967569038,1.2183556223173033,1.2183556223173033,-1.170500554541026,-1.3265672951464962,1,0,1,0,-1.3265672951464962,-1.170500554541026
1251,6,52,22,80,83,0,2821.937,34,1708.231,LESS,-600,1492,892,3,1,3.0,0.28122253820234633,3.0,-1.0476454436543674,-1.1086502175302049,0.19407182737380965,163,80,83,1,0.05983508244547061,0.0,0.1170500554541026,0.02413671131472937,-1.2208936743539738,1.2208936743539738,0.1170500554541026,0.0,0,1,0,1,0.1170500554541026,0.0
1252,6,53,6,50,56,0,2177.331,94,1201.755,LESS,162,890,1052,1,2,6.0,0.5624450764046927,6.0,-0.5238227218271837,1.592629500309888,-0.3980021434093563,106,50,56,1,-1.077031484018471,-1.170500554541026,-0.9364004436328208,-1.424065967569038,-0.18482457509894962,0.18482457509894962,-0.9364004436328208,-1.170500554541026,1,0,0,0,-1.170500554541026,-0.9364004436328208
1253,6,54,13,50,47,0,3235.244,64,1601.172,LESS,38,1544,1582,4,2,-3.0,-0.28122253820234633,3.0,-1.0476454436543674,0.24198964138984164,0.5736964610918921,97,50,47,0,-1.2565367313548828,-1.170500554541026,-1.2875506099951286,0.748238050756613,-0.3534237461063289,0.3534237461063289,-1.2875506099951286,-1.170500554541026,1,1,0,0,-1.170500554541026,-1.2875506099951286
1254,6,55,46,110,124,0,2865.366,44,2068.093,LESS,-42,1240,1198,4,2,14.0,1.3123718449442827,14.0,0.8730378697119728,-0.6584369312235226,0.2339615902322723,234,110,124,1,1.4759320336549415,1.170500554541026,1.7167341466601715,0.748238050756613,-0.4621974048207671,0.4621974048207671,1.7167341466601715,1.170500554541026,0,1,0,2,1.7167341466601715,1.170500554541026
1255,6,56,27,91,80,0,2002.322,44,1190.803,LESS,-450,1036,586,2,1,-11.0,-1.0311493067419364,11.0,0.34921514788478913,-0.6584369312235226,-0.5587488220825167,171,91,80,0,0.21939530230005888,0.4291835366650429,0.0,-0.6999646281271542,-1.0169430642644022,1.0169430642644022,0.0,0.4291835366650429,0,0,0,1,0.4291835366650429,0.0
1256,6,57,40,64,80,0,1829.599,94,1947.976,LESS,744,902,1646,1,2,16.0,1.4998535370791803,16.0,1.222253017596762,1.592629500309888,-0.7173957978407021,144,64,80,1,-0.3191204397091766,-0.6242669624218805,0.0,-1.424065967569038,0.6065037920485885,0.6065037920485885,0.0,-0.6242669624218805,1,0,1,1,-0.6242669624218805,0.0
1257,6,58,22,83,80,1,1772.886,64,1842.229,LESS,1284,560,1844,0,2,-3.0,-0.28122253820234633,3.0,-1.0476454436543674,0.24198964138984164,-0.7694869839373653,163,83,80,0,0.05983508244547061,0.1170500554541026,0.0,-2.1481673070109215,1.3407259883710465,1.3407259883710465,0.0,0.1170500554541026,1,0,1,1,0.1170500554541026,0.0
1258,6,59,54,101,110,0,2618.333,54,3603.064,LESS,-910,1482,572,2,2,9.0,0.8436676146070391,9.0,0.0,-0.20822364491684048,0.007060492159220179,211,101,110,1,1.0171964015730004,0.8193503881787182,1.170500554541026,-0.6999646281271542,-1.642391601872422,1.642391601872422,1.170500554541026,0.8193503881787182,0,0,0,2,1.170500554541026,0.8193503881787182
1259,6,60,6,56,50,1,5072.362,0,1863.422,LESS,-470,2778,2308,7,1,-6.0,-0.5624450764046927,6.0,-0.5238227218271837,-2.639375390972924,2.261098919426485,106,56,50,0,-1.077031484018471,-0.9364004436328208,-1.170500554541026,2.9205420690822637,-1.0441364789430116,1.0441364789430116,-1.170500554541026,-0.9364004436328208,0,1,0,0,-0.9364004436328208,-1.170500554541026
1260,6,61,18,50,42,1,2568.139,64,1664.948,LESS,922,954,1876,3,2,-8.0,-0.7499267685395902,8.0,-0.17460757394239454,0.24198964138984164,-0.03904295845943714,92,50,42,0,-1.3562618687640005,-1.170500554541026,-1.4826340357519663,0.02413671131472937,0.8485251826882134,0.8485251826882134,-1.4826340357519663,-1.170500554541026,1,1,1,0,-1.170500554541026,-1.4826340357519663
1261,6,62,43,110,117,0,2989.6040000000007,74,1320.9260000000004,LESS,74,1754,1828,5,2,7.0,0.6561859224721414,7.0,-0.34921514788478913,0.6922029276965238,0.3480748407793653,227,110,117,1,1.3363168412821769,1.170500554541026,1.4436173506005987,1.4723393901984967,-0.3044755996848317,0.3044755996848317,1.4436173506005987,1.170500554541026,1,1,0,2,1.4436173506005987,1.170500554541026
1262,6,63,32,77,80,0,1675.984,64,1914.827,LESS,706,1088,1794,2,2,3.0,0.28122253820234633,3.0,-1.0476454436543674,0.24198964138984164,-0.8584919760051252,157,77,80,1,-0.05983508244547061,-0.1170500554541026,0.0,-0.6999646281271542,0.5548363041592304,0.5548363041592304,0.0,-0.1170500554541026,0,0,1,1,-0.1170500554541026,0.0
1263,6,64,27,80,91,0,3503.513,44,1203.748,LESS,-316,1500,1184,4,1,11.0,1.0311493067419364,11.0,0.34921514788478913,-0.6584369312235226,0.8201029358501616,171,80,91,1,0.21939530230005888,0.0,0.4291835366650429,0.748238050756613,-0.8347471859177181,0.8347471859177181,0.4291835366650429,0.0,0,1,0,1,0.4291835366650429,0.0
1264,6,65,16,44,50,0,2771.2470000000008,54,2031.247,LESS,220,1116,1336,3,2,6.0,0.5624450764046927,6.0,-0.5238227218271837,-0.20822364491684048,0.14751279816992668,94,44,50,1,-1.3163718138003533,-1.4046006654492311,-1.170500554541026,0.02413671131472937,-0.1059636725309819,0.1059636725309819,-1.170500554541026,-1.4046006654492311,0,1,1,0,-1.4046006654492311,-1.170500554541026
1265,6,66,7,50,57,0,2388.186,44,2314.702,LESS,-602,1250,648,2,2,7.0,0.6561859224721414,7.0,-0.34921514788478913,-0.6584369312235226,-0.20433072690146695,107,50,57,1,-1.0570864565366473,-1.170500554541026,-0.8973837584814532,-0.6999646281271542,-1.2236130158218348,1.2236130158218348,-0.8973837584814532,-1.170500554541026,0,0,0,0,-1.170500554541026,-0.8973837584814532
1266,6,67,14,50,46,1,3945.564,34,3035.246,LESS,542,1372,1914,4,2,-4.0,-0.3749633842697951,4.0,-0.8730378697119728,-1.1086502175302049,1.2261290833862837,96,50,46,0,-1.2764817588367063,-1.170500554541026,-1.3265672951464962,0.748238050756613,0.33185030379463193,0.33185030379463193,-1.3265672951464962,-1.170500554541026,0,1,1,0,-1.170500554541026,-1.3265672951464962
1267,6,68,51,110,108,1,3299.362,24,1648.98,LESS,990,780,1770,2,2,-2.0,-0.18748169213489754,2.0,-1.222253017596762,-1.5588635038368868,0.632589178284526,218,110,108,0,1.156811593945765,1.170500554541026,1.092467184238291,-0.6999646281271542,0.940982792595486,0.940982792595486,1.092467184238291,1.170500554541026,0,0,1,2,1.170500554541026,1.092467184238291
1268,6,69,50,133,110,1,1688.906,74,1249.903,LESS,1040,584,1624,1,2,-23.0,-2.1560394595513217,23.0,2.444506035193524,0.6922029276965238,-0.8466230516537228,243,133,110,0,1.6554372809913533,2.0678843130224793,1.170500554541026,-1.424065967569038,1.00896632929201,1.00896632929201,1.170500554541026,2.0678843130224793,1,0,1,2,2.0678843130224793,1.170500554541026
1269,6,70,49,131,110,1,2604.156,74,1943.291,LESS,1044,1036,2080,3,2,-21.0,-1.9685577674164243,21.0,2.0952908873087353,0.6922029276965238,-0.005961156233430565,241,131,110,0,1.6155472260277064,1.9898509427197442,1.170500554541026,0.02413671131472937,1.0144050122277317,1.0144050122277317,1.170500554541026,1.9898509427197442,1,1,1,2,1.9898509427197442,1.170500554541026
1270,6,71,47,126,110,1,1623.296,64,1945.524,LESS,682,696,1378,1,2,-16.0,-1.4998535370791803,16.0,1.222253017596762,0.24198964138984164,-0.9068861786228845,236,126,110,0,1.5158220886185887,1.7947675169629065,1.170500554541026,-1.424065967569038,0.5222042065448989,0.5222042065448989,1.170500554541026,1.7947675169629065,0,0,1,2,1.7947675169629065,1.170500554541026
1271,6,72,50,110,133,0,3169.172,74,2268.02,LESS,34,1716,1750,4,2,23.0,2.1560394595513217,23.0,2.444506035193524,0.6922029276965238,0.5130089847147168,243,110,133,1,1.6554372809913533,1.170500554541026,2.0678843130224793,0.748238050756613,-0.3588624290420508,0.3588624290420508,2.0678843130224793,1.170500554541026,1,1,0,2,2.0678843130224793,1.170500554541026
1272,6,73,47,110,126,0,2024.944,54,2444.96,LESS,-1054,1584,530,2,1,16.0,1.4998535370791803,16.0,1.222253017596762,-0.20822364491684048,-0.5379703971732593,236,110,126,1,1.5158220886185887,1.170500554541026,1.7947675169629065,-0.6999646281271542,-1.8381841875584108,1.8381841875584108,1.7947675169629065,1.170500554541026,0,0,0,2,1.7947675169629065,1.170500554541026
1273,6,74,12,48,50,0,2595.24,100,1136.082,LESS,102,1502,1604,4,2,2.0,0.18748169213489754,2.0,-1.222253017596762,1.8627574720938973,-0.014150548704960166,98,48,50,1,-1.2365917038730592,-1.248533924843761,-1.170500554541026,0.748238050756613,-0.2664048191347783,0.2664048191347783,-1.170500554541026,-1.248533924843761,1,1,0,0,-1.248533924843761,-1.170500554541026
1274,6,75,32,80,77,1,3293.758,54,1511.054,LESS,332,1384,1716,5,2,-3.0,-0.28122253820234633,3.0,-1.0476454436543674,-0.20822364491684048,0.6274418750756371,157,80,77,0,-0.05983508244547061,0.0,-0.1170500554541026,1.4723393901984967,0.046319449669231606,0.046319449669231606,-0.1170500554541026,0.0,0,1,1,1,0.0,-0.1170500554541026
1275,6,76,43,117,110,1,3866.424,24,1357.382,LESS,156,1596,1752,4,1,-7.0,-0.6561859224721414,7.0,-0.34921514788478913,-1.5588635038368868,1.153438580896732,227,117,110,0,1.3363168412821769,1.4436173506005987,1.170500554541026,0.748238050756613,-0.1929825995025325,0.1929825995025325,1.170500554541026,1.4436173506005987,0,1,0,2,1.4436173506005987,1.170500554541026
1276,6,77,40,80,64,1,2417.686,94,2697.597,LESS,2158,866,3024,3,2,-16.0,-1.4998535370791803,16.0,1.222253017596762,1.592629500309888,-0.17723482314304184,144,80,64,0,-0.3191204397091766,0.0,-0.6242669624218805,0.02413671131472937,2.529078209826284,2.529078209826284,-0.6242669624218805,0.0,1,1,1,1,0.0,-0.6242669624218805
1277,6,78,31,80,78,0,1925.797,84,1710.003,LESS,936,898,1834,3,2,-2.0,-0.18748169213489754,2.0,-1.222253017596762,1.1424162140032061,-0.6290374334422958,158,80,78,0,-0.03989005496364707,0.0,-0.07803337030273506,0.02413671131472937,0.8675605729632402,0.8675605729632402,-0.07803337030273506,0.0,1,1,1,1,0.0,-0.07803337030273506
1278,6,79,46,124,110,1,2135.408,100,2156.491,LESS,2080,720,2800,3,2,-14.0,-1.3123718449442827,14.0,0.8730378697119728,1.8627574720938973,-0.4365086374183212,234,124,110,0,1.4759320336549415,1.7167341466601715,1.170500554541026,0.02413671131472937,2.4230238925797067,2.4230238925797067,1.170500554541026,1.7167341466601715,1,1,1,2,1.7167341466601715,1.170500554541026
1279,6,80,58,92,110,0,2478.857,54,1882.872,LESS,-440,1356,916,4,2,18.0,1.6873352292140782,18.0,1.571468165481551,-0.20822364491684048,-0.12104894081061406,202,92,110,1,0.8376911542365885,0.4682002218164104,1.170500554541026,0.748238050756613,-1.0033463569250973,1.0033463569250973,1.170500554541026,0.4682002218164104,0,1,0,2,1.170500554541026,0.4682002218164104
1280,6,81,48,128,110,0,1976.739,64,1582.624,MORE,360,968,1328,2,2,-18.0,-1.6873352292140782,18.0,1.571468165481551,0.24198964138984164,-0.5822469409249502,238,128,110,1,1.5557121435822359,1.8728008872656416,1.170500554541026,-0.6999646281271542,0.08439023021928499,0.08439023021928499,1.170500554541026,1.8728008872656416,1,0,0,2,1.8728008872656416,1.170500554541026
1281,6,82,8,50,58,1,2004.993,100,2061.641,MORE,1970,476,2446,2,2,8.0,0.7499267685395902,8.0,-0.17460757394239454,1.8627574720938973,-0.556295494660864,108,50,58,0,-1.0371414290548238,-1.170500554541026,-0.8583670733300858,-0.6999646281271542,2.273460111847354,2.273460111847354,-0.8583670733300858,-1.170500554541026,1,0,1,0,-1.170500554541026,-0.8583670733300858
1282,6,83,4,54,50,0,4613.913,44,1239.115,MORE,-232,1836,1604,6,1,-4.0,-0.3749633842697951,4.0,-0.8730378697119728,-0.6584369312235226,1.8400111234215268,104,54,50,1,-1.116921538982118,-1.0144338139355558,-1.170500554541026,2.19644072964038,-0.720534844267558,0.720534844267558,-1.170500554541026,-1.0144338139355558,0,1,0,0,-1.0144338139355558,-1.170500554541026
1283,6,84,37,80,69,1,1711.7420000000004,0,2362.1910000000007,MORE,-684,1786,1102,1,1,-11.0,-1.0311493067419364,11.0,0.34921514788478913,-2.639375390972924,-0.8256480666290648,149,80,69,1,-0.21939530230005888,0.0,-0.4291835366650429,-1.424065967569038,-1.335106016004134,1.335106016004134,-0.4291835366650429,0.0,0,0,0,1,0.0,-0.4291835366650429
1284,6,85,52,105,110,1,4627.032,34,1642.76,MORE,206,1744,1950,5,2,5.0,0.4687042303372438,5.0,-0.6984302957695783,-1.1086502175302049,1.8520609932997236,215,105,110,0,1.0969765115002945,0.9754171287841883,1.170500554541026,1.4723393901984967,-0.1249990628060086,0.1249990628060086,1.170500554541026,0.9754171287841883,0,1,0,2,1.170500554541026,0.9754171287841883
1285,6,86,5,55,50,0,5225.785,24,1078.644,MORE,-274,2478,2204,8,2,-5.0,-0.4687042303372438,5.0,-0.6984302957695783,-1.5588635038368868,2.4020187445901757,105,55,50,1,-1.0969765115002945,-0.9754171287841883,-1.170500554541026,3.6446434085241473,-0.777641015092638,0.777641015092638,-1.170500554541026,-0.9754171287841883,0,1,0,0,-0.9754171287841883,-1.170500554541026
1286,6,87,30,96,80,0,2770.914,34,1582.312,MORE,-280,1204,924,3,1,-16.0,-1.4998535370791803,16.0,1.222253017596762,-1.1086502175302049,0.14720693593428022,176,96,80,1,0.3191204397091766,0.6242669624218805,0.0,0.02413671131472937,-0.7857990394962209,0.7857990394962209,0.0,0.6242669624218805,0,1,0,1,0.6242669624218805,0.0
1287,6,88,33,80,75,1,3621.255,54,2196.786,MORE,760,1594,2354,5,2,-5.0,-0.4687042303372438,5.0,-0.6984302957695783,-0.20822364491684048,0.9282495765391277,155,80,75,1,-0.09972513740911768,0.0,-0.19508342575683765,1.4723393901984967,0.6282585237914762,0.6282585237914762,-0.19508342575683765,0.0,1,1,1,1,0.0,-0.19508342575683765
1288,6,89,48,110,128,1,4006.095,24,1646.671,MORE,240,1706,1946,5,1,18.0,1.6873352292140782,18.0,1.571468165481551,-1.5588635038368868,1.2817271223829354,238,110,128,0,1.5557121435822359,1.170500554541026,1.8728008872656416,1.4723393901984967,-0.07877025785237235,0.07877025785237235,1.8728008872656416,1.170500554541026,0,1,0,2,1.8728008872656416,1.170500554541026
1289,6,90,9,59,50,0,3613.889,54,1221.421,MORE,-720,1976,1256,3,2,-9.0,-0.8436676146070391,9.0,0.0,-0.20822364491684048,0.9214838671464308,109,59,50,1,-1.0171964015730004,-0.8193503881787182,-1.170500554541026,0.02413671131472937,-1.384054162425631,1.384054162425631,-1.170500554541026,-0.8193503881787182,1,1,0,0,-0.8193503881787182,-1.170500554541026
1290,6,91,44,110,119,0,2647.951,54,2643.33,MORE,-344,1474,1130,4,2,9.0,0.8436676146070391,9.0,0.0,-0.20822364491684048,0.034264779532678966,229,110,119,0,1.376206896245824,1.170500554541026,1.5216507209033339,0.748238050756613,-0.8728179664677715,0.8728179664677715,1.5216507209033339,1.170500554541026,1,1,0,2,1.5216507209033339,1.170500554541026
1291,6,92,2,52,50,1,2386.248,64,1332.287,MORE,860,764,1624,3,2,-2.0,-0.18748169213489754,2.0,-1.222253017596762,0.24198964138984164,-0.2061107900026138,102,52,50,1,-1.156811593945765,-1.092467184238291,-1.170500554541026,0.02413671131472937,0.7642255971845239,0.7642255971845239,-1.170500554541026,-1.092467184238291,1,1,1,0,-1.092467184238291,-1.170500554541026
1292,6,93,8,58,50,1,5160.542,44,1972.438,MORE,668,2068,2736,6,2,-8.0,-0.7499267685395902,8.0,-0.17460757394239454,-0.6584369312235226,2.342092709033873,108,58,50,1,-1.0371414290548238,-0.8583670733300858,-1.170500554541026,2.19644072964038,0.5031688162698722,0.5031688162698722,-1.170500554541026,-0.8583670733300858,0,1,1,0,-0.8583670733300858,-1.170500554541026
1293,6,94,44,119,110,0,2065.98,74,1873.753,MORE,820,964,1784,2,2,-9.0,-0.8436676146070391,9.0,0.0,0.6922029276965238,-0.5002786172874717,229,119,110,1,1.376206896245824,1.5216507209033339,1.170500554541026,-0.6999646281271542,0.7098387678273047,0.7098387678273047,1.170500554541026,1.5216507209033339,1,0,1,2,1.5216507209033339,1.170500554541026
1294,6,95,34,74,80,0,2924.2790000000005,54,1291.474,MORE,-700,1630,930,4,1,6.0,0.5624450764046927,6.0,-0.5238227218271837,-0.20822364491684048,0.288073487795666,154,74,80,0,-0.11967016489094122,-0.2341001109082052,0.0,0.748238050756613,-1.3568607477470216,1.3568607477470216,0.0,-0.2341001109082052,0,1,0,1,-0.2341001109082052,0.0
1295,6,96,24,86,80,0,2003.695,74,1088.548,MORE,676,786,1462,3,2,-6.0,-0.5624450764046927,6.0,-0.5238227218271837,0.6922029276965238,-0.5574877144262348,166,86,80,1,0.11967016489094122,0.2341001109082052,0.0,0.02413671131472937,0.514046182141316,0.514046182141316,0.0,0.2341001109082052,1,1,1,1,0.2341001109082052,0.0
1296,6,97,39,66,80,1,1363.7910000000004,100,968.02,MORE,1246,426,1672,1,2,14.0,1.3123718449442827,14.0,0.8730378697119728,1.8627574720938973,-1.1452428737018712,146,66,80,0,-0.2792303847455295,-0.5462335921191455,0.0,-1.424065967569038,1.2890585004816884,1.2890585004816884,0.0,-0.5462335921191455,1,0,1,1,-0.5462335921191455,0.0
1297,6,98,9,50,59,1,2217.916,74,1329.341,MORE,1084,766,1850,3,2,9.0,0.8436676146070391,9.0,0.0,0.6922029276965238,-0.3607246093742483,109,50,59,0,-1.0171964015730004,-1.170500554541026,-0.8193503881787182,0.02413671131472937,1.0687918415849509,1.0687918415849509,-0.8193503881787182,-1.170500554541026,1,1,1,0,-1.170500554541026,-0.8193503881787182
1298,6,99,57,94,110,1,1400.724,100,2213.264,MORE,1738,508,2246,1,2,16.0,1.4998535370791803,16.0,1.222253017596762,1.8627574720938973,-1.1113197207015355,204,94,110,0,0.8775812092002355,0.5462335921191455,1.170500554541026,-1.424065967569038,1.9580165015754833,1.9580165015754833,1.170500554541026,0.5462335921191455,1,0,1,2,1.170500554541026,0.5462335921191455
1299,6,100,60,110,87,0,1797.961,84,1183.893,MORE,140,1066,1206,2,2,-23.0,-2.1560394595513217,23.0,2.444506035193524,1.1424162140032061,-0.7464554657427038,197,110,87,1,0.7379660168274708,1.170500554541026,0.27311679605957273,-0.6999646281271542,-0.21473733124542013,0.21473733124542013,0.27311679605957273,1.170500554541026,1,0,0,2,1.170500554541026,0.27311679605957273
1300,6,101,33,75,80,1,2228.883,74,1386.473,MORE,1290,894,2184,3,2,5.0,0.4687042303372438,5.0,-0.6984302957695783,0.6922029276965238,-0.3506513627125996,155,75,80,0,-0.09972513740911768,-0.19508342575683765,0.0,0.02413671131472937,1.3488840127746293,1.3488840127746293,0.0,-0.19508342575683765,1,1,1,1,-0.19508342575683765,0.0
1301,6,102,15,50,45,0,3844.088,44,1737.29,MORE,-350,1866,1516,6,2,-5.0,-0.4687042303372438,5.0,-0.6984302957695783,-0.6584369312235226,1.1329228484781495,95,50,45,1,-1.2964267863185297,-1.170500554541026,-1.3655839802978638,2.19644072964038,-0.8809759908713544,0.8809759908713544,-1.3655839802978638,-1.170500554541026,0,1,0,0,-1.170500554541026,-1.3655839802978638
1302,6,103,59,89,110,1,3052.768,54,3971.851,MORE,326,1514,1840,4,2,21.0,1.9685577674164243,21.0,2.0952908873087353,-0.20822364491684048,0.4060913039996076,199,89,110,0,0.7778560717911179,0.3511501663623078,1.170500554541026,0.748238050756613,0.03816142526564874,0.03816142526564874,1.170500554541026,0.3511501663623078,0,1,0,2,1.170500554541026,0.3511501663623078
1303,6,104,29,80,94,1,2088.88,74,1581.1760000000004,MORE,1602,744,2346,3,2,14.0,1.3123718449442827,14.0,0.8730378697119728,0.6922029276965238,-0.4792448479292365,174,80,94,0,0.2792303847455295,0.0,0.5462335921191455,0.02413671131472937,1.7731012817609384,1.7731012817609384,0.5462335921191455,0.0,1,0,1,1,0.5462335921191455,0.0
1304,6,105,55,110,98,0,3037.557,44,2003.705,MORE,-942,1946,1004,4,2,-12.0,-1.124890152809385,12.0,0.5238227218271837,-0.6584369312235226,0.3921199212175937,208,110,98,1,0.9573613191275298,1.170500554541026,0.7023003327246156,0.748238050756613,-1.6859010653581972,1.6859010653581972,0.7023003327246156,1.170500554541026,0,1,0,2,1.170500554541026,0.7023003327246156
1305,6,106,29,94,80,0,2712.239,54,2191.6620000000007,MORE,-230,1596,1366,5,2,-14.0,-1.3123718449442827,14.0,0.8730378697119728,-0.20822364491684048,0.09331364261137852,174,94,80,1,0.2792303847455295,0.5462335921191455,0.0,1.4723393901984967,-0.717815502799697,0.717815502799697,0.0,0.5462335921191455,0,1,0,1,0.5462335921191455,0.0
1306,6,107,57,110,94,0,1593.224,94,1072.27,MORE,454,970,1424,2,2,-16.0,-1.4998535370791803,16.0,1.222253017596762,1.592629500309888,-0.9345074673626595,204,110,94,1,0.8775812092002355,1.170500554541026,0.5462335921191455,-0.6999646281271542,0.2121992792087499,0.2121992792087499,0.5462335921191455,1.170500554541026,1,0,1,2,1.170500554541026,0.5462335921191455
1307,6,108,39,80,66,0,1890.398,44,1518.134,MORE,184,888,1072,3,2,-14.0,-1.3123718449442827,14.0,0.8730378697119728,-0.6584369312235226,-0.661551599447194,146,80,66,1,-0.2792303847455295,0.0,-0.5462335921191455,0.02413671131472937,-0.1549118189524791,0.1549118189524791,-0.5462335921191455,0.0,0,0,0,1,0.0,-0.5462335921191455
1308,6,109,4,50,54,1,2797.303,64,2315.72,MORE,2266,776,3042,2,2,4.0,0.3749633842697951,4.0,-0.8730378697119728,0.24198964138984164,0.1714453699777064,104,50,54,0,-1.116921538982118,-1.170500554541026,-1.0144338139355558,-0.6999646281271542,2.6759226490907757,2.6759226490907757,-1.0144338139355558,-1.170500554541026,1,0,1,0,-1.170500554541026,-1.0144338139355558
1309,6,110,55,98,110,0,3297.712,54,1941.148,MORE,-484,1580,1096,4,2,12.0,1.124890152809385,12.0,0.5238227218271837,-0.20822364491684048,0.6310736446844785,208,98,110,0,0.9573613191275298,0.7023003327246156,1.170500554541026,0.748238050756613,-1.0631718692180383,1.0631718692180383,1.170500554541026,0.7023003327246156,0,1,0,2,1.170500554541026,0.7023003327246156
1310,6,111,2,50,52,1,2174.46,64,1085.746,MORE,1178,756,1934,3,2,2.0,0.18748169213489754,2.0,-1.222253017596762,0.24198964138984164,-0.4006391718734391,102,50,52,0,-1.156811593945765,-1.170500554541026,-1.092467184238291,0.02413671131472937,1.1966008905744159,1.1966008905744159,-1.092467184238291,-1.170500554541026,1,0,1,0,-1.170500554541026,-1.092467184238291
1311,6,112,59,110,89,0,1800.0410000000004,94,861.574,MORE,-252,1136,884,2,2,-21.0,-1.9685577674164243,21.0,2.0952908873087353,1.592629500309888,-0.7445449749014316,199,110,89,1,0.7778560717911179,1.170500554541026,0.3511501663623078,-0.6999646281271542,-0.7477282589461676,0.7477282589461676,0.3511501663623078,1.170500554541026,1,0,0,2,1.170500554541026,0.3511501663623078
1312,6,113,60,87,110,1,1699.086,94,1683.8370000000002,MORE,1356,712,2068,1,2,23.0,2.1560394595513217,23.0,2.444506035193524,1.592629500309888,-0.8372726685940356,197,87,110,0,0.7379660168274708,0.27311679605957273,1.170500554541026,-1.424065967569038,1.4386222812140408,1.4386222812140408,1.170500554541026,0.27311679605957273,1,0,1,2,1.170500554541026,0.27311679605957273
1313,6,114,52,110,105,0,3231.4590000000007,54,1321.1629999999998,MORE,-90,1544,1454,4,2,-5.0,-0.4687042303372438,5.0,-0.6984302957695783,-0.20822364491684048,0.5702199188639048,215,110,105,1,1.0969765115002945,1.170500554541026,0.9754171287841883,0.748238050756613,-0.52746160004943,0.52746160004943,0.9754171287841883,1.170500554541026,0,1,0,2,1.170500554541026,0.9754171287841883
1314,6,115,30,80,96,1,2290.637,84,2184.835,MORE,1778,962,2740,3,2,16.0,1.4998535370791803,16.0,1.222253017596762,1.1424162140032061,-0.2939299918414878,176,80,96,0,0.3191204397091766,0.0,0.6242669624218805,0.02413671131472937,2.0124033309327025,2.0124033309327025,0.6242669624218805,0.0,1,0,1,1,0.6242669624218805,0.0
1315,6,116,24,80,86,1,3646.764,74,730.938,MORE,332,1548,1880,5,2,6.0,0.5624450764046927,6.0,-0.5238227218271837,0.6922029276965238,0.951679725995862,166,80,86,0,0.11967016489094122,0.0,0.2341001109082052,1.4723393901984967,0.046319449669231606,0.046319449669231606,0.2341001109082052,0.0,1,1,0,1,0.2341001109082052,0.0
1316,6,117,5,50,55,1,3965.336,44,1412.566,MORE,220,1364,1584,5,2,5.0,0.4687042303372438,5.0,-0.6984302957695783,-0.6584369312235226,1.244289768440913,105,50,55,0,-1.0969765115002945,-1.170500554541026,-0.9754171287841883,1.4723393901984967,-0.1059636725309819,0.1059636725309819,-0.9754171287841883,-1.170500554541026,0,1,0,0,-1.170500554541026,-0.9754171287841883
1317,6,118,34,80,74,1,3670.988,34,1664.825,MORE,-306,1834,1528,3,2,-6.0,-0.5624450764046927,6.0,-0.5238227218271837,-1.1086502175302049,0.9739295962549837,154,80,74,1,-0.11967016489094122,0.0,-0.2341001109082052,0.02413671131472937,-0.8211504785784134,0.8211504785784134,-0.2341001109082052,0.0,0,0,0,1,0.0,-0.2341001109082052
1318,6,119,15,45,50,1,1861.353,84,2091.131,MORE,1542,892,2434,1,2,5.0,0.4687042303372438,5.0,-0.6984302957695783,1.1424162140032061,-0.6882295833340907,95,45,50,0,-1.2964267863185297,-1.3655839802978638,-1.170500554541026,-1.424065967569038,1.6915210377251098,1.6915210377251098,-1.170500554541026,-1.3655839802978638,1,0,1,0,-1.3655839802978638,-1.170500554541026
1319,6,120,37,69,80,1,3099.9709999999995,64,1051.592,MORE,742,1524,2266,3,2,11.0,1.0311493067419364,11.0,0.34921514788478913,0.24198964138984164,0.4494475055287239,149,69,80,0,-0.21939530230005888,-0.4291835366650429,0.0,0.02413671131472937,0.6037844505807275,0.6037844505807275,0.0,-0.4291835366650429,1,0,1,1,-0.4291835366650429,0.0
1320,6,121,48,128,110,1,2425.369,54,3145.692,LESS,366,1040,1406,3,1,-18.0,-1.6873352292140782,18.0,1.571468165481551,-0.20822364491684048,-0.17017794759809335,238,128,110,0,1.5557121435822359,1.8728008872656416,1.170500554541026,0.02413671131472937,0.09254825462286785,0.09254825462286785,1.170500554541026,1.8728008872656416,0,1,1,2,1.8728008872656416,1.170500554541026
1321,6,122,8,50,58,0,1891.933,74,2665.538,LESS,600,1294,1894,2,2,8.0,0.7499267685395902,8.0,-0.17460757394239454,0.6922029276965238,-0.6601416939465437,108,50,58,1,-1.0371414290548238,-1.170500554541026,-0.8583670733300858,-0.6999646281271542,0.41071120636259967,0.41071120636259967,-0.8583670733300858,-1.170500554541026,1,0,1,0,-1.170500554541026,-0.8583670733300858
1322,6,123,4,54,50,0,2044.302,94,1654.557,LESS,478,1094,1572,2,2,-4.0,-0.3749633842697951,4.0,-0.8730378697119728,1.592629500309888,-0.5201899732764595,104,54,50,0,-1.116921538982118,-1.0144338139355558,-1.170500554541026,-0.6999646281271542,0.24483137682308137,0.24483137682308137,-1.170500554541026,-1.0144338139355558,1,0,1,0,-1.0144338139355558,-1.170500554541026
1323,6,124,37,80,69,1,2331.542,64,2475.028,LESS,932,1010,1942,4,2,-11.0,-1.0311493067419364,11.0,0.34921514788478913,0.24198964138984164,-0.2563585361384921,149,80,69,0,-0.21939530230005888,0.0,-0.4291835366650429,0.748238050756613,0.8621218900275183,0.8621218900275183,-0.4291835366650429,0.0,1,1,1,1,0.0,-0.4291835366650429
1324,6,125,52,105,110,1,4785.945,34,1143.323,LESS,44,1996,2040,6,2,5.0,0.4687042303372438,5.0,-0.6984302957695783,-1.1086502175302049,1.9980234120781168,215,105,110,1,1.0969765115002945,0.9754171287841883,1.170500554541026,2.19644072964038,-0.345265721702746,0.345265721702746,1.170500554541026,0.9754171287841883,0,1,0,2,1.170500554541026,0.9754171287841883
1325,6,126,5,55,50,0,1920.198,64,1260.263,LESS,-110,922,812,2,2,-5.0,-0.4687042303372438,5.0,-0.6984302957695783,0.24198964138984164,-0.6341801441251236,105,55,50,0,-1.0969765115002945,-0.9754171287841883,-1.170500554541026,-0.6999646281271542,-0.5546550147280396,0.5546550147280396,-1.170500554541026,-0.9754171287841883,1,0,0,0,-0.9754171287841883,-1.170500554541026
1326,6,127,30,96,80,1,1467.219,84,2442.702,LESS,1514,804,2318,3,2,-16.0,-1.4998535370791803,16.0,1.222253017596762,1.1424162140032061,-1.0502437166196208,176,96,80,0,0.3191204397091766,0.6242669624218805,0.0,0.02413671131472937,1.6534502571750564,1.6534502571750564,0.0,0.6242669624218805,1,1,1,1,0.6242669624218805,0.0
1327,6,128,33,80,75,1,3917.63,24,1933.264,LESS,416,1584,2000,5,1,-5.0,-0.4687042303372438,5.0,-0.6984302957695783,-1.5588635038368868,1.2004715587900854,155,80,75,0,-0.09972513740911768,0.0,-0.19508342575683765,1.4723393901984967,0.16053179131939174,0.16053179131939174,-0.19508342575683765,0.0,0,1,1,1,0.0,-0.19508342575683765
1328,6,129,48,110,128,0,1610.102,94,2471.341,LESS,700,1204,1904,3,2,18.0,1.6873352292140782,18.0,1.571468165481551,1.592629500309888,-0.9190049363919915,238,110,128,1,1.5557121435822359,1.170500554541026,1.8728008872656416,0.02413671131472937,0.5466782797556474,0.5466782797556474,1.8728008872656416,1.170500554541026,1,1,1,2,1.8728008872656416,1.170500554541026
1329,6,130,9,59,50,1,3836.994,24,1470.493,LESS,368,1510,1878,5,2,-9.0,-0.8436676146070391,9.0,0.0,-1.5588635038368868,1.1264069725031576,109,59,50,0,-1.0171964015730004,-0.8193503881787182,-1.170500554541026,1.4723393901984967,0.09526759609072881,0.09526759609072881,-1.170500554541026,-0.8193503881787182,0,1,1,0,-0.8193503881787182,-1.170500554541026
1330,6,131,44,110,119,1,2354.648,44,1549.937,LESS,420,844,1264,3,2,9.0,0.8436676146070391,9.0,0.0,-0.6584369312235226,-0.2351355547065539,229,110,119,1,1.376206896245824,1.170500554541026,1.5216507209033339,0.02413671131472937,0.16597047425511366,0.16597047425511366,1.5216507209033339,1.170500554541026,0,1,1,2,1.5216507209033339,1.170500554541026
1331,6,132,2,52,50,0,3061.2990000000004,54,3245.7209999999995,LESS,112,1634,1746,4,2,-2.0,-0.18748169213489754,2.0,-1.222253017596762,-0.20822364491684048,0.4139270719644597,102,52,50,0,-1.156811593945765,-1.092467184238291,-1.170500554541026,0.748238050756613,-0.2528081117954735,0.2528081117954735,-1.170500554541026,-1.092467184238291,0,1,0,0,-1.092467184238291,-1.170500554541026
1332,6,133,8,58,50,1,3584.885,14,1495.5120000000004,LESS,216,1674,1890,5,1,-8.0,-0.7499267685395902,8.0,-0.17460757394239454,-2.009076790143569,0.894843541973232,108,58,50,0,-1.0371414290548238,-0.8583670733300858,-1.170500554541026,1.4723393901984967,-0.11140235546670382,0.11140235546670382,-1.170500554541026,-0.8583670733300858,0,1,1,0,-0.8583670733300858,-1.170500554541026
1333,6,134,44,119,110,0,1484.713,94,2070.076,LESS,1432,898,2330,2,2,-9.0,-0.8436676146070391,9.0,0.0,1.592629500309888,-1.0341753864382688,229,119,110,0,1.376206896245824,1.5216507209033339,1.170500554541026,-0.6999646281271542,1.541957256992757,1.541957256992757,1.170500554541026,1.5216507209033339,1,0,1,2,1.5216507209033339,1.170500554541026
1334,6,135,34,74,80,0,1891.344,64,1122.114,LESS,-428,1116,688,2,2,6.0,0.5624450764046927,6.0,-0.5238227218271837,0.24198964138984164,-0.6606826935164999,154,74,80,1,-0.11967016489094122,-0.2341001109082052,0.0,-0.6999646281271542,-0.9870303081179317,0.9870303081179317,0.0,-0.2341001109082052,1,0,0,1,-0.2341001109082052,0.0
1335,6,136,24,86,80,0,1606.882,74,2006.73,LESS,448,850,1298,2,2,-6.0,-0.5624450764046927,6.0,-0.5238227218271837,0.6922029276965238,-0.9219625231751146,166,86,80,0,0.11967016489094122,0.2341001109082052,0.0,-0.6999646281271542,0.20404125480516705,0.20404125480516705,0.0,0.2341001109082052,1,0,1,1,0.2341001109082052,0.0
1336,6,137,39,66,80,0,1277.719,84,1255.262,LESS,500,876,1376,3,2,14.0,1.3123718449442827,14.0,0.8730378697119728,1.1424162140032061,-1.2243004543220468,146,66,80,1,-0.2792303847455295,-0.5462335921191455,0.0,0.02413671131472937,0.27474413296955186,0.27474413296955186,0.0,-0.5462335921191455,1,1,1,1,-0.5462335921191455,0.0
1337,6,138,9,50,59,0,1658.101,54,1424.689,LESS,104,742,846,3,2,9.0,0.8436676146070391,9.0,0.0,-0.20822364491684048,-0.8749176047140035,109,50,59,1,-1.0171964015730004,-1.170500554541026,-0.8193503881787182,0.02413671131472937,-0.26368547766691736,0.26368547766691736,-0.8193503881787182,-1.170500554541026,0,1,0,0,-1.170500554541026,-0.8193503881787182
1338,6,139,57,94,110,0,2822.0170000000007,64,1137.329,LESS,-336,1590,1254,5,2,16.0,1.4998535370791803,16.0,1.222253017596762,0.24198964138984164,0.19414530779078246,204,94,110,1,0.8775812092002355,0.5462335921191455,1.170500554541026,1.4723393901984967,-0.8619406005963277,0.8619406005963277,1.170500554541026,0.5462335921191455,1,1,0,2,1.170500554541026,0.5462335921191455
1339,6,140,60,110,87,1,2684.756,54,2808.405,LESS,416,1026,1442,3,2,-23.0,-2.1560394595513217,23.0,2.444506035193524,-0.20822364491684048,0.06807036386585978,197,110,87,0,0.7379660168274708,1.170500554541026,0.27311679605957273,0.02413671131472937,0.16053179131939174,0.16053179131939174,0.27311679605957273,1.170500554541026,0,1,1,2,1.170500554541026,0.27311679605957273
1340,6,141,33,75,80,0,1676.987,100,2223.357,LESS,1122,1032,2154,2,2,5.0,0.4687042303372438,5.0,-0.6984302957695783,1.8627574720938973,-0.8575707152773385,155,75,80,1,-0.09972513740911768,-0.19508342575683765,0.0,-0.6999646281271542,1.120459329474309,1.120459329474309,0.0,-0.19508342575683765,1,0,1,1,-0.19508342575683765,0.0
1341,6,142,15,50,45,0,1805.868,74,1907.093,LESS,250,1130,1380,2,2,-5.0,-0.4687042303372438,5.0,-0.6984302957695783,0.6922029276965238,-0.7391928450302339,95,50,45,0,-1.2964267863185297,-1.170500554541026,-1.3655839802978638,-0.6999646281271542,-0.06517355051306757,0.06517355051306757,-1.3655839802978638,-1.170500554541026,1,0,1,0,-1.170500554541026,-1.3655839802978638
1342,6,143,59,89,110,0,1671.542,84,1390.1529999999998,LESS,196,1048,1244,2,2,21.0,1.9685577674164243,21.0,2.0952908873087353,1.1424162140032061,-0.8625719761574955,199,89,110,1,0.7778560717911179,0.3511501663623078,1.170500554541026,-0.6999646281271542,-0.13859577014531338,0.13859577014531338,1.170500554541026,0.3511501663623078,1,0,1,2,1.170500554541026,0.3511501663623078
1343,6,144,29,80,94,0,1571.427,64,1155.466,LESS,-32,1074,1042,2,2,14.0,1.3123718449442827,14.0,0.8730378697119728,0.24198964138984164,-0.9545281254718933,174,80,94,1,0.2792303847455295,0.0,0.5462335921191455,-0.6999646281271542,-0.4486006974814623,0.4486006974814623,0.5462335921191455,0.0,1,0,0,1,0.5462335921191455,0.0
1344,6,145,55,110,98,1,2280.73,74,2688.244,LESS,1570,976,2546,3,2,-12.0,-1.124890152809385,12.0,0.5238227218271837,0.6922029276965238,-0.30302962297825803,208,110,98,0,0.9573613191275298,1.170500554541026,0.7023003327246156,0.02413671131472937,1.729591818275163,1.729591818275163,0.7023003327246156,1.170500554541026,1,1,1,2,1.170500554541026,0.7023003327246156
1345,6,146,29,94,80,1,3221.795,14,1423.514,LESS,472,1218,1690,5,1,-14.0,-1.3123718449442827,14.0,0.8730378697119728,-2.009076790143569,0.5613434844936865,174,94,80,0,0.2792303847455295,0.5462335921191455,0.0,1.4723393901984967,0.2366733524194985,0.2366733524194985,0.0,0.5462335921191455,0,1,1,1,0.5462335921191455,0.0
1346,6,147,57,110,94,1,2407.991,64,1810.79,LESS,562,980,1542,3,2,-16.0,-1.4998535370791803,16.0,1.222253017596762,0.24198964138984164,-0.1861397311748363,204,110,94,0,0.8775812092002355,1.170500554541026,0.5462335921191455,0.02413671131472937,0.3590437184732415,0.3590437184732415,0.5462335921191455,1.170500554541026,1,1,1,2,1.170500554541026,0.5462335921191455
1347,6,148,39,80,66,1,2997.993,24,885.174,LESS,186,1218,1404,2,2,-14.0,-1.3123718449442827,14.0,0.8730378697119728,-1.5588635038368868,0.355780181004091,146,80,66,0,-0.2792303847455295,0.0,-0.5462335921191455,-0.6999646281271542,-0.15219247748461817,0.15219247748461817,-0.5462335921191455,0.0,0,0,1,1,0.0,-0.5462335921191455
1348,6,149,4,50,54,0,1780.76,84,1552.0970000000002,LESS,114,1208,1322,2,2,4.0,0.3749633842697951,4.0,-0.8730378697119728,1.1424162140032061,-0.7622546738968962,104,50,54,1,-1.116921538982118,-1.170500554541026,-1.0144338139355558,-0.6999646281271542,-0.25008877032761256,0.25008877032761256,-1.0144338139355558,-1.170500554541026,1,0,0,0,-1.170500554541026,-1.0144338139355558
1349,6,150,55,98,110,1,2413.601,44,2360.0,LESS,148,860,1008,3,2,12.0,1.124890152809385,12.0,0.5238227218271837,-0.6584369312235226,-0.18098691693467464,208,98,110,1,0.9573613191275298,0.7023003327246156,1.170500554541026,0.02413671131472937,-0.20385996537397633,0.20385996537397633,1.170500554541026,0.7023003327246156,0,0,0,2,1.170500554541026,0.7023003327246156
1350,6,151,2,50,52,0,5177.366,34,2467.89,LESS,-1524,3104,1580,6,1,2.0,0.18748169213489754,2.0,-1.222253017596762,-1.1086502175302049,2.357545640723084,102,50,52,1,-1.156811593945765,-1.170500554541026,-1.092467184238291,2.19644072964038,-2.477229432505735,2.477229432505735,-1.092467184238291,-1.170500554541026,0,1,0,0,-1.170500554541026,-1.092467184238291
1351,6,152,59,110,89,1,2263.326,24,2166.877,LESS,394,834,1228,3,2,-21.0,-1.9685577674164243,21.0,2.0952908873087353,-1.5588635038368868,-0.31901528769051674,199,110,89,0,0.7778560717911179,1.170500554541026,0.3511501663623078,0.02413671131472937,0.13061903517292123,0.13061903517292123,0.3511501663623078,1.170500554541026,0,0,1,2,1.170500554541026,0.3511501663623078
1352,6,153,60,87,110,0,2444.753,84,2447.9210000000007,LESS,1072,1326,2398,4,2,23.0,2.1560394595513217,23.0,2.444506035193524,1.1424162140032061,-0.15237364256577765,197,87,110,1,0.7379660168274708,0.27311679605957273,1.170500554541026,0.748238050756613,1.052475792777785,1.052475792777785,1.170500554541026,0.27311679605957273,1,1,1,2,1.170500554541026,0.27311679605957273
1353,6,154,52,110,105,0,3962.399,0,3412.408,LESS,-1314,2814,1500,6,1,-5.0,-0.4687042303372438,5.0,-0.6984302957695783,-2.639375390972924,1.2415921186328287,215,110,105,0,1.0969765115002945,1.170500554541026,0.9754171287841883,2.19644072964038,-2.191698578380335,2.191698578380335,0.9754171287841883,1.170500554541026,0,1,0,2,1.170500554541026,0.9754171287841883
1354,6,155,30,80,96,0,1620.34,84,1797.235,LESS,798,880,1678,2,2,16.0,1.4998535370791803,16.0,1.222253017596762,1.1424162140032061,-0.90960128003,176,80,96,1,0.3191204397091766,0.0,0.6242669624218805,-0.6999646281271542,0.6799260116808343,0.6799260116808343,0.6242669624218805,0.0,1,0,1,1,0.6242669624218805,0.0
1355,6,156,24,80,86,0,1457.779,100,1962.246,LESS,928,1072,2000,3,2,6.0,0.5624450764046927,6.0,-0.5238227218271837,1.8627574720938973,-1.058914405822317,166,80,86,1,0.11967016489094122,0.0,0.2341001109082052,0.02413671131472937,0.8566832070917964,0.8566832070917964,0.2341001109082052,0.0,1,1,1,1,0.2341001109082052,0.0
1356,6,157,5,50,55,0,2387.043,64,1176.573,LESS,494,1132,1626,3,2,5.0,0.4687042303372438,5.0,-0.6984302957695783,0.24198964138984164,-0.20538057835895449,105,50,55,1,-1.0969765115002945,-1.170500554541026,-0.9754171287841883,0.02413671131472937,0.26658610856596904,0.26658610856596904,-0.9754171287841883,-1.170500554541026,1,0,1,0,-1.170500554541026,-0.9754171287841883
1357,6,158,34,80,74,0,2361.97,54,1604.112,LESS,-338,1264,926,4,2,-6.0,-0.5624450764046927,6.0,-0.5238227218271837,-0.20822364491684048,-0.22841025954319186,154,80,74,0,-0.11967016489094122,0.0,-0.2341001109082052,0.748238050756613,-0.8646599420641886,0.8646599420641886,-0.2341001109082052,0.0,0,1,0,1,0.0,-0.2341001109082052
1358,6,159,15,45,50,1,2214.81,44,1867.887,LESS,510,678,1188,3,2,5.0,0.4687042303372438,5.0,-0.6984302957695783,-0.6584369312235226,-0.3635774865631865,95,45,50,1,-1.2964267863185297,-1.3655839802978638,-1.170500554541026,0.02413671131472937,0.28834084030885665,0.28834084030885665,-1.170500554541026,-1.3655839802978638,0,1,1,0,-1.3655839802978638,-1.170500554541026
1359,6,160,37,69,80,0,1816.238,74,2107.565,LESS,426,956,1382,2,2,11.0,1.0311493067419364,11.0,0.34921514788478913,0.6922029276965238,-0.7296679459802382,149,69,80,1,-0.21939530230005888,-0.4291835366650429,0.0,-0.6999646281271542,0.17412849865869653,0.17412849865869653,0.0,-0.4291835366650429,1,0,1,1,-0.4291835366650429,0.0
1360,6,161,3,50,53,1,2219.093,54,1724.915,MORE,356,918,1274,3,2,3.0,0.28122253820234633,3.0,-1.0476454436543674,-0.20822364491684048,-0.3596435287395481,103,50,53,0,-1.1368665664639415,-1.170500554541026,-1.0534504990869233,0.02413671131472937,0.07895154728356307,0.07895154728356307,-1.0534504990869233,-1.170500554541026,0,0,0,0,-1.170500554541026,-1.0534504990869233
1361,6,162,20,50,40,0,1555.681,74,1230.404,MORE,368,874,1242,2,2,-10.0,-0.9374084606744876,10.0,0.17460757394239454,0.6922029276965238,-0.9689909085424072,90,50,40,1,-1.3961519237276474,-1.170500554541026,-1.5606674060547012,-0.6999646281271542,0.09526759609072881,0.09526759609072881,-1.5606674060547012,-1.170500554541026,1,0,0,0,-1.170500554541026,-1.5606674060547012
1362,6,163,25,80,88,1,2286.628,64,1336.87,MORE,1240,874,2114,3,2,8.0,0.7499267685395902,8.0,-0.17460757394239454,0.24198964138984164,-0.2976122792369972,168,80,88,0,0.1595602198545883,0.0,0.31213348121094026,0.02413671131472937,1.2809004760781053,1.2809004760781053,0.31213348121094026,0.0,1,0,1,1,0.31213348121094026,0.0
1363,6,164,42,115,110,0,1884.333,64,2248.926,MORE,940,1152,2092,3,2,-5.0,-0.4687042303372438,5.0,-0.6984302957695783,0.24198964138984164,-0.6671223335588836,225,115,110,1,1.2964267863185297,1.3655839802978638,1.170500554541026,0.02413671131472937,0.8729992558989621,0.8729992558989621,1.170500554541026,1.3655839802978638,1,0,1,2,1.3655839802978638,1.170500554541026
1364,6,165,53,103,110,1,3377.466,54,2313.3,MORE,390,1314,1704,4,2,7.0,0.6561859224721414,7.0,-0.34921514788478913,-0.20822364491684048,0.7043281093742898,213,103,110,0,1.0570864565366473,0.8973837584814532,1.170500554541026,0.748238050756613,0.1251803522371993,0.1251803522371993,1.170500554541026,0.8973837584814532,0,1,0,2,1.170500554541026,0.8973837584814532
1365,6,166,26,90,80,0,2420.207000000001,54,1469.621,MORE,-452,1266,814,4,1,-10.0,-0.9374084606744876,10.0,0.17460757394239454,-0.20822364491684048,-0.17491927150321107,170,90,80,1,0.19945027481823535,0.3901668515136753,0.0,0.748238050756613,-1.0196624057322632,1.0196624057322632,0.0,0.3901668515136753,0,1,0,1,0.3901668515136753,0.0
1366,6,167,35,80,72,0,2573.202,44,869.329,MORE,-516,1388,872,4,1,-8.0,-0.7499267685395902,8.0,-0.17460757394239454,-0.6584369312235226,-0.03439256657032157,152,80,72,1,-0.1595602198545883,0.0,-0.31213348121094026,0.748238050756613,-1.1066813327038136,1.1066813327038136,-0.31213348121094026,0.0,0,1,0,1,0.0,-0.31213348121094026
1367,6,168,28,93,80,0,1927.552,64,1541.193,MORE,-142,1416,1274,2,2,-13.0,-1.218630998876834,13.0,0.6984302957695783,0.24198964138984164,-0.6274254567949726,173,93,80,1,0.25928535726370594,0.5072169069677779,0.0,-0.6999646281271542,-0.5981644782138149,0.5981644782138149,0.0,0.5072169069677779,1,0,0,1,0.5072169069677779,0.0
1368,6,169,26,80,90,1,1923.274,64,1562.845,MORE,1014,694,1708,3,2,10.0,0.9374084606744876,10.0,0.17460757394239454,0.24198964138984164,-0.6313548220925504,170,80,90,0,0.19945027481823535,0.0,0.3901668515136753,0.02413671131472937,0.9736148902098174,0.9736148902098174,0.3901668515136753,0.0,1,1,1,1,0.3901668515136753,0.0
1369,6,170,25,88,80,1,2021.136,64,1210.57,MORE,668,802,1470,3,2,-8.0,-0.7499267685395902,8.0,-0.17460757394239454,0.24198964138984164,-0.5414680650211265,168,88,80,1,0.1595602198545883,0.31213348121094026,0.0,0.02413671131472937,0.5031688162698722,0.5031688162698722,0.0,0.31213348121094026,1,1,1,1,0.31213348121094026,0.0
1370,6,171,36,80,70,0,1993.843,54,1722.678,MORE,-176,976,800,3,2,-10.0,-0.9374084606744876,10.0,0.17460757394239454,-0.20822364491684048,-0.5665368277763365,150,80,70,1,-0.19945027481823535,0.0,-0.3901668515136753,0.02413671131472937,-0.6443932831674511,0.6443932831674511,-0.3901668515136753,0.0,0,0,0,1,0.0,-0.3901668515136753
1371,6,172,28,80,93,1,3532.94,44,2756.23,MORE,670,1396,2066,5,2,13.0,1.218630998876834,13.0,0.6984302957695783,-0.6584369312235226,0.8471317887280999,173,80,93,0,0.25928535726370594,0.0,0.5072169069677779,1.4723393901984967,0.5058881577377331,0.5058881577377331,0.5072169069677779,0.0,0,1,1,1,0.5072169069677779,0.0
1372,6,173,21,82,80,0,2024.598,54,2234.426,MORE,-626,1148,522,2,2,-2.0,-0.18748169213489754,2.0,-1.222253017596762,-0.20822364491684048,-0.5382881999766632,162,82,80,1,0.03989005496364707,0.07803337030273506,0.0,-0.6999646281271542,-1.2562451134361663,1.2562451134361663,0.0,0.07803337030273506,0,0,0,1,0.07803337030273506,0.0
1373,6,174,19,50,41,0,2658.451,54,1872.915,MORE,58,1356,1414,4,2,-9.0,-0.8436676146070391,9.0,0.0,-0.20822364491684048,0.043909084260254035,91,50,41,1,-1.376206896245824,-1.170500554541026,-1.5216507209033339,0.748238050756613,-0.32623033142771934,0.32623033142771934,-1.5216507209033339,-1.170500554541026,0,1,0,0,-1.170500554541026,-1.5216507209033339
1374,6,175,56,96,110,1,2239.484,54,1719.9679999999996,MORE,972,738,1710,3,2,14.0,1.3123718449442827,14.0,0.8730378697119728,-0.20822364491684048,-0.3409142889585973,206,96,110,0,0.9174712641638826,0.6242669624218805,1.170500554541026,0.02413671131472937,0.9165087193847373,0.9165087193847373,1.170500554541026,0.6242669624218805,0,0,1,2,1.170500554541026,0.6242669624218805
1375,6,176,23,80,85,1,1283.366,84,941.489,MORE,526,380,906,1,2,5.0,0.4687042303372438,5.0,-0.6984302957695783,1.1424162140032061,-1.2191136553890358,165,80,85,0,0.09972513740911768,0.0,0.19508342575683765,-1.424065967569038,0.3100955720517443,0.3100955720517443,0.19508342575683765,0.0,1,0,1,1,0.19508342575683765,0.0
1376,6,177,10,60,50,1,4467.623,34,1748.128,MORE,416,1726,2142,5,2,-10.0,-0.9374084606744876,10.0,0.17460757394239454,-1.1086502175302049,1.7056429959361026,110,60,50,1,-0.9972513740911768,-0.7803337030273506,-1.170500554541026,1.4723393901984967,0.16053179131939174,0.16053179131939174,-1.170500554541026,-0.7803337030273506,0,1,1,0,-0.7803337030273506,-1.170500554541026
1377,6,178,19,41,50,1,1179.067,100,2480.979,MORE,2482,382,2864,1,2,9.0,0.8436676146070391,9.0,0.0,1.8627574720938973,-1.314912830511069,91,41,50,0,-1.376206896245824,-1.5216507209033339,-1.170500554541026,-1.424065967569038,2.969611527619759,2.969611527619759,-1.170500554541026,-1.5216507209033339,1,0,1,0,-1.5216507209033339,-1.170500554541026
1378,6,179,56,110,96,1,4555.062,44,1323.892,MORE,630,1442,2072,5,2,-14.0,-1.3123718449442827,14.0,0.8730378697119728,-0.6584369312235226,1.7859561731812872,206,110,96,1,0.9174712641638826,1.170500554541026,0.6242669624218805,1.4723393901984967,0.451501328380514,0.451501328380514,0.6242669624218805,1.170500554541026,0,1,1,2,1.170500554541026,0.6242669624218805
1379,6,180,35,72,80,1,1342.918,64,1239.736,MORE,996,404,1400,1,2,8.0,0.7499267685395902,8.0,-0.17460757394239454,0.24198964138984164,-1.1644148329950788,152,72,80,0,-0.1595602198545883,-0.31213348121094026,0.0,-1.424065967569038,0.9491408169990688,0.9491408169990688,0.0,-0.31213348121094026,1,0,1,1,-0.31213348121094026,0.0
1380,6,181,11,49,50,1,1767.813,64,1619.947,MORE,608,756,1364,3,2,1.0,0.09374084606744876,1.0,-1.3968605915391563,0.24198964138984164,-0.7741465608786021,99,49,50,0,-1.2166466763912356,-1.2095172396923934,-1.170500554541026,0.02413671131472937,0.4215885722340435,0.4215885722340435,-1.170500554541026,-1.2095172396923934,1,0,1,0,-1.2095172396923934,-1.170500554541026
1381,6,182,17,43,50,1,2081.146,74,1742.326,MORE,1364,738,2102,3,2,7.0,0.6561859224721414,7.0,-0.34921514788478913,0.6922029276965238,-0.4863485672400045,93,43,50,0,-1.3363168412821769,-1.4436173506005987,-1.170500554541026,0.02413671131472937,1.4494996470854846,1.4494996470854846,-1.170500554541026,-1.4436173506005987,1,0,1,0,-1.4436173506005987,-1.170500554541026
1382,6,183,1,51,50,1,1579.585,64,1387.87,MORE,1010,474,1484,1,2,-1.0,-0.09374084606744876,1.0,-1.3968605915391563,0.24198964138984164,-0.9470349599511734,101,51,50,1,-1.1767566214275886,-1.1314838693896585,-1.170500554541026,-1.424065967569038,0.9681762072740955,0.9681762072740955,-1.170500554541026,-1.1314838693896585,1,0,1,0,-1.1314838693896585,-1.170500554541026
1383,6,184,41,112,110,1,2602.75,54,1810.117,MORE,728,896,1624,3,2,-2.0,-0.18748169213489754,2.0,-1.222253017596762,-0.20822364491684048,-0.007252574561713427,222,112,110,1,1.2365917038730592,1.248533924843761,1.170500554541026,0.02413671131472937,0.5847490603057008,0.5847490603057008,1.170500554541026,1.248533924843761,0,0,1,2,1.248533924843761,1.170500554541026
1384,6,185,20,40,50,1,1439.3429999999996,100,994.828,MORE,910,452,1362,1,2,10.0,0.9374084606744876,10.0,0.17460757394239454,1.8627574720938973,-1.075847967913515,90,40,50,0,-1.3961519237276474,-1.5606674060547012,-1.170500554541026,-1.424065967569038,0.8322091338810477,0.8322091338810477,-1.170500554541026,-1.5606674060547012,1,0,1,0,-1.5606674060547012,-1.170500554541026
1385,6,186,1,50,51,1,1198.59,100,1511.21,MORE,1708,386,2094,1,2,1.0,0.09374084606744876,1.0,-1.3968605915391563,1.8627574720938973,-1.2969808532542646,101,50,51,0,-1.1767566214275886,-1.170500554541026,-1.1314838693896585,-1.424065967569038,1.917226379557569,1.917226379557569,-1.1314838693896585,-1.170500554541026,1,0,1,0,-1.170500554541026,-1.1314838693896585
1386,6,187,23,85,80,0,1701.021,74,2017.806,MORE,1642,768,2410,3,2,-5.0,-0.4687042303372438,5.0,-0.6984302957695783,0.6922029276965238,-0.8354953610085254,165,85,80,1,0.09972513740911768,0.19508342575683765,0.0,0.02413671131472937,1.8274881111181576,1.8274881111181576,0.0,0.19508342575683765,1,0,1,1,0.19508342575683765,0.0
1387,6,188,11,50,49,1,2031.543,74,1723.602,MORE,1682,682,2364,3,2,-1.0,-0.09374084606744876,1.0,-1.3968605915391563,0.6922029276965238,-0.5319091812782815,99,50,49,1,-1.2166466763912356,-1.170500554541026,-1.2095172396923934,0.02413671131472937,1.8818749404753765,1.8818749404753765,-1.2095172396923934,-1.170500554541026,1,1,1,0,-1.170500554541026,-1.2095172396923934
1388,6,189,17,50,43,0,2616.971,34,1048.119,MORE,-444,1394,950,4,2,-7.0,-0.6561859224721414,7.0,-0.34921514788478913,-1.1086502175302049,0.0058094880602718,93,50,43,1,-1.3363168412821769,-1.170500554541026,-1.4436173506005987,0.748238050756613,-1.0087850398608194,1.0087850398608194,-1.4436173506005987,-1.170500554541026,0,1,0,0,-1.170500554541026,-1.4436173506005987
1389,6,190,21,80,82,0,2551.144,44,1977.075,MORE,-672,1448,776,4,2,2.0,0.18748169213489754,2.0,-1.222253017596762,-0.6584369312235226,-0.0546529545399268,162,80,82,0,0.03989005496364707,0.0,0.07803337030273506,0.748238050756613,-1.3187899671969683,1.3187899671969683,0.07803337030273506,0.0,0,1,0,1,0.07803337030273506,0.0
1390,6,191,10,50,60,1,1199.081,94,1889.409,MORE,1956,400,2356,1,2,10.0,0.9374084606744876,10.0,0.17460757394239454,1.592629500309888,-1.296529867195099,110,50,60,0,-0.9972513740911768,-1.170500554541026,-0.7803337030273506,-1.424065967569038,2.2544247215723274,2.2544247215723274,-0.7803337030273506,-1.170500554541026,1,0,1,0,-1.170500554541026,-0.7803337030273506
1391,6,192,3,53,50,0,3041.2090000000007,24,1742.1729999999998,MORE,-502,1594,1092,4,2,-3.0,-0.28122253820234633,3.0,-1.0476454436543674,-1.5588635038368868,0.3954743022523664,103,53,50,1,-1.1368665664639415,-1.0534504990869233,-1.170500554541026,0.748238050756613,-1.087645942428787,1.087645942428787,-1.170500554541026,-1.0534504990869233,0,1,0,0,-1.0534504990869233,-1.170500554541026
1392,6,193,45,122,110,1,3468.601,64,1209.878,MORE,856,1370,2226,3,2,-12.0,-1.124890152809385,12.0,0.5238227218271837,0.24198964138984164,0.7880360818835808,232,122,110,1,1.4360419786912946,1.6387007763574364,1.170500554541026,0.02413671131472937,0.758786914248802,0.758786914248802,1.170500554541026,1.6387007763574364,1,1,1,2,1.6387007763574364,1.170500554541026
1393,6,194,38,67,80,1,1921.719,64,947.95,MORE,638,632,1270,1,2,13.0,1.218630998876834,13.0,0.6984302957695783,0.24198964138984164,-0.6327830976974435,147,67,80,0,-0.25928535726370594,-0.5072169069677779,0.0,-1.424065967569038,0.4623786942519578,0.4623786942519578,0.0,-0.5072169069677779,1,0,1,1,-0.5072169069677779,0.0
1394,6,195,38,80,67,0,2037.211,44,1808.751,MORE,258,934,1192,3,2,-13.0,-1.218630998876834,13.0,0.6984302957695783,-0.6584369312235226,-0.5267030937358151,147,80,67,1,-0.25928535726370594,0.0,-0.5072169069677779,0.02413671131472937,-0.05429618464162375,0.05429618464162375,-0.5072169069677779,0.0,0,1,0,1,0.0,-0.5072169069677779
1395,6,196,36,70,80,1,2503.706,94,2165.9970000000008,MORE,1700,1052,2752,2,2,10.0,0.9374084606744876,10.0,0.17460757394239454,1.592629500309888,-0.0982250047938984,150,70,80,0,-0.19945027481823535,-0.3901668515136753,0.0,-0.6999646281271542,1.9063490136861252,1.9063490136861252,0.0,-0.3901668515136753,1,0,1,1,-0.3901668515136753,0.0
1396,6,197,45,110,122,1,2870.153,54,1910.509,MORE,950,1122,2072,2,2,12.0,1.124890152809385,12.0,0.5238227218271837,-0.20822364491684048,0.2383584746828342,232,110,122,0,1.4360419786912946,1.170500554541026,1.6387007763574364,-0.6999646281271542,0.8865959632382668,0.8865959632382668,1.6387007763574364,1.170500554541026,0,0,1,2,1.6387007763574364,1.170500554541026
1397,6,198,42,110,115,1,1684.625,84,1718.9720000000002,MORE,1560,784,2344,1,2,5.0,0.4687042303372438,5.0,-0.6984302957695783,1.1424162140032061,-0.8505551724669369,225,110,115,0,1.2964267863185297,1.170500554541026,1.3655839802978638,-1.424065967569038,1.7159951109358582,1.7159951109358582,1.3655839802978638,1.170500554541026,1,0,1,2,1.3655839802978638,1.170500554541026
1398,6,199,41,110,112,1,2492.483,54,1504.745,MORE,54,1012,1066,3,2,2.0,0.18748169213489754,2.0,-1.222253017596762,-0.20822364491684048,-0.10853338878985787,222,110,112,0,1.2365917038730592,1.170500554541026,1.248533924843761,0.02413671131472937,-0.33166901436344126,0.33166901436344126,1.248533924843761,1.170500554541026,0,1,0,2,1.248533924843761,1.170500554541026
1399,6,200,53,110,103,0,5907.275,24,1954.021,MORE,-1412,2692,1280,3,2,-7.0,-0.6561859224721414,7.0,-0.34921514788478913,-1.5588635038368868,3.0279708616182814,213,110,103,1,1.0570864565366473,1.170500554541026,0.8973837584814532,0.02413671131472937,-2.324946310305522,2.324946310305522,0.8973837584814532,1.170500554541026,0,0,0,2,1.170500554541026,0.8973837584814532
1400,6,201,3,50,53,0,1731.005,54,2411.519,LESS,-334,978,644,2,2,3.0,0.28122253820234633,3.0,-1.0476454436543674,-0.20822364491684048,-0.8079549007274195,103,50,53,1,-1.1368665664639415,-1.170500554541026,-1.0534504990869233,-0.6999646281271542,-0.8592212591284667,0.8592212591284667,-1.0534504990869233,-1.170500554541026,0,0,0,0,-1.170500554541026,-1.0534504990869233
1401,6,202,20,50,40,1,2851.458,44,1695.909,LESS,576,1040,1616,3,2,-10.0,-0.9374084606744876,10.0,0.17460757394239454,-0.6584369312235226,0.2211870197416901,90,50,40,0,-1.3961519237276474,-1.170500554541026,-1.5606674060547012,0.02413671131472937,0.3780791087482682,0.3780791087482682,-1.5606674060547012,-1.170500554541026,0,1,1,0,-1.170500554541026,-1.5606674060547012
1402,6,203,25,80,88,1,2398.445,24,1759.187,LESS,474,938,1412,3,1,8.0,0.7499267685395902,8.0,-0.17460757394239454,-1.5588635038368868,-0.19490778193002006,168,80,88,1,0.1595602198545883,0.0,0.31213348121094026,0.02413671131472937,0.23939269388735945,0.23939269388735945,0.31213348121094026,0.0,0,1,1,1,0.31213348121094026,0.0
1403,6,204,42,115,110,1,1463.681,44,1676.023,LESS,696,382,1078,1,2,-5.0,-0.4687042303372438,5.0,-0.6984302957695783,-0.6584369312235226,-1.0534933880602075,225,115,110,0,1.2964267863185297,1.3655839802978638,1.170500554541026,-1.424065967569038,0.5412395968199255,0.5412395968199255,1.170500554541026,1.3655839802978638,0,0,1,2,1.3655839802978638,1.170500554541026
1404,6,205,53,103,110,0,2014.43,44,2142.188,LESS,-504,1310,806,4,1,7.0,0.6561859224721414,7.0,-0.34921514788478913,-0.6584369312235226,-0.5476275609738044,213,103,110,1,1.0570864565366473,0.8973837584814532,1.170500554541026,0.748238050756613,-1.090365283896648,1.090365283896648,1.170500554541026,0.8973837584814532,0,1,0,2,1.170500554541026,0.8973837584814532
1405,6,206,26,90,80,1,2120.2,64,2038.573,LESS,190,1022,1212,3,2,-10.0,-0.9374084606744876,10.0,0.17460757394239454,0.24198964138984164,-0.4504772646846986,170,90,80,0,0.19945027481823535,0.3901668515136753,0.0,0.02413671131472937,-0.14675379454889625,0.14675379454889625,0.0,0.3901668515136753,1,0,1,1,0.3901668515136753,0.0
1406,6,207,35,80,72,0,1590.71,74,1286.309,LESS,58,978,1036,2,2,-8.0,-0.7499267685395902,8.0,-0.17460757394239454,0.6922029276965238,-0.9368165894660044,152,80,72,0,-0.1595602198545883,0.0,-0.31213348121094026,-0.6999646281271542,-0.32623033142771934,0.32623033142771934,-0.31213348121094026,0.0,1,0,0,1,0.0,-0.31213348121094026
1407,6,208,28,93,80,1,3189.212,34,1443.971,LESS,170,1396,1566,5,2,-13.0,-1.218630998876834,13.0,0.6984302957695783,-1.1086502175302049,0.5314158291662029,173,93,80,0,0.25928535726370594,0.5072169069677779,0.0,1.4723393901984967,-0.1739472092275058,0.1739472092275058,0.0,0.5072169069677779,0,1,0,1,0.5072169069677779,0.0
1408,6,209,26,80,90,0,1438.044,74,1699.037,LESS,270,1064,1334,3,2,10.0,0.9374084606744876,10.0,0.17460757394239454,0.6922029276965238,-1.0770411061840972,170,80,90,1,0.19945027481823535,0.0,0.3901668515136753,0.02413671131472937,-0.03798013583445802,0.03798013583445802,0.3901668515136753,0.0,1,1,1,1,0.3901668515136753,0.0
1409,6,210,25,88,80,0,1940.528,54,1269.054,LESS,-524,1208,684,2,2,-8.0,-0.7499267685395902,8.0,-0.17460757394239454,-0.20822364491684048,-0.6155069331621141,168,88,80,0,0.1595602198545883,0.31213348121094026,0.0,-0.6999646281271542,-1.1175586985752575,1.1175586985752575,0.0,0.31213348121094026,0,0,0,1,0.31213348121094026,0.0
1410,6,211,36,80,70,0,4441.81,34,2181.4210000000007,LESS,-234,2004,1770,5,2,-10.0,-0.9374084606744876,10.0,0.17460757394239454,-1.1086502175302049,1.6819336208948754,150,80,70,0,-0.19945027481823535,0.0,-0.3901668515136753,1.4723393901984967,-0.7232541857354189,0.7232541857354189,-0.3901668515136753,0.0,0,1,0,1,0.0,-0.3901668515136753
1411,6,212,28,80,93,0,1528.134,74,1577.445,LESS,536,986,1522,2,2,13.0,1.218630998876834,13.0,0.6984302957695783,0.6922029276965238,-0.9942929716215032,173,80,93,1,0.25928535726370594,0.0,0.5072169069677779,-0.6999646281271542,0.3236922793910491,0.3236922793910491,0.5072169069677779,0.0,1,0,1,1,0.5072169069677779,0.0
1412,6,213,21,82,80,0,1431.446,64,1804.58,LESS,-224,906,682,2,2,-2.0,-0.18748169213489754,2.0,-1.222253017596762,0.24198964138984164,-1.0831014035738629,162,82,80,0,0.03989005496364707,0.07803337030273506,0.0,-0.6999646281271542,-0.7096574783961141,0.7096574783961141,0.0,0.07803337030273506,1,0,0,1,0.07803337030273506,0.0
1413,6,214,19,50,41,0,1663.206,64,1170.064,LESS,312,696,1008,3,2,-9.0,-0.8436676146070391,9.0,0.0,0.24198964138984164,-0.8702286356059781,91,50,41,0,-1.376206896245824,-1.170500554541026,-1.5216507209033339,0.02413671131472937,0.01912603499062205,0.01912603499062205,-1.5216507209033339,-1.170500554541026,1,0,1,0,-1.170500554541026,-1.5216507209033339
1414,6,215,56,96,110,0,1442.37,74,2069.264,LESS,162,920,1082,2,2,14.0,1.3123718449442827,14.0,0.8730378697119728,0.6922029276965238,-1.0730676526363363,206,96,110,1,0.9174712641638826,0.6242669624218805,1.170500554541026,-0.6999646281271542,-0.18482457509894962,0.18482457509894962,1.170500554541026,0.6242669624218805,1,0,0,2,1.170500554541026,0.6242669624218805
1415,6,216,23,80,85,0,2646.513,24,1393.355,LESS,-622,1498,876,4,1,5.0,0.4687042303372438,5.0,-0.6984302957695783,-1.5588635038368868,0.03294396903760717,165,80,85,1,0.09972513740911768,0.0,0.19508342575683765,0.748238050756613,-1.2508064305004443,1.2508064305004443,0.19508342575683765,0.0,0,1,0,1,0.19508342575683765,0.0
1416,6,217,10,60,50,1,3014.756,34,2097.882,LESS,322,1268,1590,5,2,-10.0,-0.9374084606744876,10.0,0.17460757394239454,-1.1086502175302049,0.3711770838753615,110,60,50,0,-0.9972513740911768,-0.7803337030273506,-1.170500554541026,1.4723393901984967,0.03272274232992683,0.03272274232992683,-1.170500554541026,-0.7803337030273506,0,1,1,0,-0.7803337030273506,-1.170500554541026
1417,6,218,19,41,50,0,1225.74,44,1531.016,LESS,-342,890,548,2,1,9.0,0.8436676146070391,9.0,0.0,-0.6584369312235226,-1.272043436744392,91,41,50,1,-1.376206896245824,-1.5216507209033339,-1.170500554541026,-0.6999646281271542,-0.8700986249999105,0.8700986249999105,-1.170500554541026,-1.5216507209033339,0,0,0,0,-1.5216507209033339,-1.170500554541026
1418,6,219,56,110,96,1,2014.943,54,1733.7020000000002,LESS,458,730,1188,3,2,-14.0,-1.3123718449442827,14.0,0.8730378697119728,-0.20822364491684048,-0.5471563677999715,206,110,96,0,0.9174712641638826,1.170500554541026,0.6242669624218805,0.02413671131472937,0.2176379621444718,0.2176379621444718,0.6242669624218805,1.170500554541026,0,1,1,2,1.170500554541026,0.6242669624218805
1419,6,220,35,72,80,0,1310.065,74,806.9,LESS,28,888,916,3,2,8.0,0.7499267685395902,8.0,-0.17460757394239454,0.6922029276965238,-1.1945904847298427,152,72,80,1,-0.1595602198545883,-0.31213348121094026,0.0,0.02413671131472937,-0.36702045344563367,0.36702045344563367,0.0,-0.31213348121094026,1,0,0,1,-0.31213348121094026,0.0
1420,6,221,11,49,50,1,3393.889,54,1269.015,LESS,184,1430,1614,5,2,1.0,0.09374084606744876,1.0,-1.3968605915391563,-0.20822364491684048,0.7194127204734295,99,49,50,1,-1.2166466763912356,-1.2095172396923934,-1.170500554541026,1.4723393901984967,-0.1549118189524791,0.1549118189524791,-1.170500554541026,-1.2095172396923934,0,1,0,0,-1.2095172396923934,-1.170500554541026
1421,6,222,17,43,50,0,1245.218,64,2234.645,LESS,416,750,1166,2,2,7.0,0.6561859224721414,7.0,-0.34921514788478913,0.24198964138984164,-1.254152792222134,93,43,50,1,-1.3363168412821769,-1.4436173506005987,-1.170500554541026,-0.6999646281271542,0.16053179131939174,0.16053179131939174,-1.170500554541026,-1.4436173506005987,1,0,1,0,-1.4436173506005987,-1.170500554541026
1422,6,223,1,51,50,0,1462.408,74,1776.984,LESS,190,960,1150,2,2,-1.0,-0.09374084606744876,1.0,-1.3968605915391563,0.6922029276965238,-1.0546626451952743,101,51,50,0,-1.1767566214275886,-1.1314838693896585,-1.170500554541026,-0.6999646281271542,-0.14675379454889625,0.14675379454889625,-1.170500554541026,-1.1314838693896585,1,0,1,0,-1.1314838693896585,-1.170500554541026
1423,6,224,41,112,110,0,1597.046,64,1012.81,LESS,-406,972,566,2,2,-2.0,-0.18748169213489754,2.0,-1.222253017596762,0.24198964138984164,-0.930996940441822,222,112,110,0,1.2365917038730592,1.248533924843761,1.170500554541026,-0.6999646281271542,-0.9571175519714611,0.9571175519714611,1.170500554541026,1.248533924843761,1,0,0,2,1.248533924843761,1.170500554541026
1424,6,225,20,40,50,0,1587.007,64,1901.517,LESS,-654,1030,376,2,1,10.0,0.9374084606744876,10.0,0.17460757394239454,0.24198964138984164,-0.940217814266596,90,40,50,1,-1.3961519237276474,-1.5606674060547012,-1.170500554541026,-0.6999646281271542,-1.2943158939862196,1.2943158939862196,-1.170500554541026,-1.5606674060547012,1,0,0,0,-1.5606674060547012,-1.170500554541026
1425,6,226,1,50,51,0,1592.751,74,2016.448,LESS,-144,902,758,1,2,1.0,0.09374084606744876,1.0,-1.3968605915391563,0.6922029276965238,-0.9349419203280064,101,50,51,1,-1.1767566214275886,-1.170500554541026,-1.1314838693896585,-1.424065967569038,-0.6008838196816758,0.6008838196816758,-1.1314838693896585,-1.170500554541026,1,0,0,0,-1.170500554541026,-1.1314838693896585
1426,6,227,23,85,80,1,4144.806,4,2358.724,LESS,-456,2234,1778,4,1,-5.0,-0.4687042303372438,5.0,-0.6984302957695783,-2.459290076450251,1.4091338988654745,165,85,80,0,0.09972513740911768,0.19508342575683765,0.0,0.748238050756613,-1.025101088667985,1.025101088667985,0.0,0.19508342575683765,0,1,0,1,0.19508342575683765,0.0
1427,6,228,11,50,49,0,1656.356,34,1557.58,LESS,-614,972,358,1,1,-1.0,-0.09374084606744876,1.0,-1.3968605915391563,-1.1086502175302049,-0.8765203963092053,99,50,49,0,-1.2166466763912356,-1.170500554541026,-1.2095172396923934,-1.424065967569038,-1.2399290646290004,1.2399290646290004,-1.2095172396923934,-1.170500554541026,0,0,0,0,-1.170500554541026,-1.2095172396923934
1428,6,229,17,50,43,0,1462.895,44,1291.634,LESS,-440,860,420,2,1,-7.0,-0.6561859224721414,7.0,-0.34921514788478913,-0.6584369312235226,-1.0542153331569577,93,50,43,0,-1.3363168412821769,-1.170500554541026,-1.4436173506005987,-0.6999646281271542,-1.0033463569250973,1.0033463569250973,-1.4436173506005987,-1.170500554541026,0,0,0,0,-1.170500554541026,-1.4436173506005987
1429,6,230,21,80,82,0,1550.981,54,2025.337,LESS,-732,1174,442,2,1,2.0,0.18748169213489754,2.0,-1.222253017596762,-0.20822364491684048,-0.973307883039512,162,80,82,1,0.03989005496364707,0.0,0.07803337030273506,-0.6999646281271542,-1.400370211232797,1.400370211232797,0.07803337030273506,0.0,0,0,0,1,0.07803337030273506,0.0
1430,6,231,10,50,60,0,1503.257,64,1145.208,LESS,-500,908,408,2,1,10.0,0.9374084606744876,10.0,0.17460757394239454,0.24198964138984164,-1.017142625784159,110,50,60,1,-0.9972513740911768,-1.170500554541026,-0.7803337030273506,-0.6999646281271542,-1.084926600960926,1.084926600960926,-0.7803337030273506,-1.170500554541026,1,0,0,0,-1.170500554541026,-0.7803337030273506
1431,6,232,3,53,50,0,1716.808,54,1815.222,LESS,-608,1198,590,2,2,-3.0,-0.28122253820234633,3.0,-1.0476454436543674,-0.20822364491684048,-0.8209949192243132,103,53,50,0,-1.1368665664639415,-1.0534504990869233,-1.170500554541026,-0.6999646281271542,-1.2317710402254176,1.2317710402254176,-1.170500554541026,-1.0534504990869233,0,0,0,0,-1.0534504990869233,-1.170500554541026
1432,6,233,45,122,110,1,1170.135,74,1465.951,LESS,816,478,1294,1,2,-12.0,-1.124890152809385,12.0,0.5238227218271837,0.6922029276965238,-1.323116919065993,232,122,110,0,1.4360419786912946,1.6387007763574364,1.170500554541026,-1.424065967569038,0.7044000848915828,0.7044000848915828,1.170500554541026,1.6387007763574364,1,0,1,2,1.6387007763574364,1.170500554541026
1433,6,234,38,67,80,0,1385.53,64,982.675,LESS,42,808,850,2,2,13.0,1.218630998876834,13.0,0.6984302957695783,0.24198964138984164,-1.1252754888949426,147,67,80,1,-0.25928535726370594,-0.5072169069677779,0.0,-0.6999646281271542,-0.34798506317060696,0.34798506317060696,0.0,-0.5072169069677779,1,0,0,1,-0.5072169069677779,0.0
1434,6,235,38,80,67,1,1559.527,74,1535.303,LESS,704,516,1220,1,2,-13.0,-1.218630998876834,13.0,0.6984302957695783,0.6922029276965238,-0.965458337496478,147,80,67,0,-0.25928535726370594,0.0,-0.5072169069677779,-1.424065967569038,0.5521169626913693,0.5521169626913693,-0.5072169069677779,0.0,1,0,1,1,0.0,-0.5072169069677779
1435,6,236,36,70,80,0,1404.849,84,1032.374,LESS,400,800,1200,2,2,10.0,0.9374084606744876,10.0,0.17460757394239454,1.1424162140032061,-1.1075308867014169,150,70,80,1,-0.19945027481823535,-0.3901668515136753,0.0,-0.6999646281271542,0.1387770595765041,0.1387770595765041,0.0,-0.3901668515136753,1,0,1,1,-0.3901668515136753,0.0
1436,6,237,45,110,122,0,4426.453,14,980.493,LESS,-470,2168,1698,5,1,12.0,1.124890152809385,12.0,0.5238227218271837,-2.009076790143569,1.6678281363518876,232,110,122,1,1.4360419786912946,1.170500554541026,1.6387007763574364,1.4723393901984967,-1.0441364789430116,1.0441364789430116,1.6387007763574364,1.170500554541026,0,1,0,2,1.6387007763574364,1.170500554541026
1437,6,238,42,110,115,0,1465.382,64,1364.275,LESS,48,902,950,2,2,5.0,0.4687042303372438,5.0,-0.6984302957695783,0.24198964138984164,-1.0519310106943405,225,110,115,1,1.2964267863185297,1.170500554541026,1.3655839802978638,-0.6999646281271542,-0.3398270387670241,0.3398270387670241,1.3655839802978638,1.170500554541026,1,0,0,2,1.3655839802978638,1.170500554541026
1438,6,239,41,110,112,1,1831.341,44,1301.537,LESS,296,730,1026,3,2,2.0,0.18748169213489754,2.0,-1.222253017596762,-0.6584369312235226,-0.7157957617611368,222,110,112,1,1.2365917038730592,1.170500554541026,1.248533924843761,0.02413671131472937,-0.0026286967522655955,0.0026286967522655955,1.248533924843761,1.170500554541026,0,1,1,2,1.248533924843761,1.170500554541026
1439,6,240,53,110,103,1,1191.365,44,1822.287,LESS,-112,756,644,3,2,-7.0,-0.6561859224721414,7.0,-0.34921514788478913,-0.6584369312235226,-1.3036170534120484,213,110,103,0,1.0570864565366473,1.170500554541026,0.8973837584814532,0.02413671131472937,-0.5573743561959006,0.5573743561959006,0.8973837584814532,1.170500554541026,0,1,0,2,1.170500554541026,0.8973837584814532
1440,7,1,49,110,131,1,4083.058,70,999.476,MORE,-852,2158,1306,3,2,21.0,1.9685577674164243,21.0,2.0952908873087353,0.4958062297457522,-0.14940825498528812,241,110,131,0,1.6155472260277064,1.170500554541026,1.9898509427197442,-0.33156925250277336,-0.43486768438182943,0.43486768438182943,1.9898509427197442,1.170500554541026,1,0,0,2,1.9898509427197442,1.170500554541026
1441,7,2,13,47,50,1,4313.189,80,1378.333,MORE,-1108,2378,1270,3,2,3.0,0.28122253820234633,3.0,-1.0476454436543674,0.8747664053476009,-0.08516889430476454,97,47,50,0,-1.2565367313548828,-1.2875506099951286,-1.170500554541026,-0.33156925250277336,-0.6840216114997711,0.6840216114997711,-1.170500554541026,-1.2875506099951286,1,1,0,0,-1.2875506099951286,-1.170500554541026
1442,7,3,16,50,44,0,11158.922,30,1334.765,MORE,-1682,5674,3992,7,1,-6.0,-0.5624450764046927,6.0,-0.5238227218271837,-1.0200344726616426,1.8257666654831912,94,50,44,1,-1.3163718138003533,-1.170500554541026,-1.4046006654492311,1.6332855771432915,-1.2426714324595312,1.2426714324595312,-1.4046006654492311,-1.170500554541026,0,1,0,0,-1.170500554541026,-1.4046006654492311
1443,7,4,7,57,50,0,5597.9540000000015,20,1276.14,MORE,-3020,4302,1282,4,1,-7.0,-0.6561859224721414,7.0,-0.34921514788478913,-1.3989946482634914,0.2734637202700334,107,57,50,1,-1.0570864565366473,-0.8973837584814532,-1.170500554541026,0.15964445490874285,-2.5448900046618985,2.5448900046618985,-1.170500554541026,-0.8973837584814532,0,1,0,0,-0.8973837584814532,-1.170500554541026
1444,7,5,18,42,50,1,1564.9229999999998,80,1835.487,MORE,-44,900,856,1,2,8.0,0.7499267685395902,8.0,-0.17460757394239454,0.8747664053476009,-0.8523269513245469,92,42,50,0,-1.3562618687640005,-1.4826340357519663,-1.170500554541026,-1.3139966673258057,0.3515243980841742,0.3515243980841742,-1.170500554541026,-1.4826340357519663,1,0,1,0,-1.4826340357519663,-1.170500554541026
1445,7,6,51,108,110,1,15107.624,10,1378.668,MORE,-1542,7840,6298,8,1,2.0,0.18748169213489754,2.0,-1.222253017596762,-1.77795482386534,2.928017522594595,218,108,110,0,1.156811593945765,1.092467184238291,1.170500554541026,2.1244992845548074,-1.1064153785669069,1.1064153785669069,1.170500554541026,1.092467184238291,0,1,0,2,1.170500554541026,1.092467184238291
1446,7,7,31,78,80,0,9450.808,20,1738.249,MORE,-1986,5230,3244,6,1,2.0,0.18748169213489754,2.0,-1.222253017596762,-1.3989946482634914,1.3489593195391347,158,78,80,0,-0.03989005496364707,-0.07803337030273506,0.0,1.1420718697317753,-1.538541720912087,1.538541720912087,0.0,-0.07803337030273506,0,1,0,1,-0.07803337030273506,0.0
1447,7,8,58,110,92,0,4452.746,40,1420.156,MORE,-290,2074,1784,4,1,-18.0,-1.6873352292140782,18.0,1.571468165481551,-0.6410742970597939,-0.04621259350873185,202,110,92,1,0.8376911542365885,1.170500554541026,0.4682002218164104,0.15964445490874285,0.11210304624427705,0.11210304624427705,0.4682002218164104,1.170500554541026,0,1,0,2,1.170500554541026,0.4682002218164104
1448,7,9,12,50,48,1,1721.744,70,2214.439,MORE,-546,1142,596,1,1,-2.0,-0.18748169213489754,2.0,-1.222253017596762,0.4958062297457522,-0.8085515330572108,98,50,48,1,-1.2365917038730592,-1.170500554541026,-1.248533924843761,-1.3139966673258057,-0.1370508808736647,0.1370508808736647,-1.248533924843761,-1.170500554541026,0,0,0,0,-1.170500554541026,-1.248533924843761
1449,7,10,54,110,101,0,11827.374,30,1710.043,MORE,-694,5834,5140,6,2,-9.0,-0.8436676146070391,9.0,0.0,-1.0200344726616426,2.012360080214876,211,110,101,1,1.0171964015730004,1.170500554541026,0.8193503881787182,1.1420718697317753,-0.28109299498872475,0.28109299498872475,0.8193503881787182,1.170500554541026,0,1,0,2,1.170500554541026,0.8193503881787182
1450,7,11,14,46,50,1,3334.369,80,1452.102,MORE,-236,1670,1434,3,2,4.0,0.3749633842697951,4.0,-0.8730378697119728,0.8747664053476009,-0.3583992327698562,96,46,50,0,-1.2764817588367063,-1.3265672951464962,-1.170500554541026,-0.33156925250277336,0.1646589527457179,0.1646589527457179,-1.170500554541026,-1.3265672951464962,1,1,0,0,-1.3265672951464962,-1.170500554541026
1451,7,12,22,80,83,1,2647.196,70,1233.237,MORE,452,1354,1806,3,2,3.0,0.28122253820234633,3.0,-1.0476454436543674,0.4958062297457522,-0.5502184757093879,163,80,83,0,0.05983508244547061,0.0,0.1170500554541026,-0.33156925250277336,0.8342601318751864,0.8342601318751864,0.1170500554541026,0.0,0,1,1,1,0.1170500554541026,0.0
1452,7,13,6,50,56,1,1496.54,80,1632.572,MORE,416,534,950,1,2,6.0,0.5624450764046927,6.0,-0.5238227218271837,0.8747664053476009,-0.8714155582545836,106,50,56,0,-1.077031484018471,-1.170500554541026,-0.9364004436328208,-1.3139966673258057,0.7992228608742259,0.7992228608742259,-0.9364004436328208,-1.170500554541026,1,0,1,0,-1.170500554541026,-0.9364004436328208
1453,7,14,13,50,47,0,5530.411999999998,40,1257.929,MORE,-268,2712,2444,4,1,-3.0,-0.28122253820234633,3.0,-1.0476454436543674,-0.6410742970597939,0.25460987224832354,97,50,47,1,-1.2565367313548828,-1.170500554541026,-1.2875506099951286,0.15964445490874285,0.13351471185597516,0.13351471185597516,-1.2875506099951286,-1.170500554541026,0,1,0,0,-1.170500554541026,-1.2875506099951286
1454,7,15,46,110,124,0,9395.325,40,1538.372,MORE,14,4320,4334,4,1,14.0,1.3123718449442827,14.0,0.8730378697119728,-0.6410742970597939,1.3334716518688188,234,110,124,0,1.4759320336549415,1.170500554541026,1.7167341466601715,0.15964445490874285,0.4079733346968329,0.4079733346968329,1.7167341466601715,1.170500554541026,0,1,1,2,1.7167341466601715,1.170500554541026
1455,7,16,27,91,80,0,11928.201,20,679.075,MORE,-762,5800,5038,8,1,-11.0,-1.0311493067419364,11.0,0.34921514788478913,-1.3989946482634914,2.0405051889543984,171,91,80,1,0.21939530230005888,0.4291835366650429,0.0,2.1244992845548074,-0.34727450687942807,0.34727450687942807,0.0,0.4291835366650429,0,1,0,1,0.4291835366650429,0.0
1456,7,17,40,64,80,1,1513.154,70,778.8330000000002,MORE,340,596,936,1,2,16.0,1.4998535370791803,16.0,1.222253017596762,0.4958062297457522,-0.8667778834591574,144,64,80,0,-0.3191204397091766,-0.6242669624218805,0.0,-1.3139966673258057,0.7252552887610869,0.7252552887610869,0.0,-0.6242669624218805,0,0,1,1,-0.6242669624218805,0.0
1457,7,18,22,83,80,1,2556.452,80,1243.85,MORE,66,1318,1384,3,2,-3.0,-0.28122253820234633,3.0,-1.0476454436543674,0.8747664053476009,-0.5755489898321849,163,83,80,1,0.05983508244547061,0.1170500554541026,0.0,-0.33156925250277336,0.4585827261426648,0.4585827261426648,0.0,0.1170500554541026,1,0,1,1,0.1170500554541026,0.0
1458,7,19,54,101,110,1,8147.533,50,1263.967,MORE,1836,2858,4694,4,2,9.0,0.8436676146070391,9.0,0.0,-0.2621141214579453,0.9851597758405054,211,101,110,0,1.0171964015730004,0.8193503881787182,1.170500554541026,0.15964445490874285,2.181248550356559,2.181248550356559,1.170500554541026,0.8193503881787182,0,1,1,2,1.170500554541026,0.8193503881787182
1459,7,20,6,56,50,0,3727.561,40,1026.169,MORE,-558,1962,1404,4,1,-6.0,-0.5624450764046927,6.0,-0.5238227218271837,-0.6410742970597939,-0.24864260413357345,106,56,50,1,-1.077031484018471,-0.9364004436328208,-1.170500554541026,0.15964445490874285,-0.14872997120731823,0.14872997120731823,-1.170500554541026,-0.9364004436328208,0,1,0,0,-0.9364004436328208,-1.170500554541026
1460,7,21,18,50,42,1,3034.284,60,1171.367,MORE,-510,1612,1102,3,2,-8.0,-0.7499267685395902,8.0,-0.17460757394239454,0.11684605414390345,-0.4421657333708829,92,50,42,1,-1.3562618687640005,-1.170500554541026,-1.4826340357519663,-0.33156925250277336,-0.10201360987270414,0.10201360987270414,-1.4826340357519663,-1.170500554541026,0,1,0,0,-1.170500554541026,-1.4826340357519663
1461,7,22,43,110,117,1,8183.826999999998,60,2110.993,MORE,108,3642,3750,4,2,7.0,0.6561859224721414,7.0,-0.34921514788478913,0.11684605414390345,0.995290976576342,227,110,117,0,1.3363168412821769,1.170500554541026,1.4436173506005987,0.15964445490874285,0.4994595423104522,0.4994595423104522,1.4436173506005987,1.170500554541026,0,1,1,2,1.4436173506005987,1.170500554541026
1462,7,23,32,77,80,1,2979.43,70,1904.789,MORE,-214,1410,1196,3,2,3.0,0.28122253820234633,3.0,-1.0476454436543674,0.4958062297457522,-0.4574778203594653,157,77,80,0,-0.05983508244547061,-0.1170500554541026,0.0,-0.33156925250277336,0.186070618357416,0.186070618357416,0.0,-0.1170500554541026,1,0,0,1,-0.1170500554541026,0.0
1463,7,24,27,80,91,1,1699.13,80,1671.309,MORE,44,890,934,1,2,11.0,1.0311493067419364,11.0,0.34921514788478913,0.8747664053476009,-0.8148640633222743,171,80,91,0,0.21939530230005888,0.0,0.4291835366650429,-1.3139966673258057,0.43717106053096666,0.43717106053096666,0.4291835366650429,0.0,1,0,1,1,0.4291835366650429,0.0
1464,7,25,16,44,50,1,2417.411,80,1360.914,MORE,4,1174,1178,3,2,6.0,0.5624450764046927,6.0,-0.5238227218271837,0.8747664053476009,-0.614361253057829,94,44,50,0,-1.3163718138003533,-1.4046006654492311,-1.170500554541026,-0.33156925250277336,0.3982407594187883,0.3982407594187883,-1.170500554541026,-1.4046006654492311,1,0,1,0,-1.4046006654492311,-1.170500554541026
1465,7,26,7,50,57,1,4118.085,50,1405.935,MORE,322,1860,2182,3,2,7.0,0.6561859224721414,7.0,-0.34921514788478913,-0.2621141214579453,-0.13963072789612282,107,50,57,0,-1.0570864565366473,-1.170500554541026,-0.8973837584814532,-0.33156925250277336,0.7077366532606066,0.7077366532606066,-0.8973837584814532,-1.170500554541026,0,0,1,0,-1.170500554541026,-0.8973837584814532
1466,7,27,14,50,46,1,12443.438999999997,10,2199.5660000000007,MORE,-1866,6896,5030,9,1,-4.0,-0.3749633842697951,4.0,-0.8730378697119728,-1.77795482386534,2.1843300526985763,96,50,46,1,-1.2764817588367063,-1.170500554541026,-1.3265672951464962,2.615712991966324,-1.4217508175755518,1.4217508175755518,-1.3265672951464962,-1.170500554541026,0,1,0,0,-1.170500554541026,-1.3265672951464962
1467,7,28,51,110,108,1,3872.137,10,1147.383,MORE,-792,2362,1570,3,1,-2.0,-0.18748169213489754,2.0,-1.222253017596762,-1.77795482386534,-0.2082852867371889,218,110,108,1,1.156811593945765,1.170500554541026,1.092467184238291,-0.33156925250277336,-0.37647223271356184,0.37647223271356184,1.092467184238291,1.170500554541026,0,0,0,2,1.170500554541026,1.092467184238291
1468,7,29,50,133,110,1,7794.385,20,1823.72,MORE,-664,4272,3608,7,1,-23.0,-2.1560394595513217,23.0,2.444506035193524,-1.3989946482634914,0.8865811326085831,243,133,110,1,1.6554372809913533,2.0678843130224793,1.170500554541026,1.6332855771432915,-0.251895269154591,0.251895269154591,1.170500554541026,2.0678843130224793,0,1,0,2,2.0678843130224793,1.170500554541026
1469,7,30,49,131,110,0,15631.356000000002,20,1204.53,MORE,-1544,7840,6296,10,1,-21.0,-1.9685577674164243,21.0,2.0952908873087353,-1.3989946482634914,3.0742134233986236,241,131,110,1,1.6155472260277064,1.9898509427197442,1.170500554541026,3.10692669937784,-1.1083618936225157,1.1083618936225157,1.170500554541026,1.9898509427197442,0,1,0,2,1.9898509427197442,1.170500554541026
1470,7,31,47,126,110,1,15260.773,10,1834.596,MORE,-1090,7558,6468,5,1,-16.0,-1.4998535370791803,16.0,1.222253017596762,-1.77795482386534,2.9707679293145133,236,126,110,1,1.5158220886185887,1.7947675169629065,1.170500554541026,0.6508581623202591,-0.6665029759992909,0.6665029759992909,1.170500554541026,1.7947675169629065,0,1,0,2,1.7947675169629065,1.170500554541026
1471,7,32,50,110,133,1,3851.631,70,1164.59,MORE,-76,2098,2022,3,2,23.0,2.1560394595513217,23.0,2.444506035193524,0.4958062297457522,-0.2140093844472533,243,110,133,0,1.6554372809913533,1.170500554541026,2.0678843130224793,-0.33156925250277336,0.32038015719443147,0.32038015719443147,2.0678843130224793,1.170500554541026,1,1,1,2,2.0678843130224793,1.170500554541026
1472,7,33,47,110,126,1,3440.1220000000008,30,1011.76,MORE,-1052,1798,746,3,2,16.0,1.4998535370791803,16.0,1.222253017596762,-1.0200344726616426,-0.3288790676897608,236,110,126,0,1.5158220886185887,1.170500554541026,1.7947675169629065,-0.33156925250277336,-0.6295191899427214,0.6295191899427214,1.7947675169629065,1.170500554541026,0,1,0,2,1.7947675169629065,1.170500554541026
1473,7,34,12,48,50,1,2026.291,80,2726.119,MORE,1908,1034,2942,1,2,2.0,0.18748169213489754,2.0,-1.222253017596762,0.8747664053476009,-0.7235394982719302,98,48,50,0,-1.2365917038730592,-1.248533924843761,-1.170500554541026,-1.3139966673258057,2.25132309235848,2.25132309235848,-1.170500554541026,-1.248533924843761,1,0,1,0,-1.248533924843761,-1.170500554541026
1474,7,35,32,80,77,1,3003.111,40,1559.4029999999998,MORE,86,1360,1446,3,2,-3.0,-0.28122253820234633,3.0,-1.0476454436543674,-0.6410742970597939,-0.4508674449633845,157,80,77,1,-0.05983508244547061,0.0,-0.1170500554541026,-0.33156925250277336,0.478047876698754,0.478047876698754,-0.1170500554541026,0.0,0,1,1,1,0.0,-0.1170500554541026
1475,7,36,43,117,110,0,11883.827,20,2163.159,MORE,-1602,6046,4444,7,1,-7.0,-0.6561859224721414,7.0,-0.34921514788478913,-1.3989946482634914,2.028118516186116,227,117,110,1,1.3363168412821769,1.4436173506005987,1.170500554541026,1.6332855771432915,-1.1648108302351743,1.1648108302351743,1.170500554541026,1.4436173506005987,0,1,0,2,1.4436173506005987,1.170500554541026
1476,7,37,40,80,64,0,2465.224,80,1827.828,MORE,212,1700,1912,2,2,-16.0,-1.4998535370791803,16.0,1.222253017596762,0.8747664053476009,-0.6010146089628662,144,80,64,1,-0.3191204397091766,0.0,-0.6242669624218805,-0.8227829599142895,0.6006783252021161,0.6006783252021161,-0.6242669624218805,0.0,1,0,1,1,0.0,-0.6242669624218805
1477,7,38,31,80,78,1,4102.412,50,1795.226,MORE,-540,2266,1726,3,2,-2.0,-0.18748169213489754,2.0,-1.222253017596762,-0.2621141214579453,-0.1440057295253941,158,80,78,1,-0.03989005496364707,0.0,-0.07803337030273506,-0.33156925250277336,-0.13121133570683793,0.13121133570683793,-0.07803337030273506,0.0,0,1,0,1,0.0,-0.07803337030273506
1478,7,39,46,124,110,0,5583.298000000002,50,1457.862,MORE,-948,3126,2178,4,2,-14.0,-1.3123718449442827,14.0,0.8730378697119728,-0.2621141214579453,0.2693726066428656,234,124,110,1,1.4759320336549415,1.7167341466601715,1.170500554541026,0.15964445490874285,-0.5283004070510575,0.5283004070510575,1.170500554541026,1.7167341466601715,0,1,0,2,1.7167341466601715,1.170500554541026
1479,7,40,58,92,110,1,2509.03,70,1738.535,MORE,-816,2416,1600,1,1,18.0,1.6873352292140782,18.0,1.571468165481551,0.4958062297457522,-0.588786489179043,202,92,110,0,0.8376911542365885,0.4682002218164104,1.170500554541026,-1.3139966673258057,-0.3998304133808689,0.3998304133808689,1.170500554541026,0.4682002218164104,1,0,0,2,1.170500554541026,0.4682002218164104
1480,7,41,49,110,131,0,2540.528,100,1537.138,LESS,-158,1724,1566,2,2,21.0,1.9685577674164243,21.0,2.0952908873087353,1.6326867565512984,-0.5799940562486029,241,110,131,1,1.6155472260277064,1.170500554541026,1.9898509427197442,-0.8227829599142895,0.24057303991446577,0.24057303991446577,1.9898509427197442,1.170500554541026,1,0,1,2,1.9898509427197442,1.170500554541026
1481,7,42,13,47,50,0,1803.085,80,2363.957000000001,LESS,-596,1538,942,2,2,3.0,0.28122253820234633,3.0,-1.0476454436543674,0.8747664053476009,-0.7858457965979138,97,47,50,1,-1.2565367313548828,-1.2875506099951286,-1.170500554541026,-0.8227829599142895,-0.1857137572638877,0.1857137572638877,-1.170500554541026,-1.2875506099951286,1,0,1,0,-1.2875506099951286,-1.170500554541026
1482,7,43,16,50,44,0,1677.886,90,1433.72,LESS,-78,1110,1032,2,2,-6.0,-0.5624450764046927,6.0,-0.5238227218271837,1.2537265809494496,-0.8207941682551041,94,50,44,0,-1.3163718138003533,-1.170500554541026,-1.4046006654492311,-0.8227829599142895,0.3184336421388226,0.3184336421388226,-1.4046006654492311,-1.170500554541026,1,0,1,0,-1.170500554541026,-1.4046006654492311
1483,7,44,7,57,50,1,4365.371,30,1533.43,LESS,-758,2782,2024,5,1,-7.0,-0.6561859224721414,7.0,-0.34921514788478913,-1.0200344726616426,-0.07060267628532751,107,57,50,0,-1.0570864565366473,-0.8973837584814532,-1.170500554541026,0.6508581623202591,-0.34338147676821024,0.34338147676821024,-1.170500554541026,-0.8973837584814532,0,1,0,0,-0.8973837584814532,-1.170500554541026
1484,7,45,18,42,50,0,2389.2870000000007,80,844.201,LESS,-874,1550,676,2,2,8.0,0.7499267685395902,8.0,-0.17460757394239454,0.8747664053476009,-0.6222118589291761,92,42,50,1,-1.3562618687640005,-1.4826340357519663,-1.170500554541026,-0.8227829599142895,-0.4562793499935276,0.4562793499935276,-1.170500554541026,-1.4826340357519663,1,0,0,0,-1.4826340357519663,-1.170500554541026
1485,7,46,51,108,110,0,3377.805,50,1563.969,LESS,-796,1940,1144,4,1,2.0,0.18748169213489754,2.0,-1.222253017596762,-0.2621141214579453,-0.3462743957399941,218,108,110,1,1.156811593945765,1.092467184238291,1.170500554541026,0.15964445490874285,-0.38036526282477967,0.38036526282477967,1.170500554541026,1.092467184238291,0,1,0,2,1.170500554541026,1.092467184238291
1486,7,47,31,78,80,0,3784.675,50,2417.966,LESS,-1072,2286,1214,4,1,2.0,0.18748169213489754,2.0,-1.222253017596762,-0.2621141214579453,-0.23269965491809436,158,78,80,1,-0.03989005496364707,-0.07803337030273506,0.0,0.15964445490874285,-0.6489843404988106,0.6489843404988106,0.0,-0.07803337030273506,0,1,0,1,-0.07803337030273506,0.0
1487,7,48,58,110,92,1,16413.455,10,1395.507,LESS,1906,6846,8752,7,1,-18.0,-1.6873352292140782,18.0,1.571468165481551,-1.77795482386534,3.29253055472329,202,110,92,0,0.8376911542365885,1.170500554541026,0.4682002218164104,1.6332855771432915,2.249376577302871,2.249376577302871,0.4682002218164104,1.170500554541026,0,1,1,2,1.170500554541026,0.4682002218164104
1488,7,49,12,50,48,0,5827.548000000002,10,2110.696,LESS,-848,3600,2752,4,1,-2.0,-0.18748169213489754,2.0,-1.222253017596762,-1.77795482386534,0.3375531813860244,98,50,48,0,-1.2365917038730592,-1.170500554541026,-1.248533924843761,0.15964445490874285,-0.4309746542706116,0.4309746542706116,-1.248533924843761,-1.170500554541026,0,1,0,0,-1.170500554541026,-1.248533924843761
1489,7,50,54,110,101,0,12620.652,20,1629.461,LESS,1574,4990,6564,6,1,-9.0,-0.8436676146070391,9.0,0.0,-1.3989946482634914,2.2337977464220544,211,110,101,0,1.0171964015730004,1.170500554541026,0.8193503881787182,1.1420718697317753,1.9262550780717904,1.9262550780717904,0.8193503881787182,1.170500554541026,0,1,1,2,1.170500554541026,0.8193503881787182
1490,7,51,14,46,50,1,9482.994,10,1212.383,LESS,776,4370,5146,5,1,4.0,0.3749633842697951,4.0,-0.8730378697119728,-1.77795482386534,1.3579438025634267,96,46,50,1,-1.2764817588367063,-1.3265672951464962,-1.170500554541026,0.6508581623202591,1.1495955708838315,1.1495955708838315,-1.170500554541026,-1.3265672951464962,0,1,1,0,-1.3265672951464962,-1.170500554541026
1491,7,52,22,80,83,0,3521.427,60,1322.309,LESS,-1154,2240,1086,4,1,3.0,0.28122253820234633,3.0,-1.0476454436543674,0.11684605414390345,-0.30618338036328185,163,80,83,1,0.05983508244547061,0.0,0.1170500554541026,0.15964445490874285,-0.7287914577787763,0.7287914577787763,0.1170500554541026,0.0,1,1,0,1,0.1170500554541026,0.0
1492,7,53,6,50,56,0,2778.823,60,2922.806,LESS,-966,2136,1170,2,2,6.0,0.5624450764046927,6.0,-0.5238227218271837,0.11684605414390345,-0.5134757755590593,106,50,56,1,-1.077031484018471,-1.170500554541026,-0.9364004436328208,-0.8227829599142895,-0.5458190425515378,0.5458190425515378,-0.9364004436328208,-1.170500554541026,1,0,0,0,-1.170500554541026,-0.9364004436328208
1493,7,54,13,50,47,0,8080.843000000002,70,3859.423,LESS,-1980,4742,2762,6,1,-3.0,-0.28122253820234633,3.0,-1.0476454436543674,0.4958062297457522,0.9665437572954853,97,50,47,0,-1.2565367313548828,-1.170500554541026,-1.2875506099951286,1.1420718697317753,-1.5327021757452604,1.5327021757452604,-1.2875506099951286,-1.170500554541026,1,1,0,0,-1.170500554541026,-1.2875506099951286
1494,7,55,46,110,124,0,12239.264,40,2908.534,LESS,-1952,6628,4676,7,1,14.0,1.3123718449442827,14.0,0.8730378697119728,-0.6410742970597939,2.127336116779705,234,110,124,1,1.4759320336549415,1.170500554541026,1.7167341466601715,1.6332855771432915,-1.5054509649667354,1.5054509649667354,1.7167341466601715,1.170500554541026,0,1,0,2,1.7167341466601715,1.170500554541026
1495,7,56,27,91,80,0,4362.292,50,3185.823,LESS,-1202,2656,1454,4,1,-11.0,-1.0311493067419364,11.0,0.34921514788478913,-0.2621141214579453,-0.07146215628382974,171,91,80,0,0.21939530230005888,0.4291835366650429,0.0,0.15964445490874285,-0.7755078191133904,0.7755078191133904,0.0,0.4291835366650429,0,1,0,1,0.4291835366650429,0.0
1496,7,57,40,64,80,0,3057.76,80,801.8860000000002,LESS,-1314,2208,894,2,2,16.0,1.4998535370791803,16.0,1.222253017596762,0.8747664053476009,-0.435612582203348,144,64,80,1,-0.3191204397091766,-0.6242669624218805,0.0,-0.8227829599142895,-0.8845126622274899,0.8845126622274899,0.0,-0.6242669624218805,1,0,0,1,-0.6242669624218805,0.0
1497,7,58,22,83,80,0,3561.9,50,969.494,LESS,-580,1762,1182,4,1,-3.0,-0.28122253820234633,3.0,-1.0476454436543674,-0.2621141214579453,-0.2948856427928423,163,83,80,0,0.05983508244547061,0.1170500554541026,0.0,0.15964445490874285,-0.17014163681901634,0.17014163681901634,0.0,0.1170500554541026,1,1,1,1,0.1170500554541026,0.0
1498,7,59,54,101,110,0,3161.163,70,1970.956,LESS,822,1814,2636,4,2,9.0,0.8436676146070391,9.0,0.0,0.4958062297457522,-0.40674840218219416,211,101,110,1,1.0171964015730004,0.8193503881787182,1.170500554541026,0.15964445490874285,1.1943654171628366,1.1943654171628366,1.170500554541026,0.8193503881787182,1,1,1,2,1.170500554541026,0.8193503881787182
1499,7,60,6,56,50,0,11508.136,30,1104.21,LESS,-1286,6032,4746,6,1,-6.0,-0.5624450764046927,6.0,-0.5238227218271837,-1.0200344726616426,1.923247161812188,106,56,50,0,-1.077031484018471,-0.9364004436328208,-1.170500554541026,1.1420718697317753,-0.857261451448965,0.857261451448965,-1.170500554541026,-0.9364004436328208,0,1,0,0,-0.9364004436328208,-1.170500554541026
1500,7,61,18,50,42,0,10793.268,20,1507.739,LESS,-1278,5638,4360,7,1,-8.0,-0.7499267685395902,8.0,-0.17460757394239454,-1.3989946482634914,1.7236970651673875,92,50,42,0,-1.3562618687640005,-1.170500554541026,-1.4826340357519663,1.6332855771432915,-0.8494753912265294,0.8494753912265294,-1.4826340357519663,-1.170500554541026,0,1,0,0,-1.170500554541026,-1.4826340357519663
1501,7,62,43,110,117,0,2590.077,80,1764.4260000000004,LESS,-930,2256,1326,3,2,7.0,0.6561859224721414,7.0,-0.34921514788478913,0.8747664053476009,-0.5661628206377582,227,110,117,1,1.3363168412821769,1.170500554541026,1.4436173506005987,-0.33156925250277336,-0.5107817715505772,0.5107817715505772,1.4436173506005987,1.170500554541026,1,0,0,2,1.4436173506005987,1.170500554541026
1502,7,63,32,77,80,0,3393.646,50,1133.687,LESS,-670,1888,1218,3,1,3.0,0.28122253820234633,3.0,-1.0476454436543674,-0.2621141214579453,-0.3418524981575728,157,77,80,1,-0.05983508244547061,-0.1170500554541026,0.0,-0.33156925250277336,-0.25773481432141776,0.25773481432141776,0.0,-0.1170500554541026,0,0,1,1,-0.1170500554541026,0.0
1503,7,64,27,80,91,0,4699.779,80,730.933,LESS,-1132,2964,1832,3,2,11.0,1.0311493067419364,11.0,0.34921514788478913,0.8747664053476009,0.02274483502976049,171,80,91,1,0.21939530230005888,0.0,0.4291835366650429,-0.33156925250277336,-0.7073797921670782,0.7073797921670782,0.4291835366650429,0.0,1,0,0,1,0.4291835366650429,0.0
1504,7,65,16,44,50,0,2150.871,80,1347.389,LESS,330,1346,1676,2,2,6.0,0.5624450764046927,6.0,-0.5238227218271837,0.8747664053476009,-0.6887639158706909,94,44,50,1,-1.3163718138003533,-1.4046006654492311,-1.170500554541026,-0.8227829599142895,0.7155227134830423,0.7155227134830423,-1.170500554541026,-1.4046006654492311,1,0,1,0,-1.4046006654492311,-1.170500554541026
1505,7,66,7,50,57,0,3551.735,80,1210.232,LESS,74,1974,2048,3,2,7.0,0.6561859224721414,7.0,-0.34921514788478913,0.8747664053476009,-0.2977231271009864,107,50,57,1,-1.0570864565366473,-1.170500554541026,-0.8973837584814532,-0.33156925250277336,0.4663687863651005,0.4663687863651005,-0.8973837584814532,-1.170500554541026,1,0,1,0,-1.170500554541026,-0.8973837584814532
1506,7,67,14,50,46,0,10303.177,30,1133.188,LESS,-850,5172,4322,6,1,-4.0,-0.3749633842697951,4.0,-0.8730378697119728,-1.0200344726616426,1.586891799839038,96,50,46,0,-1.2764817588367063,-1.170500554541026,-1.3265672951464962,1.1420718697317753,-0.43292116932622055,0.43292116932622055,-1.3265672951464962,-1.170500554541026,0,1,0,0,-1.170500554541026,-1.3265672951464962
1507,7,68,51,110,108,0,11565.877,20,1682.711,LESS,-1072,5696,4624,6,1,-2.0,-0.18748169213489754,2.0,-1.222253017596762,-1.3989946482634914,1.9393651334242443,218,110,108,0,1.156811593945765,1.170500554541026,1.092467184238291,1.1420718697317753,-0.6489843404988106,0.6489843404988106,1.092467184238291,1.170500554541026,0,1,0,2,1.170500554541026,1.092467184238291
1508,7,69,50,133,110,1,19757.21,10,1332.93,LESS,-1132,9996,8864,7,1,-23.0,-2.1560394595513217,23.0,2.444506035193524,-1.77795482386534,4.2259149465362285,243,133,110,0,1.6554372809913533,2.0678843130224793,1.170500554541026,1.6332855771432915,-0.7073797921670782,0.7073797921670782,1.170500554541026,2.0678843130224793,0,1,0,2,2.0678843130224793,1.170500554541026
1509,7,70,49,131,110,1,4363.442,40,1315.901,LESS,-346,2480,2134,3,2,-21.0,-1.9685577674164243,21.0,2.0952908873087353,-0.6410742970597939,-0.07114114231881599,241,131,110,0,1.6155472260277064,1.9898509427197442,1.170500554541026,-0.33156925250277336,0.05760062468722729,0.05760062468722729,1.170500554541026,1.9898509427197442,0,0,1,2,1.9898509427197442,1.170500554541026
1510,7,71,47,126,110,1,8813.949,20,1096.187,LESS,160,4236,4396,7,1,-16.0,-1.4998535370791803,16.0,1.222253017596762,-1.3989946482634914,1.1711848562828262,236,126,110,0,1.5158220886185887,1.7947675169629065,1.170500554541026,1.6332855771432915,0.5500689337562841,0.5500689337562841,1.170500554541026,1.7947675169629065,0,1,1,2,1.7947675169629065,1.170500554541026
1511,7,72,50,110,133,0,4360.618,30,975.129,LESS,-552,2356,1804,4,1,23.0,2.1560394595513217,23.0,2.444506035193524,-1.0200344726616426,-0.07192944095985858,243,110,133,1,1.6554372809913533,1.170500554541026,2.0678843130224793,0.15964445490874285,-0.14289042604049146,0.14289042604049146,2.0678843130224793,1.170500554541026,0,1,1,2,2.0678843130224793,1.170500554541026
1512,7,73,47,110,126,0,3519.583,80,674.3889999999999,LESS,-1350,2486,1136,2,2,16.0,1.4998535370791803,16.0,1.222253017596762,0.8747664053476009,-0.3066981192776171,236,110,126,1,1.5158220886185887,1.170500554541026,1.7947675169629065,-0.8227829599142895,-0.9195499332284505,0.9195499332284505,1.7947675169629065,1.170500554541026,1,0,0,2,1.7947675169629065,1.170500554541026
1513,7,74,12,48,50,0,5913.826,50,1751.437,LESS,-740,3096,2356,6,1,2.0,0.18748169213489754,2.0,-1.222253017596762,-0.2621141214579453,0.3616370447542542,98,48,50,1,-1.2365917038730592,-1.248533924843761,-1.170500554541026,1.1420718697317753,-0.32586284126772996,0.32586284126772996,-1.170500554541026,-1.248533924843761,1,1,0,0,-1.248533924843761,-1.170500554541026
1514,7,75,32,80,77,0,2326.993,80,1575.891,LESS,210,1584,1794,2,2,-3.0,-0.28122253820234633,3.0,-1.0476454436543674,0.8747664053476009,-0.6396007667001091,157,80,77,0,-0.05983508244547061,0.0,-0.1170500554541026,-0.8227829599142895,0.5987318101465071,0.5987318101465071,-0.1170500554541026,0.0,1,0,1,1,0.0,-0.1170500554541026
1515,7,76,43,117,110,0,10471.065,20,893.3839999999999,LESS,-5722,7816,2094,4,1,-7.0,-0.6561859224721414,7.0,-0.34921514788478913,-1.3989946482634914,1.6337564890201208,227,117,110,0,1.3363168412821769,1.4436173506005987,1.170500554541026,0.15964445490874285,-5.174631844789549,5.174631844789549,1.170500554541026,1.4436173506005987,0,1,0,2,1.4436173506005987,1.170500554541026
1516,7,77,40,80,64,1,3836.047,40,2492.894,LESS,-570,2046,1476,5,2,-16.0,-1.4998535370791803,16.0,1.222253017596762,-0.6410742970597939,-0.21835954238705832,144,80,64,0,-0.3191204397091766,0.0,-0.6242669624218805,0.6508581623202591,-0.16040906154097173,0.16040906154097173,-0.6242669624218805,0.0,0,1,1,1,0.0,-0.6242669624218805
1517,7,78,31,80,78,0,3412.04,30,1692.656,LESS,-2122,3142,1020,4,1,-2.0,-0.18748169213489754,2.0,-1.222253017596762,-1.0200344726616426,-0.3367179495728209,158,80,78,0,-0.03989005496364707,0.0,-0.07803337030273506,0.15964445490874285,-1.6709047446934935,1.6709047446934935,-0.07803337030273506,0.0,0,1,0,1,0.0,-0.07803337030273506
1518,7,79,46,124,110,1,10925.699,40,966.459,LESS,-2170,6080,3910,6,2,-14.0,-1.3123718449442827,14.0,0.8730378697119728,-0.6410742970597939,1.7606641959506482,234,124,110,0,1.4759320336549415,1.7167341466601715,1.170500554541026,1.1420718697317753,-1.7176211060281077,1.7176211060281077,1.170500554541026,1.7167341466601715,0,1,0,2,1.7167341466601715,1.170500554541026
1519,7,80,58,92,110,0,7813.467,60,1725.102,LESS,-3462,5352,1890,4,1,18.0,1.6873352292140782,18.0,1.571468165481551,0.11684605414390345,0.8919077312871867,202,92,110,1,0.8376911542365885,0.4682002218164104,1.170500554541026,0.15964445490874285,-2.97506983195147,2.97506983195147,1.170500554541026,0.4682002218164104,1,1,0,2,1.170500554541026,0.4682002218164104
1520,7,81,48,128,110,0,4146.132000000001,70,1034.434,MORE,202,2106,2308,4,2,-18.0,-1.6873352292140782,18.0,1.571468165481551,0.4958062297457522,-0.13180161600330206,238,128,110,1,1.5557121435822359,1.8728008872656416,1.170500554541026,0.15964445490874285,0.5909457499240715,0.5909457499240715,1.170500554541026,1.8728008872656416,1,1,1,2,1.8728008872656416,1.170500554541026
1521,7,82,8,50,58,1,5066.16,80,1168.707,MORE,-1188,3198,2010,3,2,8.0,0.7499267685395902,8.0,-0.17460757394239454,0.8747664053476009,0.12501737199996804,108,50,58,0,-1.0371414290548238,-1.170500554541026,-0.8583670733300858,-0.33156925250277336,-0.7618822137241279,0.7618822137241279,-0.8583670733300858,-1.170500554541026,1,1,0,0,-1.170500554541026,-0.8583670733300858
1522,7,83,4,54,50,1,2065.108,70,1846.702,MORE,340,676,1016,1,2,-4.0,-0.3749633842697951,4.0,-0.8730378697119728,0.4958062297457522,-0.7127040208111105,104,54,50,1,-1.116921538982118,-1.0144338139355558,-1.170500554541026,-1.3139966673258057,0.7252552887610869,0.7252552887610869,-1.170500554541026,-1.0144338139355558,1,0,1,0,-1.0144338139355558,-1.170500554541026
1523,7,84,37,80,69,0,2471.3520000000008,70,1855.221,MORE,-1408,1984,576,2,1,-11.0,-1.0311493067419364,11.0,0.34921514788478913,0.4958062297457522,-0.5993040232432095,149,80,69,1,-0.21939530230005888,0.0,-0.4291835366650429,-0.8227829599142895,-0.9759988698411092,0.9759988698411092,-0.4291835366650429,0.0,1,0,0,1,0.0,-0.4291835366650429
1524,7,85,52,105,110,0,14248.641,20,1614.264,MORE,-1334,7486,6152,10,1,5.0,0.4687042303372438,5.0,-0.6984302957695783,-1.3989946482634914,2.688238793281994,215,105,110,0,1.0969765115002945,0.9754171287841883,1.170500554541026,3.10692669937784,-0.9039778127835791,0.9039778127835791,1.170500554541026,0.9754171287841883,0,1,0,2,1.170500554541026,0.9754171287841883
1525,7,86,5,55,50,0,7423.446999999999,40,1600.186,MORE,-1752,4216,2464,5,1,-5.0,-0.4687042303372438,5.0,-0.6984302957695783,-0.6410742970597939,0.7830365429091855,105,55,50,1,-1.0969765115002945,-0.9754171287841883,-1.170500554541026,0.6508581623202591,-1.3107994594058434,1.3107994594058434,-1.170500554541026,-0.9754171287841883,0,1,0,0,-0.9754171287841883,-1.170500554541026
1526,7,87,30,96,80,1,5118.518,40,938.655,MORE,-814,2668,1854,5,2,-16.0,-1.4998535370791803,16.0,1.222253017596762,-0.6410742970597939,0.1396327191131812,176,96,80,1,0.3191204397091766,0.6242669624218805,0.0,0.6508581623202591,-0.39788389832526,0.39788389832526,0.0,0.6242669624218805,0,1,0,1,0.6242669624218805,0.0
1527,7,88,33,80,75,1,7975.717,80,1354.626,MORE,-66,3798,3732,7,2,-5.0,-0.4687042303372438,5.0,-0.6984302957695783,0.8747664053476009,0.9371986146119666,155,80,75,1,-0.09972513740911768,0.0,-0.19508342575683765,1.6332855771432915,0.3301127324724761,0.3301127324724761,-0.19508342575683765,0.0,1,1,1,1,0.0,-0.19508342575683765
1528,7,89,48,110,128,1,12748.498,70,1113.254,MORE,1028,5348,6376,5,2,18.0,1.6873352292140782,18.0,1.571468165481551,0.4958062297457522,2.269485008483933,238,110,128,0,1.5557121435822359,1.170500554541026,1.8728008872656416,0.6508581623202591,1.3948564678905553,1.3948564678905553,1.8728008872656416,1.170500554541026,0,1,1,2,1.8728008872656416,1.170500554541026
1529,7,90,9,59,50,1,1561.601,80,1587.999,MORE,534,594,1128,1,2,-9.0,-0.8436676146070391,9.0,0.0,0.8747664053476009,-0.8532542629695696,109,59,50,1,-1.0171964015730004,-0.8193503881787182,-1.170500554541026,-1.3139966673258057,0.9140672491551521,0.9140672491551521,-1.170500554541026,-0.8193503881787182,1,0,1,0,-0.8193503881787182,-1.170500554541026
1530,7,91,44,110,119,1,2412.444,90,760.7539999999998,MORE,132,1162,1294,3,2,9.0,0.8436676146070391,9.0,0.0,1.2537265809494496,-0.6157477542441105,229,110,119,0,1.376206896245824,1.170500554541026,1.5216507209033339,-0.33156925250277336,0.5228177229777592,0.5228177229777592,1.5216507209033339,1.170500554541026,1,1,1,2,1.5216507209033339,1.170500554541026
1531,7,92,2,52,50,0,4049.958,30,1714.741,MORE,-870,2292,1422,4,1,-2.0,-0.18748169213489754,2.0,-1.222253017596762,-1.0200344726616426,-0.15864787432612146,102,52,50,1,-1.156811593945765,-1.092467184238291,-1.170500554541026,0.15964445490874285,-0.45238631988230976,0.45238631988230976,-1.170500554541026,-1.092467184238291,0,1,0,0,-1.092467184238291,-1.170500554541026
1532,7,93,8,58,50,0,6057.979,40,1285.614,MORE,-472,2962,2490,6,1,-8.0,-0.7499267685395902,8.0,-0.17460757394239454,-0.6410742970597939,0.40187628484002935,108,58,50,1,-1.0371414290548238,-0.8583670733300858,-1.170500554541026,1.1420718697317753,-0.06502982381613466,0.06502982381613466,-1.170500554541026,-0.8583670733300858,0,1,0,0,-0.8583670733300858,-1.170500554541026
1533,7,94,44,119,110,1,5368.815,60,1295.725,MORE,760,2220,2980,5,2,-9.0,-0.8436676146070391,9.0,0.0,0.11684605414390345,0.2095012690271561,229,119,110,1,1.376206896245824,1.5216507209033339,1.170500554541026,0.6508581623202591,1.1340234504389601,1.1340234504389601,1.170500554541026,1.5216507209033339,0,1,1,2,1.5216507209033339,1.170500554541026
1534,7,95,34,74,80,1,2718.774000000001,70,1072.487,MORE,346,1142,1488,3,2,6.0,0.5624450764046927,6.0,-0.5238227218271837,0.4958062297457522,-0.5302380082417691,154,74,80,0,-0.11967016489094122,-0.2341001109082052,0.0,-0.33156925250277336,0.7310948339279136,0.7310948339279136,0.0,-0.2341001109082052,1,0,1,1,-0.2341001109082052,0.0
1535,7,96,24,86,80,1,4263.372,50,1245.65,MORE,42,1970,2012,3,2,-6.0,-0.5624450764046927,6.0,-0.5238227218271837,-0.2621141214579453,-0.0990749401265862,166,86,80,1,0.11967016489094122,0.2341001109082052,0.0,-0.33156925250277336,0.43522454547535777,0.43522454547535777,0.0,0.2341001109082052,0,0,1,1,0.2341001109082052,0.0
1536,7,97,39,66,80,1,1263.261,80,1406.108,MORE,820,550,1370,1,2,14.0,1.3123718449442827,14.0,0.8730378697119728,0.8747664053476009,-0.9365336597715102,146,66,80,0,-0.2792303847455295,-0.5462335921191455,0.0,-1.3139966673258057,1.1924189021072278,1.1924189021072278,0.0,-0.5462335921191455,1,0,1,1,-0.5462335921191455,0.0
1537,7,98,9,50,59,1,1384.323,80,1985.567,MORE,2004,582,2586,1,2,9.0,0.8436676146070391,9.0,0.0,0.8747664053476009,-0.9027401009606348,109,50,59,0,-1.0171964015730004,-1.170500554541026,-0.8193503881787182,-1.3139966673258057,2.344755815027708,2.344755815027708,-0.8193503881787182,-1.170500554541026,1,0,1,0,-1.170500554541026,-0.8193503881787182
1538,7,99,57,94,110,1,3093.112,70,894.3660000000001,MORE,446,1424,1870,3,2,16.0,1.4998535370791803,16.0,1.222253017596762,0.4958062297457522,-0.4257443337762441,204,94,110,0,0.8775812092002355,0.5462335921191455,1.170500554541026,-0.33156925250277336,0.8284205867083596,0.8284205867083596,1.170500554541026,0.5462335921191455,1,0,1,2,1.170500554541026,0.5462335921191455
1539,7,100,60,110,87,0,4106.6579999999985,60,1591.075,MORE,-606,2354,1748,5,2,-23.0,-2.1560394595513217,23.0,2.444506035193524,0.11684605414390345,-0.1428204901380478,197,110,87,1,0.7379660168274708,1.170500554541026,0.27311679605957273,0.6508581623202591,-0.1954463325419323,0.1954463325419323,0.27311679605957273,1.170500554541026,0,1,0,2,1.170500554541026,0.27311679605957273
1540,7,101,33,75,80,1,8186.085,30,1436.178,MORE,274,3598,3872,7,2,5.0,0.4687042303372438,5.0,-0.6984302957695783,-1.0200344726616426,0.9959212805180826,155,75,80,0,-0.09972513740911768,-0.19508342575683765,0.0,1.6332855771432915,0.6610202919259925,0.6610202919259925,0.0,-0.19508342575683765,0,1,1,1,-0.19508342575683765,0.0
1541,7,102,15,50,45,1,13449.288,20,1104.007,MORE,-1562,6862,5300,11,2,-5.0,-0.4687042303372438,5.0,-0.6984302957695783,-1.3989946482634914,2.4651053359118067,95,50,45,1,-1.2964267863185297,-1.170500554541026,-1.3655839802978638,3.5981404067893563,-1.125880529122996,1.125880529122996,-1.3655839802978638,-1.170500554541026,0,1,0,0,-1.170500554541026,-1.3655839802978638
1542,7,103,59,89,110,1,3480.991,50,1142.065,MORE,-556,1854,1298,3,2,21.0,1.9685577674164243,21.0,2.0952908873087353,-0.2621141214579453,-0.3174707896583253,199,89,110,0,0.7778560717911179,0.3511501663623078,1.170500554541026,-0.33156925250277336,-0.1467834561517093,0.1467834561517093,1.170500554541026,0.3511501663623078,0,0,0,2,1.170500554541026,0.3511501663623078
1543,7,104,29,80,94,1,3189.641,70,1235.786,MORE,988,1470,2458,3,2,14.0,1.3123718449442827,14.0,0.8730378697119728,0.4958062297457522,-0.39879897983813817,174,80,94,0,0.2792303847455295,0.0,0.5462335921191455,-0.33156925250277336,1.3559261667783769,1.3559261667783769,0.5462335921191455,0.0,1,0,1,1,0.5462335921191455,0.0
1544,7,105,55,110,98,0,2569.138,90,1123.823,MORE,-120,1572,1452,2,2,-12.0,-1.124890152809385,12.0,0.5238227218271837,1.2537265809494496,-0.5720077870842148,208,110,98,1,0.9573613191275298,1.170500554541026,0.7023003327246156,-0.8227829599142895,0.27755682597103526,0.27755682597103526,0.7023003327246156,1.170500554541026,1,0,0,2,1.170500554541026,0.7023003327246156
1545,7,106,29,94,80,0,13104.227,20,1359.0,MORE,-1998,6844,4846,8,1,-14.0,-1.3123718449442827,14.0,0.8730378697119728,-1.3989946482634914,2.3687841187103778,174,94,80,1,0.2792303847455295,0.5462335921191455,0.0,2.1244992845548074,-1.5502208112457405,1.5502208112457405,0.0,0.5462335921191455,0,1,0,1,0.5462335921191455,0.0
1546,7,107,57,110,94,0,2316.53,80,751.564,MORE,-372,1462,1090,2,2,-16.0,-1.4998535370791803,16.0,1.222253017596762,0.8747664053476009,-0.6425214354965785,204,110,94,1,0.8775812092002355,1.170500554541026,0.5462335921191455,-0.8227829599142895,0.032295928964311334,0.032295928964311334,0.5462335921191455,1.170500554541026,1,0,0,2,1.170500554541026,0.5462335921191455
1547,7,108,39,80,66,0,2093.2870000000007,70,1068.941,MORE,-40,1360,1320,2,2,-14.0,-1.3123718449442827,14.0,0.8730378697119728,0.4958062297457522,-0.7048380620979581,146,80,66,1,-0.2792303847455295,0.0,-0.5462335921191455,-0.8227829599142895,0.35541742819539207,0.35541742819539207,-0.5462335921191455,0.0,1,0,1,1,0.0,-0.5462335921191455
1548,7,109,4,50,54,0,4197.348,30,2314.072,MORE,-746,2218,1472,4,1,4.0,0.3749633842697951,4.0,-0.8730378697119728,-1.0200344726616426,-0.11750504971447702,104,50,54,0,-1.116921538982118,-1.170500554541026,-1.0144338139355558,0.15964445490874285,-0.3317023864345567,0.3317023864345567,-1.0144338139355558,-1.170500554541026,0,1,0,0,-1.170500554541026,-1.0144338139355558
1549,7,110,55,98,110,1,1885.133,80,3219.39,MORE,324,1668,1992,3,2,12.0,1.124890152809385,12.0,0.5238227218271837,0.8747664053476009,-0.762942706335778,208,98,110,0,0.9573613191275298,0.7023003327246156,1.170500554541026,-0.33156925250277336,0.7096831683162156,0.7096831683162156,1.170500554541026,0.7023003327246156,1,0,1,2,1.170500554541026,0.7023003327246156
1550,7,111,2,50,52,1,2367.676,40,2105.6220000000008,MORE,-432,1642,1210,3,1,2.0,0.18748169213489754,2.0,-1.222253017596762,-0.6410742970597939,-0.6282444091882322,102,50,52,0,-1.156811593945765,-1.170500554541026,-1.092467184238291,-0.33156925250277336,-0.026099522703956265,0.026099522703956265,-1.092467184238291,-1.170500554541026,0,0,0,0,-1.170500554541026,-1.092467184238291
1551,7,112,59,110,89,0,2318.676,50,1189.63,MORE,-472,1436,964,3,2,-21.0,-1.9685577674164243,21.0,2.0952908873087353,-0.2621141214579453,-0.6419223955236049,199,110,89,1,0.7778560717911179,1.170500554541026,0.3511501663623078,-0.33156925250277336,-0.06502982381613466,0.06502982381613466,0.3511501663623078,1.170500554541026,0,0,0,2,1.170500554541026,0.3511501663623078
1552,7,113,60,87,110,1,2718.215,60,1179.095,MORE,-142,1256,1114,3,2,23.0,2.1560394595513217,23.0,2.444506035193524,0.11684605414390345,-0.5303940489430239,197,87,110,0,0.7379660168274708,0.27311679605957273,1.170500554541026,-0.33156925250277336,0.25614516035933715,0.25614516035933715,1.170500554541026,0.27311679605957273,0,0,0,2,1.170500554541026,0.27311679605957273
1553,7,114,52,110,105,0,4299.052,60,1130.079,MORE,-790,2336,1546,4,1,-5.0,-0.4687042303372438,5.0,-0.6984302957695783,0.11684605414390345,-0.08911513293380888,215,110,105,1,1.0969765115002945,1.170500554541026,0.9754171287841883,0.15964445490874285,-0.37452571765795295,0.37452571765795295,0.9754171287841883,1.170500554541026,0,1,0,2,1.170500554541026,0.9754171287841883
1554,7,115,30,80,96,1,4727.753,80,1938.915,MORE,-2060,3524,1464,1,2,16.0,1.4998535370791803,16.0,1.222253017596762,0.8747664053476009,0.03055356951436672,176,80,96,0,0.3191204397091766,0.0,0.6242669624218805,-1.3139966673258057,-1.610562777969617,1.610562777969617,0.6242669624218805,0.0,1,0,0,1,0.6242669624218805,0.0
1555,7,116,24,80,86,1,2908.156,80,828.1289999999998,MORE,294,1364,1658,3,2,6.0,0.5624450764046927,6.0,-0.5238227218271837,0.8747664053476009,-0.4773734284832888,166,80,86,0,0.11967016489094122,0.0,0.2341001109082052,-0.33156925250277336,0.6804854424820818,0.6804854424820818,0.2341001109082052,0.0,1,0,1,1,0.2341001109082052,0.0
1556,7,117,5,50,55,1,1443.693,80,1463.03,MORE,700,590,1290,1,2,5.0,0.4687042303372438,5.0,-0.6984302957695783,0.8747664053476009,-0.886167406088572,105,50,55,0,-1.0969765115002945,-1.170500554541026,-0.9754171287841883,-1.3139966673258057,1.0756279987706925,1.0756279987706925,-0.9754171287841883,-1.170500554541026,1,0,1,0,-1.170500554541026,-0.9754171287841883
1557,7,118,34,80,74,0,2914.18,50,1059.379,MORE,-782,1770,988,4,1,-6.0,-0.5624450764046927,6.0,-0.5238227218271837,-0.2621141214579453,-0.4756918735917728,154,80,74,1,-0.11967016489094122,0.0,-0.2341001109082052,0.15964445490874285,-0.36673965743551723,0.36673965743551723,-0.2341001109082052,0.0,0,1,0,1,0.0,-0.2341001109082052
1558,7,119,15,45,50,1,5322.768,80,1392.804,MORE,1434,2172,3606,5,2,5.0,0.4687042303372438,5.0,-0.6984302957695783,0.8747664053476009,0.19664759072542345,95,45,50,0,-1.2964267863185297,-1.3655839802978638,-1.170500554541026,0.6508581623202591,1.7899990241791661,1.7899990241791661,-1.170500554541026,-1.3655839802978638,1,1,1,0,-1.3655839802978638,-1.170500554541026
1559,7,120,37,69,80,1,2847.647,100,1951.381,MORE,1682,1460,3142,2,2,11.0,1.0311493067419364,11.0,0.34921514788478913,1.6326867565512984,-0.4942640667520045,149,69,80,0,-0.21939530230005888,-0.4291835366650429,0.0,-0.8227829599142895,2.031366891074672,2.031366891074672,0.0,-0.4291835366650429,1,0,1,1,-0.4291835366650429,0.0
1560,7,121,48,128,110,1,5965.564,10,1197.907,LESS,-380,2800,2420,5,1,-18.0,-1.6873352292140782,18.0,1.571468165481551,-1.77795482386534,0.3760793234689382,238,128,110,0,1.5557121435822359,1.8728008872656416,1.170500554541026,0.6508581623202591,0.024509868741875655,0.024509868741875655,1.170500554541026,1.8728008872656416,0,1,1,2,1.8728008872656416,1.170500554541026
1561,7,122,8,50,58,0,3822.554,50,1582.4029999999998,LESS,-772,2238,1466,5,1,8.0,0.7499267685395902,8.0,-0.17460757394239454,-0.2621141214579453,-0.22212601319569472,108,50,58,1,-1.0371414290548238,-1.170500554541026,-0.8583670733300858,0.6508581623202591,-0.3570070821574727,0.3570070821574727,-0.8583670733300858,-1.170500554541026,1,1,0,0,-1.170500554541026,-0.8583670733300858
1562,7,123,4,54,50,1,4079.596,0,2677.711,LESS,-890,3020,2130,3,1,-4.0,-0.3749633842697951,4.0,-0.8730378697119728,-2.156914999467189,-0.15037464659126892,104,54,50,0,-1.116921538982118,-1.0144338139355558,-1.170500554541026,-0.33156925250277336,-0.4718514704383989,0.4718514704383989,-1.170500554541026,-1.0144338139355558,0,0,0,0,-1.0144338139355558,-1.170500554541026
1563,7,124,37,80,69,1,9497.507,10,1380.5839999999996,LESS,68,4822,4890,7,1,-11.0,-1.0311493067419364,11.0,0.34921514788478913,-1.77795482386534,1.3619949988019011,149,80,69,0,-0.21939530230005888,0.0,-0.4291835366650429,1.6332855771432915,0.4605292411982737,0.4605292411982737,-0.4291835366650429,0.0,0,1,1,1,0.0,-0.4291835366650429
1564,7,125,52,105,110,0,6977.5909999999985,50,1322.615,LESS,-1124,3584,2460,3,1,5.0,0.4687042303372438,5.0,-0.6984302957695783,-0.2621141214579453,0.6585791495307378,215,105,110,1,1.0969765115002945,0.9754171287841883,1.170500554541026,-0.33156925250277336,-0.6995937319446425,0.6995937319446425,1.170500554541026,0.9754171287841883,0,0,0,2,1.170500554541026,0.9754171287841883
1565,7,126,5,55,50,0,2314.086,70,821.887,LESS,-1088,1708,620,2,2,-5.0,-0.4687042303372438,5.0,-0.6984302957695783,0.4958062297457522,-0.6432036599578776,105,55,50,0,-1.0969765115002945,-0.9754171287841883,-1.170500554541026,-0.8227829599142895,-0.6645564609436819,0.6645564609436819,-1.170500554541026,-0.9754171287841883,1,0,0,0,-0.9754171287841883,-1.170500554541026
1566,7,127,30,96,80,1,2606.052,80,1823.061,LESS,874,1266,2140,3,2,-16.0,-1.4998535370791803,16.0,1.222253017596762,0.8747664053476009,-0.5617035179498485,176,96,80,0,0.3191204397091766,0.6242669624218805,0.0,-0.33156925250277336,1.2449748086086685,1.2449748086086685,0.0,0.6242669624218805,1,0,1,1,0.6242669624218805,0.0
1567,7,128,33,80,75,0,1906.373,60,1061.419,LESS,-224,1236,1012,3,2,-5.0,-0.4687042303372438,5.0,-0.6984302957695783,0.11684605414390345,-0.7570137179732612,155,80,75,0,-0.09972513740911768,0.0,-0.19508342575683765,-0.33156925250277336,0.1763380430793714,0.1763380430793714,-0.19508342575683765,0.0,1,0,1,1,0.0,-0.19508342575683765
1568,7,129,48,110,128,1,3149.876,10,1667.0410000000004,LESS,-506,2076,1570,3,1,18.0,1.6873352292140782,18.0,1.571468165481551,-1.77795482386534,-0.4098990844631605,238,110,128,1,1.5557121435822359,1.170500554541026,1.8728008872656416,-0.33156925250277336,-0.0981205797614863,0.0981205797614863,1.8728008872656416,1.170500554541026,0,0,1,2,1.8728008872656416,1.170500554541026
1569,7,130,9,59,50,1,1323.84,10,4525.71,LESS,-1068,1810,742,1,1,-9.0,-0.8436676146070391,9.0,0.0,-1.77795482386534,-0.9196234815223154,109,59,50,0,-1.0171964015730004,-0.8193503881787182,-1.170500554541026,-1.3139966673258057,-0.6450913103875927,0.6450913103875927,-1.170500554541026,-0.8193503881787182,0,0,0,0,-0.8193503881787182,-1.170500554541026
1570,7,131,44,110,119,0,2000.422,90,1720.9879999999996,LESS,-114,1454,1340,2,2,9.0,0.8436676146070391,9.0,0.0,1.2537265809494496,-0.7307606376292721,229,110,119,1,1.376206896245824,1.170500554541026,1.5216507209033339,-0.8227829599142895,0.28339637113786204,0.28339637113786204,1.5216507209033339,1.170500554541026,1,0,1,2,1.5216507209033339,1.170500554541026
1571,7,132,2,52,50,1,5809.339,10,1357.771,LESS,-650,2850,2200,4,1,-2.0,-0.18748169213489754,2.0,-1.222253017596762,-1.77795482386534,0.3324702741782524,102,52,50,0,-1.156811593945765,-1.092467184238291,-1.170500554541026,0.15964445490874285,-0.23826966376532854,0.23826966376532854,-1.170500554541026,-1.092467184238291,0,1,1,0,-1.092467184238291,-1.170500554541026
1572,7,133,8,58,50,1,11412.856000000002,20,1323.549,LESS,-872,5518,4646,9,2,-8.0,-0.7499267685395902,8.0,-0.17460757394239454,-1.3989946482634914,1.8966504569543448,108,58,50,0,-1.0371414290548238,-0.8583670733300858,-1.170500554541026,2.615712991966324,-0.45433283493791865,0.45433283493791865,-1.170500554541026,-0.8583670733300858,0,1,0,0,-0.8583670733300858,-1.170500554541026
1573,7,134,44,119,110,0,4894.394,30,1349.78,LESS,-1674,3058,1384,4,1,-9.0,-0.8436676146070391,9.0,0.0,-1.0200344726616426,0.07707016790034317,229,119,110,0,1.376206896245824,1.5216507209033339,1.170500554541026,0.15964445490874285,-1.2348853722370956,1.2348853722370956,1.170500554541026,1.5216507209033339,0,1,0,2,1.5216507209033339,1.170500554541026
1574,7,135,34,74,80,0,1918.664,100,952.38,LESS,12,1316,1328,3,2,6.0,0.5624450764046927,6.0,-0.5238227218271837,1.6326867565512984,-0.7535827765437091,154,74,80,1,-0.11967016489094122,-0.2341001109082052,0.0,-0.33156925250277336,0.40602681964122395,0.40602681964122395,0.0,-0.2341001109082052,1,0,1,1,-0.2341001109082052,0.0
1575,7,136,24,86,80,1,16962.564,10,1101.78,LESS,-2554,9216,6662,10,1,-6.0,-0.5624450764046927,6.0,-0.5238227218271837,-1.77795482386534,3.445810256736149,166,86,80,0,0.11967016489094122,0.2341001109082052,0.0,3.10692669937784,-2.0913519967050203,2.0913519967050203,0.0,0.2341001109082052,0,1,0,1,0.2341001109082052,0.0
1576,7,137,39,66,80,0,2624.68,50,1527.7620000000004,LESS,68,1446,1514,4,2,14.0,1.3123718449442827,14.0,0.8730378697119728,-0.2621141214579453,-0.5565036500017808,146,66,80,1,-0.2792303847455295,-0.5462335921191455,0.0,0.15964445490874285,0.4605292411982737,0.4605292411982737,0.0,-0.5462335921191455,0,1,1,1,-0.5462335921191455,0.0
1577,7,138,9,50,59,0,1981.838,80,778.637,LESS,-724,1416,692,2,2,9.0,0.8436676146070391,9.0,0.0,0.8747664053476009,-0.7359482233038961,109,50,59,1,-1.0171964015730004,-1.170500554541026,-0.8193503881787182,-0.8227829599142895,-0.3102907208228586,0.3102907208228586,-0.8193503881787182,-1.170500554541026,1,0,0,0,-1.170500554541026,-0.8193503881787182
1578,7,139,57,94,110,0,1826.308,100,1206.331,LESS,190,1212,1402,2,2,16.0,1.4998535370791803,16.0,1.222253017596762,1.6326867565512984,-0.7793632685026819,204,94,110,1,0.8775812092002355,0.5462335921191455,1.170500554541026,-0.8227829599142895,0.5792666595904179,0.5792666595904179,1.170500554541026,0.5462335921191455,1,0,1,2,1.170500554541026,0.5462335921191455
1579,7,140,60,110,87,1,2720.901,80,1179.662,LESS,1212,1158,2370,3,2,-23.0,-2.1560394595513217,23.0,2.444506035193524,0.8747664053476009,-0.529644271977783,197,110,87,0,0.7379660168274708,1.170500554541026,0.27311679605957273,-0.33156925250277336,1.573935853006576,1.573935853006576,0.27311679605957273,1.170500554541026,1,0,1,2,1.170500554541026,0.27311679605957273
1580,7,141,33,75,80,0,7352.448,40,1132.214,LESS,-208,3434,3226,7,1,5.0,0.4687042303372438,5.0,-0.6984302957695783,-0.6410742970597939,0.7632176989943873,155,75,80,1,-0.09972513740911768,-0.19508342575683765,0.0,1.6332855771432915,0.19191016352424278,0.19191016352424278,0.0,-0.19508342575683765,0,1,1,1,-0.19508342575683765,0.0
1581,7,142,15,50,45,1,7470.791999999998,10,1117.349,LESS,372,3154,3526,7,1,-5.0,-0.4687042303372438,5.0,-0.6984302957695783,-1.77795482386534,0.7962525482775159,95,50,45,0,-1.2964267863185297,-1.170500554541026,-1.3655839802978638,1.6332855771432915,0.7563995296508296,0.7563995296508296,-1.3655839802978638,-1.170500554541026,0,1,1,0,-1.170500554541026,-1.3655839802978638
1582,7,143,59,89,110,0,1978.485,90,1192.351,LESS,298,1186,1484,2,2,21.0,1.9685577674164243,21.0,2.0952908873087353,1.2537265809494496,-0.7368841883688452,199,89,110,1,0.7778560717911179,0.3511501663623078,1.170500554541026,-0.8227829599142895,0.6843784725932995,0.6843784725932995,1.170500554541026,0.3511501663623078,1,0,1,2,1.170500554541026,0.3511501663623078
1583,7,144,29,80,94,0,1912.798,90,1395.9720000000002,LESS,148,1398,1546,3,2,14.0,1.3123718449442827,14.0,0.8730378697119728,1.2537265809494496,-0.7552202269078578,174,80,94,1,0.2792303847455295,0.0,0.5462335921191455,-0.33156925250277336,0.5383898434226306,0.5383898434226306,0.5462335921191455,0.0,1,0,1,1,0.5462335921191455,0.0
1584,7,145,55,110,98,1,12046.813999999997,30,7237.475,LESS,2228,5648,7876,8,1,-12.0,-1.124890152809385,12.0,0.5238227218271837,-1.0200344726616426,2.0736151275910824,208,110,98,0,0.9573613191275298,1.170500554541026,0.7023003327246156,2.1244992845548074,2.562765501255907,2.562765501255907,0.7023003327246156,1.170500554541026,0,1,1,2,1.170500554541026,0.7023003327246156
1585,7,146,29,94,80,0,3841.352,10,1025.693,LESS,-1426,2642,1216,4,1,-14.0,-1.3123718449442827,14.0,0.8730378697119728,-1.77795482386534,-0.21687869100932056,174,94,80,0,0.2792303847455295,0.5462335921191455,0.0,0.15964445490874285,-0.9935175053415894,0.9935175053415894,0.0,0.5462335921191455,0,1,0,1,0.5462335921191455,0.0
1586,7,147,57,110,94,1,3467.74,70,2409.044,LESS,618,1450,2068,3,2,-16.0,-1.4998535370791803,16.0,1.222253017596762,0.4958062297457522,-0.3211697079630197,204,110,94,0,0.8775812092002355,1.170500554541026,0.5462335921191455,-0.33156925250277336,0.9958208814907268,0.9958208814907268,0.5462335921191455,1.170500554541026,1,0,1,2,1.170500554541026,0.5462335921191455
1587,7,148,39,80,66,1,12776.036,30,1815.827,LESS,-958,6318,5360,11,2,-14.0,-1.3123718449442827,14.0,0.8730378697119728,-1.0200344726616426,2.2771720368044126,146,80,66,0,-0.2792303847455295,0.0,-0.5462335921191455,3.5981404067893563,-0.5380329823291021,0.5380329823291021,-0.5462335921191455,0.0,0,1,0,1,0.0,-0.5462335921191455
1588,7,149,4,50,54,0,2286.018,80,686.633,LESS,-576,1538,962,2,2,4.0,0.3749633842697951,4.0,-0.8730378697119728,0.8747664053476009,-0.6510386338448416,104,50,54,1,-1.116921538982118,-1.170500554541026,-1.0144338139355558,-0.8227829599142895,-0.1662486067077985,0.1662486067077985,-1.0144338139355558,-1.170500554541026,1,0,1,0,-1.170500554541026,-1.0144338139355558
1589,7,150,55,98,110,0,5683.752,70,1878.777,LESS,-728,2408,1680,3,2,12.0,1.124890152809385,12.0,0.5238227218271837,0.4958062297457522,0.2974135952006924,208,98,110,1,0.9573613191275298,0.7023003327246156,1.170500554541026,-0.33156925250277336,-0.3141837509340764,0.3141837509340764,1.170500554541026,0.7023003327246156,1,0,0,2,1.170500554541026,0.7023003327246156
1590,7,151,2,50,52,1,2816.8340000000007,70,2315.8,LESS,24,1152,1176,2,2,2.0,0.18748169213489754,2.0,-1.222253017596762,0.4958062297457522,-0.5028652870163275,102,50,52,1,-1.156811593945765,-1.170500554541026,-1.092467184238291,-0.8227829599142895,0.4177059099748775,0.4177059099748775,-1.092467184238291,-1.170500554541026,1,0,1,0,-1.170500554541026,-1.092467184238291
1591,7,152,59,110,89,1,2519.755,80,1278.614,LESS,496,1248,1744,3,2,-21.0,-1.9685577674164243,21.0,2.0952908873087353,0.8747664053476009,-0.585792685027066,199,110,89,0,0.7778560717911179,1.170500554541026,0.3511501663623078,-0.33156925250277336,0.8770834630985826,0.8770834630985826,0.3511501663623078,1.170500554541026,1,0,1,2,1.170500554541026,0.3511501663623078
1592,7,153,60,87,110,0,3017.106,80,1942.479,LESS,-750,2124,1374,4,2,23.0,2.1560394595513217,23.0,2.444506035193524,0.8747664053476009,-0.44696084458045504,197,87,110,1,0.7379660168274708,0.27311679605957273,1.170500554541026,0.15964445490874285,-0.3355954165457745,0.3355954165457745,1.170500554541026,0.27311679605957273,1,1,0,2,1.170500554541026,0.27311679605957273
1593,7,154,52,110,105,0,2250.793,90,757.325,LESS,-772,1596,824,2,2,-5.0,-0.4687042303372438,5.0,-0.6984302957695783,1.2537265809494496,-0.6608714311645051,215,110,105,0,1.0969765115002945,1.170500554541026,0.9754171287841883,-0.8227829599142895,-0.3570070821574727,0.3570070821574727,0.9754171287841883,1.170500554541026,1,0,0,2,1.170500554541026,0.9754171287841883
1594,7,155,30,80,96,0,3324.625,90,1215.812,LESS,-1514,2712,1198,2,2,16.0,1.4998535370791803,16.0,1.222253017596762,1.2537265809494496,-0.3611191980525475,176,80,96,1,0.3191204397091766,0.0,0.6242669624218805,-0.8227829599142895,-1.0791641677883819,1.0791641677883819,0.6242669624218805,0.0,1,0,0,1,0.6242669624218805,0.0
1595,7,156,24,80,86,0,2641.159,50,1748.693,LESS,-1584,2186,602,2,1,6.0,0.5624450764046927,6.0,-0.5238227218271837,-0.2621141214579453,-0.5519036594544214,166,80,86,1,0.11967016489094122,0.0,0.2341001109082052,-0.8227829599142895,-1.1472921947346941,1.1472921947346941,0.2341001109082052,0.0,0,0,0,1,0.2341001109082052,0.0
1596,7,157,5,50,55,0,3210.068,30,1251.327,LESS,-90,1678,1588,4,1,5.0,0.4687042303372438,5.0,-0.6984302957695783,-1.0200344726616426,-0.39309693439175736,105,50,55,1,-1.0969765115002945,-1.170500554541026,-0.9754171287841883,0.15964445490874285,0.30675455180516903,0.30675455180516903,-0.9754171287841883,-1.170500554541026,0,1,1,0,-1.170500554541026,-0.9754171287841883
1597,7,158,34,80,74,0,3212.384,70,818.044,LESS,-656,1820,1164,4,2,-6.0,-0.5624450764046927,6.0,-0.5238227218271837,0.4958062297457522,-0.39245044018047737,154,80,74,0,-0.11967016489094122,0.0,-0.2341001109082052,0.15964445490874285,-0.2441092089321553,0.2441092089321553,-0.2341001109082052,0.0,1,1,1,1,0.0,-0.2341001109082052
1598,7,159,15,45,50,0,1866.3,100,2208.612,LESS,524,1234,1758,2,2,5.0,0.4687042303372438,5.0,-0.6984302957695783,1.6326867565512984,-0.7681997985123916,95,45,50,1,-1.2964267863185297,-1.3655839802978638,-1.170500554541026,-0.8227829599142895,0.9043346738771075,0.9043346738771075,-1.170500554541026,-1.3655839802978638,1,0,1,0,-1.3655839802978638,-1.170500554541026
1599,7,160,37,69,80,0,3729.593,60,1462.908,LESS,-1140,2450,1310,4,2,11.0,1.0311493067419364,11.0,0.34921514788478913,0.11684605414390345,-0.2480753864145229,149,69,80,1,-0.21939530230005888,-0.4291835366650429,0.0,0.15964445490874285,-0.7151658523895139,0.7151658523895139,0.0,-0.4291835366650429,1,1,0,1,-0.4291835366650429,0.0
1600,7,161,3,50,53,0,4640.823,40,1032.92,MORE,-1850,3074,1224,4,1,3.0,0.28122253820234633,3.0,-1.0476454436543674,-0.6410742970597939,0.006287705185102664,103,50,53,0,-1.1368665664639415,-1.170500554541026,-1.0534504990869233,0.15964445490874285,-1.4061786971306804,1.4061786971306804,-1.0534504990869233,-1.170500554541026,0,1,0,0,-1.170500554541026,-1.0534504990869233
1601,7,162,20,50,40,0,6168.616999999998,60,960.85,MORE,-2122,3892,1770,4,1,-10.0,-0.9374084606744876,10.0,0.17460757394239454,0.11684605414390345,0.4327600614149872,90,50,40,1,-1.3961519237276474,-1.170500554541026,-1.5606674060547012,0.15964445490874285,-1.6709047446934935,1.6709047446934935,-1.5606674060547012,-1.170500554541026,0,1,0,0,-1.170500554541026,-1.5606674060547012
1602,7,163,25,80,88,1,1488.7679999999998,90,1343.995,MORE,1092,646,1738,1,2,8.0,0.7499267685395902,8.0,-0.17460757394239454,1.2537265809494496,-0.8735850543729206,168,80,88,0,0.1595602198545883,0.0,0.31213348121094026,-1.3139966673258057,1.4571449496700408,1.4571449496700408,0.31213348121094026,0.0,1,0,1,1,0.31213348121094026,0.0
1603,7,164,42,115,110,1,4667.444,30,1049.818,MORE,384,1932,2316,5,2,-5.0,-0.4687042303372438,5.0,-0.6984302957695783,-1.0200344726616426,0.013718759761305876,225,115,110,1,1.2964267863185297,1.3655839802978638,1.170500554541026,0.6508581623202591,0.7680786199844831,0.7680786199844831,1.170500554541026,1.3655839802978638,0,1,1,2,1.3655839802978638,1.170500554541026
1604,7,165,53,103,110,1,3948.767,70,1355.711,MORE,-1890,2906,1016,3,2,7.0,0.6561859224721414,7.0,-0.34921514788478913,0.4958062297457522,-0.18689459096413574,213,103,110,0,1.0570864565366473,0.8973837584814532,1.170500554541026,-0.33156925250277336,-1.4451089982428589,1.4451089982428589,1.170500554541026,0.8973837584814532,0,0,0,2,1.170500554541026,0.8973837584814532
1605,7,166,26,90,80,0,5512.26,80,1032.782,MORE,-1044,3032,1988,6,2,-10.0,-0.9374084606744876,10.0,0.17460757394239454,0.8747664053476009,0.2495428761675141,170,90,80,1,0.19945027481823535,0.3901668515136753,0.0,1.1420718697317753,-0.6217331297202857,0.6217331297202857,0.0,0.3901668515136753,1,1,0,1,0.3901668515136753,0.0
1606,7,167,35,80,72,1,2251.195,100,1658.612,MORE,914,1152,2066,3,2,-8.0,-0.7499267685395902,8.0,-0.17460757394239454,1.6326867565512984,-0.6607592158480392,152,80,72,1,-0.1595602198545883,0.0,-0.31213348121094026,-0.33156925250277336,1.283905109720847,1.283905109720847,-0.31213348121094026,0.0,1,0,1,1,0.0,-0.31213348121094026
1607,7,168,28,93,80,0,1813.576,80,1808.321,MORE,-132,1102,970,3,2,-13.0,-1.218630998876834,13.0,0.6984302957695783,0.8747664053476009,-0.7829173118092526,173,93,80,1,0.25928535726370594,0.5072169069677779,0.0,-0.33156925250277336,0.2658777356373817,0.2658777356373817,0.0,0.5072169069677779,1,0,0,1,0.5072169069677779,0.0
1608,7,169,26,80,90,1,2808.504000000001,90,792.1,MORE,-144,1520,1376,3,2,10.0,0.9374084606744876,10.0,0.17460757394239454,1.2537265809494496,-0.5051905446933408,170,80,90,0,0.19945027481823535,0.0,0.3901668515136753,-0.33156925250277336,0.2541986453037282,0.2541986453037282,0.3901668515136753,0.0,1,0,0,1,0.3901668515136753,0.0
1609,7,170,25,88,80,1,2526.192,70,845.143,MORE,356,1104,1460,3,2,-8.0,-0.7499267685395902,8.0,-0.17460757394239454,0.4958062297457522,-0.5839958442507233,168,88,80,1,0.1595602198545883,0.31213348121094026,0.0,-0.33156925250277336,0.7408274092059582,0.7408274092059582,0.0,0.31213348121094026,0,0,1,1,0.31213348121094026,0.0
1610,7,171,36,80,70,1,2766.042,70,1760.2420000000004,MORE,298,1164,1462,3,2,-10.0,-0.9374084606744876,10.0,0.17460757394239454,0.4958062297457522,-0.5170434968519654,150,80,70,1,-0.19945027481823535,0.0,-0.3901668515136753,-0.33156925250277336,0.6843784725932995,0.6843784725932995,-0.3901668515136753,0.0,0,0,1,1,0.0,-0.3901668515136753
1611,7,172,28,80,93,1,1804.396,90,1216.2,MORE,148,1360,1508,2,2,13.0,1.218630998876834,13.0,0.6984302957695783,1.2537265809494496,-0.7854798406777981,173,80,93,0,0.25928535726370594,0.0,0.5072169069677779,-0.8227829599142895,0.5383898434226306,0.5383898434226306,0.5072169069677779,0.0,1,0,1,1,0.5072169069677779,0.0
1612,7,173,21,82,80,0,4606.689,70,1759.4,MORE,1102,2444,3546,7,2,-2.0,-0.18748169213489754,2.0,-1.222253017596762,0.4958062297457522,-0.0032405475816649145,162,82,80,1,0.03989005496364707,0.07803337030273506,0.0,1.6332855771432915,1.4668775249480854,1.4668775249480854,0.0,0.07803337030273506,0,1,1,1,0.07803337030273506,0.0
1613,7,174,19,50,41,1,2456.038,40,1173.385,MORE,164,1168,1332,3,2,-9.0,-0.8436676146070391,9.0,0.0,-0.6410742970597939,-0.6035788126868812,91,50,41,1,-1.376206896245824,-1.170500554541026,-1.5216507209033339,-0.33156925250277336,0.553961963867502,0.553961963867502,-1.5216507209033339,-1.170500554541026,0,0,1,0,-1.170500554541026,-1.5216507209033339
1614,7,175,56,96,110,1,1383.182,100,1224.429,MORE,1052,498,1550,1,2,14.0,1.3123718449442827,14.0,0.8730378697119728,1.6326867565512984,-0.9030586026424444,206,96,110,0,0.9174712641638826,0.6242669624218805,1.170500554541026,-1.3139966673258057,1.4182146485578624,1.4182146485578624,1.170500554541026,0.6242669624218805,1,0,1,2,1.170500554541026,0.6242669624218805
1615,7,176,23,80,85,1,2131.568,70,92.3330000001,MORE,222,882,1104,3,2,5.0,0.4687042303372438,5.0,-0.6984302957695783,0.4958062297457522,-0.6941522050590928,165,80,85,0,0.09972513740911768,0.0,0.19508342575683765,-0.33156925250277336,0.6104109004801607,0.6104109004801607,0.19508342575683765,0.0,0,0,1,1,0.19508342575683765,0.0
1616,7,177,10,60,50,0,12090.306,90,1873.781,MORE,-96,1322,1226,2,2,-10.0,-0.9374084606744876,10.0,0.17460757394239454,1.2537265809494496,2.0857555966053294,110,60,50,1,-0.9972513740911768,-0.7803337030273506,-1.170500554541026,-0.8227829599142895,0.3009150066383423,0.3009150066383423,-1.170500554541026,-0.7803337030273506,1,0,1,0,-0.7803337030273506,-1.170500554541026
1617,7,178,19,41,50,1,3136.882,80,1768.616,MORE,-348,1820,1472,1,2,9.0,0.8436676146070391,9.0,0.0,0.8747664053476009,-0.4135262631252388,91,41,50,0,-1.376206896245824,-1.5216507209033339,-1.170500554541026,-1.3139966673258057,0.055654109631618376,0.055654109631618376,-1.170500554541026,-1.5216507209033339,1,0,0,0,-1.5216507209033339,-1.170500554541026
1618,7,179,56,110,96,1,2550.215,60,1114.28,MORE,294,1134,1428,3,2,-14.0,-1.3123718449442827,14.0,0.8730378697119728,0.11684605414390345,-0.5772900020928731,206,110,96,1,0.9174712641638826,1.170500554541026,0.6242669624218805,-0.33156925250277336,0.6804854424820818,0.6804854424820818,0.6242669624218805,1.170500554541026,0,0,1,2,1.170500554541026,0.6242669624218805
1619,7,180,35,72,80,1,1454.421,90,868.279,MORE,924,530,1454,1,2,8.0,0.7499267685395902,8.0,-0.17460757394239454,1.2537265809494496,-0.8831727645088603,152,72,80,0,-0.1595602198545883,-0.31213348121094026,0.0,-1.3139966673258057,1.2936376849988915,1.2936376849988915,0.0,-0.31213348121094026,1,0,1,1,-0.31213348121094026,0.0
1620,7,181,11,49,50,0,3341.082000000001,30,1567.369,MORE,-1084,2172,1088,4,1,1.0,0.09374084606744876,1.0,-1.3968605915391563,-1.0200344726616426,-0.35652534864190993,99,49,50,0,-1.2166466763912356,-1.2095172396923934,-1.170500554541026,0.15964445490874285,-0.6606634308324641,0.6606634308324641,-1.170500554541026,-1.2095172396923934,0,1,0,0,-1.2095172396923934,-1.170500554541026
1621,7,182,17,43,50,1,1343.957,80,788.2130000000002,MORE,602,544,1146,1,2,7.0,0.6561859224721414,7.0,-0.34921514788478913,0.8747664053476009,-0.9140079702751992,93,43,50,0,-1.3363168412821769,-1.4436173506005987,-1.170500554541026,-1.3139966673258057,0.9802487610458555,0.9802487610458555,-1.170500554541026,-1.4436173506005987,1,0,1,0,-1.4436173506005987,-1.170500554541026
1622,7,183,1,51,50,0,3425.812,70,1003.183,MORE,-634,1884,1250,4,2,-1.0,-0.09374084606744876,1.0,-1.3968605915391563,0.4958062297457522,-0.3328735979848464,101,51,50,1,-1.1767566214275886,-1.1314838693896585,-1.170500554541026,0.15964445490874285,-0.2226975433204572,0.2226975433204572,-1.170500554541026,-1.1314838693896585,1,1,0,0,-1.1314838693896585,-1.170500554541026
1623,7,184,41,112,110,0,2157.652,70,849.154,MORE,-450,1612,1162,3,2,-2.0,-0.18748169213489754,2.0,-1.222253017596762,0.4958062297457522,-0.6868710500474222,222,112,110,1,1.2365917038730592,1.248533924843761,1.170500554541026,-0.33156925250277336,-0.04361815820443654,0.04361815820443654,1.170500554541026,1.248533924843761,1,1,0,2,1.248533924843761,1.170500554541026
1624,7,185,20,40,50,1,1216.547,80,1236.169,MORE,582,440,1022,1,2,10.0,0.9374084606744876,10.0,0.17460757394239454,0.8747664053476009,-0.9495735261729509,90,40,50,0,-1.3961519237276474,-1.5606674060547012,-1.170500554541026,-1.3139966673258057,0.9607836104897662,0.9607836104897662,-1.170500554541026,-1.5606674060547012,1,0,1,0,-1.5606674060547012,-1.170500554541026
1625,7,186,1,50,51,0,3568.159,60,1150.439,MORE,-1074,2168,1094,4,1,1.0,0.09374084606744876,1.0,-1.3968605915391563,0.11684605414390345,-0.2931384893954321,101,50,51,0,-1.1767566214275886,-1.170500554541026,-1.1314838693896585,0.15964445490874285,-0.6509308555544195,0.6509308555544195,-1.1314838693896585,-1.170500554541026,0,1,0,0,-1.170500554541026,-1.1314838693896585
1626,7,187,23,85,80,0,3399.878,70,945.821,MORE,-776,1984,1208,4,1,-5.0,-0.4687042303372438,5.0,-0.6984302957695783,0.4958062297457522,-0.34011288160977604,165,85,80,1,0.09972513740911768,0.19508342575683765,0.0,0.15964445490874285,-0.3609001122686905,0.3609001122686905,0.0,0.19508342575683765,1,1,0,1,0.19508342575683765,0.0
1627,7,188,11,50,49,1,3012.47,70,2069.922,MORE,578,1070,1648,3,2,-1.0,-0.09374084606744876,1.0,-1.3968605915391563,0.4958062297457522,-0.4482549495733283,99,50,49,1,-1.2166466763912356,-1.170500554541026,-1.2095172396923934,-0.33156925250277336,0.9568905803785483,0.9568905803785483,-1.2095172396923934,-1.170500554541026,1,1,1,0,-1.170500554541026,-1.2095172396923934
1628,7,189,17,50,43,1,2355.175,70,1163.014,MORE,894,1088,1982,3,2,-7.0,-0.6561859224721414,7.0,-0.34921514788478913,0.4958062297457522,-0.6317339705592219,93,50,43,1,-1.3363168412821769,-1.170500554541026,-1.4436173506005987,-0.33156925250277336,1.2644399591647577,1.2644399591647577,-1.4436173506005987,-1.170500554541026,1,1,1,0,-1.170500554541026,-1.4436173506005987
1629,7,190,21,80,82,0,3481.451,70,1579.263,MORE,-1288,2412,1124,4,1,2.0,0.18748169213489754,2.0,-1.222253017596762,0.4958062297457522,-0.3173423840723198,162,80,82,0,0.03989005496364707,0.0,0.07803337030273506,0.15964445490874285,-0.859207966504574,0.859207966504574,0.07803337030273506,0.0,1,1,0,1,0.07803337030273506,0.0
1630,7,191,10,50,60,1,1541.305,100,1274.704,MORE,786,778,1564,1,2,10.0,0.9374084606744876,10.0,0.17460757394239454,1.6326867565512984,-0.8589197407381965,110,50,60,0,-0.9972513740911768,-1.170500554541026,-0.7803337030273506,-1.3139966673258057,1.159328146161876,1.159328146161876,-0.7803337030273506,-1.170500554541026,1,0,1,0,-1.170500554541026,-0.7803337030273506
1631,7,192,3,53,50,0,3198.916,70,1240.167,MORE,-342,1850,1508,2,2,-3.0,-0.28122253820234633,3.0,-1.0476454436543674,0.4958062297457522,-0.3962099324246569,103,53,50,1,-1.1368665664639415,-1.0534504990869233,-1.170500554541026,-0.8227829599142895,0.06149365479844513,0.06149365479844513,-1.170500554541026,-1.0534504990869233,1,0,0,0,-1.0534504990869233,-1.170500554541026
1632,7,193,45,122,110,1,1410.329,80,1012.688,MORE,666,564,1230,1,2,-12.0,-1.124890152809385,12.0,0.5238227218271837,0.8747664053476009,-0.8954807190700697,232,122,110,1,1.4360419786912946,1.6387007763574364,1.170500554541026,-1.3139966673258057,1.0425372428253408,1.0425372428253408,1.170500554541026,1.6387007763574364,1,0,1,2,1.6387007763574364,1.170500554541026
1633,7,194,38,67,80,1,1376.219,80,1172.171,MORE,1148,500,1648,1,2,13.0,1.218630998876834,13.0,0.6984302957695783,0.8747664053476009,-0.9050022724149586,147,67,80,0,-0.25928535726370594,-0.5072169069677779,0.0,-1.3139966673258057,1.5116473712270906,1.5116473712270906,0.0,-0.5072169069677779,1,0,1,1,-0.5072169069677779,0.0
1634,7,195,38,80,67,0,2630.958,60,2068.106,MORE,262,1512,1774,4,2,-13.0,-1.218630998876834,13.0,0.6984302957695783,0.11684605414390345,-0.5547511928953834,147,80,67,1,-0.25928535726370594,0.0,-0.5072169069677779,0.15964445490874285,0.649341201592339,0.649341201592339,-0.5072169069677779,0.0,0,1,1,1,0.0,-0.5072169069677779
1635,7,196,36,70,80,1,1467.97,90,1975.197,MORE,1568,542,2110,1,2,10.0,0.9374084606744876,10.0,0.17460757394239454,1.2537265809494496,-0.8793906617158406,150,70,80,0,-0.19945027481823535,-0.3901668515136753,0.0,-1.3139966673258057,1.9204155329049637,1.9204155329049637,0.0,-0.3901668515136753,1,0,1,1,-0.3901668515136753,0.0
1636,7,197,45,110,122,1,1521.71,70,1209.567,MORE,1336,500,1836,1,2,12.0,1.124890152809385,12.0,0.5238227218271837,0.4958062297457522,-0.8643895395594543,232,110,122,0,1.4360419786912946,1.170500554541026,1.6387007763574364,-1.3139966673258057,1.694619786454329,1.694619786454329,1.6387007763574364,1.170500554541026,1,0,1,2,1.6387007763574364,1.170500554541026
1637,7,198,42,110,115,1,1211.751,90,1823.632,MORE,2068,438,2506,1,2,5.0,0.4687042303372438,5.0,-0.6984302957695783,1.2537265809494496,-0.9509122939783478,225,110,115,0,1.2964267863185297,1.170500554541026,1.3655839802978638,-1.3139966673258057,2.407044296807194,2.407044296807194,1.3655839802978638,1.170500554541026,1,0,1,2,1.3655839802978638,1.170500554541026
1638,7,199,41,110,112,1,2661.007,80,1040.681,MORE,834,1084,1918,3,2,2.0,0.18748169213489754,2.0,-1.222253017596762,0.8747664053476009,-0.5463632375608607,222,110,112,0,1.2365917038730592,1.170500554541026,1.248533924843761,-0.33156925250277336,1.20604450749649,1.20604450749649,1.248533924843761,1.170500554541026,1,0,1,2,1.248533924843761,1.170500554541026
1639,7,200,53,110,103,0,7486.021,60,1288.694,MORE,-736,4016,3280,6,2,-7.0,-0.6561859224721414,7.0,-0.34921514788478913,0.11684605414390345,0.8005036106020348,213,110,103,1,1.0570864565366473,1.170500554541026,0.8973837584814532,1.1420718697317753,-0.3219698111565121,0.3219698111565121,0.8973837584814532,1.170500554541026,0,1,0,2,1.170500554541026,0.8973837584814532
1640,7,201,3,50,53,0,3734.464,20,1519.6370000000004,LESS,-744,2202,1458,4,1,3.0,0.28122253820234633,3.0,-1.0476454436543674,-1.3989946482634914,-0.2467156829157556,103,50,53,1,-1.1368665664639415,-1.170500554541026,-1.0534504990869233,0.15964445490874285,-0.3297558713789478,0.3297558713789478,-1.0534504990869233,-1.170500554541026,0,0,0,0,-1.170500554541026,-1.0534504990869233
1641,7,202,20,50,40,0,7637.415,20,1814.371,LESS,-742,3652,2910,7,1,-10.0,-0.9374084606744876,10.0,0.17460757394239454,-1.3989946482634914,0.8427641220970841,90,50,40,0,-1.3961519237276474,-1.170500554541026,-1.5606674060547012,1.6332855771432915,-0.32780935632333885,0.32780935632333885,-1.5606674060547012,-1.170500554541026,0,1,0,0,-1.170500554541026,-1.5606674060547012
1642,7,203,25,80,88,0,1796.056,80,1089.892,LESS,340,1028,1368,2,2,8.0,0.7499267685395902,8.0,-0.17460757394239454,0.8747664053476009,-0.7878078897805941,168,80,88,1,0.1595602198545883,0.0,0.31213348121094026,-0.8227829599142895,0.7252552887610869,0.7252552887610869,0.31213348121094026,0.0,1,0,1,1,0.31213348121094026,0.0
1643,7,204,42,115,110,0,3441.307,40,1320.0479999999998,LESS,-736,1996,1260,4,1,-5.0,-0.4687042303372438,5.0,-0.6984302957695783,-0.6410742970597939,-0.3285482837345076,225,115,110,0,1.2964267863185297,1.3655839802978638,1.170500554541026,0.15964445490874285,-0.3219698111565121,0.3219698111565121,1.170500554541026,1.3655839802978638,0,1,0,2,1.3655839802978638,1.170500554541026
1644,7,205,53,103,110,0,2410.442,50,3028.966,LESS,-1692,2548,856,4,1,7.0,0.6561859224721414,7.0,-0.34921514788478913,-0.2621141214579453,-0.6163065976858129,213,103,110,1,1.0570864565366473,0.8973837584814532,1.170500554541026,0.15964445490874285,-1.2524040077375758,1.2524040077375758,1.170500554541026,0.8973837584814532,0,1,0,2,1.170500554541026,0.8973837584814532
1645,7,206,26,90,80,0,1535.273,10,1334.531,LESS,-1366,1812,446,2,1,-10.0,-0.9374084606744876,10.0,0.17460757394239454,-1.77795482386534,-0.8606035287703389,170,90,80,0,0.19945027481823535,0.3901668515136753,0.0,-0.8227829599142895,-0.9351220536733218,0.9351220536733218,0.0,0.3901668515136753,0,0,0,1,0.3901668515136753,0.0
1646,7,207,35,80,72,1,8279.899,20,3743.924,LESS,-310,4038,3728,4,1,-8.0,-0.7499267685395902,8.0,-0.17460757394239454,-1.3989946482634914,1.022108762356177,152,80,72,0,-0.1595602198545883,0.0,-0.31213348121094026,0.15964445490874285,0.09263789568818785,0.09263789568818785,-0.31213348121094026,0.0,0,1,1,1,0.0,-0.31213348121094026
1647,7,208,28,93,80,0,3695.598,60,2679.066,LESS,-1016,2356,1340,4,2,-13.0,-1.218630998876834,13.0,0.6984302957695783,0.11684605414390345,-0.2575648383629105,173,93,80,0,0.25928535726370594,0.5072169069677779,0.0,0.15964445490874285,-0.5944819189417608,0.5944819189417608,0.0,0.5072169069677779,1,1,0,1,0.5072169069677779,0.0
1648,7,209,26,80,90,0,1793.599,100,2393.827,LESS,1328,1122,2450,2,2,10.0,0.9374084606744876,10.0,0.17460757394239454,1.6326867565512984,-0.7884937430954105,170,80,90,1,0.19945027481823535,0.0,0.3901668515136753,-0.8227829599142895,1.6868337262318933,1.6868337262318933,0.3901668515136753,0.0,1,0,1,1,0.3901668515136753,0.0
1649,7,210,25,88,80,0,2049.971,70,2141.259,LESS,-544,1566,1022,4,1,-8.0,-0.7499267685395902,8.0,-0.17460757394239454,0.4958062297457522,-0.7169294020184277,168,88,80,0,0.1595602198545883,0.31213348121094026,0.0,0.15964445490874285,-0.1351043658180558,0.1351043658180558,0.0,0.31213348121094026,1,1,1,1,0.31213348121094026,0.0
1650,7,211,36,80,70,1,6454.18,70,1836.634,LESS,314,2882,3196,7,2,-10.0,-0.9374084606744876,10.0,0.17460757394239454,0.4958062297457522,0.5124728534943352,150,80,70,0,-0.19945027481823535,0.0,-0.3901668515136753,1.6332855771432915,0.699950593038171,0.699950593038171,-0.3901668515136753,0.0,1,1,1,1,0.0,-0.3901668515136753
1651,7,212,28,80,93,0,1652.4820000000002,80,1740.9589999999996,LESS,-424,1178,754,2,2,13.0,1.218630998876834,13.0,0.6984302957695783,0.8747664053476009,-0.8278855063135492,173,80,93,1,0.25928535726370594,0.0,0.5072169069677779,-0.8227829599142895,-0.018313462481520586,0.018313462481520586,0.5072169069677779,0.0,1,0,1,1,0.5072169069677779,0.0
1652,7,213,21,82,80,1,4602.482,40,1464.0320000000004,LESS,490,2120,2610,5,2,-2.0,-0.18748169213489754,2.0,-1.222253017596762,-0.6410742970597939,-0.004414900408459148,162,82,80,0,0.03989005496364707,0.07803337030273506,0.0,0.6508581623202591,0.8712439179317559,0.8712439179317559,0.0,0.07803337030273506,0,1,1,1,0.07803337030273506,0.0
1653,7,214,19,50,41,0,2436.168,20,4731.647,LESS,-1024,2114,1090,5,1,-9.0,-0.8436676146070391,9.0,0.0,-1.3989946482634914,-0.6091253757171639,91,50,41,0,-1.376206896245824,-1.170500554541026,-1.5216507209033339,0.6508581623202591,-0.6022679791641965,0.6022679791641965,-1.5216507209033339,-1.170500554541026,0,1,0,0,-1.170500554541026,-1.5216507209033339
1654,7,215,56,96,110,0,3877.406,10,2218.635,LESS,-1646,2900,1254,4,1,14.0,1.3123718449442827,14.0,0.8730378697119728,-1.77795482386534,-0.20681448449226897,206,96,110,1,0.9174712641638826,0.6242669624218805,1.170500554541026,0.15964445490874285,-1.2076341614585706,1.2076341614585706,1.170500554541026,0.6242669624218805,0,1,0,2,1.170500554541026,0.6242669624218805
1655,7,216,23,80,85,0,1958.408,80,1471.443,LESS,-32,1402,1370,2,2,5.0,0.4687042303372438,5.0,-0.6984302957695783,0.8747664053476009,-0.7424885339128303,165,80,85,1,0.09972513740911768,0.0,0.19508342575683765,-0.8227829599142895,0.36320348841782774,0.36320348841782774,0.19508342575683765,0.0,1,0,1,1,0.19508342575683765,0.0
1656,7,217,10,60,50,1,7497.271,20,921.951,LESS,-936,3986,3050,7,1,-10.0,-0.9374084606744876,10.0,0.17460757394239454,-1.3989946482634914,0.803643964607605,110,60,50,0,-0.9972513740911768,-0.7803337030273506,-1.170500554541026,1.6332855771432915,-0.5166213167174041,0.5166213167174041,-1.170500554541026,-0.7803337030273506,0,1,0,0,-0.7803337030273506,-1.170500554541026
1657,7,218,19,41,50,0,1909.779,100,1652.126,LESS,-378,1414,1036,2,2,9.0,0.8436676146070391,9.0,0.0,1.6326867565512984,-0.7560629583516637,91,41,50,1,-1.376206896245824,-1.5216507209033339,-1.170500554541026,-0.8227829599142895,0.026456383797484575,0.026456383797484575,-1.170500554541026,-1.5216507209033339,1,0,1,0,-1.5216507209033339,-1.170500554541026
1658,7,219,56,110,96,0,2824.291,20,1417.168,LESS,-334,1514,1180,4,1,-14.0,-1.3123718449442827,14.0,0.8730378697119728,-1.3989946482634914,-0.5007837208101465,206,110,96,0,0.9174712641638826,1.170500554541026,0.6242669624218805,0.15964445490874285,0.06927971502088082,0.06927971502088082,0.6242669624218805,1.170500554541026,0,1,1,2,1.170500554541026,0.6242669624218805
1659,7,220,35,72,80,0,1675.047,80,673.9939999999998,LESS,-642,1180,538,2,2,8.0,0.7499267685395902,8.0,-0.17460757394239454,0.8747664053476009,-0.8215866540348209,152,72,80,1,-0.1595602198545883,-0.31213348121094026,0.0,-0.8227829599142895,-0.23048360354289285,0.23048360354289285,0.0,-0.31213348121094026,1,0,1,1,-0.31213348121094026,0.0
1660,7,221,11,49,50,0,1788.3529999999996,60,1167.817,LESS,-620,1300,680,2,2,1.0,0.09374084606744876,1.0,-1.3968605915391563,0.11684605414390345,-0.7899581250610305,99,49,50,1,-1.2166466763912356,-1.2095172396923934,-1.170500554541026,-0.8227829599142895,-0.20907193793119475,0.20907193793119475,-1.170500554541026,-1.2095172396923934,1,0,1,0,-1.2095172396923934,-1.170500554541026
1661,7,222,17,43,50,0,1869.825,80,1646.078,LESS,-666,1274,608,2,2,7.0,0.6561859224721414,7.0,-0.34921514788478913,0.8747664053476009,-0.7672158209239797,93,43,50,1,-1.3363168412821769,-1.4436173506005987,-1.170500554541026,-0.8227829599142895,-0.2538417842101999,0.2538417842101999,-1.170500554541026,-1.4436173506005987,1,0,1,0,-1.4436173506005987,-1.170500554541026
1662,7,223,1,51,50,0,5750.016,80,1912.459,LESS,-1156,4058,2902,4,2,-1.0,-0.09374084606744876,1.0,-1.3968605915391563,0.8747664053476009,0.3159106990073684,101,51,50,0,-1.1767566214275886,-1.1314838693896585,-1.170500554541026,0.15964445490874285,-0.7307379728343852,0.7307379728343852,-1.170500554541026,-1.1314838693896585,1,1,0,0,-1.1314838693896585,-1.170500554541026
1663,7,224,41,112,110,0,2405.223,20,1001.763,LESS,-1566,2040,474,2,1,-2.0,-0.18748169213489754,2.0,-1.222253017596762,-1.3989946482634914,-0.6177634428018192,222,112,110,0,1.2365917038730592,1.248533924843761,1.170500554541026,-0.8227829599142895,-1.1297735592342137,1.1297735592342137,1.170500554541026,1.248533924843761,0,0,0,2,1.248533924843761,1.170500554541026
1664,7,225,20,40,50,0,1763.336,60,1634.845,LESS,-736,1238,502,2,1,10.0,0.9374084606744876,10.0,0.17460757394239454,0.11684605414390345,-0.7969414349416837,90,40,50,1,-1.3961519237276474,-1.5606674060547012,-1.170500554541026,-0.8227829599142895,-0.3219698111565121,0.3219698111565121,-1.170500554541026,-1.5606674060547012,1,0,0,0,-1.5606674060547012,-1.170500554541026
1665,7,226,1,50,51,0,1657.99,70,1777.661,LESS,-1240,1830,590,2,2,1.0,0.09374084606744876,1.0,-1.3968605915391563,0.4958062297457522,-0.8263479889924219,101,50,51,1,-1.1767566214275886,-1.170500554541026,-1.1314838693896585,-0.8227829599142895,-0.8124916051699599,0.8124916051699599,-1.1314838693896585,-1.170500554541026,1,0,0,0,-1.170500554541026,-1.1314838693896585
1666,7,227,23,85,80,1,2819.1020000000008,40,2683.06,LESS,18,1588,1606,3,1,-5.0,-0.4687042303372438,5.0,-0.6984302957695783,-0.6410742970597939,-0.5022321916488045,165,85,80,0,0.09972513740911768,0.19508342575683765,0.0,-0.33156925250277336,0.4118663648080507,0.4118663648080507,0.0,0.19508342575683765,0,0,1,1,0.19508342575683765,0.0
1667,7,228,11,50,49,0,1617.067,90,1873.583,LESS,504,1072,1576,3,2,-1.0,-0.09374084606744876,1.0,-1.3968605915391563,1.2537265809494496,-0.8377713407230843,99,50,49,0,-1.2166466763912356,-1.170500554541026,-1.2095172396923934,-0.33156925250277336,0.8848695233210183,0.8848695233210183,-1.2095172396923934,-1.170500554541026,1,0,1,0,-1.170500554541026,-1.2095172396923934
1668,7,229,17,50,43,1,8980.375,40,1078.006,LESS,-2808,5466,2658,7,2,-7.0,-0.6561859224721414,7.0,-0.34921514788478913,-0.6410742970597939,1.217641439014474,93,50,43,0,-1.3363168412821769,-1.170500554541026,-1.4436173506005987,1.6332855771432915,-2.338559408767353,2.338559408767353,-1.4436173506005987,-1.170500554541026,0,1,0,0,-1.170500554541026,-1.4436173506005987
1669,7,230,21,80,82,0,1706.915,40,1020.273,LESS,-600,1088,488,2,1,2.0,0.18748169213489754,2.0,-1.222253017596762,-0.6410742970597939,-0.8126909383504197,162,80,82,1,0.03989005496364707,0.0,0.07803337030273506,-0.8227829599142895,-0.18960678737510553,0.18960678737510553,0.07803337030273506,0.0,0,0,1,1,0.07803337030273506,0.0
1670,7,231,10,50,60,0,1909.258,40,1782.612,LESS,-420,1078,658,2,1,10.0,0.9374084606744876,10.0,0.17460757394239454,-0.6410742970597939,-0.7562083916349439,110,50,60,1,-0.9972513740911768,-1.170500554541026,-0.7803337030273506,-0.8227829599142895,-0.014420432370302745,0.014420432370302745,-0.7803337030273506,-1.170500554541026,0,0,1,0,-1.170500554541026,-0.7803337030273506
1671,7,232,3,53,50,1,3047.705,60,1869.933,LESS,412,1360,1772,3,2,-3.0,-0.28122253820234633,3.0,-1.0476454436543674,0.11684605414390345,-0.43841936082788224,103,53,50,0,-1.1368665664639415,-1.0534504990869233,-1.170500554541026,-0.33156925250277336,0.795329830763008,0.795329830763008,-1.170500554541026,-1.0534504990869233,1,0,1,0,-1.0534504990869233,-1.170500554541026
1672,7,233,45,122,110,0,1574.966,90,749.96,LESS,-66,1062,996,3,2,-12.0,-1.124890152809385,12.0,0.5238227218271837,1.2537265809494496,-0.8495235224109522,232,122,110,0,1.4360419786912946,1.6387007763574364,1.170500554541026,-0.33156925250277336,0.3301127324724761,0.3301127324724761,1.170500554541026,1.6387007763574364,1,0,1,2,1.6387007763574364,1.170500554541026
1673,7,234,38,67,80,0,2869.004000000001,50,2641.936,LESS,-724,1736,1012,4,1,13.0,1.218630998876834,13.0,0.6984302957695783,-0.2621141214579453,-0.4883024187078296,147,67,80,1,-0.25928535726370594,-0.5072169069677779,0.0,0.15964445490874285,-0.3102907208228586,0.3102907208228586,0.0,-0.5072169069677779,0,1,0,1,-0.5072169069677779,0.0
1674,7,235,38,80,67,1,2347.152,40,1332.425,LESS,-78,1276,1198,3,2,-13.0,-1.218630998876834,13.0,0.6984302957695783,-0.6410742970597939,-0.6339735314647055,147,80,67,0,-0.25928535726370594,0.0,-0.5072169069677779,-0.33156925250277336,0.3184336421388226,0.3184336421388226,-0.5072169069677779,0.0,0,0,1,1,0.0,-0.5072169069677779
1675,7,236,36,70,80,0,4466.404,70,671.7130000000002,LESS,-1144,2534,1390,3,2,10.0,0.9374084606744876,10.0,0.17460757394239454,0.4958062297457522,-0.04240006417468031,150,70,80,1,-0.19945027481823535,-0.3901668515136753,0.0,-0.33156925250277336,-0.7190588825007317,0.7190588825007317,0.0,-0.3901668515136753,1,0,0,1,-0.3901668515136753,0.0
1676,7,237,45,110,122,0,3036.197,100,1217.768,LESS,-1342,2402,1060,2,2,12.0,1.124890152809385,12.0,0.5238227218271837,1.6326867565512984,-0.4416317336186469,232,110,122,1,1.4360419786912946,1.170500554541026,1.6387007763574364,-0.8227829599142895,-0.9117638730060148,0.9117638730060148,1.6387007763574364,1.170500554541026,1,0,0,2,1.6387007763574364,1.170500554541026
1677,7,238,42,110,115,0,5712.335,10,820.6310000000002,LESS,-3250,4496,1246,4,1,5.0,0.4687042303372438,5.0,-0.6984302957695783,-1.77795482386534,0.3053923275154669,225,110,115,1,1.2964267863185297,1.170500554541026,1.3655839802978638,0.15964445490874285,-2.7687392360569243,2.7687392360569243,1.3655839802978638,1.170500554541026,0,1,0,2,1.3655839802978638,1.170500554541026
1678,7,239,41,110,112,0,2082.118,70,935.406,LESS,-796,1356,560,2,2,2.0,0.18748169213489754,2.0,-1.222253017596762,0.4958062297457522,-0.7079558055546884,222,110,112,1,1.2365917038730592,1.170500554541026,1.248533924843761,-0.8227829599142895,-0.38036526282477967,0.38036526282477967,1.248533924843761,1.170500554541026,1,0,0,2,1.248533924843761,1.170500554541026
1679,7,240,53,110,103,0,5657.609,50,900.427,LESS,360,2552,2912,4,1,-7.0,-0.6561859224721414,7.0,-0.34921514788478913,-0.2621141214579453,0.29011597077690365,213,110,103,0,1.0570864565366473,1.170500554541026,0.8973837584814532,0.15964445490874285,0.7447204393171761,0.7447204393171761,0.8973837584814532,1.170500554541026,0,1,1,2,1.170500554541026,0.8973837584814532
1680,8,1,49,110,131,0,4931.005,74,925.315,LESS,-638,2418,1780,4,1,21.0,1.9685577674164243,21.0,2.0952908873087353,1.2055024426528271,1.0221437271648175,241,110,131,1,1.6155472260277064,1.170500554541026,1.9898509427197442,1.1313238754878707,-0.5054365060557222,0.5054365060557222,1.9898509427197442,1.170500554541026,1,1,0,2,1.9898509427197442,1.170500554541026
1681,8,2,13,47,50,0,2201.311,84,2107.361,LESS,336,1264,1600,2,2,3.0,0.28122253820234633,3.0,-1.0476454436543674,1.6413574987490585,-0.4159418978970016,97,47,50,1,-1.2565367313548828,-1.2875506099951286,-1.170500554541026,-0.4658392428479469,0.7487654137734319,0.7487654137734319,-1.170500554541026,-1.2875506099951286,1,1,1,0,-1.2875506099951286,-1.170500554541026
1682,8,3,16,50,44,1,3136.24,44,2570.353,LESS,296,1390,1686,4,1,-6.0,-0.5624450764046927,6.0,-0.5238227218271837,-0.10206272563586764,0.07660706742783746,94,50,44,0,-1.3163718138003533,-1.170500554541026,-1.4046006654492311,1.1313238754878707,0.6972581480720292,0.6972581480720292,-1.4046006654492311,-1.170500554541026,0,1,1,0,-1.170500554541026,-1.4046006654492311
1683,8,4,7,57,50,0,6726.24,34,1276.36,LESS,-378,2846,2468,6,1,-7.0,-0.6561859224721414,7.0,-0.34921514788478913,-0.5379177817320991,1.9679279971627937,107,57,50,0,-1.0570864565366473,-0.8973837584814532,-1.170500554541026,2.7284869938236884,-0.17063927899660516,0.17063927899660516,-1.170500554541026,-0.8973837584814532,0,1,1,0,-0.8973837584814532,-1.170500554541026
1684,8,5,18,42,50,0,1825.579,64,870.6489999999999,LESS,-554,1030,476,2,1,8.0,0.7499267685395902,8.0,-0.17460757394239454,0.7696473865565954,-0.6138889161619528,92,42,50,1,-1.3562618687640005,-1.4826340357519663,-1.170500554541026,-0.4658392428479469,-0.3972712480827767,0.3972712480827767,-1.170500554541026,-1.4826340357519663,1,0,0,0,-1.4826340357519663,-1.170500554541026
1685,8,6,51,108,110,1,7191.191,24,1526.2,LESS,1512,2726,4238,5,1,2.0,0.18748169213489754,2.0,-1.222253017596762,-0.9737728378283306,2.212878291759228,218,108,110,1,1.156811593945765,1.092467184238291,1.170500554541026,1.9299054346557796,2.2630790253946693,2.2630790253946693,1.170500554541026,1.092467184238291,0,1,1,2,1.170500554541026,1.092467184238291
1686,8,7,31,78,80,0,5022.577,34,2317.064,LESS,-576,2460,1884,6,1,2.0,0.18748169213489754,2.0,-1.222253017596762,-0.5379177817320991,1.070386635292308,158,78,80,1,-0.03989005496364707,-0.07803337030273506,0.0,2.7284869938236884,-0.42560024421854814,0.42560024421854814,0.0,-0.07803337030273506,0,1,0,1,-0.07803337030273506,0.0
1687,8,8,58,110,92,1,5351.962,20,2568.405,LESS,-1328,4320,2992,6,1,-18.0,-1.6873352292140782,18.0,1.571468165481551,-1.1481148602668232,1.2439166476713466,202,110,92,0,0.8376911542365885,1.170500554541026,0.4682002218164104,2.7284869938236884,-1.3939368394049176,1.3939368394049176,0.4682002218164104,1.170500554541026,0,1,0,2,1.170500554541026,0.4682002218164104
1688,8,9,12,50,48,1,6017.398,74,1432.184,LESS,164,2638,2802,5,2,-2.0,-0.18748169213489754,2.0,-1.222253017596762,1.2055024426528271,1.5944885234928257,98,50,48,0,-1.2365917038730592,-1.170500554541026,-1.248533924843761,1.9299054346557796,0.5272841712574006,0.5272841712574006,-1.248533924843761,-1.170500554541026,1,1,1,0,-1.170500554541026,-1.248533924843761
1689,8,10,54,110,101,1,4302.345,54,2246.62,LESS,1708,1556,3264,3,2,-9.0,-0.8436676146070391,9.0,0.0,0.3337923304603639,0.6909465640207572,211,110,101,0,1.0171964015730004,1.170500554541026,0.8193503881787182,0.3327423163199619,2.5154646273315424,2.5154646273315424,0.8193503881787182,1.170500554541026,1,1,1,2,1.170500554541026,0.8193503881787182
1690,8,11,14,46,50,0,3725.712,34,1360.2420000000004,LESS,-254,1962,1708,2,1,4.0,0.3749633842697951,4.0,-0.8730378697119728,-0.5379177817320991,0.3871588031082621,96,46,50,1,-1.2764817588367063,-1.3265672951464962,-1.170500554541026,-0.4658392428479469,-0.010966755322256994,0.010966755322256994,-1.170500554541026,-1.3265672951464962,0,0,1,0,-1.3265672951464962,-1.170500554541026
1691,8,12,22,80,83,1,8632.844000000001,24,1274.414,LESS,174,3662,3836,5,2,3.0,0.28122253820234633,3.0,-1.0476454436543674,-0.9737728378283306,2.9723848355796147,163,80,83,1,0.05983508244547061,0.0,0.1170500554541026,1.9299054346557796,0.5401609876827512,0.5401609876827512,0.1170500554541026,0.0,0,1,1,1,0.1170500554541026,0.0
1692,8,13,6,50,56,0,3949.768,34,1091.923,LESS,-312,1900,1588,2,1,6.0,0.5624450764046927,6.0,-0.5238227218271837,-0.5379177817320991,0.5051983023374251,106,50,56,1,-1.077031484018471,-1.170500554541026,-0.9364004436328208,-0.4658392428479469,-0.08565229058929082,0.08565229058929082,-0.9364004436328208,-1.170500554541026,0,1,1,0,-1.170500554541026,-0.9364004436328208
1693,8,14,13,50,47,1,4871.738,44,1462.76,LESS,-246,2462,2216,3,2,-3.0,-0.28122253820234633,3.0,-1.0476454436543674,-0.10206272563586764,0.9909200732532296,97,50,47,0,-1.2565367313548828,-1.170500554541026,-1.2875506099951286,0.3327423163199619,-0.0006653021819764677,0.0006653021819764677,-1.2875506099951286,-1.170500554541026,0,1,1,0,-1.170500554541026,-1.2875506099951286
1694,8,15,46,110,124,0,7526.366,24,2402.152,LESS,-890,3582,2692,3,2,14.0,1.3123718449442827,14.0,0.8730378697119728,-0.9737728378283306,2.3894586518215992,234,110,124,1,1.4759320336549415,1.170500554541026,1.7167341466601715,0.3327423163199619,-0.8299322799745589,0.8299322799745589,1.7167341466601715,1.170500554541026,0,1,0,2,1.7167341466601715,1.170500554541026
1695,8,16,27,91,80,1,4214.918,54,1733.612,LESS,176,2102,2278,3,2,-11.0,-1.0311493067419364,11.0,0.34921514788478913,0.3337923304603639,0.6448873676631139,171,91,80,0,0.21939530230005888,0.4291835366650429,0.0,0.3327423163199619,0.5427363509678214,0.5427363509678214,0.0,0.4291835366650429,1,1,1,1,0.4291835366650429,0.0
1696,8,17,40,64,80,0,2437.981,64,2063.552,LESS,-1422,2076,654,2,1,16.0,1.4998535370791803,16.0,1.222253017596762,0.7696473865565954,-0.2912569607269815,144,64,80,1,-0.3191204397091766,-0.6242669624218805,0.0,-0.4658392428479469,-1.514978913803214,1.514978913803214,0.0,-0.6242669624218805,1,0,0,1,-0.6242669624218805,0.0
1697,8,18,22,83,80,0,4873.235,44,1345.648,LESS,-622,2692,2070,4,1,-3.0,-0.28122253820234633,3.0,-1.0476454436543674,-0.10206272563586764,0.9917087382760184,163,83,80,0,0.05983508244547061,0.1170500554541026,0.0,1.1313238754878707,-0.48483359977516116,0.48483359977516116,0.0,0.1170500554541026,0,1,0,1,0.1170500554541026,0.0
1698,8,19,54,101,110,0,4016.557,54,2378.819,LESS,-2140,3408,1268,4,1,9.0,0.8436676146070391,9.0,0.0,0.3337923304603639,0.5403847740856333,211,101,110,1,1.0171964015730004,0.8193503881787182,1.170500554541026,1.1313238754878707,-2.439534333143391,2.439534333143391,1.170500554541026,0.8193503881787182,0,1,0,2,1.170500554541026,0.8193503881787182
1699,8,20,6,56,50,1,7753.638000000001,24,1528.267,LESS,-142,4002,3860,4,1,-6.0,-0.5624450764046927,6.0,-0.5238227218271837,-0.9737728378283306,2.5091924374323855,106,56,50,0,-1.077031484018471,-0.9364004436328208,-1.170500554541026,1.1313238754878707,0.1332535886416704,0.1332535886416704,-1.170500554541026,-0.9364004436328208,0,1,1,0,-0.9364004436328208,-1.170500554541026
1700,8,21,18,50,42,0,1978.586,54,2124.277,LESS,-566,1156,590,2,1,-8.0,-0.7499267685395902,8.0,-0.17460757394239454,0.3337923304603639,-0.5332801859402378,92,50,42,0,-1.3562618687640005,-1.170500554541026,-1.4826340357519663,-0.4658392428479469,-0.4127234277931975,0.4127234277931975,-1.4826340357519663,-1.170500554541026,0,1,0,0,-1.170500554541026,-1.4826340357519663
1701,8,22,43,110,117,0,7250.300999999998,64,1616.402,LESS,-1950,4686,2736,2,1,7.0,0.6561859224721414,7.0,-0.34921514788478913,0.7696473865565954,2.2440192333070352,227,110,117,1,1.3363168412821769,1.170500554541026,1.4436173506005987,-0.4658392428479469,-2.194874821061729,2.194874821061729,1.4436173506005987,1.170500554541026,1,1,0,2,1.4436173506005987,1.170500554541026
1702,8,23,32,77,80,0,6621.583000000001,34,1824.555,LESS,-726,3218,2492,3,2,3.0,0.28122253820234633,3.0,-1.0476454436543674,-0.5379177817320991,1.9127915140031089,157,77,80,1,-0.05983508244547061,-0.1170500554541026,0.0,0.3327423163199619,-0.618752490598808,0.618752490598808,0.0,-0.1170500554541026,0,1,0,1,-0.1170500554541026,0.0
1703,8,24,27,80,91,0,2099.569,64,1440.4520000000002,LESS,-938,1530,592,2,1,11.0,1.0311493067419364,11.0,0.34921514788478913,0.7696473865565954,-0.4695426706081699,171,80,91,1,0.21939530230005888,0.0,0.4291835366650429,-0.4658392428479469,-0.891740998816242,0.891740998816242,0.4291835366650429,0.0,1,1,0,1,0.4291835366650429,0.0
1704,8,25,16,44,50,0,2055.446,84,1337.098,LESS,-474,1216,742,2,2,6.0,0.5624450764046927,6.0,-0.5238227218271837,1.6413574987490585,-0.4927880058122634,94,44,50,1,-1.3163718138003533,-1.4046006654492311,-1.170500554541026,-0.4658392428479469,-0.2942567166799715,0.2942567166799715,-1.170500554541026,-1.4046006654492311,1,1,1,0,-1.4046006654492311,-1.170500554541026
1705,8,26,7,50,57,0,2333.077,84,2127.344,LESS,-372,1414,1042,2,2,7.0,0.6561859224721414,7.0,-0.34921514788478913,1.6413574987490585,-0.3465235709812756,107,50,57,1,-1.0570864565366473,-1.170500554541026,-0.8973837584814532,-0.4658392428479469,-0.16291318914139477,0.16291318914139477,-0.8973837584814532,-1.170500554541026,1,1,1,0,-1.170500554541026,-0.8973837584814532
1706,8,27,14,50,46,0,4594.955,64,1333.42,LESS,-426,1966,1540,3,1,-4.0,-0.3749633842697951,4.0,-0.8730378697119728,0.7696473865565954,0.8451023905527196,96,50,46,0,-1.2764817588367063,-1.170500554541026,-1.3265672951464962,0.3327423163199619,-0.23244799783828832,0.23244799783828832,-1.3265672951464962,-1.170500554541026,1,1,1,0,-1.170500554541026,-1.3265672951464962
1707,8,28,51,110,108,0,9217.327,24,1636.235,LESS,-364,4818,4454,5,1,-2.0,-0.18748169213489754,2.0,-1.222253017596762,-0.9737728378283306,3.2803082146810842,218,110,108,0,1.156811593945765,1.170500554541026,1.092467184238291,1.9299054346557796,-0.15261173600111425,0.15261173600111425,1.092467184238291,1.170500554541026,0,1,1,2,1.170500554541026,1.092467184238291
1708,8,29,50,133,110,1,3333.158,24,1401.695,LESS,432,1190,1622,3,2,-23.0,-2.1560394595513217,23.0,2.444506035193524,-0.9737728378283306,0.1803494448210264,243,133,110,0,1.6554372809913533,2.0678843130224793,1.170500554541026,0.3327423163199619,0.8723828514567982,0.8723828514567982,1.170500554541026,2.0678843130224793,0,1,1,2,2.0678843130224793,1.170500554541026
1709,8,30,49,131,110,1,12462.491000000002,54,2057.634,LESS,-670,5664,4994,6,2,-21.0,-1.9685577674164243,21.0,2.0952908873087353,0.3337923304603639,4.989959076414347,241,131,110,0,1.6155472260277064,1.9898509427197442,1.170500554541026,2.7284869938236884,-0.5466423186168443,0.5466423186168443,1.170500554541026,1.9898509427197442,0,1,0,2,1.9898509427197442,1.170500554541026
1710,8,31,47,126,110,1,2664.239,64,1915.109,LESS,1158,878,2036,1,2,-16.0,-1.4998535370791803,16.0,1.222253017596762,0.7696473865565954,-0.1720573810835354,236,126,110,0,1.5158220886185887,1.7947675169629065,1.170500554541026,-1.2644208020158558,1.807239723937256,1.807239723937256,1.170500554541026,1.7947675169629065,1,0,1,2,1.7947675169629065,1.170500554541026
1711,8,32,50,110,133,0,10809.408,44,1580.938,LESS,-1980,6286,4306,4,1,23.0,2.1560394595513217,23.0,2.444506035193524,-0.10206272563586764,4.119064793269764,243,110,133,1,1.6554372809913533,1.170500554541026,2.0678843130224793,1.1313238754878707,-2.2335052703377807,2.2335052703377807,2.0678843130224793,1.170500554541026,0,1,0,2,2.0678843130224793,1.170500554541026
1712,8,33,47,110,126,0,3254.2140000000004,64,1047.154,LESS,-446,1692,1246,4,1,16.0,1.4998535370791803,16.0,1.222253017596762,0.7696473865565954,0.13875935025918926,236,110,126,1,1.5158220886185887,1.170500554541026,1.7947675169629065,1.1313238754878707,-0.25820163068898966,0.25820163068898966,1.7947675169629065,1.170500554541026,1,1,1,2,1.7947675169629065,1.170500554541026
1713,8,34,12,48,50,0,1827.608,64,1948.463,LESS,-624,1166,542,2,1,2.0,0.18748169213489754,2.0,-1.222253017596762,0.7696473865565954,-0.6128199773969301,98,48,50,1,-1.2365917038730592,-1.248533924843761,-1.170500554541026,-0.4658392428479469,-0.4874089630602313,0.4874089630602313,-1.170500554541026,-1.248533924843761,1,0,0,0,-1.248533924843761,-1.170500554541026
1714,8,35,32,80,77,0,6628.51,64,846.6389999999999,LESS,662,2682,3344,4,1,-3.0,-0.28122253820234633,3.0,-1.0476454436543674,0.7696473865565954,1.9164408677859144,157,80,77,0,-0.05983508244547061,0.0,-0.1170500554541026,1.1313238754878707,1.1685496292398634,1.1685496292398634,-0.1170500554541026,0.0,1,1,1,1,0.0,-0.1170500554541026
1715,8,36,43,117,110,1,9029.66,54,1685.321,LESS,-78,4454,4376,5,1,-7.0,-0.6561859224721414,7.0,-0.34921514788478913,0.3337923304603639,3.181439544786775,227,117,110,0,1.3363168412821769,1.4436173506005987,1.170500554541026,1.9299054346557796,0.2156652137639146,0.2156652137639146,1.170500554541026,1.4436173506005987,1,1,1,2,1.4436173506005987,1.170500554541026
1716,8,37,40,80,64,1,8494.599,64,2714.808,LESS,30,3970,4000,7,1,-16.0,-1.4998535370791803,16.0,1.222253017596762,0.7696473865565954,2.8995531748745424,144,80,64,0,-0.3191204397091766,0.0,-0.6242669624218805,3.527068552991597,0.3547348311577017,0.3547348311577017,-0.6242669624218805,0.0,1,1,1,1,0.0,-0.6242669624218805
1717,8,38,31,80,78,0,2609.038,54,2289.457000000001,LESS,-1266,1978,712,2,1,-2.0,-0.18748169213489754,2.0,-1.222253017596762,0.3337923304603639,-0.20113894282233746,158,80,78,0,-0.03989005496364707,0.0,-0.07803337030273506,-0.4658392428479469,-1.3141005775677437,1.3141005775677437,-0.07803337030273506,0.0,1,0,0,1,0.0,-0.07803337030273506
1718,8,39,46,124,110,1,3992.917,4,1374.0279999999998,LESS,-460,2420,1960,3,1,-14.0,-1.3123718449442827,14.0,0.8730378697119728,-1.8454829500207937,0.5279305047878802,234,124,110,0,1.4759320336549415,1.7167341466601715,1.170500554541026,0.3327423163199619,-0.2762291736844806,0.2762291736844806,1.170500554541026,1.7167341466601715,0,1,1,2,1.7167341466601715,1.170500554541026
1719,8,40,58,92,110,0,6079.516,44,2203.323,LESS,936,2630,3566,4,1,18.0,1.6873352292140782,18.0,1.571468165481551,-0.10206272563586764,1.6272141707110082,202,92,110,1,0.8376911542365885,0.4682002218164104,1.170500554541026,1.1313238754878707,1.5213743992944713,1.5213743992944713,1.170500554541026,0.4682002218164104,0,1,1,2,1.170500554541026,0.4682002218164104
1720,8,41,49,110,131,1,4993.562,74,1516.415,MORE,914,1780,2694,4,2,21.0,1.9685577674164243,21.0,2.0952908873087353,1.2055024426528271,1.0551006529033775,241,110,131,0,1.6155472260277064,1.170500554541026,1.9898509427197442,1.1313238754878707,1.4930454031587,1.4930454031587,1.9898509427197442,1.170500554541026,1,1,1,2,1.9898509427197442,1.170500554541026
1721,8,42,13,47,50,1,3795.373,24,1723.592,MORE,1088,1096,2184,2,2,3.0,0.28122253820234633,3.0,-1.0476454436543674,-0.9737728378283306,0.4238583316002584,97,47,50,0,-1.2565367313548828,-1.2875506099951286,-1.170500554541026,-0.4658392428479469,1.7171020089598015,1.7171020089598015,-1.170500554541026,-1.2875506099951286,0,0,1,0,-1.2875506099951286,-1.170500554541026
1722,8,43,16,50,44,1,4768.419,14,1866.708,MORE,530,1986,2516,5,1,-6.0,-0.5624450764046927,6.0,-0.5238227218271837,-1.409627893924562,0.9364884890918684,94,50,44,1,-1.3163718138003533,-1.170500554541026,-1.4046006654492311,1.9299054346557796,0.9985756524252346,0.9985756524252346,-1.4046006654492311,-1.170500554541026,0,1,1,0,-1.170500554541026,-1.4046006654492311
1723,8,44,7,57,50,0,7074.001,14,696.2769999999998,MORE,-1682,4252,2570,6,1,-7.0,-0.6561859224721414,7.0,-0.34921514788478913,-1.409627893924562,2.1511390439164306,107,57,50,1,-1.0570864565366473,-0.8973837584814532,-1.170500554541026,2.7284869938236884,-1.849776140862331,1.849776140862331,-1.170500554541026,-0.8973837584814532,0,1,0,0,-0.8973837584814532,-1.170500554541026
1724,8,45,18,42,50,1,7010.269,64,1501.955,MORE,646,2516,3162,4,2,8.0,0.7499267685395902,8.0,-0.17460757394239454,0.7696473865565954,2.1175630925253817,92,42,50,0,-1.3562618687640005,-1.4826340357519663,-1.170500554541026,1.1313238754878707,1.1479467229593023,1.1479467229593023,-1.170500554541026,-1.4826340357519663,1,1,1,0,-1.4826340357519663,-1.170500554541026
1725,8,46,51,108,110,1,3297.75,64,1961.747,MORE,1550,1224,2774,3,2,2.0,0.18748169213489754,2.0,-1.222253017596762,0.7696473865565954,0.16169543605220882,218,108,110,0,1.156811593945765,1.092467184238291,1.170500554541026,0.3327423163199619,2.3120109278110017,2.3120109278110017,1.170500554541026,1.092467184238291,1,1,1,2,1.170500554541026,1.092467184238291
1726,8,47,31,78,80,0,2028.401,4,966.298,MORE,-1110,1730,620,2,1,2.0,0.18748169213489754,2.0,-1.222253017596762,-1.8454829500207937,-0.5070361324263808,158,78,80,0,-0.03989005496364707,-0.07803337030273506,0.0,-0.4658392428479469,-1.1132222413322732,1.1132222413322732,0.0,-0.07803337030273506,0,0,0,1,-0.07803337030273506,0.0
1727,8,48,58,110,92,0,7001.148,14,2176.115,MORE,-1408,3848,2440,5,1,-18.0,-1.6873352292140782,18.0,1.571468165481551,-1.409627893924562,2.112757872971033,202,110,92,1,0.8376911542365885,1.170500554541026,0.4682002218164104,1.9299054346557796,-1.496951370807723,1.496951370807723,0.4682002218164104,1.170500554541026,0,1,0,2,1.170500554541026,0.4682002218164104
1728,8,49,12,50,48,0,1904.903,84,2073.659,MORE,-812,1432,620,2,1,-2.0,-0.18748169213489754,2.0,-1.222253017596762,1.6413574987490585,-0.5720986260699484,98,50,48,1,-1.2365917038730592,-1.170500554541026,-1.248533924843761,-0.4658392428479469,-0.7294931118568236,0.7294931118568236,-1.248533924843761,-1.170500554541026,1,0,0,0,-1.170500554541026,-1.248533924843761
1729,8,50,54,110,101,0,6137.828,24,689.951,MORE,-230,2552,2322,5,1,-9.0,-0.8436676146070391,9.0,0.0,-0.9737728378283306,1.6579347016454666,211,110,101,1,1.0171964015730004,1.170500554541026,0.8193503881787182,1.9299054346557796,0.019937604098584586,0.019937604098584586,0.8193503881787182,1.170500554541026,0,1,0,2,1.170500554541026,0.8193503881787182
1730,8,51,14,46,50,1,1789.591,64,1408.092,MORE,708,562,1270,1,2,4.0,0.3749633842697951,4.0,-0.8730378697119728,0.7696473865565954,-0.6328484865294464,96,46,50,0,-1.2764817588367063,-1.3265672951464962,-1.170500554541026,-1.2644208020158558,1.2277829847964763,1.2277829847964763,-1.170500554541026,-1.3265672951464962,1,0,1,0,-1.3265672951464962,-1.170500554541026
1731,8,52,22,80,83,1,1607.714,84,964.204,MORE,974,566,1540,2,2,3.0,0.28122253820234633,3.0,-1.0476454436543674,1.6413574987490585,-0.7286668087404226,163,80,83,0,0.05983508244547061,0.0,0.1170500554541026,-0.4658392428479469,1.5703063017108039,1.5703063017108039,0.1170500554541026,0.0,1,0,1,1,0.1170500554541026,0.0
1732,8,53,6,50,56,1,1430.6329999999996,64,1845.498,MORE,-272,1104,832,1,1,6.0,0.5624450764046927,6.0,-0.5238227218271837,0.7696473865565954,-0.8219584526285553,106,50,56,0,-1.077031484018471,-1.170500554541026,-0.9364004436328208,-1.2644208020158558,-0.03414502488788818,0.03414502488788818,-0.9364004436328208,-1.170500554541026,1,0,0,0,-1.170500554541026,-0.9364004436328208
1733,8,54,13,50,47,0,1845.803,24,2201.731,MORE,-256,1088,832,2,2,-3.0,-0.28122253820234633,3.0,-1.0476454436543674,-0.9737728378283306,-0.6032342993143316,97,50,47,1,-1.2565367313548828,-1.170500554541026,-1.2875506099951286,-0.4658392428479469,-0.013542118607327127,0.013542118607327127,-1.2875506099951286,-1.170500554541026,0,0,0,0,-1.170500554541026,-1.2875506099951286
1734,8,55,46,110,124,0,2698.17,24,1727.056,MORE,-396,1408,1012,2,1,14.0,1.3123718449442827,14.0,0.8730378697119728,-0.9737728378283306,-0.15418150073065606,234,110,124,0,1.4759320336549415,1.170500554541026,1.7167341466601715,-0.4658392428479469,-0.19381754856223635,0.19381754856223635,1.7167341466601715,1.170500554541026,0,0,0,2,1.7167341466601715,1.170500554541026
1735,8,56,27,91,80,1,2192.458,24,2150.305,MORE,356,1050,1406,2,1,-11.0,-1.0311493067419364,11.0,0.34921514788478913,-0.9737728378283306,-0.42060592691954857,171,91,80,1,0.21939530230005888,0.4291835366650429,0.0,-0.4658392428479469,0.7745190466241332,0.7745190466241332,0.0,0.4291835366650429,0,0,1,1,0.4291835366650429,0.0
1736,8,57,40,64,80,1,2213.166,74,688.687,MORE,314,836,1150,3,2,16.0,1.4998535370791803,16.0,1.222253017596762,1.2055024426528271,-0.40969632418613583,144,64,80,0,-0.3191204397091766,-0.6242669624218805,0.0,0.3327423163199619,0.7204364176376604,0.7204364176376604,0.0,-0.6242669624218805,1,1,1,1,-0.6242669624218805,0.0
1737,8,58,22,83,80,0,2714.831,84,799.8480000000002,MORE,-8,1502,1494,2,2,-3.0,-0.28122253820234633,3.0,-1.0476454436543674,1.6413574987490585,-0.14540398039352118,163,83,80,1,0.05983508244547061,0.1170500554541026,0.0,-0.4658392428479469,0.3058029287413692,0.3058029287413692,0.0,0.1170500554541026,1,1,0,1,0.1170500554541026,0.0
1738,8,59,54,101,110,0,3723.87,24,1608.841,MORE,-122,1674,1552,4,1,9.0,0.8436676146070391,9.0,0.0,-0.9737728378283306,0.38618838161729496,211,101,110,0,1.0171964015730004,0.8193503881787182,1.170500554541026,1.1313238754878707,0.1590072214923717,0.1590072214923717,1.170500554541026,0.8193503881787182,0,1,0,2,1.170500554541026,0.8193503881787182
1739,8,60,6,56,50,0,2246.661,74,1280.635,MORE,-626,1342,716,2,1,-6.0,-0.5624450764046927,6.0,-0.5238227218271837,1.2055024426528271,-0.39205014186260606,106,56,50,1,-1.077031484018471,-0.9364004436328208,-1.170500554541026,-0.4658392428479469,-0.4899843263453014,0.4899843263453014,-1.170500554541026,-0.9364004436328208,1,1,0,0,-0.9364004436328208,-1.170500554541026
1740,8,61,18,50,42,0,3688.427,24,1723.461,MORE,132,1622,1754,4,2,-8.0,-0.7499267685395902,8.0,-0.17460757394239454,-0.9737728378283306,0.3675159337864884,92,50,42,1,-1.3562618687640005,-1.170500554541026,-1.4826340357519663,1.1313238754878707,0.48607835869627847,0.48607835869627847,-1.4826340357519663,-1.170500554541026,0,1,0,0,-1.170500554541026,-1.4826340357519663
1741,8,62,43,110,117,1,1567.154,14,1225.682,MORE,402,464,866,1,2,7.0,0.6561859224721414,7.0,-0.34921514788478913,-1.409627893924562,-0.7500350474340297,227,110,117,0,1.3363168412821769,1.170500554541026,1.4436173506005987,-1.2644208020158558,0.8337524021807462,0.8337524021807462,1.4436173506005987,1.170500554541026,0,0,1,2,1.4436173506005987,1.170500554541026
1742,8,63,32,77,80,0,2141.277,24,663.0210000000002,MORE,-252,1098,846,2,1,3.0,0.28122253820234633,3.0,-1.0476454436543674,-0.9737728378283306,-0.4475696306813215,157,77,80,0,-0.05983508244547061,-0.1170500554541026,0.0,-0.4658392428479469,-0.008391392037186862,0.008391392037186862,0.0,-0.1170500554541026,0,1,0,1,-0.1170500554541026,0.0
1743,8,64,27,80,91,1,2819.9970000000008,14,1465.882,MORE,0,1392,1392,3,1,11.0,1.0311493067419364,11.0,0.34921514788478913,-1.409627893924562,-0.08999934058948006,171,80,91,0,0.21939530230005888,0.0,0.4291835366650429,0.3327423163199619,0.31610438188164974,0.31610438188164974,0.4291835366650429,0.0,0,1,0,1,0.4291835366650429,0.0
1744,8,65,16,44,50,1,1751.997,64,1466.815,MORE,370,566,936,1,2,6.0,0.5624450764046927,6.0,-0.5238227218271837,0.7696473865565954,-0.6526541464270662,94,44,50,0,-1.3163718138003533,-1.4046006654492311,-1.170500554541026,-1.2644208020158558,0.7925465896196241,0.7925465896196241,-1.170500554541026,-1.4046006654492311,1,0,1,0,-1.4046006654492311,-1.170500554541026
1745,8,66,7,50,57,1,1681.4260000000004,54,1614.911,MORE,748,418,1166,1,2,7.0,0.6561859224721414,7.0,-0.34921514788478913,0.3337923304603639,-0.6898330905307779,107,50,57,0,-1.0570864565366473,-1.170500554541026,-0.8973837584814532,-1.2644208020158558,1.279290250497879,1.279290250497879,-0.8973837584814532,-1.170500554541026,1,0,1,0,-1.170500554541026,-0.8973837584814532
1746,8,67,14,50,46,1,3260.446,24,1662.7420000000004,MORE,136,1478,1614,3,1,-4.0,-0.3749633842697951,4.0,-0.8730378697119728,-0.9737728378283306,0.14204255695392665,96,50,46,1,-1.2764817588367063,-1.170500554541026,-1.3265672951464962,0.3327423163199619,0.49122908526641873,0.49122908526641873,-1.3265672951464962,-1.170500554541026,0,1,1,0,-1.170500554541026,-1.3265672951464962
1747,8,68,51,110,108,1,2745.432,54,1068.561,MORE,214,1090,1304,3,2,-2.0,-0.18748169213489754,2.0,-1.222253017596762,0.3337923304603639,-0.1292824450813154,218,110,108,1,1.156811593945765,1.170500554541026,1.092467184238291,0.3327423163199619,0.5916682533841539,0.5916682533841539,1.092467184238291,1.170500554541026,1,1,1,2,1.170500554541026,1.092467184238291
1748,8,69,50,133,110,1,3064.343,44,1983.687,MORE,654,1326,1980,3,2,-23.0,-2.1560394595513217,23.0,2.444506035193524,-0.10206272563586764,0.03872954628991155,243,133,110,1,1.6554372809913533,2.0678843130224793,1.170500554541026,0.3327423163199619,1.1582481760995829,1.1582481760995829,1.170500554541026,2.0678843130224793,0,1,1,2,2.0678843130224793,1.170500554541026
1749,8,70,49,131,110,0,3042.958,64,1176.042,MORE,-404,1538,1134,2,1,-21.0,-1.9685577674164243,21.0,2.0952908873087353,0.7696473865565954,0.02746327941459634,241,131,110,1,1.6155472260277064,1.9898509427197442,1.170500554541026,-0.4658392428479469,-0.20411900170251687,0.20411900170251687,1.170500554541026,1.9898509427197442,1,1,0,2,1.9898509427197442,1.170500554541026
1750,8,71,47,126,110,0,2689.534,64,1293.446,MORE,-356,1248,892,2,1,-16.0,-1.4998535370791803,16.0,1.222253017596762,0.7696473865565954,-0.15873120756887082,236,126,110,1,1.5158220886185887,1.7947675169629065,1.170500554541026,-0.4658392428479469,-0.14231028286083372,0.14231028286083372,1.170500554541026,1.7947675169629065,1,1,0,2,1.7947675169629065,1.170500554541026
1751,8,72,50,110,133,1,3982.511,44,2224.305,MORE,764,1086,1850,1,2,23.0,2.1560394595513217,23.0,2.444506035193524,-0.10206272563586764,0.5224483082433615,243,110,133,0,1.6554372809913533,1.170500554541026,2.0678843130224793,-1.2644208020158558,1.29989315677844,1.29989315677844,2.0678843130224793,1.170500554541026,0,0,1,2,2.0678843130224793,1.170500554541026
1752,8,73,47,110,126,1,1819.573,74,988.667,MORE,482,710,1192,1,2,16.0,1.4998535370791803,16.0,1.222253017596762,1.2055024426528271,-0.6170530591992753,236,110,126,0,1.5158220886185887,1.170500554541026,1.7947675169629065,-1.2644208020158558,0.9367669335835515,0.9367669335835515,1.7947675169629065,1.170500554541026,1,0,1,2,1.7947675169629065,1.170500554541026
1753,8,74,12,48,50,1,6171.741,54,1323.1660000000004,MORE,48,2684,2732,7,2,2.0,0.18748169213489754,2.0,-1.222253017596762,0.3337923304603639,1.67580109905218,98,48,50,0,-1.2365917038730592,-1.248533924843761,-1.170500554541026,3.527068552991597,0.3779131007233329,0.3779131007233329,-1.170500554541026,-1.248533924843761,1,1,0,0,-1.248533924843761,-1.170500554541026
1754,8,75,32,80,77,1,1524.247,64,2276.526,MORE,398,632,1030,1,1,-3.0,-0.28122253820234633,3.0,-1.0476454436543674,0.7696473865565954,-0.7726397569415889,157,80,77,1,-0.05983508244547061,0.0,-0.1170500554541026,-1.2644208020158558,0.8286016756106059,0.8286016756106059,-0.1170500554541026,0.0,1,0,1,1,0.0,-0.1170500554541026
1755,8,76,43,117,110,1,4600.759,24,754.523,MORE,770,1796,2566,3,1,-7.0,-0.6561859224721414,7.0,-0.34921514788478913,-0.9737728378283306,0.8481601138608482,227,117,110,1,1.3363168412821769,1.4436173506005987,1.170500554541026,0.3327423163199619,1.3076192466336505,1.3076192466336505,1.170500554541026,1.4436173506005987,0,1,1,2,1.4436173506005987,1.170500554541026
1756,8,77,40,80,64,0,2025.769,64,1350.939,MORE,-374,1084,710,2,1,-16.0,-1.4998535370791803,16.0,1.222253017596762,0.7696473865565954,-0.5084227498879581,144,80,64,1,-0.3191204397091766,0.0,-0.6242669624218805,-0.4658392428479469,-0.1654885524264649,0.1654885524264649,-0.6242669624218805,0.0,1,1,0,1,0.0,-0.6242669624218805
1757,8,78,31,80,78,1,1791.142,64,2404.707000000001,MORE,-94,1356,1262,1,1,-2.0,-0.18748169213489754,2.0,-1.222253017596762,0.7696473865565954,-0.6320313726681597,158,80,78,1,-0.03989005496364707,0.0,-0.07803337030273506,-1.2644208020158558,0.19506230748335354,0.19506230748335354,-0.07803337030273506,0.0,1,0,0,1,0.0,-0.07803337030273506
1758,8,79,46,124,110,0,2225.989,24,2000.816,MORE,-280,1332,1052,2,1,-14.0,-1.3123718449442827,14.0,0.8730378697119728,-0.9737728378283306,-0.4029407787036871,234,124,110,1,1.4759320336549415,1.7167341466601715,1.170500554541026,-0.4658392428479469,-0.04444647802816871,0.04444647802816871,1.170500554541026,1.7167341466601715,0,0,0,2,1.7167341466601715,1.170500554541026
1759,8,80,58,92,110,0,2391.515,4,1980.087,MORE,-1590,2210,620,2,1,18.0,1.6873352292140782,18.0,1.571468165481551,-1.8454829500207937,-0.315736659423657,202,92,110,0,0.8376911542365885,0.4682002218164104,1.170500554541026,-0.4658392428479469,-1.731309429749105,1.731309429749105,1.170500554541026,0.4682002218164104,0,0,0,2,1.170500554541026,0.4682002218164104
1760,8,81,48,128,110,0,2798.97,64,1832.279,LESS,300,1568,1868,4,2,-18.0,-1.6873352292140782,18.0,1.571468165481551,0.7696473865565954,-0.10107700220216496,238,128,110,0,1.5557121435822359,1.8728008872656416,1.170500554541026,1.1313238754878707,0.7024088746421695,0.7024088746421695,1.170500554541026,1.8728008872656416,1,1,1,2,1.8728008872656416,1.170500554541026
1761,8,82,8,50,58,0,1729.804,14,1285.979,LESS,-782,1314,532,2,1,8.0,0.7499267685395902,8.0,-0.17460757394239454,-1.409627893924562,-0.6643460922191575,108,50,58,1,-1.0371414290548238,-1.170500554541026,-0.8583670733300858,-0.4658392428479469,-0.6908626625807717,0.6908626625807717,-0.8583670733300858,-1.170500554541026,0,0,0,0,-1.170500554541026,-0.8583670733300858
1762,8,83,4,54,50,0,1877.844,14,1933.26,LESS,-948,1576,628,2,1,-4.0,-0.3749633842697951,4.0,-0.8730378697119728,-1.409627893924562,-0.5863541283088616,104,54,50,0,-1.116921538982118,-1.0144338139355558,-1.170500554541026,-0.4658392428479469,-0.9046178152415927,0.9046178152415927,-1.170500554541026,-1.0144338139355558,0,1,0,0,-1.0144338139355558,-1.170500554541026
1763,8,84,37,80,69,1,3232.736,4,1286.895,LESS,354,1260,1614,3,1,-11.0,-1.0311493067419364,11.0,0.34921514788478913,-1.8454829500207937,0.127444088162017,149,80,69,0,-0.21939530230005888,0.0,-0.4291835366650429,0.3327423163199619,0.771943683339063,0.771943683339063,-0.4291835366650429,0.0,0,1,1,1,0.0,-0.4291835366650429
1764,8,85,52,105,110,0,2248.897,4,1210.043,LESS,-1226,1878,652,2,1,5.0,0.4687042303372438,5.0,-0.6984302957695783,-1.8454829500207937,-0.3908721492166765,215,105,110,1,1.0969765115002945,0.9754171287841883,1.170500554541026,-0.4658392428479469,-1.262593311866341,1.262593311866341,1.170500554541026,0.9754171287841883,0,1,0,2,1.170500554541026,0.9754171287841883
1765,8,86,5,55,50,0,2051.915,34,1560.175,LESS,-512,1196,684,2,1,-5.0,-0.4687042303372438,5.0,-0.6984302957695783,-0.5379177817320991,-0.4946482437517882,105,55,50,0,-1.0969765115002945,-0.9754171287841883,-1.170500554541026,-0.4658392428479469,-0.34318861909630394,0.34318861909630394,-1.170500554541026,-0.9754171287841883,0,1,1,0,-0.9754171287841883,-1.170500554541026
1766,8,87,30,96,80,1,1535.46,54,1587.8670000000004,LESS,672,512,1184,1,2,-16.0,-1.4998535370791803,16.0,1.222253017596762,0.3337923304603639,-0.7667324083106368,176,96,80,0,0.3191204397091766,0.6242669624218805,0.0,-1.2644208020158558,1.181426445665214,1.181426445665214,0.0,0.6242669624218805,1,0,1,1,0.6242669624218805,0.0
1767,8,88,33,80,75,1,3373.361,4,1690.515,LESS,-130,1906,1776,3,1,-5.0,-0.4687042303372438,5.0,-0.6984302957695783,-1.8454829500207937,0.2015296050823452,155,80,75,0,-0.09972513740911768,0.0,-0.19508342575683765,0.3327423163199619,0.14870576835209118,0.14870576835209118,-0.19508342575683765,0.0,0,1,1,1,0.0,-0.19508342575683765
1768,8,89,48,110,128,0,1809.149,94,1336.6329999999996,LESS,642,986,1628,2,2,18.0,1.6873352292140782,18.0,1.571468165481551,2.07721255484529,-0.6225447386899599,238,110,128,1,1.5557121435822359,1.170500554541026,1.8728008872656416,-0.4658392428479469,1.142795996389162,1.142795996389162,1.8728008872656416,1.170500554541026,1,1,1,2,1.8728008872656416,1.170500554541026
1769,8,90,9,59,50,1,2734.632,4,1952.1,LESS,-646,1940,1294,3,1,-9.0,-0.8436676146070391,9.0,0.0,-1.8454829500207937,-0.13497221278079646,109,59,50,0,-1.0171964015730004,-0.8193503881787182,-1.170500554541026,0.3327423163199619,-0.5157379591960027,0.5157379591960027,-1.170500554541026,-0.8193503881787182,0,1,0,0,-0.8193503881787182,-1.170500554541026
1770,8,91,44,110,119,1,2794.365,44,1737.466,LESS,-736,1952,1216,3,1,9.0,0.8436676146070391,9.0,0.0,-0.10206272563586764,-0.10350305592958264,229,110,119,1,1.376206896245824,1.170500554541026,1.5216507209033339,0.3327423163199619,-0.6316293070241586,0.6316293070241586,1.5216507209033339,1.170500554541026,0,1,0,2,1.5216507209033339,1.170500554541026
1771,8,92,2,52,50,0,2546.506,34,871.087,LESS,-612,1290,678,2,1,-2.0,-0.18748169213489754,2.0,-1.222253017596762,-0.5379177817320991,-0.2340826978023337,102,52,50,0,-1.156811593945765,-1.092467184238291,-1.170500554541026,-0.4658392428479469,-0.4719567833498105,0.4719567833498105,-1.170500554541026,-1.092467184238291,0,1,0,0,-1.092467184238291,-1.170500554541026
1772,8,93,8,58,50,1,2131.962,34,1488.057,LESS,48,974,1022,3,2,-8.0,-0.7499267685395902,8.0,-0.17460757394239454,-0.5379177817320991,-0.4524770553221241,108,58,50,0,-1.0371414290548238,-0.8583670733300858,-1.170500554541026,0.3327423163199619,0.3779131007233329,0.3779131007233329,-1.170500554541026,-0.8583670733300858,0,1,1,0,-0.8583670733300858,-1.170500554541026
1773,8,94,44,119,110,0,3849.161,14,718.732,LESS,-678,2292,1614,4,1,-9.0,-0.8436676146070391,9.0,0.0,-1.409627893924562,0.452195482065045,229,119,110,0,1.376206896245824,1.5216507209033339,1.170500554541026,1.1313238754878707,-0.5569437717571248,0.5569437717571248,1.170500554541026,1.5216507209033339,0,1,0,2,1.5216507209033339,1.170500554541026
1774,8,95,34,74,80,0,3392.605,24,1606.112,LESS,-520,1688,1168,4,1,6.0,0.5624450764046927,6.0,-0.5238227218271837,-0.9737728378283306,0.2116679281942727,154,74,80,1,-0.11967016489094122,-0.2341001109082052,0.0,1.1313238754878707,-0.35349007223658446,0.35349007223658446,0.0,-0.2341001109082052,0,1,1,1,-0.2341001109082052,0.0
1775,8,96,24,86,80,0,3605.734,24,1196.431,LESS,-20,1620,1600,4,1,-6.0,-0.5624450764046927,6.0,-0.5238227218271837,-0.9737728378283306,0.3239507522704513,166,86,80,0,0.11967016489094122,0.2341001109082052,0.0,1.1313238754878707,0.29035074903094843,0.29035074903094843,0.0,0.2341001109082052,0,1,1,1,0.2341001109082052,0.0
1776,8,97,39,66,80,0,2144.74,24,1328.295,LESS,-474,1196,722,2,1,14.0,1.3123718449442827,14.0,0.8730378697119728,-0.9737728378283306,-0.44574521720508986,146,66,80,1,-0.2792303847455295,-0.5462335921191455,0.0,-0.4658392428479469,-0.2942567166799715,0.2942567166799715,0.0,-0.5462335921191455,0,0,1,1,-0.5462335921191455,0.0
1777,8,98,9,50,59,0,2174.261,54,2555.75,LESS,-2094,2640,546,2,1,9.0,0.8436676146070391,9.0,0.0,0.3337923304603639,-0.4301926586628319,109,50,59,1,-1.0171964015730004,-1.170500554541026,-0.8193503881787182,-0.4658392428479469,-2.3803009775867783,2.3803009775867783,-0.8193503881787182,-1.170500554541026,1,0,0,0,-1.170500554541026,-0.8193503881787182
1778,8,99,57,94,110,0,1571.94,54,1430.328,LESS,-662,1156,494,2,1,16.0,1.4998535370791803,16.0,1.222253017596762,0.3337923304603639,-0.7475136374146114,204,94,110,1,0.8775812092002355,0.5462335921191455,1.170500554541026,-0.4658392428479469,-0.5363408654765638,0.5363408654765638,1.170500554541026,0.5462335921191455,1,0,0,2,1.170500554541026,0.5462335921191455
1779,8,100,60,110,87,0,1742.6370000000004,4,1298.982,LESS,-1222,1798,576,2,1,-23.0,-2.1560394595513217,23.0,2.444506035193524,-1.8454829500207937,-0.6575852784332832,197,110,87,0,0.7379660168274708,1.170500554541026,0.27311679605957273,-0.4658392428479469,-1.2574425852962008,1.2574425852962008,0.27311679605957273,1.170500554541026,0,0,0,2,1.170500554541026,0.27311679605957273
1780,8,101,33,75,80,1,2352.831,54,916.648,LESS,44,1108,1152,3,2,5.0,0.4687042303372438,5.0,-0.6984302957695783,0.3337923304603639,-0.33611656439465043,155,75,80,1,-0.09972513740911768,-0.19508342575683765,0.0,0.3327423163199619,0.37276237415319263,0.37276237415319263,0.0,-0.19508342575683765,1,1,1,1,-0.19508342575683765,0.0
1781,8,102,15,50,45,1,6759.439,64,1476.461,LESS,444,2758,3202,6,2,-5.0,-0.4687042303372438,5.0,-0.6984302957695783,0.7696473865565954,1.9854182377049303,95,50,45,0,-1.2964267863185297,-1.170500554541026,-1.3655839802978638,2.7284869938236884,0.887835031167219,0.887835031167219,-1.3655839802978638,-1.170500554541026,1,1,1,0,-1.170500554541026,-1.3655839802978638
1782,8,103,59,89,110,0,2251.397,24,965.516,LESS,-738,1502,764,2,1,21.0,1.9685577674164243,21.0,2.0952908873087353,-0.9737728378283306,-0.38955507336031503,199,89,110,1,0.7778560717911179,0.3511501663623078,1.170500554541026,-0.4658392428479469,-0.6342046703092288,0.6342046703092288,1.170500554541026,0.3511501663623078,0,0,0,2,1.170500554541026,0.3511501663623078
1783,8,104,29,80,94,0,2173.127,24,1355.405,LESS,-626,1404,778,2,1,14.0,1.3123718449442827,14.0,0.8730378697119728,-0.9737728378283306,-0.4307900842712775,174,80,94,1,0.2792303847455295,0.0,0.5462335921191455,-0.4658392428479469,-0.4899843263453014,0.4899843263453014,0.5462335921191455,0.0,0,0,0,1,0.5462335921191455,0.0
1784,8,105,55,110,98,1,1704.156,14,1225.832,LESS,-78,994,916,1,1,-12.0,-1.124890152809385,12.0,0.5238227218271837,-1.409627893924562,-0.6778582368447404,208,110,98,0,0.9573613191275298,1.170500554541026,0.7023003327246156,-1.2644208020158558,0.2156652137639146,0.2156652137639146,0.7023003327246156,1.170500554541026,0,0,1,2,1.170500554541026,0.7023003327246156
1785,8,106,29,94,80,1,1743.33,64,1941.259,LESS,-162,1230,1068,1,1,-14.0,-1.3123718449442827,14.0,0.8730378697119728,0.7696473865565954,-0.6572201850059001,174,94,80,0,0.2792303847455295,0.5462335921191455,0.0,-1.2644208020158558,0.10749995579096906,0.10749995579096906,0.0,0.5462335921191455,1,0,1,1,0.5462335921191455,0.0
1786,8,107,57,110,94,1,1646.439,64,1105.614,LESS,526,428,954,1,2,-16.0,-1.4998535370791803,16.0,1.222253017596762,0.7696473865565954,-0.7082653037253845,204,110,94,0,0.8775812092002355,1.170500554541026,0.5462335921191455,-1.2644208020158558,0.9934249258550943,0.9934249258550943,0.5462335921191455,1.170500554541026,1,0,1,2,1.170500554541026,0.5462335921191455
1787,8,108,39,80,66,1,2039.622,24,1849.381,LESS,272,576,848,1,2,-14.0,-1.3123718449442827,14.0,0.8730378697119728,-0.9737728378283306,-0.5011245691526883,146,80,66,0,-0.2792303847455295,0.0,-0.5462335921191455,-1.2644208020158558,0.6663537886511877,0.6663537886511877,-0.5462335921191455,0.0,0,0,1,1,0.0,-0.5462335921191455
1788,8,109,4,50,54,0,1675.7420000000004,4,1559.547,LESS,-1734,2300,566,2,1,4.0,0.3749633842697951,4.0,-0.8730378697119728,-1.8454829500207937,-0.6928275941978012,104,50,54,1,-1.116921538982118,-1.170500554541026,-1.0144338139355558,-0.4658392428479469,-1.9167355862741544,1.9167355862741544,-1.0144338139355558,-1.170500554541026,0,0,0,0,-1.170500554541026,-1.0144338139355558
1789,8,110,55,98,110,0,1763.484,74,1363.2220000000002,LESS,-446,1026,580,2,1,12.0,1.124890152809385,12.0,0.5238227218271837,1.2055024426528271,-0.646602446282257,208,98,110,1,0.9573613191275298,0.7023003327246156,1.170500554541026,-0.4658392428479469,-0.25820163068898966,0.25820163068898966,1.170500554541026,0.7023003327246156,1,0,1,2,1.170500554541026,0.7023003327246156
1790,8,111,2,50,52,0,2261.381,74,1023.498,LESS,-668,1382,714,2,1,2.0,0.18748169213489754,2.0,-1.222253017596762,1.2055024426528271,-0.3842951992203503,102,50,52,1,-1.156811593945765,-1.170500554541026,-1.092467184238291,-0.4658392428479469,-0.5440669553317742,0.5440669553317742,-1.092467184238291,-1.170500554541026,1,0,0,0,-1.170500554541026,-1.092467184238291
1791,8,112,59,110,89,1,2515.522,54,996.82,LESS,296,970,1266,3,2,-21.0,-1.9685577674164243,21.0,2.0952908873087353,0.3337923304603639,-0.2504060091357342,199,110,89,0,0.7778560717911179,1.170500554541026,0.3511501663623078,0.3327423163199619,0.6972581480720292,0.6972581480720292,0.3511501663623078,1.170500554541026,0,1,1,2,1.170500554541026,0.3511501663623078
1792,8,113,60,87,110,1,3370.842,14,1704.864,LESS,-490,2014,1524,5,1,23.0,2.1560394595513217,23.0,2.444506035193524,-1.409627893924562,0.2002025194494756,197,87,110,1,0.7379660168274708,0.27311679605957273,1.170500554541026,1.9299054346557796,-0.31485962296053255,0.31485962296053255,1.170500554541026,0.27311679605957273,0,1,1,2,1.170500554541026,0.27311679605957273
1793,8,114,52,110,105,1,2468.761,14,1357.8270000000002,LESS,18,1202,1220,3,1,-5.0,-0.4687042303372438,5.0,-0.6984302957695783,-1.409627893924562,-0.27504112278346016,215,110,105,0,1.0969765115002945,1.170500554541026,0.9754171287841883,0.3327423163199619,0.3392826514472809,0.3392826514472809,0.9754171287841883,1.170500554541026,0,1,1,2,1.170500554541026,0.9754171287841883
1794,8,115,30,80,96,0,1909.49,64,1325.891,LESS,-560,1120,560,2,1,16.0,1.4998535370791803,16.0,1.222253017596762,0.7696473865565954,-0.5696820552886965,176,80,96,1,0.3191204397091766,0.0,0.6242669624218805,-0.4658392428479469,-0.4049973379379871,0.4049973379379871,0.6242669624218805,0.0,1,0,0,1,0.6242669624218805,0.0
1795,8,116,24,80,86,0,4207.208,14,2860.326,LESS,-1276,2840,1564,4,1,6.0,0.5624450764046927,6.0,-0.5238227218271837,-1.409627893924562,0.6408255057220954,166,80,86,1,0.11967016489094122,0.0,0.2341001109082052,1.1313238754878707,-1.3269773939930942,1.3269773939930942,0.2341001109082052,0.0,0,1,0,1,0.2341001109082052,0.0
1796,8,117,5,50,55,0,1917.889,74,1653.066,LESS,8,1178,1186,2,2,5.0,0.4687042303372438,5.0,-0.6984302957695783,1.2055024426528271,-0.5652572072416648,105,50,55,1,-1.0969765115002945,-1.170500554541026,-0.9754171287841883,-0.4658392428479469,0.32640583502193027,0.32640583502193027,-0.9754171287841883,-1.170500554541026,1,0,1,0,-1.170500554541026,-0.9754171287841883
1797,8,118,34,80,74,0,2471.071,64,1116.823,LESS,-1100,1582,482,2,1,-6.0,-0.5624450764046927,6.0,-0.5238227218271837,0.7696473865565954,-0.27382414469218225,154,80,74,0,-0.11967016489094122,0.0,-0.2341001109082052,-0.4658392428479469,-1.1003454249069227,1.1003454249069227,-0.2341001109082052,0.0,1,0,0,1,0.0,-0.2341001109082052
1798,8,119,15,45,50,0,2157.019,64,1612.639,LESS,-368,1082,714,2,1,5.0,0.4687042303372438,5.0,-0.6984302957695783,0.7696473865565954,-0.4392762674289852,95,45,50,1,-1.2964267863185297,-1.3655839802978638,-1.170500554541026,-0.4658392428479469,-0.1577624625712545,0.1577624625712545,-1.170500554541026,-1.3655839802978638,1,0,1,0,-1.3655839802978638,-1.170500554541026
1799,8,120,37,69,80,0,2608.648,4,2193.084,LESS,-1706,2318,612,2,1,11.0,1.0311493067419364,11.0,0.34921514788478913,-1.8454829500207937,-0.20134440665592976,149,69,80,1,-0.21939530230005888,-0.4291835366650429,0.0,-0.4658392428479469,-1.8806805002831726,1.8806805002831726,0.0,-0.4291835366650429,0,0,0,1,-0.4291835366650429,0.0
1800,8,121,48,128,110,1,3815.021,24,1784.456,MORE,1436,1018,2454,4,2,-18.0,-1.6873352292140782,18.0,1.571468165481551,-0.9737728378283306,0.434209494170574,238,128,110,1,1.5557121435822359,1.8728008872656416,1.170500554541026,1.1313238754878707,2.165215220562004,2.165215220562004,1.170500554541026,1.8728008872656416,0,1,1,2,1.8728008872656416,1.170500554541026
1801,8,122,8,50,58,1,1408.148,74,1192.008,MORE,1026,524,1550,1,2,8.0,0.7499267685395902,8.0,-0.17460757394239454,1.2055024426528271,-0.8338042328806694,108,50,58,0,-1.0371414290548238,-1.170500554541026,-0.8583670733300858,-1.2644208020158558,1.6372657471226273,1.6372657471226273,-0.8583670733300858,-1.170500554541026,1,0,1,0,-1.170500554541026,-0.8583670733300858
1802,8,123,4,54,50,1,1627.54,24,1544.582,MORE,550,472,1022,1,2,-4.0,-0.3749633842697951,4.0,-0.8730378697119728,-0.9737728378283306,-0.7182218703691341,104,54,50,1,-1.116921538982118,-1.0144338139355558,-1.170500554541026,-1.2644208020158558,1.024329285275936,1.024329285275936,-1.170500554541026,-1.0144338139355558,0,0,1,0,-1.0144338139355558,-1.170500554541026
1803,8,124,37,80,69,0,2892.416,14,2010.363,MORE,-554,2082,1528,2,1,-11.0,-1.0311493067419364,11.0,0.34921514788478913,-1.409627893924562,-0.05184681401274617,149,80,69,1,-0.21939530230005888,0.0,-0.4291835366650429,-0.4658392428479469,-0.3972712480827767,0.3972712480827767,-0.4291835366650429,0.0,0,0,0,1,0.0,-0.4291835366650429
1804,8,125,52,105,110,1,2685.763,14,1823.105,MORE,142,1592,1734,3,1,5.0,0.4687042303372438,5.0,-0.6984302957695783,-1.409627893924562,-0.16071788479060645,215,105,110,0,1.0969765115002945,0.9754171287841883,1.170500554541026,0.3327423163199619,0.4989551751216291,0.4989551751216291,1.170500554541026,0.9754171287841883,0,1,1,2,1.170500554541026,0.9754171287841883
1805,8,126,5,55,50,0,6899.6680000000015,14,1110.34,MORE,-858,3910,3052,6,1,-5.0,-0.4687042303372438,5.0,-0.6984302957695783,-1.409627893924562,2.059295129809612,105,55,50,1,-1.0969765115002945,-0.9754171287841883,-1.170500554541026,2.7284869938236884,-0.7887264674134368,0.7887264674134368,-1.170500554541026,-0.9754171287841883,0,1,0,0,-0.9754171287841883,-1.170500554541026
1806,8,127,30,96,80,1,3338.149000000001,54,1909.693,MORE,488,1330,1818,3,2,-16.0,-1.4998535370791803,16.0,1.222253017596762,0.3337923304603639,0.18297885506066675,176,96,80,1,0.3191204397091766,0.6242669624218805,0.0,0.3327423163199619,0.9444930234387618,0.9444930234387618,0.0,0.6242669624218805,1,1,1,1,0.6242669624218805,0.0
1807,8,128,33,80,75,0,5372.894,4,1140.248,MORE,-1332,3548,2216,4,1,-5.0,-0.4687042303372438,5.0,-0.6984302957695783,-1.8454829500207937,1.254944260401489,155,80,75,1,-0.09972513740911768,0.0,-0.19508342575683765,1.1313238754878707,-1.399087565975058,1.399087565975058,-0.19508342575683765,0.0,0,1,0,1,0.0,-0.19508342575683765
1808,8,129,48,110,128,1,8255.298,44,1500.945,MORE,-410,2460,2050,5,2,18.0,1.6873352292140782,18.0,1.571468165481551,-0.10206272563586764,2.773482147073288,238,110,128,0,1.5557121435822359,1.170500554541026,1.8728008872656416,1.9299054346557796,-0.21184509155772727,0.21184509155772727,1.8728008872656416,1.170500554541026,0,1,0,2,1.8728008872656416,1.170500554541026
1809,8,130,9,59,50,0,2263.993,44,2629.106,MORE,-1078,2168,1090,4,1,-9.0,-0.8436676146070391,9.0,0.0,-0.10206272563586764,-0.3829191183656238,109,59,50,1,-1.0171964015730004,-0.8193503881787182,-1.170500554541026,1.1313238754878707,-1.072016428771151,1.072016428771151,-1.170500554541026,-0.8193503881787182,0,1,0,0,-0.8193503881787182,-1.170500554541026
1810,8,131,44,110,119,1,2397.12,64,863.2280000000002,MORE,354,882,1236,3,2,9.0,0.8436676146070391,9.0,0.0,0.7696473865565954,-0.3127837753536947,229,110,119,0,1.376206896245824,1.170500554541026,1.5216507209033339,0.3327423163199619,0.771943683339063,0.771943683339063,1.5216507209033339,1.170500554541026,1,1,1,2,1.5216507209033339,1.170500554541026
1811,8,132,2,52,50,0,2290.511,34,3672.838,MORE,-872,1600,728,2,1,-2.0,-0.18748169213489754,2.0,-1.222253017596762,-0.5379177817320991,-0.3689486313420273,102,52,50,1,-1.156811593945765,-1.092467184238291,-1.170500554541026,-0.4658392428479469,-0.8067540104089277,0.8067540104089277,-1.170500554541026,-1.092467184238291,0,0,0,0,-1.092467184238291,-1.170500554541026
1812,8,133,8,58,50,0,3064.158,14,936.646,MORE,-826,1990,1164,3,1,-8.0,-0.7499267685395902,8.0,-0.17460757394239454,-1.409627893924562,0.038632082676540835,108,58,50,1,-1.0371414290548238,-0.8583670733300858,-1.170500554541026,0.3327423163199619,-0.7475206548523146,0.7475206548523146,-1.170500554541026,-0.8583670733300858,0,1,0,0,-0.8583670733300858,-1.170500554541026
1813,8,134,44,119,110,1,3191.691,34,1512.461,MORE,600,1222,1822,3,2,-9.0,-0.8436676146070391,9.0,0.0,-0.5379177817320991,0.10582033675227563,229,119,110,1,1.376206896245824,1.5216507209033339,1.170500554541026,0.3327423163199619,1.0887133674026892,1.0887133674026892,1.170500554541026,1.5216507209033339,0,1,1,2,1.5216507209033339,1.170500554541026
1814,8,135,34,74,80,1,1773.727,24,1601.635,MORE,-24,1078,1054,2,1,6.0,0.5624450764046927,6.0,-0.5238227218271837,-0.9737728378283306,-0.6412061230835729,154,74,80,0,-0.11967016489094122,-0.2341001109082052,0.0,-0.4658392428479469,0.28520002246080817,0.28520002246080817,0.0,-0.2341001109082052,0,0,0,1,-0.2341001109082052,0.0
1815,8,136,24,86,80,0,5151.366,64,1782.739,MORE,-906,3150,2244,2,1,-6.0,-0.5624450764046927,6.0,-0.5238227218271837,0.7696473865565954,1.1382365882782786,166,86,80,1,0.11967016489094122,0.2341001109082052,0.0,-0.4658392428479469,-0.8505351862551199,0.8505351862551199,0.0,0.2341001109082052,1,0,0,1,0.2341001109082052,0.0
1816,8,137,39,66,80,1,3350.238,34,3228.813,MORE,654,1254,1908,3,1,14.0,1.3123718449442827,14.0,0.8730378697119728,-0.5379177817320991,0.18934770707168735,146,66,80,0,-0.2792303847455295,-0.5462335921191455,0.0,0.3327423163199619,1.1582481760995829,1.1582481760995829,0.0,-0.5462335921191455,0,1,1,1,-0.5462335921191455,0.0
1817,8,138,9,50,59,1,1429.8670000000004,84,1076.9589999999996,MORE,432,532,964,1,2,9.0,0.8436676146070391,9.0,0.0,1.6413574987490585,-0.8223620046709439,109,50,59,0,-1.0171964015730004,-1.170500554541026,-0.8193503881787182,-1.2644208020158558,0.8723828514567982,0.8723828514567982,-0.8193503881787182,-1.170500554541026,1,0,1,0,-1.170500554541026,-0.8193503881787182
1818,8,139,57,94,110,1,2588.006,64,1119.055,MORE,158,1072,1230,3,2,16.0,1.4998535370791803,16.0,1.222253017596762,0.7696473865565954,-0.21221923858673464,204,94,110,0,0.8775812092002355,0.5462335921191455,1.170500554541026,0.3327423163199619,0.5195580814021902,0.5195580814021902,1.170500554541026,0.5462335921191455,1,1,1,2,1.170500554541026,0.5462335921191455
1819,8,140,60,110,87,1,3949.258,24,2999.515,MORE,324,2296,2620,3,1,-23.0,-2.1560394595513217,23.0,2.444506035193524,-0.9737728378283306,0.5049296188627274,197,110,87,1,0.7379660168274708,1.170500554541026,0.27311679605957273,0.3327423163199619,0.7333132340630111,0.7333132340630111,0.27311679605957273,1.170500554541026,0,1,1,2,1.170500554541026,0.27311679605957273
1820,8,141,33,75,80,0,2819.317,54,1258.794,MORE,-576,1350,774,1,1,5.0,0.4687042303372438,5.0,-0.6984302957695783,0.3337923304603639,-0.09035758522241076,155,75,80,0,-0.09972513740911768,-0.19508342575683765,0.0,-1.2644208020158558,-0.42560024421854814,0.42560024421854814,0.0,-0.19508342575683765,1,0,0,1,-0.19508342575683765,0.0
1821,8,142,15,50,45,0,2724.465,64,937.57,MORE,-630,1482,852,2,1,-5.0,-0.4687042303372438,5.0,-0.6984302957695783,0.7696473865565954,-0.1403284968734469,95,50,45,1,-1.2964267863185297,-1.170500554541026,-1.3655839802978638,-0.4658392428479469,-0.4951350529154417,0.4951350529154417,-1.3655839802978638,-1.170500554541026,1,0,0,0,-1.170500554541026,-1.3655839802978638
1822,8,143,59,89,110,1,1768.763,64,1817.318,MORE,546,488,1034,1,2,21.0,1.9685577674164243,21.0,2.0952908873087353,0.7696473865565954,-0.6438213089039643,199,89,110,0,0.7778560717911179,0.3511501663623078,1.170500554541026,-1.2644208020158558,1.0191785587057958,1.0191785587057958,1.170500554541026,0.3511501663623078,1,0,1,2,1.170500554541026,0.3511501663623078
1823,8,144,29,80,94,1,2662.831,74,1375.0220000000004,MORE,136,1136,1272,3,2,14.0,1.3123718449442827,14.0,0.8730378697119728,1.2055024426528271,-0.17279915820583808,174,80,94,0,0.2792303847455295,0.0,0.5462335921191455,0.3327423163199619,0.49122908526641873,0.49122908526641873,0.5462335921191455,0.0,1,1,0,1,0.5462335921191455,0.0
1824,8,145,55,110,98,0,2720.735,14,1484.5839999999996,MORE,-1718,2434,716,2,1,-12.0,-1.124890152809385,12.0,0.5238227218271837,-1.409627893924562,-0.1422935740511381,208,110,98,1,0.9573613191275298,1.170500554541026,0.7023003327246156,-0.4658392428479469,-1.8961326799935934,1.8961326799935934,0.7023003327246156,1.170500554541026,0,0,0,2,1.170500554541026,0.7023003327246156
1825,8,146,29,94,80,0,2168.314,14,1136.924,MORE,-914,1512,598,2,1,-14.0,-1.3123718449442827,14.0,0.8730378697119728,-1.409627893924562,-0.4333257187099445,174,94,80,1,0.2792303847455295,0.5462335921191455,0.0,-0.4658392428479469,-0.8608366393954004,0.8608366393954004,0.0,0.5462335921191455,0,0,0,1,0.5462335921191455,0.0
1826,8,147,57,110,94,0,2177.405,14,2861.682,MORE,-1478,2610,1132,2,1,-16.0,-1.4998535370791803,16.0,1.222253017596762,-1.409627893924562,-0.4285363040658717,204,110,94,1,0.8775812092002355,1.170500554541026,0.5462335921191455,-0.4658392428479469,-1.5870890857851776,1.5870890857851776,0.5462335921191455,1.170500554541026,0,0,0,2,1.170500554541026,0.5462335921191455
1827,8,148,39,80,66,1,2734.053,34,1367.9820000000002,MORE,234,1054,1288,3,2,-14.0,-1.3123718449442827,14.0,0.8730378697119728,-0.5379177817320991,-0.13527724754912984,146,80,66,1,-0.2792303847455295,0.0,-0.5462335921191455,0.3327423163199619,0.6174218862348552,0.6174218862348552,-0.5462335921191455,0.0,0,1,1,1,0.0,-0.5462335921191455
1828,8,149,4,50,54,1,7071.145,24,849.0360000000002,MORE,-1642,4182,2540,4,1,4.0,0.3749633842697951,4.0,-0.8730378697119728,-0.9737728378283306,2.149634416458124,104,50,54,0,-1.116921538982118,-1.170500554541026,-1.0144338139355558,1.1313238754878707,-1.7982688751609284,1.7982688751609284,-1.0144338139355558,-1.170500554541026,0,1,0,0,-1.170500554541026,-1.0144338139355558
1829,8,150,55,98,110,1,3290.315,64,2344.618,MORE,758,1134,1892,2,1,12.0,1.124890152809385,12.0,0.5238227218271837,0.7696473865565954,0.15777845245539007,208,98,110,0,0.9573613191275298,0.7023003327246156,1.170500554541026,-0.4658392428479469,1.2921670669232297,1.2921670669232297,1.170500554541026,0.7023003327246156,1,0,1,2,1.170500554541026,0.7023003327246156
1830,8,151,2,50,52,1,1529.6629999999998,64,1133.469,MORE,684,428,1112,1,2,2.0,0.18748169213489754,2.0,-1.222253017596762,0.7696473865565954,-0.7697864438063677,102,50,52,0,-1.156811593945765,-1.170500554541026,-1.092467184238291,-1.2644208020158558,1.1968786253756347,1.1968786253756347,-1.092467184238291,-1.170500554541026,1,0,1,0,-1.170500554541026,-1.092467184238291
1831,8,152,59,110,89,0,6277.281999999998,44,1032.306,MORE,-110,2914,2804,2,1,-21.0,-1.9685577674164243,21.0,2.0952908873087353,-0.10206272563586764,1.7314033002346743,199,110,89,1,0.7778560717911179,1.170500554541026,0.3511501663623078,-0.4658392428479469,0.1744594012027925,0.1744594012027925,0.3511501663623078,1.170500554541026,0,0,0,2,1.170500554541026,0.3511501663623078
1832,8,153,60,87,110,1,3580.2670000000007,24,1158.812,MORE,630,1312,1942,3,2,23.0,2.1560394595513217,23.0,2.444506035193524,-0.9737728378283306,0.31053396393686955,197,87,110,0,0.7379660168274708,0.27311679605957273,1.170500554541026,0.3327423163199619,1.1273438166787413,1.1273438166787413,1.170500554541026,0.27311679605957273,0,1,1,2,1.170500554541026,0.27311679605957273
1833,8,154,52,110,105,0,2067.7270000000008,74,2588.152,MORE,616,1252,1868,2,2,-5.0,-0.4687042303372438,5.0,-0.6984302957695783,1.2055024426528271,-0.4863180023754733,215,110,105,1,1.0969765115002945,1.170500554541026,0.9754171287841883,-0.4658392428479469,1.1093162736832503,1.1093162736832503,0.9754171287841883,1.170500554541026,1,0,1,2,1.170500554541026,0.9754171287841883
1834,8,155,30,80,96,1,2687.155,54,1555.828,MORE,538,1278,1816,3,2,16.0,1.4998535370791803,16.0,1.222253017596762,0.3337923304603639,-0.15998453695378426,176,80,96,0,0.3191204397091766,0.0,0.6242669624218805,0.3327423163199619,1.0088771055655152,1.0088771055655152,0.6242669624218805,0.0,1,1,1,1,0.6242669624218805,0.0
1835,8,156,24,80,86,1,2634.212,64,1402.294,MORE,-152,1258,1106,3,2,6.0,0.5624450764046927,6.0,-0.5238227218271837,0.7696473865565954,-0.1878765157791208,166,80,86,0,0.11967016489094122,0.0,0.2341001109082052,0.3327423163199619,0.12037677221631972,0.12037677221631972,0.2341001109082052,0.0,1,1,0,1,0.2341001109082052,0.0
1836,8,157,5,50,55,1,5321.699000000001,14,916.803,MORE,-1202,3108,1906,5,1,5.0,0.4687042303372438,5.0,-0.6984302957695783,-1.409627893924562,1.2279731810149213,105,50,55,0,-1.0969765115002945,-1.170500554541026,-0.9754171287841883,1.9299054346557796,-1.2316889524454993,1.2316889524454993,-0.9754171287841883,-1.170500554541026,0,1,0,0,-1.170500554541026,-0.9754171287841883
1837,8,158,34,80,74,0,6242.055,24,2113.855,MORE,-942,3384,2442,2,2,-6.0,-0.5624450764046927,6.0,-0.5238227218271837,-0.9737728378283306,1.712844647757858,154,80,74,1,-0.11967016489094122,0.0,-0.2341001109082052,-0.4658392428479469,-0.8968917253863823,0.8968917253863823,-0.2341001109082052,0.0,0,0,0,1,0.0,-0.2341001109082052
1838,8,159,15,45,50,1,3841.281,44,1440.598,MORE,682,1244,1926,2,1,5.0,0.4687042303372438,5.0,-0.6984302957695783,-0.10206272563586764,0.44804405896579386,95,45,50,0,-1.2964267863185297,-1.3655839802978638,-1.170500554541026,-0.4658392428479469,1.1943032620905647,1.1943032620905647,-1.170500554541026,-1.3655839802978638,0,1,1,0,-1.3655839802978638,-1.170500554541026
1839,8,160,37,69,80,1,1794.3270000000002,74,1269.576,MORE,722,458,1180,1,2,11.0,1.0311493067419364,11.0,0.34921514788478913,1.2055024426528271,-0.6303534180271552,149,69,80,0,-0.21939530230005888,-0.4291835366650429,0.0,-1.2644208020158558,1.2458105277919673,1.2458105277919673,0.0,-0.4291835366650429,1,0,1,1,-0.4291835366650429,0.0
1840,8,161,3,50,53,0,5953.334,64,2403.66,LESS,-1472,2358,886,3,1,3.0,0.28122253820234633,3.0,-1.0476454436543674,0.7696473865565954,1.560737664428051,103,50,53,1,-1.1368665664639415,-1.170500554541026,-1.0534504990869233,0.3327423163199619,-1.579362995929967,1.579362995929967,-1.0534504990869233,-1.170500554541026,1,1,0,0,-1.170500554541026,-1.0534504990869233
1841,8,162,20,50,40,1,1816.584,34,1981.971,LESS,1220,322,1542,1,2,-10.0,-0.9374084606744876,10.0,0.17460757394239454,-0.5379177817320991,-0.6186277550931409,90,50,40,0,-1.3961519237276474,-1.170500554541026,-1.5606674060547012,-1.2644208020158558,1.8870759857744301,1.8870759857744301,-1.5606674060547012,-1.170500554541026,0,0,1,0,-1.170500554541026,-1.5606674060547012
1842,8,163,25,80,88,0,1597.207,94,939.532,LESS,158,1000,1158,2,2,8.0,0.7499267685395902,8.0,-0.17460757394239454,2.07721255484529,-0.7342022151495381,168,80,88,1,0.1595602198545883,0.0,0.31213348121094026,-0.4658392428479469,0.5195580814021902,0.5195580814021902,0.31213348121094026,0.0,1,0,1,1,0.31213348121094026,0.0
1843,8,164,42,115,110,1,2356.35,14,1010.61,LESS,1798,292,2090,1,2,-5.0,-0.4687042303372438,5.0,-0.6984302957695783,-1.409627893924562,-0.33426264841923625,225,115,110,0,1.2964267863185297,1.3655839802978638,1.170500554541026,-1.2644208020158558,2.631355975159698,2.631355975159698,1.170500554541026,1.3655839802978638,0,0,1,2,1.3655839802978638,1.170500554541026
1844,8,165,53,103,110,0,1568.646,34,1458.519,LESS,-534,968,434,2,1,7.0,0.6561859224721414,7.0,-0.34921514788478913,-0.5379177817320991,-0.7492490165629532,213,103,110,1,1.0570864565366473,0.8973837584814532,1.170500554541026,-0.4658392428479469,-0.3715176152320754,0.3715176152320754,1.170500554541026,0.8973837584814532,0,0,0,2,1.170500554541026,0.8973837584814532
1845,8,166,26,90,80,0,1684.2020000000002,24,1153.275,LESS,-1104,1512,408,2,1,-10.0,-0.9374084606744876,10.0,0.17460757394239454,-0.9737728378283306,-0.6883706094998744,170,90,80,0,0.19945027481823535,0.3901668515136753,0.0,-0.4658392428479469,-1.105496151477063,1.105496151477063,0.0,0.3901668515136753,0,0,0,1,0.3901668515136753,0.0
1846,8,167,35,80,72,0,1487.091,34,1731.004,LESS,-872,1294,422,2,1,-8.0,-0.7499267685395902,8.0,-0.17460757394239454,-0.5379177817320991,-0.7922146651491745,152,80,72,0,-0.1595602198545883,0.0,-0.31213348121094026,-0.4658392428479469,-0.8067540104089277,0.8067540104089277,-0.31213348121094026,0.0,0,0,0,1,0.0,-0.31213348121094026
1847,8,168,28,93,80,0,1492.9720000000002,24,654.325,LESS,-808,1232,424,2,1,-13.0,-1.218630998876834,13.0,0.6984302957695783,-0.9737728378283306,-0.7891163759046698,173,93,80,0,0.25928535726370594,0.5072169069677779,0.0,-0.4658392428479469,-0.7243423852866834,0.7243423852866834,0.0,0.5072169069677779,0,0,0,1,0.5072169069677779,0.0
1848,8,169,26,80,90,0,1482.4920000000004,74,1403.4720000000002,LESS,-396,928,532,2,1,10.0,0.9374084606744876,10.0,0.17460757394239454,1.2055024426528271,-0.7946375578945366,170,80,90,1,0.19945027481823535,0.0,0.3901668515136753,-0.4658392428479469,-0.19381754856223635,0.19381754856223635,0.3901668515136753,0.0,1,0,1,1,0.3901668515136753,0.0
1849,8,170,25,88,80,1,1957.235,74,1242.813,LESS,440,728,1168,3,2,-8.0,-0.7499267685395902,8.0,-0.17460757394239454,1.2055024426528271,-0.5445285405839068,168,88,80,0,0.1595602198545883,0.31213348121094026,0.0,0.3327423163199619,0.8826843045970787,0.8826843045970787,0.0,0.31213348121094026,1,1,1,1,0.31213348121094026,0.0
1850,8,171,36,80,70,1,1489.436,64,1964.742,LESS,-494,1450,956,1,1,-10.0,-0.9374084606744876,10.0,0.17460757394239454,0.7696473865565954,-0.7909792479959075,150,80,70,0,-0.19945027481823535,0.0,-0.3901668515136753,-1.2644208020158558,-0.3200103495306728,0.3200103495306728,-0.3901668515136753,0.0,1,0,1,1,0.0,-0.3901668515136753
1851,8,172,28,80,93,0,1604.745,14,1969.499,LESS,-1002,1736,734,2,1,13.0,1.218630998876834,13.0,0.6984302957695783,-1.409627893924562,-0.7302309680274374,173,80,93,1,0.25928535726370594,0.0,0.5072169069677779,-0.4658392428479469,-0.9741526239384862,0.9741526239384862,0.5072169069677779,0.0,0,0,0,1,0.5072169069677779,0.0
1852,8,173,21,82,80,0,1681.695,24,1166.53,LESS,-578,1120,542,2,1,-2.0,-0.18748169213489754,2.0,-1.222253017596762,-0.9737728378283306,-0.6896913731686337,162,82,80,0,0.03989005496364707,0.07803337030273506,0.0,-0.4658392428479469,-0.42817560750361827,0.42817560750361827,0.0,0.07803337030273506,0,0,0,1,0.07803337030273506,0.0
1853,8,174,19,50,41,1,1654.8629999999996,74,725.806,LESS,560,482,1042,1,2,-9.0,-0.8436676146070391,9.0,0.0,1.2055024426528271,-0.7038272849197894,91,50,41,0,-1.376206896245824,-1.170500554541026,-1.5216507209033339,-1.2644208020158558,1.0372061017012866,1.0372061017012866,-1.5216507209033339,-1.170500554541026,1,0,1,0,-1.170500554541026,-1.5216507209033339
1854,8,175,56,96,110,0,1608.159,64,1468.595,LESS,-524,976,452,2,1,14.0,1.3123718449442827,14.0,0.8730378697119728,0.7696473865565954,-0.7284323692379899,206,96,110,1,0.9174712641638826,0.6242669624218805,1.170500554541026,-0.4658392428479469,-0.3586407988067247,0.3586407988067247,1.170500554541026,0.6242669624218805,1,0,1,2,1.170500554541026,0.6242669624218805
1855,8,176,23,80,85,0,1337.638,84,1092.205,LESS,-736,1136,400,2,1,5.0,0.4687042303372438,5.0,-0.6984302957695783,1.6413574987490585,-0.8709510403334859,165,80,85,1,0.09972513740911768,0.0,0.19508342575683765,-0.4658392428479469,-0.6316293070241586,0.6316293070241586,0.19508342575683765,0.0,1,0,0,1,0.19508342575683765,0.0
1856,8,177,10,60,50,1,2440.471,14,827.8480000000002,LESS,-242,1594,1352,3,1,-10.0,-0.9374084606744876,10.0,0.17460757394239454,-1.409627893924562,-0.2899451531740456,110,60,50,0,-0.9972513740911768,-0.7803337030273506,-1.170500554541026,0.3327423163199619,0.004485424388163795,0.004485424388163795,-1.170500554541026,-0.7803337030273506,0,1,1,0,-0.7803337030273506,-1.170500554541026
1857,8,178,19,41,50,0,1575.245,34,1213.155,LESS,-1518,2026,508,2,1,9.0,0.8436676146070391,9.0,0.0,-0.5379177817320991,-0.7457724631325017,91,41,50,1,-1.376206896245824,-1.5216507209033339,-1.170500554541026,-0.4658392428479469,-1.6385963514865802,1.6385963514865802,-1.170500554541026,-1.5216507209033339,0,0,0,0,-1.5216507209033339,-1.170500554541026
1858,8,179,56,110,96,0,2015.823,24,1732.621,LESS,-1658,2160,502,2,1,-14.0,-1.3123718449442827,14.0,0.8730378697119728,-0.9737728378283306,-0.5136626044749062,206,110,96,0,0.9174712641638826,1.170500554541026,0.6242669624218805,-0.4658392428479469,-1.8188717814414894,1.8188717814414894,0.6242669624218805,1.170500554541026,0,0,0,2,1.170500554541026,0.6242669624218805
1859,8,180,35,72,80,0,2109.254,64,1325.034,LESS,-292,1146,854,3,1,8.0,0.7499267685395902,8.0,-0.17460757394239454,0.7696473865565954,-0.4644403187406259,152,72,80,1,-0.1595602198545883,-0.31213348121094026,0.0,0.3327423163199619,-0.059898657738589496,0.059898657738589496,0.0,-0.31213348121094026,1,1,1,1,-0.31213348121094026,0.0
1860,8,181,11,49,50,0,1834.646,54,1063.9,LESS,-778,1196,418,2,1,1.0,0.09374084606744876,1.0,-1.3968605915391563,0.3337923304603639,-0.6091121454461013,99,49,50,1,-1.2166466763912356,-1.2095172396923934,-1.170500554541026,-0.4658392428479469,-0.6857119360106314,0.6857119360106314,-1.170500554541026,-1.2095172396923934,1,0,0,0,-1.2095172396923934,-1.170500554541026
1861,8,182,17,43,50,0,1710.672,54,858.313,LESS,-882,1334,452,2,1,7.0,0.6561859224721414,7.0,-0.34921514788478913,0.3337923304603639,-0.6744254103327201,93,43,50,1,-1.3363168412821769,-1.4436173506005987,-1.170500554541026,-0.4658392428479469,-0.8196308268342783,0.8196308268342783,-1.170500554541026,-1.4436173506005987,1,0,0,0,-1.4436173506005987,-1.170500554541026
1862,8,183,1,51,50,0,1792.779,64,1086.181,LESS,-598,1064,466,2,1,-1.0,-0.09374084606744876,1.0,-1.3968605915391563,0.7696473865565954,-0.6311689513974142,101,51,50,0,-1.1767566214275886,-1.1314838693896585,-1.170500554541026,-0.4658392428479469,-0.4539292403543196,0.4539292403543196,-1.170500554541026,-1.1314838693896585,1,0,0,0,-1.1314838693896585,-1.170500554541026
1863,8,184,41,112,110,0,1716.701,54,1923.709,LESS,-726,1162,436,2,1,-2.0,-0.18748169213489754,2.0,-1.222253017596762,0.3337923304603639,-0.6712491501975191,222,112,110,0,1.2365917038730592,1.248533924843761,1.170500554541026,-0.4658392428479469,-0.618752490598808,0.618752490598808,1.170500554541026,1.248533924843761,1,0,0,2,1.248533924843761,1.170500554541026
1864,8,185,20,40,50,0,1792.024,64,1791.392,LESS,-1740,2204,464,2,1,10.0,0.9374084606744876,10.0,0.17460757394239454,0.7696473865565954,-0.6315667083060355,90,40,50,1,-1.3961519237276474,-1.5606674060547012,-1.170500554541026,-0.4658392428479469,-1.9244616761293647,1.9244616761293647,-1.170500554541026,-1.5606674060547012,1,0,0,0,-1.5606674060547012,-1.170500554541026
1865,8,186,1,50,51,0,3222.881,44,2541.476,LESS,-1800,2974,1174,4,1,1.0,0.09374084606744876,1.0,-1.3968605915391563,-0.10206272563586764,0.12225217513624036,101,50,51,1,-1.1767566214275886,-1.170500554541026,-1.1314838693896585,1.1313238754878707,-2.0017225746814686,2.0017225746814686,-1.1314838693896585,-1.170500554541026,0,1,0,0,-1.170500554541026,-1.1314838693896585
1866,8,187,23,85,80,0,1853.679,44,1158.598,LESS,-1620,1998,378,2,1,-5.0,-0.4687042303372438,5.0,-0.6984302957695783,-0.10206272563586764,-0.5990849835364507,165,85,80,0,0.09972513740911768,0.19508342575683765,0.0,-0.4658392428479469,-1.7699398790251568,1.7699398790251568,0.0,0.19508342575683765,0,0,0,1,0.19508342575683765,0.0
1867,8,188,11,50,49,0,1256.672,64,762.367,LESS,-364,722,358,2,1,-1.0,-0.09374084606744876,1.0,-1.3968605915391563,0.7696473865565954,-0.9136063858479484,99,50,49,0,-1.2166466763912356,-1.170500554541026,-1.2095172396923934,-0.4658392428479469,-0.15261173600111425,0.15261173600111425,-1.2095172396923934,-1.170500554541026,1,0,1,0,-1.170500554541026,-1.2095172396923934
1868,8,189,17,50,43,0,1255.339,34,1198.486,LESS,-588,954,366,2,1,-7.0,-0.6561859224721414,7.0,-0.34921514788478913,-0.5379177817320991,-0.9143086506945604,93,50,43,0,-1.3363168412821769,-1.170500554541026,-1.4436173506005987,-0.4658392428479469,-0.44105242392896893,0.44105242392896893,-1.4436173506005987,-1.170500554541026,0,0,0,0,-1.170500554541026,-1.4436173506005987
1869,8,190,21,80,82,0,1437.8429999999996,64,1345.0870000000002,LESS,-1258,1640,382,2,1,2.0,0.18748169213489754,2.0,-1.222253017596762,0.7696473865565954,-0.8181600058588091,162,80,82,1,0.03989005496364707,0.0,0.07803337030273506,-0.4658392428479469,-1.3037991244274632,1.3037991244274632,0.07803337030273506,0.0,1,0,0,1,0.07803337030273506,0.0
1870,8,191,10,50,60,0,1549.129,64,2070.396,LESS,-854,1254,400,2,1,10.0,0.9374084606744876,10.0,0.17460757394239454,0.7696473865565954,-0.7595311643583953,110,50,60,1,-0.9972513740911768,-1.170500554541026,-0.7803337030273506,-0.4658392428479469,-0.7835757408432965,0.7835757408432965,-0.7803337030273506,-1.170500554541026,1,0,0,0,-1.170500554541026,-0.7803337030273506
1871,8,192,3,53,50,0,1246.492,74,1818.285,LESS,-696,1080,384,2,1,-3.0,-0.28122253820234633,3.0,-1.0476454436543674,1.2055024426528271,-0.918969518735052,103,53,50,0,-1.1368665664639415,-1.0534504990869233,-1.170500554541026,-0.4658392428479469,-0.580122041322756,0.580122041322756,-1.170500554541026,-1.0534504990869233,1,0,0,0,-1.0534504990869233,-1.170500554541026
1872,8,193,45,122,110,1,1726.535,64,1365.902,LESS,-22,1102,1080,3,1,-12.0,-1.124890152809385,12.0,0.5238227218271837,0.7696473865565954,-0.6660683006089357,232,122,110,0,1.4360419786912946,1.6387007763574364,1.170500554541026,0.3327423163199619,0.2877753857458783,0.2877753857458783,1.170500554541026,1.6387007763574364,1,1,1,2,1.6387007763574364,1.170500554541026
1873,8,194,38,67,80,0,1176.152,84,1183.264,LESS,-866,1178,312,2,1,13.0,1.218630998876834,13.0,0.6984302957695783,1.6413574987490585,-0.956026765029636,147,67,80,1,-0.25928535726370594,-0.5072169069677779,0.0,-0.4658392428479469,-0.7990279205537173,0.7990279205537173,0.0,-0.5072169069677779,1,0,0,1,-0.5072169069677779,0.0
1874,8,195,38,80,67,1,1661.2679999999998,74,1349.66,LESS,534,564,1098,1,2,-13.0,-1.218630998876834,13.0,0.6984302957695783,1.2055024426528271,-0.7004529365757914,147,80,67,0,-0.25928535726370594,0.0,-0.5072169069677779,-1.2644208020158558,1.003726378995375,1.003726378995375,-0.5072169069677779,0.0,1,0,1,1,0.0,-0.5072169069677779
1875,8,196,36,70,80,0,1511.4029999999998,54,1078.42,LESS,-796,1164,368,2,1,10.0,0.9374084606744876,10.0,0.17460757394239454,0.3337923304603639,-0.7794063658612314,150,70,80,1,-0.19945027481823535,-0.3901668515136753,0.0,-0.4658392428479469,-0.7088902055762626,0.7088902055762626,0.0,-0.3901668515136753,1,0,0,1,-0.3901668515136753,0.0
1876,8,197,45,110,122,0,1570.601,64,714.5189999999999,LESS,-670,1038,368,2,1,12.0,1.124890152809385,12.0,0.5238227218271837,0.7696473865565954,-0.7482190632432785,232,110,122,1,1.4360419786912946,1.170500554541026,1.6387007763574364,-0.4658392428479469,-0.5466423186168443,0.5466423186168443,1.6387007763574364,1.170500554541026,1,0,0,2,1.6387007763574364,1.170500554541026
1877,8,198,42,110,115,0,1476.527,64,1559.568,LESS,-1330,1744,414,2,1,5.0,0.4687042303372438,5.0,-0.6984302957695783,0.7696473865565954,-0.7977801008878151,225,110,115,1,1.2964267863185297,1.170500554541026,1.3655839802978638,-0.4658392428479469,-1.3965122026899879,1.3965122026899879,1.3655839802978638,1.170500554541026,1,0,0,2,1.3655839802978638,1.170500554541026
1878,8,199,41,110,112,0,1724.697,54,846.373,LESS,-798,1344,546,2,1,2.0,0.18748169213489754,2.0,-1.222253017596762,0.3337923304603639,-0.6670366147785327,222,110,112,1,1.2365917038730592,1.170500554541026,1.248533924843761,-0.4658392428479469,-0.7114655688613327,0.7114655688613327,1.248533924843761,1.170500554541026,1,0,0,2,1.248533924843761,1.170500554541026
1879,8,200,53,110,103,0,1499.0839999999996,64,1907.718,LESS,-134,1110,976,2,2,-7.0,-0.6561859224721414,7.0,-0.34921514788478913,0.7696473865565954,-0.7858963888510379,213,110,103,0,1.0570864565366473,1.170500554541026,0.8973837584814532,-0.4658392428479469,0.14355504178195092,0.14355504178195092,0.8973837584814532,1.170500554541026,1,0,1,2,1.170500554541026,0.8973837584814532
1880,8,201,3,50,53,1,3558.772,74,1706.7620000000004,MORE,30,1380,1410,2,2,3.0,0.28122253820234633,3.0,-1.0476454436543674,1.2055024426528271,0.2992097457238739,103,50,53,0,-1.1368665664639415,-1.170500554541026,-1.0534504990869233,-0.4658392428479469,0.3547348311577017,0.3547348311577017,-1.0534504990869233,-1.170500554541026,1,0,0,0,-1.170500554541026,-1.0534504990869233
1881,8,202,20,50,40,0,2050.16,14,723.459,MORE,-922,1672,750,2,1,-10.0,-0.9374084606744876,10.0,0.17460757394239454,-1.409627893924562,-0.4955728310029539,90,50,40,1,-1.3961519237276474,-1.170500554541026,-1.5606674060547012,-0.4658392428479469,-0.871138092535681,0.871138092535681,-1.5606674060547012,-1.170500554541026,0,0,0,0,-1.170500554541026,-1.5606674060547012
1882,8,203,25,80,88,1,2111.391,14,1002.812,MORE,-666,1624,958,3,1,8.0,0.7499267685395902,8.0,-0.17460757394239454,-1.409627893924562,-0.4633144822986081,168,80,88,0,0.1595602198545883,0.0,0.31213348121094026,0.3327423163199619,-0.541491592046704,0.541491592046704,0.31213348121094026,0.0,0,1,0,1,0.31213348121094026,0.0
1883,8,204,42,115,110,1,1777.964,54,1572.891,MORE,1188,640,1828,3,2,-5.0,-0.4687042303372438,5.0,-0.6984302957695783,0.3337923304603639,-0.6389739429222119,225,115,110,1,1.2964267863185297,1.3655839802978638,1.170500554541026,0.3327423163199619,1.845870173213308,1.845870173213308,1.170500554541026,1.3655839802978638,0,1,1,2,1.3655839802978638,1.170500554541026
1884,8,205,53,103,110,1,2248.647,44,1592.511,MORE,400,1052,1452,3,2,7.0,0.6561859224721414,7.0,-0.34921514788478913,-0.10206272563586764,-0.3910038568023126,213,103,110,0,1.0570864565366473,0.8973837584814532,1.170500554541026,0.3327423163199619,0.8311770388956761,0.8311770388956761,1.170500554541026,0.8973837584814532,0,1,1,2,1.170500554541026,0.8973837584814532
1885,8,206,26,90,80,0,1563.1270000000004,54,1570.025,MORE,-1292,1750,458,2,1,-10.0,-0.9374084606744876,10.0,0.17460757394239454,0.3337923304603639,-0.7521565932234564,170,90,80,1,0.19945027481823535,0.3901668515136753,0.0,-0.4658392428479469,-1.3475803002736553,1.3475803002736553,0.0,0.3901668515136753,0,0,0,1,0.3901668515136753,0.0
1886,8,207,35,80,72,1,2271.978,54,872.1519999999998,MORE,188,1000,1188,3,2,-8.0,-0.7499267685395902,8.0,-0.17460757394239454,0.3337923304603639,-0.3787123780804055,152,80,72,1,-0.1595602198545883,0.0,-0.31213348121094026,0.3327423163199619,0.5581885306782421,0.5581885306782421,-0.31213348121094026,0.0,0,1,1,1,0.0,-0.31213348121094026
1887,8,208,28,93,80,1,2260.891,54,1080.651,MORE,430,882,1312,3,2,-13.0,-1.218630998876834,13.0,0.6984302957695783,0.3337923304603639,-0.38455334608819697,173,93,80,1,0.25928535726370594,0.5072169069677779,0.0,0.3327423163199619,0.869807488171728,0.869807488171728,0.0,0.5072169069677779,0,1,1,1,0.5072169069677779,0.0
1888,8,209,26,80,90,1,1509.5379999999998,54,966.046,MORE,440,450,890,1,2,10.0,0.9374084606744876,10.0,0.17460757394239454,0.3337923304603639,-0.7803889044500769,170,80,90,0,0.19945027481823535,0.0,0.3901668515136753,-1.2644208020158558,0.8826843045970787,0.8826843045970787,0.3901668515136753,0.0,0,0,1,1,0.3901668515136753,0.0
1889,8,210,25,88,80,1,4128.835999999998,44,1230.883,MORE,1082,1368,2450,5,2,-8.0,-0.7499267685395902,8.0,-0.17460757394239454,-0.10206272563586764,0.5995367581161929,168,88,80,1,0.1595602198545883,0.31213348121094026,0.0,1.9299054346557796,1.709375919104591,1.709375919104591,0.0,0.31213348121094026,0,1,1,1,0.31213348121094026,0.0
1890,8,211,36,80,70,1,1242.251,44,1182.846,MORE,580,406,986,1,2,-10.0,-0.9374084606744876,10.0,0.17460757394239454,-0.10206272563586764,-0.9212038062177836,150,80,70,1,-0.19945027481823535,0.0,-0.3901668515136753,-1.2644208020158558,1.062959734551988,1.062959734551988,-0.3901668515136753,0.0,0,0,1,1,0.0,-0.3901668515136753
1891,8,212,28,80,93,1,2094.95,64,611.255,MORE,444,796,1240,3,2,13.0,1.218630998876834,13.0,0.6984302957695783,0.7696473865565954,-0.4719760999603833,173,80,93,0,0.25928535726370594,0.0,0.5072169069677779,0.3327423163199619,0.887835031167219,0.887835031167219,0.5072169069677779,0.0,1,1,1,1,0.5072169069677779,0.0
1892,8,213,21,82,80,1,2392.54,44,1166.873,MORE,214,1142,1356,3,1,-2.0,-0.18748169213489754,2.0,-1.222253017596762,-0.10206272563586764,-0.3151966583225488,162,82,80,1,0.03989005496364707,0.07803337030273506,0.0,0.3327423163199619,0.5916682533841539,0.5916682533841539,0.0,0.07803337030273506,0,1,1,1,0.07803337030273506,0.0
1893,8,214,19,50,41,0,2566.652,54,1612.864,MORE,-1200,1936,736,2,2,-9.0,-0.8436676146070391,9.0,0.0,0.3337923304603639,-0.22346917372143105,91,50,41,1,-1.376206896245824,-1.170500554541026,-1.5216507209033339,-0.4658392428479469,-1.2291135891604292,1.2291135891604292,-1.5216507209033339,-1.170500554541026,1,0,0,0,-1.170500554541026,-1.5216507209033339
1894,8,215,56,96,110,1,1587.263,54,1218.851,MORE,360,540,900,1,2,14.0,1.3123718449442827,14.0,0.8730378697119728,0.3337923304603639,-0.7394410160758013,206,96,110,0,0.9174712641638826,0.6242669624218805,1.170500554541026,-1.2644208020158558,0.7796697731942734,0.7796697731942734,1.170500554541026,0.6242669624218805,1,0,1,2,1.170500554541026,0.6242669624218805
1895,8,216,23,80,85,1,1428.436,64,1168.519,MORE,648,442,1090,1,2,5.0,0.4687042303372438,5.0,-0.6984302957695783,0.7696473865565954,-0.8231158988911255,165,80,85,0,0.09972513740911768,0.0,0.19508342575683765,-1.2644208020158558,1.1505220862443724,1.1505220862443724,0.19508342575683765,0.0,1,0,1,1,0.19508342575683765,0.0
1896,8,217,10,60,50,1,2804.1890000000008,44,1610.182,MORE,-94,1688,1594,3,1,-10.0,-0.9374084606744876,10.0,0.17460757394239454,-0.10206272563586764,-0.0983274746444244,110,60,50,1,-0.9972513740911768,-0.7803337030273506,-1.170500554541026,0.3327423163199619,0.19506230748335354,0.19506230748335354,-1.170500554541026,-0.7803337030273506,0,1,0,0,-0.7803337030273506,-1.170500554541026
1897,8,218,19,41,50,0,2272.403,54,1164.256,MORE,-716,1478,762,2,1,9.0,0.8436676146070391,9.0,0.0,0.3337923304603639,-0.3784884751848242,91,41,50,0,-1.376206896245824,-1.5216507209033339,-1.170500554541026,-0.4658392428479469,-0.6058756741734573,0.6058756741734573,-1.170500554541026,-1.5216507209033339,1,0,0,0,-1.5216507209033339,-1.170500554541026
1898,8,219,56,110,96,0,2089.807,54,1679.729,MORE,-1246,1752,506,2,1,-14.0,-1.3123718449442827,14.0,0.8730378697119728,0.3337923304603639,-0.4746855884120899,206,110,96,1,0.9174712641638826,1.170500554541026,0.6242669624218805,-0.4658392428479469,-1.2883469447170424,1.2883469447170424,0.6242669624218805,1.170500554541026,1,0,0,2,1.170500554541026,0.6242669624218805
1899,8,220,35,72,80,1,2406.058,54,1189.687,MORE,430,944,1374,3,2,8.0,0.7499267685395902,8.0,-0.17460757394239454,0.3337923304603639,-0.3080749657520314,152,72,80,0,-0.1595602198545883,-0.31213348121094026,0.0,0.3327423163199619,0.869807488171728,0.869807488171728,0.0,-0.31213348121094026,1,1,1,1,-0.31213348121094026,0.0
1900,8,221,11,49,50,1,1395.817,54,1127.096,MORE,292,508,800,1,2,1.0,0.09374084606744876,1.0,-1.3968605915391563,0.3337923304603639,-0.8403005778345862,99,49,50,0,-1.2166466763912356,-1.2095172396923934,-1.170500554541026,-1.2644208020158558,0.692107421501889,0.692107421501889,-1.170500554541026,-1.2095172396923934,1,0,1,0,-1.2095172396923934,-1.170500554541026
1901,8,222,17,43,50,1,1477.77,54,1360.4160000000004,MORE,1010,516,1526,1,2,7.0,0.6561859224721414,7.0,-0.34921514788478913,0.3337923304603639,-0.7971252507720322,93,43,50,0,-1.3363168412821769,-1.4436173506005987,-1.170500554541026,-1.2644208020158558,1.6166628408420662,1.6166628408420662,-1.170500554541026,-1.4436173506005987,1,0,1,0,-1.4436173506005987,-1.170500554541026
1902,8,223,1,51,50,1,1956.009,54,757.1160000000001,MORE,432,726,1158,3,2,-1.0,-0.09374084606744876,1.0,-1.3968605915391563,0.3337923304603639,-0.5451744345838663,101,51,50,1,-1.1767566214275886,-1.1314838693896585,-1.170500554541026,0.3327423163199619,0.8723828514567982,0.8723828514567982,-1.170500554541026,-1.1314838693896585,1,1,1,0,-1.1314838693896585,-1.170500554541026
1903,8,224,41,112,110,1,2400.082000000001,64,1573.641,MORE,596,852,1448,3,2,-2.0,-0.18748169213489754,2.0,-1.222253017596762,0.7696473865565954,-0.3112233038790773,222,112,110,1,1.2365917038730592,1.248533924843761,1.170500554541026,0.3327423163199619,1.083562640832549,1.083562640832549,1.170500554541026,1.248533924843761,1,1,1,2,1.248533924843761,1.170500554541026
1904,8,225,20,40,50,1,1644.349,64,1748.119,MORE,58,1188,1246,2,1,10.0,0.9374084606744876,10.0,0.17460757394239454,0.7696473865565954,-0.7093663791413027,90,40,50,0,-1.3961519237276474,-1.5606674060547012,-1.170500554541026,-0.4658392428479469,0.3907899171486836,0.3907899171486836,-1.170500554541026,-1.5606674060547012,1,0,0,0,-1.5606674060547012,-1.170500554541026
1905,8,226,1,50,51,0,2142.379,74,1406.91,MORE,-780,1366,586,2,1,1.0,0.09374084606744876,1.0,-1.3968605915391563,1.2055024426528271,-0.4469890636438375,101,50,51,0,-1.1767566214275886,-1.170500554541026,-1.1314838693896585,-0.4658392428479469,-0.6882872992957015,0.6882872992957015,-1.1314838693896585,-1.170500554541026,1,0,0,0,-1.170500554541026,-1.1314838693896585
1906,8,227,23,85,80,1,2177.221,14,860.8389999999998,MORE,-146,1360,1214,3,1,-5.0,-0.4687042303372438,5.0,-0.6984302957695783,-1.409627893924562,-0.42863324084890003,165,85,80,1,0.09972513740911768,0.19508342575683765,0.0,0.3327423163199619,0.12810286207153013,0.12810286207153013,0.0,0.19508342575683765,0,1,0,1,0.19508342575683765,0.0
1907,8,228,11,50,49,0,1539.542,74,1258.364,MORE,-458,1024,566,2,1,-1.0,-0.09374084606744876,1.0,-1.3968605915391563,1.2055024426528271,-0.7645818868523699,99,50,49,1,-1.2166466763912356,-1.170500554541026,-1.2095172396923934,-0.4658392428479469,-0.27365381039941045,0.27365381039941045,-1.2095172396923934,-1.170500554541026,1,0,0,0,-1.170500554541026,-1.2095172396923934
1908,8,229,17,50,43,1,1636.221,4,782.8969999999998,MORE,-222,1084,862,1,1,-7.0,-0.6561859224721414,7.0,-0.34921514788478913,-1.8454829500207937,-0.7136484561655048,93,50,43,1,-1.3363168412821769,-1.170500554541026,-1.4436173506005987,-1.2644208020158558,0.03023905723886511,0.03023905723886511,-1.4436173506005987,-1.170500554541026,0,0,0,0,-1.170500554541026,-1.4436173506005987
1909,8,230,21,80,82,1,1258.661,74,1741.504,MORE,206,674,880,1,1,2.0,0.18748169213489754,2.0,-1.222253017596762,1.2055024426528271,-0.9125585202966272,162,80,82,0,0.03989005496364707,0.0,0.07803337030273506,-1.2644208020158558,0.5813668002438733,0.5813668002438733,0.07803337030273506,0.0,1,0,1,1,0.07803337030273506,0.0
1910,8,231,10,50,60,1,1221.12,84,1636.692,MORE,-98,822,724,1,2,10.0,0.9374084606744876,10.0,0.17460757394239454,1.6413574987490585,-0.9323362581860928,110,50,60,0,-0.9972513740911768,-1.170500554541026,-0.7803337030273506,-1.2644208020158558,0.18991158091321328,0.18991158091321328,-0.7803337030273506,-1.170500554541026,1,0,0,0,-1.170500554541026,-0.7803337030273506
1911,8,232,3,53,50,1,1365.15,20,1378.545,MORE,-576,1466,890,1,1,-3.0,-0.28122253820234633,3.0,-1.0476454436543674,-1.1481148602668232,-0.8564568839494001,103,53,50,1,-1.1368665664639415,-1.0534504990869233,-1.170500554541026,-1.2644208020158558,-0.42560024421854814,0.42560024421854814,-1.170500554541026,-1.0534504990869233,0,0,0,0,-1.0534504990869233,-1.170500554541026
1912,8,233,45,122,110,0,1922.175,64,813.3739999999998,MORE,-750,1396,646,2,1,-12.0,-1.124890152809385,12.0,0.5238227218271837,0.7696473865565954,-0.5629992123935189,232,122,110,1,1.4360419786912946,1.6387007763574364,1.170500554541026,-0.4658392428479469,-0.6496568500196496,0.6496568500196496,1.170500554541026,1.6387007763574364,1,1,0,2,1.6387007763574364,1.170500554541026
1913,8,234,38,67,80,1,1437.994,54,1597.136,MORE,206,866,1072,2,1,13.0,1.218630998876834,13.0,0.6984302957695783,0.3337923304603639,-0.8180804544770846,147,67,80,0,-0.25928535726370594,-0.5072169069677779,0.0,-0.4658392428479469,0.5813668002438733,0.5813668002438733,0.0,-0.5072169069677779,0,0,1,1,-0.5072169069677779,0.0
1914,8,235,38,80,67,0,2292.136,64,1105.003,MORE,-1358,1826,468,2,1,-13.0,-1.218630998876834,13.0,0.6984302957695783,0.7696473865565954,-0.3680925320353924,147,80,67,1,-0.25928535726370594,0.0,-0.5072169069677779,-0.4658392428479469,-1.4325672886809697,1.4325672886809697,-0.5072169069677779,0.0,1,0,0,1,0.0,-0.5072169069677779
1915,8,236,36,70,80,1,2162.836,64,665.895,MORE,410,846,1256,3,2,10.0,0.9374084606744876,10.0,0.17460757394239454,0.7696473865565954,-0.4362116953264036,150,70,80,0,-0.19945027481823535,-0.3901668515136753,0.0,0.3327423163199619,0.8440538553210267,0.8440538553210267,0.0,-0.3901668515136753,1,1,1,1,-0.3901668515136753,0.0
1916,8,237,45,110,122,1,1459.06,74,1282.882,MORE,660,582,1242,2,2,12.0,1.124890152809385,12.0,0.5238227218271837,1.2055024426528271,-0.8069822464810409,232,110,122,0,1.4360419786912946,1.170500554541026,1.6387007763574364,-0.4658392428479469,1.1659742659547931,1.1659742659547931,1.6387007763574364,1.170500554541026,1,0,1,2,1.6387007763574364,1.170500554541026
1917,8,238,42,110,115,0,2033.541,64,1883.873,MORE,-994,1472,478,2,1,5.0,0.4687042303372438,5.0,-0.6984302957695783,0.7696473865565954,-0.5043282244657018,225,110,115,0,1.2964267863185297,1.170500554541026,1.3655839802978638,-0.4658392428479469,-0.9638511707982057,0.9638511707982057,1.3655839802978638,1.170500554541026,1,0,0,2,1.3655839802978638,1.170500554541026
1918,8,239,41,110,112,1,2197.817,64,1175.085,MORE,326,814,1140,3,2,2.0,0.18748169213489754,2.0,-1.222253017596762,0.7696473865565954,-0.4177826431138523,222,110,112,0,1.2365917038730592,1.170500554541026,1.248533924843761,0.3327423163199619,0.7358885973480812,0.7358885973480812,1.248533924843761,1.170500554541026,1,1,1,2,1.248533924843761,1.170500554541026
1919,8,240,53,110,103,0,3077.082000000001,64,1341.0929999999996,MORE,-552,1690,1138,4,1,-7.0,-0.6561859224721414,7.0,-0.34921514788478913,0.7696473865565954,0.045440838023587136,213,110,103,1,1.0570864565366473,1.170500554541026,0.8973837584814532,1.1313238754878707,-0.39469588479770656,0.39469588479770656,0.8973837584814532,1.170500554541026,1,1,0,2,1.170500554541026,0.8973837584814532
1920,9,1,49,110,131,1,1737.66,60,1361.161,MORE,252,686,938,1,2,21.0,1.9685577674164243,21.0,2.0952908873087353,0.2637199245091737,-0.037291478560762266,241,110,131,0,1.6155472260277064,1.170500554541026,1.9898509427197442,-0.48320794109883863,0.7686344060886127,0.7686344060886127,1.9898509427197442,1.170500554541026,0,0,1,2,1.9898509427197442,1.170500554541026
1921,9,2,13,47,50,1,1700.417,30,1439.5220000000004,MORE,94,428,522,1,2,3.0,0.28122253820234633,3.0,-1.0476454436543674,-0.8275349355287865,-0.10340315423526908,97,47,50,0,-1.2565367313548828,-1.2875506099951286,-1.170500554541026,-0.48320794109883863,0.3257978465018706,0.3257978465018706,-1.170500554541026,-1.2875506099951286,0,1,1,0,-1.2875506099951286,-1.170500554541026
1922,9,3,16,50,44,0,1476.671,30,1334.914,MORE,-22,424,402,1,2,-6.0,-0.5624450764046927,6.0,-0.5238227218271837,-0.8275349355287865,-0.5005844496590568,94,50,44,1,-1.3163718138003533,-1.170500554541026,-1.4046006654492311,-0.48320794109883863,0.0006773344002117904,0.0006773344002117904,-1.4046006654492311,-1.170500554541026,0,1,0,0,-1.170500554541026,-1.4046006654492311
1923,9,4,7,57,50,1,1643.3270000000002,70,1003.951,MORE,80,404,484,1,2,-7.0,-0.6561859224721414,7.0,-0.34921514788478913,0.6274715445218272,-0.20474610631371484,107,57,50,1,-1.0570864565366473,-0.8973837584814532,-1.170500554541026,-0.48320794109883863,0.2865591640068428,0.2865591640068428,-1.170500554541026,-0.8973837584814532,1,1,1,0,-0.8973837584814532,-1.170500554541026
1924,9,5,18,42,50,1,1397.6760000000004,50,1210.4,MORE,-4,382,378,1,2,8.0,0.7499267685395902,8.0,-0.17460757394239454,-0.10003169550347968,-0.6408119238127936,92,42,50,0,-1.3562618687640005,-1.4826340357519663,-1.170500554541026,-0.48320794109883863,0.05112706903667608,0.05112706903667608,-1.170500554541026,-1.4826340357519663,0,1,0,0,-1.4826340357519663,-1.170500554541026
1925,9,6,51,108,110,0,2087.1220000000008,10,857.758,MORE,-414,1072,658,2,1,2.0,0.18748169213489754,2.0,-1.222253017596762,-1.5550381755540934,0.5830537783885823,218,108,110,0,1.156811593945765,1.092467184238291,1.170500554541026,1.300944456804566,-1.098005775460566,1.098005775460566,1.170500554541026,1.092467184238291,0,1,0,2,1.170500554541026,1.092467184238291
1926,9,7,31,78,80,1,1959.917,70,873.334,MORE,-162,1122,960,2,2,2.0,0.18748169213489754,2.0,-1.222253017596762,0.6274715445218272,0.357246627939487,158,78,80,0,-0.03989005496364707,-0.07803337030273506,0.0,1.300944456804566,-0.391709490550066,0.391709490550066,0.0,-0.07803337030273506,1,1,0,1,-0.07803337030273506,0.0
1927,9,8,58,110,92,0,1866.011,80,1118.559,MORE,618,582,1200,1,2,-18.0,-1.6873352292140782,18.0,1.571468165481551,0.9912231645344806,0.1905499865333112,202,110,92,1,0.8376911542365885,1.170500554541026,0.4682002218164104,-0.48320794109883863,1.7944456770300532,1.7944456770300532,0.4682002218164104,1.170500554541026,1,1,1,2,1.170500554541026,0.4682002218164104
1928,9,9,12,50,48,1,2345.818,30,670.529,MORE,216,608,824,1,2,-2.0,-0.18748169213489754,2.0,-1.222253017596762,-0.8275349355287865,1.0422763450532468,98,50,48,1,-1.2365917038730592,-1.170500554541026,-1.248533924843761,-0.48320794109883863,0.6677349368156841,0.6677349368156841,-1.248533924843761,-1.170500554541026,0,1,1,0,-1.170500554541026,-1.248533924843761
1929,9,10,54,110,101,0,3013.5290000000005,60,1471.275,MORE,2,1080,1082,2,2,-9.0,-0.8436676146070391,9.0,0.0,0.2637199245091737,2.227559299603107,211,110,101,1,1.0171964015730004,1.170500554541026,0.8193503881787182,1.300944456804566,0.06794364724883084,0.06794364724883084,0.8193503881787182,1.170500554541026,0,1,0,2,1.170500554541026,0.8193503881787182
1930,9,11,14,46,50,1,1952.562,80,1371.634,MORE,208,888,1096,2,2,4.0,0.3749633842697951,4.0,-0.8730378697119728,0.9912231645344806,0.34419044625202905,96,46,50,0,-1.2764817588367063,-1.3265672951464962,-1.170500554541026,1.300944456804566,0.6453128325328111,0.6453128325328111,-1.170500554541026,-1.3265672951464962,1,1,1,0,-1.3265672951464962,-1.170500554541026
1931,9,12,22,80,83,0,2152.213,0,1187.2,MORE,-1096,1568,472,2,1,3.0,0.28122253820234633,3.0,-1.0476454436543674,-1.9187897955667468,0.6985996549648321,163,80,83,0,0.05983508244547061,0.0,0.1170500554541026,1.300944456804566,-3.009490165575491,3.009490165575491,0.1170500554541026,0.0,0,1,0,1,0.1170500554541026,0.0
1932,9,13,6,50,56,0,2567.785,50,1172.744,MORE,22,752,774,2,1,6.0,0.5624450764046927,6.0,-0.5238227218271837,-0.10003169550347968,1.4362996598894084,106,50,56,0,-1.077031484018471,-1.170500554541026,-0.9364004436328208,1.300944456804566,0.1239989079560134,0.1239989079560134,-0.9364004436328208,-1.170500554541026,0,1,1,0,-1.170500554541026,-0.9364004436328208
1933,9,14,13,50,47,1,2959.43,70,1362.374,MORE,-302,1052,750,1,1,-3.0,-0.28122253820234633,3.0,-1.0476454436543674,0.6274715445218272,2.131525802239437,97,50,47,1,-1.2565367313548828,-1.170500554541026,-1.2875506099951286,-0.48320794109883863,-0.7840963155003439,0.7840963155003439,-1.2875506099951286,-1.170500554541026,1,1,0,0,-1.170500554541026,-1.2875506099951286
1934,9,15,46,110,124,1,2399.982,60,1583.975,MORE,-308,976,668,1,1,14.0,1.3123718449442827,14.0,0.8730378697119728,0.2637199245091737,1.1384252267554178,234,110,124,0,1.4759320336549415,1.170500554541026,1.7167341466601715,-0.48320794109883863,-0.8009128937124986,0.8009128937124986,1.7167341466601715,1.170500554541026,0,1,0,2,1.7167341466601715,1.170500554541026
1935,9,16,27,91,80,0,2534.684,80,1199.852,MORE,-390,1034,644,2,1,-11.0,-1.0311493067419364,11.0,0.34921514788478913,0.9912231645344806,1.3775406292930057,171,91,80,1,0.21939530230005888,0.4291835366650429,0.0,1.300944456804566,-1.030739462611947,1.030739462611947,0.0,0.4291835366650429,1,1,0,1,0.4291835366650429,0.0
1936,9,17,40,64,80,1,2663.548,70,1061.817,MORE,-610,1164,554,1,1,16.0,1.4998535370791803,16.0,1.222253017596762,0.6274715445218272,1.6062927430894127,144,64,80,0,-0.3191204397091766,-0.6242669624218805,0.0,-0.48320794109883863,-1.6473473303909552,1.6473473303909552,0.0,-0.6242669624218805,1,1,0,1,-0.6242669624218805,0.0
1937,9,18,22,83,80,0,2875.6540000000005,30,1082.231,MORE,192,698,890,1,2,-3.0,-0.28122253820234633,3.0,-1.0476454436543674,-0.8275349355287865,1.9828113662029356,163,83,80,1,0.05983508244547061,0.1170500554541026,0.0,-0.48320794109883863,0.600468623967065,0.600468623967065,0.0,0.1170500554541026,0,1,1,1,0.1170500554541026,0.0
1938,9,19,54,101,110,0,2027.183,60,2019.26,MORE,-96,848,752,1,1,9.0,0.8436676146070391,9.0,0.0,0.2637199245091737,0.4766534419963933,211,101,110,0,1.0171964015730004,0.8193503881787182,1.170500554541026,-0.48320794109883863,-0.2067271302163636,0.2067271302163636,1.170500554541026,0.8193503881787182,1,1,0,2,1.170500554541026,0.8193503881787182
1939,9,20,6,56,50,1,2750.827,20,1589.905,MORE,106,730,836,1,2,-6.0,-0.5624450764046927,6.0,-0.5238227218271837,-1.19128655554144,1.7612255073993581,106,56,50,1,-1.077031484018471,-0.9364004436328208,-1.170500554541026,-0.48320794109883863,0.35943100292618013,0.35943100292618013,-1.170500554541026,-0.9364004436328208,0,1,1,0,-0.9364004436328208,-1.170500554541026
1940,9,21,18,50,42,1,2205.375,60,956.601,MORE,242,490,732,1,2,-8.0,-0.7499267685395902,8.0,-0.17460757394239454,0.2637199245091737,0.7929698427103977,92,50,42,1,-1.3562618687640005,-1.170500554541026,-1.4826340357519663,-0.48320794109883863,0.7406067757350214,0.7406067757350214,-1.4826340357519663,-1.170500554541026,1,1,1,0,-1.170500554541026,-1.4826340357519663
1941,9,22,43,110,117,1,1977.979,40,1540.266,MORE,84,516,600,1,2,7.0,0.6561859224721414,7.0,-0.34921514788478913,-0.4637833155161331,0.3893092728937857,227,110,117,0,1.3363168412821769,1.170500554541026,1.4436173506005987,-0.48320794109883863,0.2977702161482793,0.2977702161482793,1.4436173506005987,1.170500554541026,0,1,1,2,1.4436173506005987,1.170500554541026
1942,9,23,32,77,80,0,1980.279,40,1372.989,MORE,-172,782,610,2,1,3.0,0.28122253820234633,3.0,-1.0476454436543674,-0.4637833155161331,0.3933921033330994,157,77,80,0,-0.05983508244547061,-0.1170500554541026,0.0,1.300944456804566,-0.4197371209036573,0.4197371209036573,0.0,-0.1170500554541026,0,1,0,1,-0.1170500554541026,0.0
1943,9,24,27,80,91,1,1653.0770000000002,60,1366.677,MORE,-78,518,440,1,2,11.0,1.0311493067419364,11.0,0.34921514788478913,0.2637199245091737,-0.18743845553836275,171,80,91,0,0.21939530230005888,0.0,0.4291835366650429,-0.48320794109883863,-0.15627739557989934,0.15627739557989934,0.4291835366650429,0.0,1,1,0,1,0.4291835366650429,0.0
1944,9,25,16,44,50,1,1485.164,70,1226.889,MORE,-104,536,432,1,2,6.0,0.5624450764046927,6.0,-0.5238227218271837,0.6274715445218272,-0.4855081544759733,94,44,50,0,-1.3163718138003533,-1.4046006654492311,-1.170500554541026,-0.48320794109883863,-0.22914923449923663,0.22914923449923663,-1.170500554541026,-1.4046006654492311,1,1,0,0,-1.4046006654492311,-1.170500554541026
1945,9,26,7,50,57,1,1783.6529999999998,90,1353.81,MORE,1064,404,1468,1,2,7.0,0.6561859224721414,7.0,-0.34921514788478913,1.354974784547134,0.044352704219828974,107,50,57,0,-1.0570864565366473,-1.170500554541026,-0.8973837584814532,-0.48320794109883863,3.0444779908002237,3.0444779908002237,-0.8973837584814532,-1.170500554541026,1,1,1,0,-1.170500554541026,-0.8973837584814532
1946,9,27,14,50,46,0,1855.097,20,1493.444,MORE,-398,936,538,1,2,-4.0,-0.3749633842697951,4.0,-0.8730378697119728,-1.19128655554144,0.17117606852693248,96,50,46,1,-1.2764817588367063,-1.170500554541026,-1.3265672951464962,-0.48320794109883863,-1.05316156689482,1.05316156689482,-1.3265672951464962,-1.170500554541026,0,0,0,0,-1.170500554541026,-1.3265672951464962
1947,9,28,51,110,108,1,2431.437,0,2411.338,MORE,-1412,2158,746,1,2,-2.0,-0.18748169213489754,2.0,-1.222253017596762,-1.9187897955667468,1.1942623708722075,218,110,108,1,1.156811593945765,1.170500554541026,1.092467184238291,-0.48320794109883863,-3.8951632847489757,3.8951632847489757,1.092467184238291,1.170500554541026,0,1,0,2,1.170500554541026,1.092467184238291
1948,9,29,50,133,110,1,2048.157,50,638.129,MORE,76,594,670,1,2,-23.0,-2.1560394595513217,23.0,2.444506035193524,-0.10003169550347968,0.5138853053155972,243,133,110,1,1.6554372809913533,2.0678843130224793,1.170500554541026,-0.48320794109883863,0.2753481118654063,0.2753481118654063,1.170500554541026,2.0678843130224793,0,0,1,2,2.0678843130224793,1.170500554541026
1949,9,30,49,131,110,0,1933.937,70,477.39,MORE,54,548,602,1,2,-21.0,-1.9685577674164243,21.0,2.0952908873087353,0.6274715445218272,0.3111283954119334,241,131,110,1,1.6155472260277064,1.9898509427197442,1.170500554541026,-0.48320794109883863,0.2136873250875055,0.2136873250875055,1.170500554541026,1.9898509427197442,1,0,1,2,1.9898509427197442,1.170500554541026
1950,9,31,47,126,110,0,1995.005,60,232.80900000000003,MORE,-770,1350,580,2,1,-16.0,-1.4998535370791803,16.0,1.222253017596762,0.2637199245091737,0.41953286900672376,236,126,110,1,1.5158220886185887,1.7947675169629065,1.170500554541026,1.300944456804566,-2.0957894160484156,2.0957894160484156,1.170500554541026,1.7947675169629065,1,1,0,2,1.7947675169629065,1.170500554541026
1951,9,32,50,110,133,1,1805.838,70,1206.58,MORE,-62,596,534,1,2,23.0,2.1560394595513217,23.0,2.444506035193524,0.6274715445218272,0.08373426652251507,243,110,133,0,1.6554372809913533,1.170500554541026,2.0678843130224793,-0.48320794109883863,-0.1114331870141533,0.1114331870141533,2.0678843130224793,1.170500554541026,1,0,0,2,2.0678843130224793,1.170500554541026
1952,9,33,47,110,126,1,1846.312,80,1165.942,MORE,144,526,670,1,2,16.0,1.4998535370791803,16.0,1.222253017596762,0.9912231645344806,0.15558143139242278,236,110,126,0,1.5158220886185887,1.170500554541026,1.7947675169629065,-0.48320794109883863,0.46593599826982696,0.46593599826982696,1.7947675169629065,1.170500554541026,1,1,1,2,1.7947675169629065,1.170500554541026
1953,9,34,12,48,50,1,1751.6529999999998,60,948.746,MORE,46,462,508,1,2,2.0,0.18748169213489754,2.0,-1.222253017596762,0.2637199245091737,-0.012451893196711278,98,48,50,0,-1.2365917038730592,-1.248533924843761,-1.170500554541026,-0.48320794109883863,0.19126522080463246,0.19126522080463246,-1.170500554541026,-1.248533924843761,1,1,1,0,-1.248533924843761,-1.170500554541026
1954,9,35,32,80,77,0,2292.031,20,1429.007,MORE,-188,676,488,1,1,-3.0,-0.28122253820234633,3.0,-1.0476454436543674,-1.19128655554144,0.9467966925143886,157,80,77,1,-0.05983508244547061,0.0,-0.1170500554541026,-0.48320794109883863,-0.46458132946940334,0.46458132946940334,-0.1170500554541026,0.0,0,1,0,1,0.0,-0.1170500554541026
1955,9,36,43,117,110,0,2356.063,40,1291.98,MORE,-278,822,544,1,2,-7.0,-0.6561859224721414,7.0,-0.34921514788478913,-0.4637833155161331,1.0604626919448858,227,117,110,1,1.3363168412821769,1.4436173506005987,1.170500554541026,-0.48320794109883863,-0.7168300026517248,0.7168300026517248,1.170500554541026,1.4436173506005987,0,1,0,2,1.4436173506005987,1.170500554541026
1956,9,37,40,80,64,0,1909.306,60,764.3539999999998,MORE,-316,814,498,2,1,-16.0,-1.4998535370791803,16.0,1.222253017596762,0.2637199245091737,0.267404831694221,144,80,64,1,-0.3191204397091766,0.0,-0.6242669624218805,1.300944456804566,-0.8233349979953716,0.8233349979953716,-0.6242669624218805,0.0,1,1,0,1,0.0,-0.6242669624218805
1957,9,38,31,80,78,1,1744.836,70,1114.145,MORE,-136,746,610,2,1,-2.0,-0.18748169213489754,2.0,-1.222253017596762,0.6274715445218272,-0.024553047590103228,158,80,78,1,-0.03989005496364707,0.0,-0.07803337030273506,1.300944456804566,-0.3188376516307287,0.3188376516307287,-0.07803337030273506,0.0,1,1,0,1,0.0,-0.07803337030273506
1958,9,39,46,124,110,0,2723.051,40,1201.036,MORE,-568,1200,632,2,1,-14.0,-1.3123718449442827,14.0,0.8730378697119728,-0.4637833155161331,1.7119191168418004,234,124,110,1,1.4759320336549415,1.7167341466601715,1.170500554541026,1.300944456804566,-1.5296312829058718,1.5296312829058718,1.170500554541026,1.7167341466601715,0,1,0,2,1.7167341466601715,1.170500554541026
1959,9,40,58,92,110,1,2331.944,70,1459.428,MORE,-278,932,654,2,1,18.0,1.6873352292140782,18.0,1.571468165481551,0.6274715445218272,1.0176480017858378,202,92,110,0,0.8376911542365885,0.4682002218164104,1.170500554541026,1.300944456804566,-0.7168300026517248,0.7168300026517248,1.170500554541026,0.4682002218164104,1,1,0,2,1.170500554541026,0.4682002218164104
1960,9,41,49,110,131,0,1934.475,50,1106.1,LESS,-342,884,542,3,1,21.0,1.9685577674164243,21.0,2.0952908873087353,-0.10003169550347968,0.312083422705999,241,110,131,1,1.6155472260277064,1.170500554541026,1.9898509427197442,3.0850968547079707,-0.8962068369147089,0.8962068369147089,1.9898509427197442,1.170500554541026,0,1,0,2,1.9898509427197442,1.170500554541026
1961,9,42,13,47,50,0,1540.831,60,1521.152,LESS,-360,908,548,1,1,3.0,0.28122253820234633,3.0,-1.0476454436543674,0.2637199245091737,-0.38669123183889387,97,47,50,1,-1.2565367313548828,-1.2875506099951286,-1.170500554541026,-0.48320794109883863,-0.9466565715511732,0.9466565715511732,-1.170500554541026,-1.2875506099951286,0,1,0,0,-1.2875506099951286,-1.170500554541026
1962,9,43,16,50,44,1,1175.848,80,498.8,LESS,6,416,422,1,2,-6.0,-0.5624450764046927,6.0,-0.5238227218271837,0.9912231645344806,-1.0345884936789285,94,50,44,0,-1.3163718138003533,-1.170500554541026,-1.4046006654492311,-0.48320794109883863,0.07915469939026736,0.07915469939026736,-1.4046006654492311,-1.170500554541026,1,1,0,0,-1.170500554541026,-1.4046006654492311
1963,9,44,7,57,50,1,1182.059,50,700.044,LESS,-54,434,380,1,2,-7.0,-0.6561859224721414,7.0,-0.34921514788478913,-0.10003169550347968,-1.0235630763491117,107,57,50,0,-1.0570864565366473,-0.8973837584814532,-1.170500554541026,-0.48320794109883863,-0.08901108273128028,0.08901108273128028,-1.170500554541026,-0.8973837584814532,0,1,0,0,-0.8973837584814532,-1.170500554541026
1964,9,45,18,42,50,1,1396.51,80,1137.744,LESS,60,438,498,1,2,8.0,0.7499267685395902,8.0,-0.17460757394239454,0.9912231645344806,-0.6428817413311595,92,42,50,1,-1.3562618687640005,-1.4826340357519663,-1.170500554541026,-0.48320794109883863,0.23050390329966025,0.23050390329966025,-1.170500554541026,-1.4826340357519663,1,1,1,0,-1.4826340357519663,-1.170500554541026
1965,9,46,51,108,110,1,1930.006,20,1261.313,LESS,-346,762,416,1,2,2.0,0.18748169213489754,2.0,-1.222253017596762,-1.19128655554144,0.3041503056480456,218,108,110,1,1.156811593945765,1.092467184238291,1.170500554541026,-0.48320794109883863,-0.9074178890561454,0.9074178890561454,1.170500554541026,1.092467184238291,0,1,0,2,1.170500554541026,1.092467184238291
1966,9,47,31,78,80,1,1308.294,20,1022.559,LESS,-50,402,352,1,2,2.0,0.18748169213489754,2.0,-1.222253017596762,-1.19128655554144,-0.7994778152592066,158,78,80,1,-0.03989005496364707,-0.07803337030273506,0.0,-0.48320794109883863,-0.07780003058984378,0.07780003058984378,0.0,-0.07803337030273506,0,0,0,1,-0.07803337030273506,0.0
1967,9,48,58,110,92,1,1036.766,80,732.857,LESS,-148,464,316,1,2,-18.0,-1.6873352292140782,18.0,1.571468165481551,0.9912231645344806,-1.2814790254879047,202,110,92,0,0.8376911542365885,1.170500554541026,0.4682002218164104,-0.48320794109883863,-0.3524708080550382,0.3524708080550382,0.4682002218164104,1.170500554541026,1,0,0,2,1.170500554541026,0.4682002218164104
1968,9,49,12,50,48,0,1449.936,0,1954.664,LESS,-352,766,414,1,1,-2.0,-0.18748169213489754,2.0,-1.222253017596762,-1.9187897955667468,-0.5480429156569071,98,50,48,0,-1.2365917038730592,-1.170500554541026,-1.248533924843761,-0.48320794109883863,-0.9242344672683002,0.9242344672683002,-1.248533924843761,-1.170500554541026,0,0,0,0,-1.170500554541026,-1.248533924843761
1969,9,50,54,110,101,1,1058.787,50,1170.882,LESS,172,386,558,1,2,-9.0,-0.8436676146070391,9.0,0.0,-0.10003169550347968,-1.2423885867469788,211,110,101,0,1.0171964015730004,1.170500554541026,0.8193503881787182,-0.48320794109883863,0.5444133632598825,0.5444133632598825,0.8193503881787182,1.170500554541026,0,1,1,2,1.170500554541026,0.8193503881787182
1970,9,51,14,46,50,0,1717.17,30,1005.505,LESS,-344,728,384,2,1,4.0,0.3749633842697951,4.0,-0.8730378697119728,-0.8275349355287865,-0.0736641723440407,96,46,50,1,-1.2764817588367063,-1.3265672951464962,-1.170500554541026,1.300944456804566,-0.9018123629854272,0.9018123629854272,-1.170500554541026,-1.3265672951464962,0,1,0,0,-1.3265672951464962,-1.170500554541026
1971,9,52,22,80,83,1,1076.954,70,828.628,LESS,-76,524,448,1,2,3.0,0.28122253820234633,3.0,-1.0476454436543674,0.6274715445218272,-1.2101395517074076,163,80,83,1,0.05983508244547061,0.0,0.1170500554541026,-0.48320794109883863,-0.15067186950918107,0.15067186950918107,0.1170500554541026,0.0,1,0,0,1,0.1170500554541026,0.0
1972,9,53,6,50,56,0,1352.932,70,997.221,LESS,-4,370,366,1,2,6.0,0.5624450764046927,6.0,-0.5238227218271837,0.6274715445218272,-0.7202389521504716,106,50,56,1,-1.077031484018471,-1.170500554541026,-0.9364004436328208,-0.48320794109883863,0.05112706903667608,0.05112706903667608,-0.9364004436328208,-1.170500554541026,1,0,0,0,-1.170500554541026,-0.9364004436328208
1973,9,54,13,50,47,1,1215.279,30,1568.061,LESS,52,362,414,1,2,-3.0,-0.28122253820234633,3.0,-1.0476454436543674,-0.8275349355287865,-0.964592803656066,97,50,47,0,-1.2565367313548828,-1.170500554541026,-1.2875506099951286,-0.48320794109883863,0.20808179901678722,0.20808179901678722,-1.2875506099951286,-1.170500554541026,0,0,1,0,-1.170500554541026,-1.2875506099951286
1974,9,55,46,110,124,1,1333.7579999999996,70,1570.896,LESS,-32,344,312,1,2,14.0,1.3123718449442827,14.0,0.8730378697119728,0.6274715445218272,-0.7542755568649956,234,110,124,1,1.4759320336549415,1.170500554541026,1.7167341466601715,-0.48320794109883863,-0.027350295953379483,0.027350295953379483,1.7167341466601715,1.170500554541026,1,0,0,2,1.7167341466601715,1.170500554541026
1975,9,56,27,91,80,1,1361.499,70,1626.493,LESS,-318,530,212,1,2,-11.0,-1.0311493067419364,11.0,0.34921514788478913,0.6274715445218272,-0.7050312963358623,171,91,80,0,0.21939530230005888,0.4291835366650429,0.0,-0.48320794109883863,-0.8289405240660899,0.8289405240660899,0.0,0.4291835366650429,1,0,0,1,0.4291835366650429,0.0
1976,9,57,40,64,80,0,1991.731,80,1447.46,LESS,-44,808,764,2,1,16.0,1.4998535370791803,16.0,1.222253017596762,0.9912231645344806,0.41372104863354375,144,64,80,1,-0.3191204397091766,-0.6242669624218805,0.0,1.300944456804566,-0.06098345237768901,0.06098345237768901,0.0,-0.6242669624218805,1,1,0,1,-0.6242669624218805,0.0
1977,9,58,22,83,80,1,1165.253,70,1404.915,LESS,26,414,440,1,2,-3.0,-0.28122253820234633,3.0,-1.0476454436543674,0.6274715445218272,-1.0533961408548111,163,83,80,0,0.05983508244547061,0.1170500554541026,0.0,-0.48320794109883863,0.1352099600974499,0.1352099600974499,0.0,0.1170500554541026,1,0,1,1,0.1170500554541026,0.0
1978,9,59,54,101,110,1,1295.232,30,1194.45,LESS,-94,528,434,2,1,9.0,0.8436676146070391,9.0,0.0,-0.8275349355287865,-0.8226647418671709,211,101,110,1,1.0171964015730004,0.8193503881787182,1.170500554541026,1.300944456804566,-0.20112160414564537,0.20112160414564537,1.170500554541026,0.8193503881787182,0,1,0,2,1.170500554541026,0.8193503881787182
1979,9,60,6,56,50,0,1256.585,20,1519.933,LESS,-58,380,322,1,2,-6.0,-0.5624450764046927,6.0,-0.5238227218271837,-1.19128655554144,-0.891268719253328,106,56,50,0,-1.077031484018471,-0.9364004436328208,-1.170500554541026,-0.48320794109883863,-0.10022213487271679,0.10022213487271679,-1.170500554541026,-0.9364004436328208,0,0,0,0,-0.9364004436328208,-1.170500554541026
1980,9,61,18,50,42,1,1705.955,30,1189.575,LESS,-380,870,490,1,1,-8.0,-0.7499267685395902,8.0,-0.17460757394239454,-0.8275349355287865,-0.09357240859486904,92,50,42,0,-1.3562618687640005,-1.170500554541026,-1.4826340357519663,-0.48320794109883863,-1.0027118322583557,1.0027118322583557,-1.4826340357519663,-1.170500554541026,0,0,0,0,-1.170500554541026,-1.4826340357519663
1981,9,62,43,110,117,0,1967.892,0,574.493,LESS,-1070,1544,474,2,1,7.0,0.6561859224721414,7.0,-0.34921514788478913,-1.9187897955667468,0.37140339870189065,227,110,117,1,1.3363168412821769,1.170500554541026,1.4436173506005987,1.300944456804566,-2.936618326656154,2.936618326656154,1.4436173506005987,1.170500554541026,0,1,0,2,1.4436173506005987,1.170500554541026
1982,9,63,32,77,80,0,1166.65,60,1180.07,LESS,472,274,746,1,2,3.0,0.28122253820234633,3.0,-1.0476454436543674,0.2637199245091737,-1.050916265148845,157,77,80,1,-0.05983508244547061,-0.1170500554541026,0.0,-0.48320794109883863,1.3852422738676207,1.3852422738676207,0.0,-0.1170500554541026,1,1,1,1,-0.1170500554541026,0.0
1983,9,64,27,80,91,0,1645.865,80,1350.473,LESS,248,582,830,2,2,11.0,1.0311493067419364,11.0,0.34921514788478913,0.9912231645344806,-0.2002407916811159,171,80,91,1,0.21939530230005888,0.0,0.4291835366650429,1.300944456804566,0.7574233539471762,0.7574233539471762,0.4291835366650429,0.0,1,1,1,1,0.4291835366650429,0.0
1984,9,65,16,44,50,0,1589.229,80,1240.221,LESS,718,590,1308,2,2,6.0,0.5624450764046927,6.0,-0.5238227218271837,0.9912231645344806,-0.300777828533715,94,44,50,1,-1.3163718138003533,-1.4046006654492311,-1.170500554541026,1.300944456804566,2.074721980565966,2.074721980565966,-1.170500554541026,-1.4046006654492311,1,1,1,0,-1.4046006654492311,-1.170500554541026
1985,9,66,7,50,57,1,2286.502,100,1620.645,LESS,162,482,644,1,2,7.0,0.6561859224721414,7.0,-0.34921514788478913,1.7187264045597874,0.936981923167012,107,50,57,1,-1.0570864565366473,-1.170500554541026,-0.8973837584814532,-0.48320794109883863,0.5163857329062912,0.5163857329062912,-0.8973837584814532,-1.170500554541026,1,1,1,0,-1.170500554541026,-0.8973837584814532
1986,9,67,14,50,46,1,1508.455,20,2165.993,LESS,12,404,416,1,2,-4.0,-0.3749633842697951,4.0,-0.8730378697119728,-1.19128655554144,-0.4441632832750784,96,50,46,0,-1.2764817588367063,-1.170500554541026,-1.3265672951464962,-0.48320794109883863,0.09597127760242212,0.09597127760242212,-1.3265672951464962,-1.170500554541026,0,1,1,0,-1.170500554541026,-1.3265672951464962
1987,9,68,51,110,108,1,1655.83,80,1143.956,LESS,2,464,466,1,2,-2.0,-0.18748169213489754,2.0,-1.222253017596762,0.9912231645344806,-0.18255148501687155,218,110,108,0,1.156811593945765,1.170500554541026,1.092467184238291,-0.48320794109883863,0.06794364724883084,0.06794364724883084,1.092467184238291,1.170500554541026,1,1,0,2,1.170500554541026,1.092467184238291
1988,9,69,50,133,110,1,1218.214,80,1786.25,LESS,204,500,704,1,2,-23.0,-2.1560394595513217,23.0,2.444506035193524,0.9912231645344806,-0.9593827569867676,243,133,110,0,1.6554372809913533,2.0678843130224793,1.170500554541026,-0.48320794109883863,0.6341017803913745,0.6341017803913745,1.170500554541026,2.0678843130224793,1,1,1,2,2.0678843130224793,1.170500554541026
1989,9,70,49,131,110,1,1249.66,30,1637.3,LESS,-122,544,422,1,1,-21.0,-1.9685577674164243,21.0,2.0952908873087353,-0.8275349355287865,-0.9035615891630012,241,131,110,0,1.6155472260277064,1.9898509427197442,1.170500554541026,-0.48320794109883863,-0.2795989691357009,0.2795989691357009,1.170500554541026,1.9898509427197442,0,1,0,2,1.9898509427197442,1.170500554541026
1990,9,71,47,126,110,1,2072.901,70,1154.409,LESS,142,336,478,1,2,-16.0,-1.4998535370791803,16.0,1.222253017596762,0.6274715445218272,0.5578094602679363,236,126,110,0,1.5158220886185887,1.7947675169629065,1.170500554541026,-0.48320794109883863,0.46033047219910866,0.46033047219910866,1.170500554541026,1.7947675169629065,1,1,1,2,1.7947675169629065,1.170500554541026
1991,9,72,50,110,133,1,2098.476,10,1825.774,LESS,-1506,1994,488,2,1,23.0,2.1560394595513217,23.0,2.444506035193524,-1.5550381755540934,0.6032087596094374,243,110,133,1,1.6554372809913533,1.170500554541026,2.0678843130224793,1.300944456804566,-4.158623010072733,4.158623010072733,2.0678843130224793,1.170500554541026,0,1,0,2,2.0678843130224793,1.170500554541026
1992,9,73,47,110,126,0,2318.618,30,1647.507,LESS,-432,892,460,2,1,16.0,1.4998535370791803,16.0,1.222253017596762,-0.8275349355287865,0.9939924372491872,236,110,126,1,1.5158220886185887,1.170500554541026,1.7947675169629065,1.300944456804566,-1.1484555100970304,1.1484555100970304,1.7947675169629065,1.170500554541026,0,1,0,2,1.7947675169629065,1.170500554541026
1993,9,74,12,48,50,0,1977.603,60,1082.4589999999996,LESS,144,420,564,1,2,2.0,0.18748169213489754,2.0,-1.222253017596762,0.2637199245091737,0.3886418188741414,98,48,50,1,-1.2365917038730592,-1.248533924843761,-1.170500554541026,-0.48320794109883863,0.46593599826982696,0.46593599826982696,-1.170500554541026,-1.248533924843761,1,1,1,0,-1.248533924843761,-1.170500554541026
1994,9,75,32,80,77,0,2210.398,60,1388.313,LESS,-486,1014,528,2,1,-3.0,-0.28122253820234633,3.0,-1.0476454436543674,0.2637199245091737,0.8018863893611254,157,80,77,0,-0.05983508244547061,0.0,-0.1170500554541026,1.300944456804566,-1.2998047140064233,1.2998047140064233,-0.1170500554541026,0.0,1,1,0,1,0.0,-0.1170500554541026
1995,9,76,43,117,110,1,2364.363,10,2329.384,LESS,-676,1648,972,1,1,-7.0,-0.6561859224721414,7.0,-0.34921514788478913,-1.5550381755540934,1.0751963843998005,227,117,110,0,1.3363168412821769,1.4436173506005987,1.170500554541026,-0.48320794109883863,-1.8323296907246573,1.8323296907246573,1.170500554541026,1.4436173506005987,0,1,0,2,1.4436173506005987,1.170500554541026
1996,9,77,40,80,64,1,2040.86,60,1167.177,LESS,-206,744,538,1,1,-16.0,-1.4998535370791803,16.0,1.222253017596762,0.2637199245091737,0.5009320819609563,144,80,64,0,-0.3191204397091766,0.0,-0.6242669624218805,-0.48320794109883863,-0.5150310641058676,0.5150310641058676,-0.6242669624218805,0.0,0,1,0,1,0.0,-0.6242669624218805
1997,9,78,31,80,78,1,1994.293,40,1173.153,LESS,-478,864,386,2,1,-2.0,-0.18748169213489754,2.0,-1.222253017596762,-0.4637833155161331,0.4182689667142053,158,80,78,0,-0.03989005496364707,0.0,-0.07803337030273506,1.300944456804566,-1.2773826097235503,1.2773826097235503,-0.07803337030273506,0.0,0,1,0,1,0.0,-0.07803337030273506
1998,9,79,46,124,110,1,1529.7979999999998,70,1274.992,LESS,-200,590,390,2,1,-14.0,-1.3123718449442827,14.0,0.8730378697119728,0.6274715445218272,-0.4062763919419156,234,124,110,0,1.4759320336549415,1.7167341466601715,1.170500554541026,1.300944456804566,-0.49821448589371287,0.49821448589371287,1.170500554541026,1.7167341466601715,1,1,0,2,1.7167341466601715,1.170500554541026
1999,9,80,58,92,110,0,2425.836,30,1585.763,LESS,2216,970,3186,2,2,18.0,1.6873352292140782,18.0,1.571468165481551,-0.8275349355287865,1.1843197911806436,202,92,110,1,0.8376911542365885,0.4682002218164104,1.170500554541026,1.300944456804566,6.2732610075339394,6.2732610075339394,1.170500554541026,0.4682002218164104,0,1,1,2,1.170500554541026,0.4682002218164104
2000,9,81,48,128,110,0,1749.954,60,749.1139999999998,MORE,116,264,380,1,1,-18.0,-1.6873352292140782,18.0,1.571468165481551,0.2637199245091737,-0.015467862290795432,238,128,110,1,1.5557121435822359,1.8728008872656416,1.170500554541026,-0.48320794109883863,0.38745863327977137,0.38745863327977137,1.170500554541026,1.8728008872656416,1,1,1,2,1.8728008872656416,1.170500554541026
2001,9,82,8,50,58,1,1325.432,70,477.407,MORE,-24,374,350,1,2,8.0,0.7499267685395902,8.0,-0.17460757394239454,0.6274715445218272,-0.7690554030553108,108,50,58,0,-1.0371414290548238,-1.170500554541026,-0.8583670733300858,-0.48320794109883863,-0.004928191670506464,0.004928191670506464,-0.8583670733300858,-1.170500554541026,1,1,0,0,-1.170500554541026,-0.8583670733300858
2002,9,83,4,54,50,0,1223.842,20,635.457,MORE,124,268,392,1,2,-4.0,-0.3749633842697951,4.0,-0.8730378697119728,-1.19128655554144,-0.9493922484161336,104,54,50,1,-1.116921538982118,-1.0144338139355558,-1.170500554541026,-0.48320794109883863,0.40988073756264437,0.40988073756264437,-1.170500554541026,-1.0144338139355558,0,1,1,0,-1.0144338139355558,-1.170500554541026
2003,9,84,37,80,69,0,1031.857,70,800.6030000000002,MORE,36,322,358,1,2,-11.0,-1.0311493067419364,11.0,0.34921514788478913,0.6274715445218272,-1.290193205760336,149,80,69,1,-0.21939530230005888,0.0,-0.4291835366650429,-0.48320794109883863,0.16323759045104116,0.16323759045104116,-0.4291835366650429,0.0,1,1,1,1,0.0,-0.4291835366650429
2004,9,85,52,105,110,0,1167.827,20,878.687,MORE,110,300,410,1,2,5.0,0.4687042303372438,5.0,-0.6984302957695783,-1.19128655554144,-1.048826921050118,215,105,110,0,1.0969765115002945,0.9754171287841883,1.170500554541026,-0.48320794109883863,0.3706420550676166,0.3706420550676166,1.170500554541026,0.9754171287841883,0,1,1,2,1.170500554541026,0.9754171287841883
2005,9,86,5,55,50,1,1270.056,70,779.289,MORE,74,304,378,1,2,-5.0,-0.4687042303372438,5.0,-0.6984302957695783,0.6274715445218272,-0.8673557588846338,105,55,50,1,-1.0969765115002945,-0.9754171287841883,-1.170500554541026,-0.48320794109883863,0.269742585794688,0.269742585794688,-1.170500554541026,-0.9754171287841883,1,1,1,0,-0.9754171287841883,-1.170500554541026
2006,9,87,30,96,80,0,1048.826,70,1060.065,MORE,66,434,500,1,2,-16.0,-1.4998535370791803,16.0,1.222253017596762,0.6274715445218272,-1.2600707928365462,176,96,80,1,0.3191204397091766,0.6242669624218805,0.0,-0.48320794109883863,0.24732048151181502,0.24732048151181502,0.0,0.6242669624218805,1,1,1,1,0.6242669624218805,0.0
2007,9,88,33,80,75,0,1234.482,60,1000.89,MORE,-120,378,258,1,2,-5.0,-0.4687042303372438,5.0,-0.6984302957695783,0.2637199245091737,-0.930504719775134,155,80,75,1,-0.09972513740911768,0.0,-0.19508342575683765,-0.48320794109883863,-0.2739934430649827,0.2739934430649827,-0.19508342575683765,0.0,1,1,0,1,0.0,-0.19508342575683765
2008,9,89,48,110,128,1,1125.772,80,919.902,MORE,-116,382,266,1,2,18.0,1.6873352292140782,18.0,1.571468165481551,0.9912231645344806,-1.123480588061137,238,110,128,0,1.5557121435822359,1.170500554541026,1.8728008872656416,-0.48320794109883863,-0.26278239092354616,0.26278239092354616,1.8728008872656416,1.170500554541026,1,1,0,2,1.8728008872656416,1.170500554541026
2009,9,90,9,59,50,1,1120.901,30,1321.293,MORE,-152,520,368,1,1,-9.0,-0.8436676146070391,9.0,0.0,-0.8275349355287865,-1.1321273128741356,109,59,50,1,-1.0171964015730004,-0.8193503881787182,-1.170500554541026,-0.48320794109883863,-0.36368186019647475,0.36368186019647475,-1.170500554541026,-0.8193503881787182,0,1,0,0,-0.8193503881787182,-1.170500554541026
2010,9,91,44,110,119,1,1388.5870000000002,0,678.8810000000002,MORE,-510,758,248,1,1,9.0,0.8436676146070391,9.0,0.0,-1.9187897955667468,-0.6569462046227605,229,110,119,0,1.376206896245824,1.170500554541026,1.5216507209033339,-0.48320794109883863,-1.3670710268550423,1.3670710268550423,1.5216507209033339,1.170500554541026,0,0,0,2,1.5216507209033339,1.170500554541026
2011,9,92,2,52,50,1,1211.419,60,853.887,MORE,92,294,386,0,2,-2.0,-0.18748169213489754,2.0,-1.222253017596762,0.2637199245091737,-0.971444858219436,102,52,50,1,-1.156811593945765,-1.092467184238291,-1.170500554541026,-2.267360339002243,0.3201923204311523,0.3201923204311523,-1.170500554541026,-1.092467184238291,1,0,1,0,-1.092467184238291,-1.170500554541026
2012,9,93,8,58,50,1,1755.945,30,1129.32,MORE,-12,414,402,1,2,-8.0,-0.7499267685395902,8.0,-0.17460757394239454,-0.8275349355287865,-0.004832976568217562,108,58,50,1,-1.0371414290548238,-0.8583670733300858,-1.170500554541026,-0.48320794109883863,0.028704964753803065,0.028704964753803065,-1.170500554541026,-0.8583670733300858,0,0,0,0,-0.8583670733300858,-1.170500554541026
2013,9,94,44,119,110,1,1567.646,90,1366.919,MORE,142,858,1000,1,2,-9.0,-0.8436676146070391,9.0,0.0,1.354974784547134,-0.3390907543475023,229,119,110,1,1.376206896245824,1.5216507209033339,1.170500554541026,-0.48320794109883863,0.46033047219910866,0.46033047219910866,1.170500554541026,1.5216507209033339,1,0,1,2,1.5216507209033339,1.170500554541026
2014,9,95,34,74,80,0,1723.37,0,940.376,MORE,-46,446,400,1,2,6.0,0.5624450764046927,6.0,-0.5238227218271837,-1.9187897955667468,-0.06265828159458635,154,74,80,0,-0.11967016489094122,-0.2341001109082052,0.0,-0.48320794109883863,-0.06658897844840726,0.06658897844840726,0.0,-0.2341001109082052,0,0,0,1,-0.2341001109082052,0.0
2015,9,96,24,86,80,0,1767.759,60,1046.874,MORE,66,452,518,0,2,-6.0,-0.5624450764046927,6.0,-0.5238227218271837,0.2637199245091737,0.01613857074050153,166,86,80,1,0.11967016489094122,0.2341001109082052,0.0,-2.267360339002243,0.24732048151181502,0.24732048151181502,0.0,0.2341001109082052,0,0,1,1,0.2341001109082052,0.0
2016,9,97,39,66,80,1,1512.466,60,1802.502,MORE,126,370,496,1,2,14.0,1.3123718449442827,14.0,0.8730378697119728,0.2637199245091737,-0.43704318201764897,146,66,80,0,-0.2792303847455295,-0.5462335921191455,0.0,-0.48320794109883863,0.41548626363336266,0.41548626363336266,0.0,-0.5462335921191455,1,0,1,1,-0.5462335921191455,0.0
2017,9,98,9,50,59,1,1487.6629999999998,50,937.339,MORE,52,396,448,1,2,9.0,0.8436676146070391,9.0,0.0,-0.10003169550347968,-0.4810720704464757,109,50,59,0,-1.0171964015730004,-1.170500554541026,-0.8193503881787182,-0.48320794109883863,0.20808179901678722,0.20808179901678722,-0.8193503881787182,-1.170500554541026,0,0,1,0,-1.170500554541026,-0.8193503881787182
2018,9,99,57,94,110,1,1124.705,60,991.578,MORE,94,354,448,1,2,16.0,1.4998535370791803,16.0,1.222253017596762,0.2637199245091737,-1.1253746663562447,204,94,110,0,0.8775812092002355,0.5462335921191455,1.170500554541026,-0.48320794109883863,0.3257978465018706,0.3257978465018706,1.170500554541026,0.5462335921191455,0,0,1,2,1.170500554541026,0.5462335921191455
2019,9,100,60,110,87,0,1128.118,80,1527.308,MORE,180,364,544,1,2,-23.0,-2.1560394595513217,23.0,2.444506035193524,0.9912231645344806,-1.1193161010130368,197,110,87,1,0.7379660168274708,1.170500554541026,0.27311679605957273,-0.48320794109883863,0.5668354675427555,0.5668354675427555,0.27311679605957273,1.170500554541026,1,0,1,2,1.170500554541026,0.27311679605957273
2020,9,101,33,75,80,0,1062.346,30,812.387,MORE,-88,402,314,1,1,5.0,0.4687042303372438,5.0,-0.6984302957695783,-0.8275349355287865,-1.2360708504280582,155,75,80,0,-0.09972513740911768,-0.19508342575683765,0.0,-0.48320794109883863,-0.1843050259334906,0.1843050259334906,0.0,-0.19508342575683765,0,0,0,1,-0.19508342575683765,0.0
2021,9,102,15,50,45,0,1247.627,100,1249.066,MORE,790,426,1216,1,2,-5.0,-0.4687042303372438,5.0,-0.6984302957695783,1.7187264045597874,-0.9071704562426208,95,50,45,1,-1.2964267863185297,-1.170500554541026,-1.3655839802978638,-0.48320794109883863,2.276520919111823,2.276520919111823,-1.3655839802978638,-1.170500554541026,1,0,1,0,-1.170500554541026,-1.3655839802978638
2022,9,103,59,89,110,0,1209.127,20,1023.109,MORE,-20,390,370,1,2,21.0,1.9685577674164243,21.0,2.0952908873087353,-1.19128655554144,-0.9755134875093958,199,89,110,0,0.7778560717911179,0.3511501663623078,1.170500554541026,-0.48320794109883863,0.006282860470930045,0.006282860470930045,1.170500554541026,0.3511501663623078,0,0,0,2,1.170500554541026,0.3511501663623078
2023,9,104,29,80,94,0,2503.048,60,705.681,MORE,-244,950,706,2,1,14.0,1.3123718449442827,14.0,0.8730378697119728,0.2637199245091737,1.3213821841720779,174,80,94,0,0.2792303847455295,0.0,0.5462335921191455,1.300944456804566,-0.6215360594495144,0.6215360594495144,0.5462335921191455,0.0,0,1,0,1,0.5462335921191455,0.0
2024,9,105,55,110,98,0,2142.45,70,1510.2379999999996,MORE,-64,684,620,0,2,-12.0,-1.124890152809385,12.0,0.5238227218271837,0.6274715445218272,0.6812689273217788,208,110,98,1,0.9573613191275298,1.170500554541026,0.7023003327246156,-2.267360339002243,-0.11703871308487156,0.11703871308487156,0.7023003327246156,1.170500554541026,1,0,0,2,1.170500554541026,0.7023003327246156
2025,9,106,29,94,80,0,3268.297,10,1446.036,MORE,-538,1330,792,1,1,-14.0,-1.3123718449442827,14.0,0.8730378697119728,-1.5550381755540934,2.6798091019348917,174,94,80,1,0.2792303847455295,0.5462335921191455,0.0,-0.48320794109883863,-1.445548391845098,1.445548391845098,0.0,0.5462335921191455,0,0,0,1,0.5462335921191455,0.0
2026,9,107,57,110,94,0,1632.447,20,1420.326,MORE,-172,626,454,1,2,-16.0,-1.4998535370791803,16.0,1.222253017596762,-1.19128655554144,-0.22405966943533914,204,110,94,1,0.8775812092002355,1.170500554541026,0.5462335921191455,-0.48320794109883863,-0.4197371209036573,0.4197371209036573,0.5462335921191455,1.170500554541026,0,0,0,2,1.170500554541026,0.5462335921191455
2027,9,108,39,80,66,0,1724.622,100,2095.199,MORE,448,648,1096,2,2,-14.0,-1.3123718449442827,14.0,0.8730378697119728,1.7187264045597874,-0.06043580172066389,146,80,66,1,-0.2792303847455295,0.0,-0.5462335921191455,1.300944456804566,1.3179759610190016,1.3179759610190016,-0.5462335921191455,0.0,1,1,1,1,0.0,-0.5462335921191455
2028,9,109,4,50,54,1,1463.996,60,1357.527,MORE,148,374,522,1,2,4.0,0.3749633842697951,4.0,-0.8730378697119728,0.2637199245091737,-0.5230843956670145,104,50,54,0,-1.116921538982118,-1.170500554541026,-1.0144338139355558,-0.48320794109883863,0.47714705041126343,0.47714705041126343,-1.0144338139355558,-1.170500554541026,0,0,1,0,-1.170500554541026,-1.0144338139355558
2029,9,110,55,98,110,0,1469.6329999999996,80,839.83,MORE,-16,416,400,1,2,12.0,1.124890152809385,12.0,0.5238227218271837,0.9912231645344806,-0.513077910803358,208,98,110,0,0.9573613191275298,0.7023003327246156,1.170500554541026,-0.48320794109883863,0.017493912612366554,0.017493912612366554,1.170500554541026,0.7023003327246156,1,0,0,2,1.170500554541026,0.7023003327246156
2030,9,111,2,50,52,1,1770.168,0,1451.894,MORE,-314,746,432,1,1,2.0,0.18748169213489754,2.0,-1.222253017596762,-1.9187897955667468,0.020414891839765237,102,50,52,0,-1.156811593945765,-1.170500554541026,-1.092467184238291,-0.48320794109883863,-0.8177294719246534,0.8177294719246534,-1.092467184238291,-1.170500554541026,0,0,0,0,-1.170500554541026,-1.092467184238291
2031,9,112,59,110,89,0,1734.9779999999996,90,1439.47,MORE,50,652,702,1,2,-21.0,-1.9685577674164243,21.0,2.0952908873087353,1.354974784547134,-0.04205241388173688,199,110,89,1,0.7778560717911179,1.170500554541026,0.3511501663623078,-0.48320794109883863,0.20247627294606899,0.20247627294606899,0.3511501663623078,1.170500554541026,1,0,1,2,1.170500554541026,0.3511501663623078
2032,9,113,60,87,110,1,1830.813,70,1045.378,MORE,266,280,546,1,2,23.0,2.1560394595513217,23.0,2.444506035193524,0.6274715445218272,0.12806847966245571,197,87,110,0,0.7379660168274708,0.27311679605957273,1.170500554541026,-0.48320794109883863,0.8078730885836405,0.8078730885836405,1.170500554541026,0.27311679605957273,1,0,1,2,1.170500554541026,0.27311679605957273
2033,9,114,52,110,105,0,1773.786,70,1510.846,MORE,-166,658,492,2,2,-5.0,-0.4687042303372438,5.0,-0.6984302957695783,0.6274715445218272,0.02683736163517311,215,110,105,1,1.0969765115002945,1.170500554541026,0.9754171287841883,1.300944456804566,-0.4029205426915025,0.4029205426915025,0.9754171287841883,1.170500554541026,1,1,0,2,1.170500554541026,0.9754171287841883
2034,9,115,30,80,96,1,1453.213,70,1548.391,MORE,-130,598,468,1,2,16.0,1.4998535370791803,16.0,1.222253017596762,0.6274715445218272,-0.5422257698527195,176,80,96,0,0.3191204397091766,0.0,0.6242669624218805,-0.48320794109883863,-0.3020210734185739,0.3020210734185739,0.6242669624218805,0.0,1,0,0,1,0.6242669624218805,0.0
2035,9,116,24,80,86,0,1650.519,80,1110.384,MORE,154,972,1126,2,1,6.0,0.5624450764046927,6.0,-0.5238227218271837,0.9912231645344806,-0.19197927304434784,166,80,86,0,0.11967016489094122,0.0,0.2341001109082052,1.300944456804566,0.4939636286234182,0.4939636286234182,0.2341001109082052,0.0,1,1,1,1,0.2341001109082052,0.0
2036,9,117,5,50,55,1,1518.317,60,1182.168,MORE,732,528,1260,2,1,5.0,0.4687042303372438,5.0,-0.6984302957695783,0.2637199245091737,-0.4266568164087681,105,50,55,0,-1.0969765115002945,-1.170500554541026,-0.9754171287841883,1.300944456804566,2.1139606630609937,2.1139606630609937,-0.9754171287841883,-1.170500554541026,0,1,1,0,-1.170500554541026,-0.9754171287841883
2037,9,118,34,80,74,0,1905.45,70,1780.57,MORE,-220,630,410,2,1,-6.0,-0.5624450764046927,6.0,-0.5238227218271837,0.6274715445218272,0.260559877705528,154,80,74,1,-0.11967016489094122,0.0,-0.2341001109082052,1.300944456804566,-0.5542697466008955,0.5542697466008955,-0.2341001109082052,0.0,1,1,0,1,0.0,-0.2341001109082052
2038,9,119,15,45,50,0,1860.143,30,960.872,MORE,-112,576,464,2,1,5.0,0.4687042303372438,5.0,-0.6984302957695783,-0.8275349355287865,0.18013344348205326,95,45,50,0,-1.2964267863185297,-1.3655839802978638,-1.170500554541026,1.300944456804566,-0.25157133878210963,0.25157133878210963,-1.170500554541026,-1.3655839802978638,0,1,0,0,-1.3655839802978638,-1.170500554541026
2039,9,120,37,69,80,0,1720.63,40,912.29,MORE,-102,660,558,2,1,11.0,1.0311493067419364,11.0,0.34921514788478913,-0.4637833155161331,-0.06752217524837723,149,69,80,0,-0.21939530230005888,-0.4291835366650429,0.0,1.300944456804566,-0.22354370842851837,0.22354370842851837,0.0,-0.4291835366650429,0,1,0,1,-0.4291835366650429,0.0
2040,9,121,48,128,110,0,1300.872,60,1333.149,LESS,450,274,724,1,2,-18.0,-1.6873352292140782,18.0,1.571468165481551,0.2637199245091737,-0.8126529315725055,238,128,110,0,1.5557121435822359,1.8728008872656416,1.170500554541026,-0.48320794109883863,1.32358148708972,1.32358148708972,1.170500554541026,1.8728008872656416,0,1,1,2,1.8728008872656416,1.170500554541026
2041,9,122,8,50,58,0,1054.751,60,1074.273,LESS,-64,356,292,1,2,8.0,0.7499267685395902,8.0,-0.17460757394239454,0.2637199245091737,-1.2495530665961398,108,50,58,1,-1.0371414290548238,-1.170500554541026,-0.8583670733300858,-0.48320794109883863,-0.11703871308487156,0.11703871308487156,-0.8583670733300858,-1.170500554541026,1,1,0,0,-1.170500554541026,-0.8583670733300858
2042,9,123,4,54,50,0,1106.469,70,1389.364,LESS,-260,598,338,2,1,-4.0,-0.3749633842697951,4.0,-0.8730378697119728,0.6274715445218272,-1.1577461863089953,104,54,50,0,-1.116921538982118,-1.0144338139355558,-1.170500554541026,1.300944456804566,-0.6663802680152605,0.6663802680152605,-1.170500554541026,-1.0144338139355558,1,1,0,0,-1.0144338139355558,-1.170500554541026
2043,9,124,37,80,69,1,1347.055,70,1087.779,LESS,18,340,358,1,2,-11.0,-1.0311493067419364,11.0,0.34921514788478913,0.6274715445218272,-0.7306714714947531,149,80,69,0,-0.21939530230005888,0.0,-0.4291835366650429,-0.48320794109883863,0.11278785581457688,0.11278785581457688,-0.4291835366650429,0.0,1,0,1,1,0.0,-0.4291835366650429
2044,9,125,52,105,110,1,2228.3,30,1946.494,LESS,-1626,2102,476,2,1,5.0,0.4687042303372438,5.0,-0.6984302957695783,-0.8275349355287865,0.8336650113283413,215,105,110,1,1.0969765115002945,0.9754171287841883,1.170500554541026,1.300944456804566,-4.494954574315829,4.494954574315829,1.170500554541026,0.9754171287841883,0,1,0,2,1.170500554541026,0.9754171287841883
2045,9,126,5,55,50,0,2428.003,60,1331.165,LESS,208,444,652,1,2,-5.0,-0.4687042303372438,5.0,-0.6984302957695783,0.2637199245091737,1.1881665275119455,105,55,50,0,-1.0969765115002945,-0.9754171287841883,-1.170500554541026,-0.48320794109883863,0.6453128325328111,0.6453128325328111,-1.170500554541026,-0.9754171287841883,1,0,1,0,-0.9754171287841883,-1.170500554541026
2046,9,127,30,96,80,1,1249.481,0,712.663,LESS,38,318,356,1,2,-16.0,-1.4998535370791803,16.0,1.222253017596762,-1.9187897955667468,-0.9038793398798001,176,96,80,0,0.3191204397091766,0.6242669624218805,0.0,-0.48320794109883863,0.16884311652175943,0.16884311652175943,0.0,0.6242669624218805,0,0,1,1,0.6242669624218805,0.0
2047,9,128,33,80,75,1,1192.81,80,1271.143,LESS,42,374,416,1,2,-5.0,-0.4687042303372438,5.0,-0.6984302957695783,0.9912231645344806,-1.0044785067608235,155,80,75,0,-0.09972513740911768,0.0,-0.19508342575683765,-0.48320794109883863,0.18005416866319596,0.18005416866319596,-0.19508342575683765,0.0,1,0,1,1,0.0,-0.19508342575683765
2048,9,129,48,110,128,0,1595.585,60,1647.628,LESS,-88,556,468,1,2,18.0,1.6873352292140782,18.0,1.571468165481551,0.2637199245091737,-0.28949501537185474,238,110,128,1,1.5557121435822359,1.170500554541026,1.8728008872656416,-0.48320794109883863,-0.1843050259334906,0.1843050259334906,1.8728008872656416,1.170500554541026,1,0,0,2,1.8728008872656416,1.170500554541026
2049,9,130,9,59,50,0,2120.993,80,1181.07,LESS,-132,536,404,1,2,-9.0,-0.8436676146070391,9.0,0.0,0.9912231645344806,0.6431796696103195,109,59,50,0,-1.0171964015730004,-0.8193503881787182,-1.170500554541026,-0.48320794109883863,-0.3076265994892922,0.3076265994892922,-1.170500554541026,-0.8193503881787182,1,0,0,0,-0.8193503881787182,-1.170500554541026
2050,9,131,44,110,119,1,1511.851,20,1682.61,LESS,36,368,404,1,2,9.0,0.8436676146070391,9.0,0.0,-1.19128655554144,-0.4381348953742477,229,110,119,1,1.376206896245824,1.170500554541026,1.5216507209033339,-0.48320794109883863,0.16323759045104116,0.16323759045104116,1.5216507209033339,1.170500554541026,0,0,1,2,1.5216507209033339,1.170500554541026
2051,9,132,2,52,50,0,1884.494,70,922.566,LESS,140,440,580,1,2,-2.0,-0.18748169213489754,2.0,-1.222253017596762,0.6274715445218272,0.22335996697237093,102,52,50,0,-1.156811593945765,-1.092467184238291,-1.170500554541026,-0.48320794109883863,0.45472494612839043,0.45472494612839043,-1.170500554541026,-1.092467184238291,1,0,1,0,-1.092467184238291,-1.170500554541026
2052,9,133,8,58,50,1,2066.95,80,808.148,LESS,606,508,1114,1,2,-8.0,-0.7499267685395902,8.0,-0.17460757394239454,0.9912231645344806,0.5472455802921291,108,58,50,0,-1.0371414290548238,-0.8583670733300858,-1.170500554541026,-0.48320794109883863,1.7608125206057437,1.7608125206057437,-1.170500554541026,-0.8583670733300858,1,0,1,0,-0.8583670733300858,-1.170500554541026
2053,9,134,44,119,110,1,2003.251,10,1528.899,LESS,-168,548,380,2,1,-9.0,-0.8436676146070391,9.0,0.0,-1.5550381755540934,0.4341707037034983,229,119,110,0,1.376206896245824,1.5216507209033339,1.170500554541026,1.300944456804566,-0.40852606876222075,0.40852606876222075,1.170500554541026,1.5216507209033339,0,1,0,2,1.5216507209033339,1.170500554541026
2054,9,135,34,74,80,1,1867.288,70,1153.8010000000004,LESS,-68,464,396,1,2,6.0,0.5624450764046927,6.0,-0.5238227218271837,0.6274715445218272,0.1928168449989651,154,74,80,1,-0.11967016489094122,-0.2341001109082052,0.0,-0.48320794109883863,-0.12824976522630807,0.12824976522630807,0.0,-0.2341001109082052,1,0,0,1,-0.2341001109082052,0.0
2055,9,136,24,86,80,1,2675.363,90,1190.998,LESS,498,504,1002,1,2,-6.0,-0.5624450764046927,6.0,-0.5238227218271837,1.354974784547134,1.6272660655418012,166,86,80,0,0.11967016489094122,0.2341001109082052,0.0,-0.48320794109883863,1.458114112786958,1.458114112786958,0.0,0.2341001109082052,1,0,1,1,0.2341001109082052,0.0
2056,9,137,39,66,80,0,1946.074,40,1048.038,LESS,94,400,494,1,2,14.0,1.3123718449442827,14.0,0.8730378697119728,-0.4637833155161331,0.33267331412582585,146,66,80,1,-0.2792303847455295,-0.5462335921191455,0.0,-0.48320794109883863,0.3257978465018706,0.3257978465018706,0.0,-0.5462335921191455,0,0,1,1,-0.5462335921191455,0.0
2057,9,138,9,50,59,1,1418.2579999999996,80,1131.337,LESS,8,360,368,1,2,9.0,0.8436676146070391,9.0,0.0,0.9912231645344806,-0.6042759168119439,109,50,59,1,-1.0171964015730004,-1.170500554541026,-0.8193503881787182,-0.48320794109883863,0.0847602254609856,0.0847602254609856,-0.8193503881787182,-1.170500554541026,1,0,1,0,-1.170500554541026,-0.8193503881787182
2058,9,139,57,94,110,1,1381.159,60,1173.658,LESS,54,234,288,1,2,16.0,1.4998535370791803,16.0,1.222253017596762,0.2637199245091737,-0.6701319717980752,204,94,110,1,0.8775812092002355,0.5462335921191455,1.170500554541026,-0.48320794109883863,0.2136873250875055,0.2136873250875055,1.170500554541026,0.5462335921191455,1,0,1,2,1.170500554541026,0.5462335921191455
2059,9,140,60,110,87,1,3053.123,10,992.004,LESS,-352,600,248,1,1,-23.0,-2.1560394595513217,23.0,2.444506035193524,-1.5550381755540934,2.297844338044059,197,110,87,0,0.7379660168274708,1.170500554541026,0.27311679605957273,-0.48320794109883863,-0.9242344672683002,0.9242344672683002,0.27311679605957273,1.170500554541026,0,0,0,2,1.170500554541026,0.27311679605957273
2060,9,141,33,75,80,0,1265.693,100,2169.741,LESS,152,158,310,0,1,5.0,0.4687042303372438,5.0,-0.6984302957695783,1.7187264045597874,-0.8751007107136453,155,75,80,1,-0.09972513740911768,-0.19508342575683765,0.0,-2.267360339002243,0.48835810255269996,0.48835810255269996,0.0,-0.19508342575683765,1,0,1,1,-0.19508342575683765,0.0
2061,9,142,15,50,45,1,1815.269,80,1120.603,LESS,-134,530,396,1,2,-5.0,-0.4687042303372438,5.0,-0.6984302957695783,0.9912231645344806,0.10047564646737113,95,50,45,0,-1.2964267863185297,-1.170500554541026,-1.3655839802978638,-0.48320794109883863,-0.31323212556001045,0.31323212556001045,-1.3655839802978638,-1.170500554541026,1,0,0,0,-1.170500554541026,-1.3655839802978638
2062,9,143,59,89,110,0,1339.931,0,1344.058,LESS,-154,364,210,1,2,21.0,1.9685577674164243,21.0,2.0952908873087353,-1.9187897955667468,-0.7433175949946104,199,89,110,1,0.7778560717911179,0.3511501663623078,1.170500554541026,-0.48320794109883863,-0.369287386267193,0.369287386267193,1.170500554541026,0.3511501663623078,0,0,0,2,1.170500554541026,0.3511501663623078
2063,9,144,29,80,94,0,1271.036,30,1097.9589999999996,LESS,78,298,376,1,2,14.0,1.3123718449442827,14.0,0.8730378697119728,-0.8275349355287865,-0.8656161180887523,174,80,94,1,0.2792303847455295,0.0,0.5462335921191455,-0.48320794109883863,0.28095363793612455,0.28095363793612455,0.5462335921191455,0.0,0,0,1,1,0.5462335921191455,0.0
2064,9,145,55,110,98,1,1844.011,20,1904.943,LESS,28,410,438,1,2,-12.0,-1.124890152809385,12.0,0.5238227218271837,-1.19128655554144,0.1514968258094398,208,110,98,0,0.9573613191275298,1.170500554541026,0.7023003327246156,-0.48320794109883863,0.14081548616816816,0.14081548616816816,0.7023003327246156,1.170500554541026,0,0,1,2,1.170500554541026,0.7023003327246156
2065,9,146,29,94,80,1,1857.445,80,1564.474,LESS,-176,552,376,1,2,-14.0,-1.3123718449442827,14.0,0.8730378697119728,0.9912231645344806,0.17534410586237106,174,94,80,0,0.2792303847455295,0.5462335921191455,0.0,-0.48320794109883863,-0.4309481730450938,0.4309481730450938,0.0,0.5462335921191455,1,0,0,1,0.5462335921191455,0.0
2066,9,147,57,110,94,1,1799.812,40,963.996,LESS,22,456,478,1,2,-16.0,-1.4998535370791803,16.0,1.222253017596762,-0.4637833155161331,0.07303725077151271,204,110,94,0,0.8775812092002355,1.170500554541026,0.5462335921191455,-0.48320794109883863,0.1239989079560134,0.1239989079560134,0.5462335921191455,1.170500554541026,0,0,1,2,1.170500554541026,0.5462335921191455
2067,9,148,39,80,66,1,1272.332,90,1073.313,LESS,402,338,740,1,2,-14.0,-1.3123718449442827,14.0,0.8730378697119728,1.354974784547134,-0.8633155318933823,146,80,66,0,-0.2792303847455295,0.0,-0.5462335921191455,-0.48320794109883863,1.189048861392482,1.189048861392482,-0.5462335921191455,0.0,1,0,1,1,0.0,-0.5462335921191455
2068,9,149,4,50,54,1,1205.468,30,863.425,LESS,-74,370,296,1,1,4.0,0.3749633842697951,4.0,-0.8730378697119728,-0.8275349355287865,-0.9820087381952431,104,50,54,1,-1.116921538982118,-1.170500554541026,-1.0144338139355558,-0.48320794109883863,-0.14506634343846284,0.14506634343846284,-1.0144338139355558,-1.170500554541026,0,0,0,0,-1.170500554541026,-1.0144338139355558
2069,9,150,55,98,110,1,1390.371,20,1262.095,LESS,68,318,386,1,2,12.0,1.124890152809385,12.0,0.5238227218271837,-1.19128655554144,-0.6537793483167887,208,98,110,1,0.9573613191275298,0.7023003327246156,1.170500554541026,-0.48320794109883863,0.25292600758253325,0.25292600758253325,1.170500554541026,0.7023003327246156,0,0,1,2,1.170500554541026,0.7023003327246156
2070,9,151,2,50,52,1,1908.069,60,570.001,LESS,-80,498,418,1,1,2.0,0.18748169213489754,2.0,-1.222253017596762,0.2637199245091737,0.2652089789753377,102,50,52,1,-1.156811593945765,-1.170500554541026,-1.092467184238291,-0.48320794109883863,-0.1618829216506176,0.1618829216506176,-1.092467184238291,-1.170500554541026,0,0,0,0,-1.170500554541026,-1.092467184238291
2071,9,152,59,110,89,0,1424.142,0,1527.69,LESS,-30,386,356,1,1,-21.0,-1.9685577674164243,21.0,2.0952908873087353,-1.9187897955667468,-0.5938309714619768,199,110,89,0,0.7778560717911179,1.170500554541026,0.3511501663623078,-0.48320794109883863,-0.02174476988266123,0.02174476988266123,0.3511501663623078,1.170500554541026,0,0,0,2,1.170500554541026,0.3511501663623078
2072,9,153,60,87,110,0,1372.099,30,1174.37,LESS,-144,510,366,1,1,23.0,2.1560394595513217,23.0,2.444506035193524,-0.8275349355287865,-0.6862147734416335,197,87,110,1,0.7379660168274708,0.27311679605957273,1.170500554541026,-0.48320794109883863,-0.34125975591360175,0.34125975591360175,1.170500554541026,0.27311679605957273,0,0,0,2,1.170500554541026,0.27311679605957273
2073,9,154,52,110,105,1,2102.561,40,1264.619,LESS,-554,926,372,1,2,-5.0,-0.4687042303372438,5.0,-0.6984302957695783,-0.4637833155161331,0.6104602214983926,215,110,105,0,1.0969765115002945,1.170500554541026,0.9754171287841883,-0.48320794109883863,-1.4903926004108439,1.4903926004108439,0.9754171287841883,1.170500554541026,0,0,0,2,1.170500554541026,0.9754171287841883
2074,9,155,30,80,96,0,4213.558,80,1287.3239999999996,LESS,618,928,1546,2,1,16.0,1.4998535370791803,16.0,1.222253017596762,0.9912231645344806,4.357783181889774,176,80,96,1,0.3191204397091766,0.0,0.6242669624218805,1.300944456804566,1.7944456770300532,1.7944456770300532,0.6242669624218805,0.0,1,1,1,1,0.6242669624218805,0.0
2075,9,156,24,80,86,0,1842.573,70,1315.8829999999996,LESS,58,446,504,1,2,6.0,0.5624450764046927,6.0,-0.5238227218271837,0.6274715445218272,0.14894416921303424,166,80,86,1,0.11967016489094122,0.0,0.2341001109082052,-0.48320794109883863,0.224898377228942,0.224898377228942,0.2341001109082052,0.0,1,0,1,1,0.2341001109082052,0.0
2076,9,157,5,50,55,0,1551.521,80,1483.931,LESS,96,400,496,1,2,5.0,0.4687042303372438,5.0,-0.6984302957695783,0.9912231645344806,-0.3677149460144308,105,50,55,1,-1.0969765115002945,-1.170500554541026,-0.9754171287841883,-0.48320794109883863,0.33140337257258884,0.33140337257258884,-0.9754171287841883,-1.170500554541026,1,0,1,0,-1.170500554541026,-0.9754171287841883
2077,9,158,34,80,74,1,1512.8829999999996,0,971.547,LESS,10,392,402,1,2,-6.0,-0.5624450764046927,6.0,-0.5238227218271837,-1.9187897955667468,-0.4363029471075652,154,80,74,0,-0.11967016489094122,0.0,-0.2341001109082052,-0.48320794109883863,0.09036575153170387,0.09036575153170387,-0.2341001109082052,0.0,0,0,1,1,0.0,-0.2341001109082052
2078,9,159,15,45,50,1,1877.203,30,2355.961,LESS,170,368,538,1,2,5.0,0.4687042303372438,5.0,-0.6984302957695783,-0.8275349355287865,0.21041739447974614,95,45,50,1,-1.2964267863185297,-1.3655839802978638,-1.170500554541026,-0.48320794109883863,0.5388078371891643,0.5388078371891643,-1.170500554541026,-1.3655839802978638,0,0,1,0,-1.3655839802978638,-1.170500554541026
2079,9,160,37,69,80,0,2026.825,90,1252.561,LESS,816,1024,1840,2,2,11.0,1.0311493067419364,11.0,0.34921514788478913,1.354974784547134,0.4760179405627958,149,69,80,1,-0.21939530230005888,-0.4291835366650429,0.0,1.300944456804566,2.3493927580311604,2.3493927580311604,0.0,-0.4291835366650429,1,1,1,1,-0.4291835366650429,0.0
2080,9,161,3,50,53,1,1672.766,50,1766.74,MORE,-18,364,346,1,2,3.0,0.28122253820234633,3.0,-1.0476454436543674,-0.10003169550347968,-0.15248765183416735,103,50,53,0,-1.1368665664639415,-1.170500554541026,-1.0534504990869233,-0.48320794109883863,0.0118883865416483,0.0118883865416483,-1.0534504990869233,-1.170500554541026,0,0,0,0,-1.170500554541026,-1.0534504990869233
2081,9,162,20,50,40,0,1211.748,80,1578.1529999999998,MORE,-20,276,256,1,2,-10.0,-0.9374084606744876,10.0,0.17460757394239454,0.9912231645344806,-0.9708608359522471,90,50,40,1,-1.3961519237276474,-1.170500554541026,-1.5606674060547012,-0.48320794109883863,0.006282860470930045,0.006282860470930045,-1.5606674060547012,-1.170500554541026,1,0,0,0,-1.170500554541026,-1.5606674060547012
2082,9,163,25,80,88,1,1422.886,100,2605.97,MORE,120,270,390,1,2,8.0,0.7499267685395902,8.0,-0.17460757394239454,1.7187264045597874,-0.5960605519105763,168,80,88,0,0.1595602198545883,0.0,0.31213348121094026,-0.48320794109883863,0.3986696854212079,0.3986696854212079,0.31213348121094026,0.0,1,0,1,1,0.31213348121094026,0.0
2083,9,164,42,115,110,0,1275.274,40,642.808,MORE,132,264,396,1,2,-5.0,-0.4687042303372438,5.0,-0.6984302957695783,-0.4637833155161331,-0.8580930592183995,225,115,110,1,1.2964267863185297,1.3655839802978638,1.170500554541026,-0.48320794109883863,0.4323028418455174,0.4323028418455174,1.170500554541026,1.3655839802978638,0,0,1,2,1.3655839802978638,1.170500554541026
2084,9,165,53,103,110,0,1023.782,30,928.094,MORE,132,204,336,1,2,7.0,0.6561859224721414,7.0,-0.34921514788478913,-0.8275349355287865,-1.304527490889666,213,103,110,0,1.0570864565366473,0.8973837584814532,1.170500554541026,-0.48320794109883863,0.4323028418455174,0.4323028418455174,1.170500554541026,0.8973837584814532,0,0,1,2,1.170500554541026,0.8973837584814532
2085,9,166,26,90,80,0,1566.8429999999996,90,732.0110000000002,MORE,200,290,490,1,2,-10.0,-0.9374084606744876,10.0,0.17460757394239454,1.354974784547134,-0.3405161947139242,170,90,80,1,0.19945027481823535,0.3901668515136753,0.0,-0.48320794109883863,0.6228907282499381,0.6228907282499381,0.0,0.3901668515136753,1,0,1,1,0.3901668515136753,0.0
2086,9,167,35,80,72,0,1352.63,70,1106.364,MORE,92,272,364,1,2,-8.0,-0.7499267685395902,8.0,-0.17460757394239454,0.6274715445218272,-0.7207750455385901,152,80,72,1,-0.1595602198545883,0.0,-0.31213348121094026,-0.48320794109883863,0.3201923204311523,0.3201923204311523,-0.31213348121094026,0.0,1,0,1,1,0.0,-0.31213348121094026
2087,9,168,28,93,80,0,1244.595,90,1652.14,MORE,38,370,408,1,2,-13.0,-1.218630998876834,13.0,0.6984302957695783,1.354974784547134,-0.912552691847838,173,93,80,1,0.25928535726370594,0.5072169069677779,0.0,-0.48320794109883863,0.16884311652175943,0.16884311652175943,0.0,0.5072169069677779,1,0,1,1,0.5072169069677779,0.0
2088,9,169,26,80,90,1,1387.496,10,680.2719999999998,MORE,-2,344,342,1,2,10.0,0.9374084606744876,10.0,0.17460757394239454,-1.5550381755540934,-0.6588828863659311,170,80,90,0,0.19945027481823535,0.0,0.3901668515136753,-0.48320794109883863,0.05673259510739433,0.05673259510739433,0.3901668515136753,0.0,0,0,0,1,0.3901668515136753,0.0
2089,9,170,25,88,80,0,1483.815,20,1191.05,MORE,166,282,448,1,2,-8.0,-0.7499267685395902,8.0,-0.17460757394239454,-1.19128655554144,-0.4879028232858142,168,88,80,1,0.1595602198545883,0.31213348121094026,0.0,-0.48320794109883863,0.5275967850477278,0.5275967850477278,0.0,0.31213348121094026,0,0,1,1,0.31213348121094026,0.0
2090,9,171,36,80,70,0,1461.872,20,1282.214,MORE,-84,432,348,1,1,-10.0,-0.9374084606744876,10.0,0.17460757394239454,-1.19128655554144,-0.5268548008205374,150,80,70,1,-0.19945027481823535,0.0,-0.3901668515136753,-0.48320794109883863,-0.1730939737920541,0.1730939737920541,-0.3901668515136753,0.0,0,0,0,1,0.0,-0.3901668515136753
2091,9,172,28,80,93,1,1572.616,80,1139.168,MORE,170,322,492,1,2,13.0,1.218630998876834,13.0,0.6984302957695783,0.9912231645344806,-0.3302682903112458,173,80,93,0,0.25928535726370594,0.0,0.5072169069677779,-0.48320794109883863,0.5388078371891643,0.5388078371891643,0.5072169069677779,0.0,1,0,1,1,0.5072169069677779,0.0
2092,9,173,21,82,80,1,2036.769,0,1620.819,MORE,-28,446,418,2,1,-2.0,-0.18748169213489754,2.0,-1.222253017596762,-1.9187897955667468,0.4936699692099857,162,82,80,1,0.03989005496364707,0.07803337030273506,0.0,1.300944456804566,-0.016139243811942972,0.016139243811942972,0.0,0.07803337030273506,0,1,0,1,0.07803337030273506,0.0
2093,9,174,19,50,41,1,1693.0510000000004,30,1058.282,MORE,34,378,412,1,2,-9.0,-0.8436676146070391,9.0,0.0,-0.8275349355287865,-0.11647886250308807,91,50,41,1,-1.376206896245824,-1.170500554541026,-1.5216507209033339,-0.48320794109883863,0.15763206438032293,0.15763206438032293,-1.5216507209033339,-1.170500554541026,0,0,1,0,-1.170500554541026,-1.5216507209033339
2094,9,175,56,96,110,0,1715.57,40,1092.608,MORE,68,412,480,1,2,14.0,1.3123718449442827,14.0,0.8730378697119728,-0.4637833155161331,-0.07650440221486796,206,96,110,0,0.9174712641638826,0.6242669624218805,1.170500554541026,-0.48320794109883863,0.25292600758253325,0.25292600758253325,1.170500554541026,0.6242669624218805,0,0,1,2,1.170500554541026,0.6242669624218805
2095,9,176,23,80,85,1,1660.9160000000004,40,934.628,MORE,22,444,466,1,2,5.0,0.4687042303372438,5.0,-0.6984302957695783,-0.4637833155161331,-0.17352310431497936,165,80,85,0,0.09972513740911768,0.0,0.19508342575683765,-0.48320794109883863,0.1239989079560134,0.1239989079560134,0.19508342575683765,0.0,0,0,1,1,0.19508342575683765,0.0
2096,9,177,10,60,50,0,1437.479,80,1122.221,MORE,36,448,484,1,2,-10.0,-0.9374084606744876,10.0,0.17460757394239454,0.9912231645344806,-0.5701558803449644,110,60,50,1,-0.9972513740911768,-0.7803337030273506,-1.170500554541026,-0.48320794109883863,0.16323759045104116,0.16323759045104116,-1.170500554541026,-0.7803337030273506,1,0,1,0,-0.7803337030273506,-1.170500554541026
2097,9,178,19,41,50,1,1768.642,70,1242.411,MORE,44,390,434,1,2,9.0,0.8436676146070391,9.0,0.0,0.6274715445218272,0.017706022600464257,91,41,50,0,-1.376206896245824,-1.5216507209033339,-1.170500554541026,-0.48320794109883863,0.18565969473391422,0.18565969473391422,-1.170500554541026,-1.5216507209033339,1,0,1,0,-1.5216507209033339,-1.170500554541026
2098,9,179,56,110,96,0,1623.335,100,752.497,MORE,-34,426,392,1,2,-14.0,-1.3123718449442827,14.0,0.8730378697119728,1.7187264045597874,-0.2402347785496987,206,110,96,1,0.9174712641638826,1.170500554541026,0.6242669624218805,-0.48320794109883863,-0.03295582202409774,0.03295582202409774,0.6242669624218805,1.170500554541026,1,0,0,2,1.170500554541026,0.6242669624218805
2099,9,180,35,72,80,0,1826.331,80,1008.876,MORE,-322,722,400,2,1,8.0,0.7499267685395902,8.0,-0.17460757394239454,0.9912231645344806,0.1201122857368012,152,72,80,0,-0.1595602198545883,-0.31213348121094026,0.0,1.300944456804566,-0.8401515762075263,0.8401515762075263,0.0,-0.31213348121094026,1,1,0,1,-0.31213348121094026,0.0
2100,9,181,11,49,50,1,1082.646,30,1262.683,MORE,34,264,298,1,2,1.0,0.09374084606744876,1.0,-1.3968605915391563,-0.8275349355287865,-1.2000354339419403,99,49,50,0,-1.2166466763912356,-1.2095172396923934,-1.170500554541026,-0.48320794109883863,0.15763206438032293,0.15763206438032293,-1.170500554541026,-1.2095172396923934,0,0,1,0,-1.2095172396923934,-1.170500554541026
2101,9,182,17,43,50,1,1115.761,70,173.438,MORE,86,246,332,1,2,7.0,0.6561859224721414,7.0,-0.34921514788478913,0.6274715445218272,-1.1412515513341677,93,43,50,0,-1.3363168412821769,-1.4436173506005987,-1.170500554541026,-0.48320794109883863,0.30337574221899755,0.30337574221899755,-1.170500554541026,-1.4436173506005987,1,0,1,0,-1.4436173506005987,-1.170500554541026
2102,9,183,1,51,50,0,1659.308,80,488.0630000000001,MORE,104,268,372,1,2,-1.0,-0.09374084606744876,1.0,-1.3968605915391563,0.9912231645344806,-0.1763775353351612,101,51,50,1,-1.1767566214275886,-1.1314838693896585,-1.170500554541026,-0.48320794109883863,0.35382547685546184,0.35382547685546184,-1.170500554541026,-1.1314838693896585,1,0,1,0,-1.1314838693896585,-1.170500554541026
2103,9,184,41,112,110,0,1612.594,30,1170.436,MORE,50,350,400,0,2,-2.0,-0.18748169213489754,2.0,-1.222253017596762,-0.8275349355287865,-0.2593015967012943,222,112,110,1,1.2365917038730592,1.248533924843761,1.170500554541026,-2.267360339002243,0.20247627294606899,0.20247627294606899,1.170500554541026,1.248533924843761,0,0,1,2,1.248533924843761,1.170500554541026
2104,9,185,20,40,50,1,2141.188,90,1020.769,MORE,46,358,404,0,1,10.0,0.9374084606744876,10.0,0.17460757394239454,1.354974784547134,0.6790286960111644,90,40,50,0,-1.3961519237276474,-1.5606674060547012,-1.170500554541026,-2.267360339002243,0.19126522080463246,0.19126522080463246,-1.170500554541026,-1.5606674060547012,1,0,1,0,-1.5606674060547012,-1.170500554541026
2105,9,186,1,50,51,1,1843.804,50,1350.3870000000004,MORE,-76,552,476,1,2,1.0,0.09374084606744876,1.0,-1.3968605915391563,-0.10003169550347968,0.15112937106990176,101,50,51,0,-1.1767566214275886,-1.170500554541026,-1.1314838693896585,-0.48320794109883863,-0.15067186950918107,0.15067186950918107,-1.1314838693896585,-1.170500554541026,0,0,0,0,-1.170500554541026,-1.1314838693896585
2106,9,187,23,85,80,0,3760.222,30,1124.61,MORE,-364,1374,1010,3,1,-5.0,-0.4687042303372438,5.0,-0.6984302957695783,-0.8275349355287865,3.553046651439003,165,85,80,1,0.09972513740911768,0.19508342575683765,0.0,3.0850968547079707,-0.9578676236926097,0.9578676236926097,0.0,0.19508342575683765,0,1,0,1,0.19508342575683765,0.0
2107,9,188,11,50,49,1,1652.6729999999998,60,981.64,MORE,136,386,522,1,2,-1.0,-0.09374084606744876,1.0,-1.3968605915391563,0.2637199245091737,-0.18815561358074734,99,50,49,1,-1.2166466763912356,-1.170500554541026,-1.2095172396923934,-0.48320794109883863,0.4435138939869539,0.4435138939869539,-1.2095172396923934,-1.170500554541026,0,0,1,0,-1.170500554541026,-1.2095172396923934
2108,9,189,17,50,43,0,1279.538,70,1552.6029999999996,MORE,-34,392,358,1,2,-7.0,-0.6561859224721414,7.0,-0.34921514788478913,0.6274715445218272,-0.8505238466126452,93,50,43,1,-1.3363168412821769,-1.170500554541026,-1.4436173506005987,-0.48320794109883863,-0.03295582202409774,0.03295582202409774,-1.4436173506005987,-1.170500554541026,1,0,0,0,-1.170500554541026,-1.4436173506005987
2109,9,190,21,80,82,1,1342.9229999999998,90,854.334,MORE,10,356,366,1,2,2.0,0.18748169213489754,2.0,-1.222253017596762,1.354974784547134,-0.7380063651361644,162,80,82,0,0.03989005496364707,0.0,0.07803337030273506,-0.48320794109883863,0.09036575153170387,0.09036575153170387,0.07803337030273506,0.0,1,0,0,1,0.07803337030273506,0.0
2110,9,191,10,50,60,0,1662.773,70,1237.957,MORE,-280,648,368,2,1,10.0,0.9374084606744876,10.0,0.17460757394239454,0.6274715445218272,-0.17022666252115162,110,50,60,0,-0.9972513740911768,-1.170500554541026,-0.7803337030273506,1.300944456804566,-0.722435528722443,0.722435528722443,-0.7803337030273506,-1.170500554541026,1,1,0,0,-1.170500554541026,-0.7803337030273506
2111,9,192,3,53,50,0,2508.084,50,933.99,MORE,36,546,582,1,1,-3.0,-0.28122253820234633,3.0,-1.0476454436543674,-0.10003169550347968,1.330321807690506,103,53,50,1,-1.1368665664639415,-1.0534504990869233,-1.170500554541026,-0.48320794109883863,0.16323759045104116,0.16323759045104116,-1.170500554541026,-1.0534504990869233,0,0,1,0,-1.0534504990869233,-1.170500554541026
2112,9,193,45,122,110,0,3754.656,80,1087.499,MORE,-168,620,452,2,1,-12.0,-1.124890152809385,12.0,0.5238227218271837,0.9912231645344806,3.5431662017758634,232,122,110,1,1.4360419786912946,1.6387007763574364,1.170500554541026,1.300944456804566,-0.40852606876222075,0.40852606876222075,1.170500554541026,1.6387007763574364,1,1,0,2,1.6387007763574364,1.170500554541026
2113,9,194,38,67,80,1,1307.697,10,671.171,MORE,-12,394,382,1,2,13.0,1.218630998876834,13.0,0.6984302957695783,-1.5550381755540934,-0.8005375760297593,147,67,80,0,-0.25928535726370594,-0.5072169069677779,0.0,-0.48320794109883863,0.028704964753803065,0.028704964753803065,0.0,-0.5072169069677779,0,0,0,1,-0.5072169069677779,0.0
2114,9,195,38,80,67,0,1206.212,100,972.882,MORE,16,356,372,1,2,-13.0,-1.218630998876834,13.0,0.6984302957695783,1.7187264045597874,-0.9806880313053088,147,80,67,1,-0.25928535726370594,0.0,-0.5072169069677779,-0.48320794109883863,0.10718232974385863,0.10718232974385863,-0.5072169069677779,0.0,1,0,0,1,0.0,-0.5072169069677779
2115,9,196,36,70,80,1,1185.462,30,771.0830000000002,MORE,186,156,342,1,2,10.0,0.9374084606744876,10.0,0.17460757394239454,-0.8275349355287865,-1.0175222624425966,150,70,80,0,-0.19945027481823535,-0.3901668515136753,0.0,-0.48320794109883863,0.5836520457549103,0.5836520457549103,0.0,-0.3901668515136753,0,0,1,1,-0.3901668515136753,0.0
2116,9,197,45,110,122,0,1392.939,50,1143.355,MORE,58,246,304,1,2,12.0,1.124890152809385,12.0,0.5238227218271837,-0.10003169550347968,-0.6492207793741114,232,110,122,0,1.4360419786912946,1.170500554541026,1.6387007763574364,-0.48320794109883863,0.224898377228942,0.224898377228942,1.6387007763574364,1.170500554541026,0,0,1,2,1.6387007763574364,1.170500554541026
2117,9,198,42,110,115,0,1522.491,90,1214.62,MORE,64,334,398,1,2,5.0,0.4687042303372438,5.0,-0.6984302957695783,1.354974784547134,-0.4192473667332483,225,110,115,0,1.2964267863185297,1.170500554541026,1.3655839802978638,-0.48320794109883863,0.24171495544109675,0.24171495544109675,1.3655839802978638,1.170500554541026,1,0,1,2,1.3655839802978638,1.170500554541026
2118,9,199,41,110,112,0,3121.925,40,1085.312,MORE,158,632,790,2,2,2.0,0.18748169213489754,2.0,-1.222253017596762,-0.4637833155161331,2.41997777277696,222,110,112,0,1.2365917038730592,1.170500554541026,1.248533924843761,1.300944456804566,0.5051746807648547,0.5051746807648547,1.248533924843761,1.170500554541026,0,1,1,2,1.248533924843761,1.170500554541026
2119,9,200,53,110,103,0,1837.339,60,1272.476,MORE,-274,652,378,2,1,-7.0,-0.6561859224721414,7.0,-0.34921514788478913,0.2637199245091737,0.1396530672480911,213,110,103,1,1.0570864565366473,1.170500554541026,0.8973837584814532,1.300944456804566,-0.7056189505102882,0.7056189505102882,0.8973837584814532,1.170500554541026,0,1,0,2,1.170500554541026,0.8973837584814532
2120,9,201,3,50,53,0,2098.8160000000007,80,795.174,LESS,-146,654,508,2,1,3.0,0.28122253820234633,3.0,-1.0476454436543674,0.9912231645344806,0.6038123084569892,103,50,53,1,-1.1368665664639415,-1.170500554541026,-1.0534504990869233,1.300944456804566,-0.34686528198432,0.34686528198432,-1.0534504990869233,-1.170500554541026,1,1,0,0,-1.170500554541026,-1.0534504990869233
2121,9,202,20,50,40,1,3274.327,60,1322.9260000000004,LESS,88,872,960,2,2,-10.0,-0.9374084606744876,10.0,0.17460757394239454,0.2637199245091737,2.6905132182605707,90,50,40,0,-1.3961519237276474,-1.170500554541026,-1.5606674060547012,1.300944456804566,0.30898126828971584,0.30898126828971584,-1.5606674060547012,-1.170500554541026,0,1,1,0,-1.170500554541026,-1.5606674060547012
2122,9,203,25,80,88,1,1462.63,30,938.889,LESS,98,332,430,1,2,8.0,0.7499267685395902,8.0,-0.17460757394239454,-0.8275349355287865,-0.525509241919233,168,80,88,1,0.1595602198545883,0.0,0.31213348121094026,-0.48320794109883863,0.3370088986433071,0.3370088986433071,0.31213348121094026,0.0,0,0,1,1,0.31213348121094026,0.0
2123,9,204,42,115,110,1,1108.256,10,1128.342,LESS,-20,336,316,1,2,-5.0,-0.4687042303372438,5.0,-0.6984302957695783,-1.5550381755540934,-1.1545740045720154,225,115,110,0,1.2964267863185297,1.3655839802978638,1.170500554541026,-0.48320794109883863,0.006282860470930045,0.006282860470930045,1.170500554541026,1.3655839802978638,0,0,0,2,1.3655839802978638,1.170500554541026
2124,9,205,53,103,110,0,1124.838,70,868.2080000000002,LESS,122,274,396,1,2,7.0,0.6561859224721414,7.0,-0.34921514788478913,0.6274715445218272,-1.1251385722482319,213,103,110,1,1.0570864565366473,0.8973837584814532,1.170500554541026,-0.48320794109883863,0.40427521149192613,0.40427521149192613,1.170500554541026,0.8973837584814532,1,0,1,2,1.170500554541026,0.8973837584814532
2125,9,206,26,90,80,1,1977.762,30,881.238,LESS,-132,536,404,2,1,-10.0,-0.9374084606744876,10.0,0.17460757394239454,-0.8275349355287865,0.3889240667175546,170,90,80,0,0.19945027481823535,0.3901668515136753,0.0,1.300944456804566,-0.3076265994892922,0.3076265994892922,0.0,0.3901668515136753,0,1,0,1,0.3901668515136753,0.0
2126,9,207,35,80,72,1,2128.403,60,1391.614,LESS,772,358,1130,0,2,-8.0,-0.7499267685395902,8.0,-0.17460757394239454,0.2637199245091737,0.6563334841995868,152,80,72,0,-0.1595602198545883,0.0,-0.31213348121094026,-2.267360339002243,2.2260711844753587,2.2260711844753587,-0.31213348121094026,0.0,1,0,1,1,0.0,-0.31213348121094026
2127,9,208,28,93,80,1,1435.476,80,937.069,LESS,2,498,500,1,2,-13.0,-1.218630998876834,13.0,0.6984302957695783,0.9912231645344806,-0.5737114931145059,173,93,80,0,0.25928535726370594,0.5072169069677779,0.0,-0.48320794109883863,0.06794364724883084,0.06794364724883084,0.0,0.5072169069677779,1,0,0,1,0.5072169069677779,0.0
2128,9,209,26,80,90,0,1761.884,0,1137.508,LESS,100,366,466,1,2,10.0,0.9374084606744876,10.0,0.17460757394239454,-1.9187897955667468,0.005709601683558593,170,80,90,1,0.19945027481823535,0.0,0.3901668515136753,-0.48320794109883863,0.34261442471402537,0.34261442471402537,0.3901668515136753,0.0,0,0,1,1,0.3901668515136753,0.0
2129,9,210,25,88,80,1,1466.2220000000002,80,1356.469,LESS,222,350,572,1,2,-8.0,-0.7499267685395902,8.0,-0.17460757394239454,0.9912231645344806,-0.5191329258592262,168,88,80,0,0.1595602198545883,0.31213348121094026,0.0,-0.48320794109883863,0.6845515150278388,0.6845515150278388,0.0,0.31213348121094026,1,0,1,1,0.31213348121094026,0.0
2130,9,211,36,80,70,1,1354.152,90,1003.913,LESS,82,406,488,1,2,-10.0,-0.9374084606744876,10.0,0.17460757394239454,1.354974784547134,-0.718073276873966,150,80,70,0,-0.19945027481823535,0.0,-0.3901668515136753,-0.48320794109883863,0.2921646900775611,0.2921646900775611,-0.3901668515136753,0.0,1,0,1,1,0.0,-0.3901668515136753
2131,9,212,28,80,93,0,1400.34,100,740.168,LESS,76,316,392,1,2,13.0,1.218630998876834,13.0,0.6984302957695783,1.7187264045597874,-0.6360829410778674,173,80,93,1,0.25928535726370594,0.0,0.5072169069677779,-0.48320794109883863,0.2753481118654063,0.2753481118654063,0.5072169069677779,0.0,1,0,1,1,0.5072169069677779,0.0
2132,9,213,21,82,80,1,1141.456,40,912.881,LESS,18,432,450,1,2,-2.0,-0.18748169213489754,2.0,-1.222253017596762,-0.4637833155161331,-1.0956392347523551,162,82,80,0,0.03989005496364707,0.07803337030273506,0.0,-0.48320794109883863,0.11278785581457688,0.11278785581457688,0.0,0.07803337030273506,0,0,1,1,0.07803337030273506,0.0
2133,9,214,19,50,41,0,1343.439,0,1791.023,LESS,68,330,398,1,2,-9.0,-0.8436676146070391,9.0,0.0,-1.9187897955667468,-0.737090391002822,91,50,41,0,-1.376206896245824,-1.170500554541026,-1.5216507209033339,-0.48320794109883863,0.25292600758253325,0.25292600758253325,-1.5216507209033339,-1.170500554541026,0,1,1,0,-1.170500554541026,-1.5216507209033339
2134,9,215,56,96,110,0,1688.372,60,1477.602,LESS,-128,484,356,2,1,14.0,1.3123718449442827,14.0,0.8730378697119728,0.2637199245091737,-0.1247847597315884,206,96,110,1,0.9174712641638826,0.6242669624218805,1.170500554541026,1.300944456804566,-0.2964155473478557,0.2964155473478557,1.170500554541026,0.6242669624218805,1,1,0,2,1.170500554541026,0.6242669624218805
2135,9,216,23,80,85,1,1452.339,20,1317.0379999999998,LESS,-178,576,398,1,1,5.0,0.4687042303372438,5.0,-0.6984302957695783,-1.19128655554144,-0.5437772454196588,165,80,85,1,0.09972513740911768,0.0,0.19508342575683765,-0.48320794109883863,-0.43655369911581204,0.43655369911581204,0.19508342575683765,0.0,0,0,0,1,0.19508342575683765,0.0
2136,9,217,10,60,50,1,1166.344,40,773.039,LESS,148,250,398,1,2,-10.0,-0.9374084606744876,10.0,0.17460757394239454,-0.4637833155161331,-1.0514594591116406,110,60,50,0,-0.9972513740911768,-0.7803337030273506,-1.170500554541026,-0.48320794109883863,0.47714705041126343,0.47714705041126343,-1.170500554541026,-0.7803337030273506,0,0,1,0,-0.7803337030273506,-1.170500554541026
2137,9,218,19,41,50,0,1931.579,50,836.459,LESS,146,362,508,1,2,9.0,0.8436676146070391,9.0,0.0,-0.10003169550347968,0.30694260663980216,91,41,50,1,-1.376206896245824,-1.5216507209033339,-1.170500554541026,-0.48320794109883863,0.4715415243405452,0.4715415243405452,-1.170500554541026,-1.5216507209033339,0,0,1,0,-1.5216507209033339,-1.170500554541026
2138,9,219,56,110,96,0,4314.135,30,849.405,LESS,-612,1084,472,1,1,-14.0,-1.3123718449442827,14.0,0.8730378697119728,-0.8275349355287865,4.53632180671363,206,110,96,0,0.9174712641638826,1.170500554541026,0.6242669624218805,-0.48320794109883863,-1.6529528564616733,1.6529528564616733,0.6242669624218805,1.170500554541026,0,0,0,2,1.170500554541026,0.6242669624218805
2139,9,220,35,72,80,0,1508.253,0,986.796,LESS,-418,834,416,2,1,8.0,0.7499267685395902,8.0,-0.17460757394239454,-1.9187897955667468,-0.4445218622962703,152,72,80,1,-0.1595602198545883,-0.31213348121094026,0.0,1.300944456804566,-1.1092168276020027,1.1092168276020027,0.0,-0.31213348121094026,0,1,0,1,-0.31213348121094026,0.0
2140,9,221,11,49,50,0,1795.056,80,1020.084,LESS,-190,722,532,2,2,1.0,0.09374084606744876,1.0,-1.3968605915391563,0.9912231645344806,0.06459466748047968,99,49,50,1,-1.2166466763912356,-1.2095172396923934,-1.170500554541026,1.300944456804566,-0.4701868555401216,0.4701868555401216,-1.170500554541026,-1.2095172396923934,1,1,0,0,-1.2095172396923934,-1.170500554541026
2141,9,222,17,43,50,0,1577.658,70,1195.592,LESS,136,704,840,2,1,7.0,0.6561859224721414,7.0,-0.34921514788478913,0.6274715445218272,-0.32131801593080234,93,43,50,1,-1.3363168412821769,-1.4436173506005987,-1.170500554541026,1.300944456804566,0.4435138939869539,0.4435138939869539,-1.170500554541026,-1.4436173506005987,1,1,1,0,-1.4436173506005987,-1.170500554541026
2142,9,223,1,51,50,1,1424.6729999999998,100,1004.843,LESS,672,418,1090,1,2,-1.0,-0.09374084606744876,1.0,-1.3968605915391563,1.7187264045597874,-0.5928883701735966,101,51,50,0,-1.1767566214275886,-1.1314838693896585,-1.170500554541026,-0.48320794109883863,1.945794880939446,1.945794880939446,-1.170500554541026,-1.1314838693896585,1,1,1,0,-1.1314838693896585,-1.170500554541026
2143,9,224,41,112,110,0,3135.489,20,994.972,LESS,-348,1298,950,4,1,-2.0,-0.18748169213489754,2.0,-1.222253017596762,-1.19128655554144,2.444055821506895,222,112,110,0,1.2365917038730592,1.248533924843761,1.170500554541026,4.869249252611375,-0.9130234151268637,0.9130234151268637,1.170500554541026,1.248533924843761,0,1,0,2,1.248533924843761,1.170500554541026
2144,9,225,20,40,50,0,1865.355,60,1406.608,LESS,-316,738,422,2,1,10.0,0.9374084606744876,10.0,0.17460757394239454,0.2637199245091737,0.18938549228627224,90,40,50,1,-1.3961519237276474,-1.5606674060547012,-1.170500554541026,1.300944456804566,-0.8233349979953716,0.8233349979953716,-1.170500554541026,-1.5606674060547012,1,1,0,0,-1.5606674060547012,-1.170500554541026
2145,9,226,1,50,51,0,1991.438,70,789.462,LESS,-186,634,448,2,1,1.0,0.09374084606744876,1.0,-1.3968605915391563,0.6274715445218272,0.4132009315384488,101,50,51,1,-1.1767566214275886,-1.170500554541026,-1.1314838693896585,1.300944456804566,-0.45897580339868504,0.45897580339868504,-1.1314838693896585,-1.170500554541026,1,1,0,0,-1.170500554541026,-1.1314838693896585
2146,9,227,23,85,80,1,2118.678,80,643.434,LESS,320,484,804,2,2,-5.0,-0.4687042303372438,5.0,-0.6984302957695783,0.9912231645344806,0.6390702120159666,165,85,80,0,0.09972513740911768,0.19508342575683765,0.0,1.300944456804566,0.9592222924930334,0.9592222924930334,0.0,0.19508342575683765,1,1,1,1,0.19508342575683765,0.0
2147,9,228,11,50,49,0,1691.866,30,832.9680000000002,LESS,-188,676,488,2,1,-1.0,-0.09374084606744876,1.0,-1.3968605915391563,-0.8275349355287865,-0.11858240775117004,99,50,49,0,-1.2166466763912356,-1.170500554541026,-1.2095172396923934,1.300944456804566,-0.46458132946940334,0.46458132946940334,-1.2095172396923934,-1.170500554541026,0,1,0,0,-1.170500554541026,-1.2095172396923934
2148,9,229,17,50,43,1,2304.968,60,1120.606,LESS,-232,904,672,3,2,-7.0,-0.6561859224721414,7.0,-0.34921514788478913,0.2637199245091737,0.9697617261636942,93,50,43,0,-1.3363168412821769,-1.170500554541026,-1.4436173506005987,3.0850968547079707,-0.5879029030252049,0.5879029030252049,-1.4436173506005987,-1.170500554541026,1,1,0,0,-1.170500554541026,-1.4436173506005987
2149,9,230,21,80,82,1,1434.476,20,743.0830000000002,LESS,426,332,758,3,2,2.0,0.18748169213489754,2.0,-1.222253017596762,-1.19128655554144,-0.5754866367837728,162,80,82,1,0.03989005496364707,0.0,0.07803337030273506,3.0850968547079707,1.256315174241101,1.256315174241101,0.07803337030273506,0.0,0,1,1,1,0.07803337030273506,0.0
2150,9,231,10,50,60,0,1629.369,50,750.243,LESS,-88,476,388,2,1,10.0,0.9374084606744876,10.0,0.17460757394239454,-0.10003169550347968,-0.22952356164934254,110,50,60,1,-0.9972513740911768,-1.170500554541026,-0.7803337030273506,1.300944456804566,-0.1843050259334906,0.1843050259334906,-0.7803337030273506,-1.170500554541026,0,1,0,0,-1.170500554541026,-0.7803337030273506
2151,9,232,3,53,50,1,1102.14,80,606.972,LESS,304,134,438,1,2,-3.0,-0.28122253820234633,3.0,-1.0476454436543674,0.9912231645344806,-1.1654307832532516,103,53,50,0,-1.1368665664639415,-1.0534504990869233,-1.170500554541026,-0.48320794109883863,0.9143780839272874,0.9143780839272874,-1.170500554541026,-1.0534504990869233,1,1,1,0,-1.0534504990869233,-1.170500554541026
2152,9,233,45,122,110,1,1199.066,90,1183.045,LESS,256,68,324,1,2,-12.0,-1.124890152809385,12.0,0.5238227218271837,1.354974784547134,-0.9933732079658898,232,122,110,0,1.4360419786912946,1.6387007763574364,1.170500554541026,-0.48320794109883863,0.7798454582300492,0.7798454582300492,1.170500554541026,1.6387007763574364,1,1,1,2,1.6387007763574364,1.170500554541026
2153,9,234,38,67,80,1,1727.3239999999996,20,765.622,LESS,188,254,442,2,1,13.0,1.218630998876834,13.0,0.6984302957695783,-1.19128655554144,-0.05563936352630559,147,67,80,1,-0.25928535726370594,-0.5072169069677779,0.0,1.300944456804566,0.5892575718256285,0.5892575718256285,0.0,-0.5072169069677779,0,1,1,1,-0.5072169069677779,0.0
2154,9,235,38,80,67,1,1306.924,40,1052.019,LESS,34,414,448,1,2,-13.0,-1.218630998876834,13.0,0.6984302957695783,-0.4637833155161331,-0.8019097620861024,147,80,67,0,-0.25928535726370594,0.0,-0.5072169069677779,-0.48320794109883863,0.15763206438032293,0.15763206438032293,-0.5072169069677779,0.0,0,0,1,1,0.0,-0.5072169069677779
2155,9,236,36,70,80,1,1751.975,80,708.913,LESS,-368,760,392,2,2,10.0,0.9374084606744876,10.0,0.17460757394239454,0.9912231645344806,-0.011880296935207136,150,70,80,1,-0.19945027481823535,-0.3901668515136753,0.0,1.300944456804566,-0.9690786758340463,0.9690786758340463,0.0,-0.3901668515136753,1,1,0,1,-0.3901668515136753,0.0
2156,9,237,45,110,122,1,1602.2220000000002,0,750.923,LESS,-336,686,350,1,1,12.0,1.124890152809385,12.0,0.5238227218271837,-1.9187897955667468,-0.2777133868389301,232,110,122,1,1.4360419786912946,1.170500554541026,1.6387007763574364,-0.48320794109883863,-0.8793902587025542,0.8793902587025542,1.6387007763574364,1.170500554541026,0,0,0,2,1.6387007763574364,1.170500554541026
2157,9,238,42,110,115,1,3075.759,60,1014.196,LESS,414,806,1220,2,2,5.0,0.4687042303372438,5.0,-0.6984302957695783,0.2637199245091737,2.3380264901415844,225,110,115,1,1.2964267863185297,1.170500554541026,1.3655839802978638,1.300944456804566,1.2226820178167914,1.2226820178167914,1.3655839802978638,1.170500554541026,1,1,1,2,1.3655839802978638,1.170500554541026
2158,9,239,41,110,112,1,2489.889,60,1122.941,LESS,78,792,870,2,2,2.0,0.18748169213489754,2.0,-1.222253017596762,0.2637199245091737,1.2980230686281955,222,110,112,1,1.2365917038730592,1.170500554541026,1.248533924843761,1.300944456804566,0.28095363793612455,0.28095363793612455,1.248533924843761,1.170500554541026,1,1,1,2,1.248533924843761,1.170500554541026
2159,9,240,53,110,103,1,3025.539,10,861.7189999999998,LESS,156,834,990,2,1,-7.0,-0.6561859224721414,7.0,-0.34921514788478913,-1.5550381755540934,2.248878775071001,213,110,103,0,1.0570864565366473,1.170500554541026,0.8973837584814532,1.300944456804566,0.4995691546941365,0.4995691546941365,0.8973837584814532,1.170500554541026,0,1,1,2,1.170500554541026,0.8973837584814532
2160,10,1,49,110,131,0,3736.991,34,2038.201,LESS,-404,1780,1376,3,1,21.0,1.9685577674164243,21.0,2.0952908873087353,-1.007736362405932,0.7324381406487458,241,110,131,1,1.6155472260277064,1.170500554541026,1.9898509427197442,-0.11623018807364008,-0.8331383071936135,0.8331383071936135,1.9898509427197442,1.170500554541026,0,1,0,2,1.9898509427197442,1.170500554541026
2161,10,2,13,47,50,0,1653.211,100,1759.474,LESS,1052,862,1914,2,2,3.0,0.28122253820234633,3.0,-1.0476454436543674,1.2564542731273958,-0.6721831209348162,97,47,50,1,-1.2565367313548828,-1.2875506099951286,-1.170500554541026,-0.7361245244663871,0.966215517116553,0.966215517116553,-1.170500554541026,-1.2875506099951286,1,0,1,0,-1.2875506099951286,-1.170500554541026
2162,10,3,16,50,44,1,8416.123,24,941.431,LESS,504,3198,3702,6,2,-6.0,-0.5624450764046927,6.0,-0.5238227218271837,-1.3507955496079511,3.886517886570108,94,50,44,0,-1.3163718138003533,-1.170500554541026,-1.4046006654492311,1.743452821104601,0.28898619313168256,0.28898619313168256,-1.4046006654492311,-1.170500554541026,0,1,1,0,-1.170500554541026,-1.4046006654492311
2163,10,4,7,57,50,1,2071.994,64,1083.678,LESS,66,1000,1066,3,2,-7.0,-0.6561859224721414,7.0,-0.34921514788478913,0.02144119920012621,-0.3898925212603069,107,57,50,0,-1.0570864565366473,-0.8973837584814532,-1.170500554541026,-0.11623018807364008,-0.25230293808250215,0.25230293808250215,-1.170500554541026,-0.8973837584814532,0,1,0,0,-0.8973837584814532,-1.170500554541026
2164,10,5,18,42,50,0,1730.19,74,1409.571,LESS,-434,1062,628,2,1,8.0,0.7499267685395902,8.0,-0.17460757394239454,0.3645003864021456,-0.6202936028016923,92,42,50,1,-1.3562618687640005,-1.4826340357519663,-1.170500554541026,-0.7361245244663871,-0.8702129052219822,0.8702129052219822,-1.170500554541026,-1.4826340357519663,1,0,0,0,-1.4826340357519663,-1.170500554541026
2165,10,6,51,108,110,1,2771.217,44,1342.941,LESS,706,1002,1708,3,2,2.0,0.18748169213489754,2.0,-1.222253017596762,-0.6646771752039125,0.08143530240065676,218,108,110,1,1.156811593945765,1.092467184238291,1.170500554541026,-0.11623018807364008,0.5386218198560325,0.5386218198560325,1.170500554541026,1.092467184238291,0,1,1,2,1.170500554541026,1.092467184238291
2166,10,7,31,78,80,1,2459.204,24,958.607,LESS,52,1254,1306,3,1,2.0,0.18748169213489754,2.0,-1.222253017596762,-1.3507955496079511,-0.12888445001585164,158,78,80,1,-0.03989005496364707,-0.07803337030273506,0.0,-0.11623018807364008,-0.2696044171624076,0.2696044171624076,0.0,-0.07803337030273506,0,1,0,1,-0.07803337030273506,0.0
2167,10,8,58,110,92,1,2078.841,64,1213.024,LESS,324,732,1056,3,2,-18.0,-1.6873352292140782,18.0,1.571468165481551,0.02144119920012621,-0.3852771387448484,202,110,92,0,0.8376911542365885,1.170500554541026,0.4682002218164104,-0.11623018807364008,0.06653860496146966,0.06653860496146966,0.4682002218164104,1.170500554541026,0,1,1,2,1.170500554541026,0.4682002218164104
2168,10,9,12,50,48,1,2362.94,74,1452.685,LESS,286,898,1184,3,2,-2.0,-0.18748169213489754,2.0,-1.222253017596762,0.3645003864021456,-0.19377347914804416,98,50,48,0,-1.2365917038730592,-1.170500554541026,-1.248533924843761,-0.11623018807364008,0.019577447458869166,0.019577447458869166,-1.248533924843761,-1.170500554541026,0,1,0,0,-1.170500554541026,-1.248533924843761
2169,10,10,54,110,101,1,2434.135,54,1784.13,LESS,652,934,1586,3,2,-9.0,-0.8436676146070391,9.0,0.0,-0.3216179880018931,-0.14578280320411444,211,110,101,0,1.0171964015730004,1.170500554541026,0.8193503881787182,-0.11623018807364008,0.4718875434049687,0.4718875434049687,0.8193503881787182,1.170500554541026,0,1,1,2,1.170500554541026,0.8193503881787182
2170,10,11,14,46,50,1,1757.168,0,6617.686,LESS,-1256,2300,1044,3,1,4.0,0.3749633842697951,4.0,-0.8730378697119728,-2.1741375988927976,-0.6021084429503639,96,46,50,1,-1.2764817588367063,-1.3265672951464962,-1.170500554541026,-0.11623018807364008,-1.8860568911992877,1.8860568911992877,-1.170500554541026,-1.3265672951464962,0,1,0,0,-1.3265672951464962,-1.170500554541026
2171,10,12,22,80,83,1,5145.206,34,2001.978,LESS,708,1930,2638,6,2,3.0,0.28122253820234633,3.0,-1.0476454436543674,-1.007736362405932,1.6816788137912542,163,80,83,1,0.05983508244547061,0.0,0.1170500554541026,1.743452821104601,0.5410934597245904,0.5410934597245904,0.1170500554541026,0.0,0,1,1,1,0.1170500554541026,0.0
2172,10,13,6,50,56,0,1340.961,84,1253.654,LESS,-116,822,706,2,2,6.0,0.5624450764046927,6.0,-0.5238227218271837,0.7075595736041649,-0.8826626288144711,106,50,56,1,-1.077031484018471,-1.170500554541026,-0.9364004436328208,-0.7361245244663871,-0.47722216612127294,0.47722216612127294,-0.9364004436328208,-1.170500554541026,1,0,0,0,-1.170500554541026,-0.9364004436328208
2173,10,14,13,50,47,0,3698.658,34,1062.811,LESS,-738,2166,1428,3,1,-3.0,-0.28122253820234633,3.0,-1.0476454436543674,-1.007736362405932,0.7065988741137551,97,50,47,0,-1.2565367313548828,-1.170500554541026,-1.2875506099951286,-0.11623018807364008,-1.2459021652427862,1.2459021652427862,-1.2875506099951286,-1.170500554541026,0,1,0,0,-1.170500554541026,-1.2875506099951286
2174,10,15,46,110,124,0,1507.605,14,2028.516,LESS,-954,1548,594,2,1,14.0,1.3123718449442827,14.0,0.8730378697119728,-1.6938547368099706,-0.7703322937909413,234,110,124,1,1.4759320336549415,1.170500554541026,1.7167341466601715,-0.7361245244663871,-1.5128392710470417,1.5128392710470417,1.7167341466601715,1.170500554541026,0,0,0,2,1.7167341466601715,1.170500554541026
2175,10,16,27,91,80,1,1235.475,64,940.556,LESS,382,394,776,1,2,-11.0,-1.0311493067419364,11.0,0.34921514788478913,0.02144119920012621,-0.9537679654620076,171,91,80,0,0.21939530230005888,0.4291835366650429,0.0,-1.3560188608591341,0.13821616114964935,0.13821616114964935,0.0,0.4291835366650429,0,0,1,1,0.4291835366650429,0.0
2176,10,17,40,64,80,0,1457.088,94,1782.8239999999996,LESS,32,818,850,2,2,16.0,1.4998535370791803,16.0,1.222253017596762,1.0506187608061843,-0.8043844740937645,144,64,80,1,-0.3191204397091766,-0.6242669624218805,0.0,-0.7361245244663871,-0.2943208158479868,0.2943208158479868,0.0,-0.6242669624218805,1,0,0,1,-0.6242669624218805,0.0
2177,10,18,22,83,80,1,2494.292,34,1580.766,LESS,626,928,1554,3,2,-3.0,-0.28122253820234633,3.0,-1.0476454436543674,-1.007736362405932,-0.10523255258596764,163,83,80,0,0.05983508244547061,0.1170500554541026,0.0,-0.11623018807364008,0.4397562251137157,0.4397562251137157,0.0,0.1170500554541026,0,0,1,1,0.1170500554541026,0.0
2178,10,19,54,101,110,0,2932.98,54,2755.164,LESS,-298,1722,1424,4,2,9.0,0.8436676146070391,9.0,0.0,-0.3216179880018931,0.1904754837717908,211,101,110,1,1.0171964015730004,0.8193503881787182,1.170500554541026,0.503664148319107,-0.7021413941600436,0.7021413941600436,1.170500554541026,0.8193503881787182,0,1,0,2,1.170500554541026,0.8193503881787182
2179,10,20,6,56,50,1,2451.452,100,1345.263,LESS,1118,922,2040,3,2,-6.0,-0.5624450764046927,6.0,-0.5238227218271837,1.2564542731273958,-0.13410986921547716,106,56,50,0,-1.077031484018471,-0.9364004436328208,-1.170500554541026,-0.11623018807364008,1.0477796327789644,1.0477796327789644,-1.170500554541026,-0.9364004436328208,1,1,1,0,-0.9364004436328208,-1.170500554541026
2180,10,21,18,50,42,1,5389.64,54,1471.966,LESS,838,2216,3054,5,2,-8.0,-0.7499267685395902,8.0,-0.17460757394239454,-0.3216179880018931,1.8464453407057635,92,50,42,0,-1.3562618687640005,-1.170500554541026,-1.4826340357519663,1.123558484711854,0.7017500511808554,0.7017500511808554,-1.4826340357519663,-1.170500554541026,0,1,1,0,-1.170500554541026,-1.4826340357519663
2181,10,22,43,110,117,0,2740.613,34,1207.445,LESS,-992,1946,954,2,1,7.0,0.6561859224721414,7.0,-0.34921514788478913,-1.007736362405932,0.06080595137055584,227,110,117,1,1.3363168412821769,1.170500554541026,1.4436173506005987,-0.7361245244663871,-1.559800428549642,1.559800428549642,1.4436173506005987,1.170500554541026,0,0,0,2,1.4436173506005987,1.170500554541026
2182,10,23,32,77,80,0,4739.92,34,1205.97,LESS,-1478,3000,1522,4,1,3.0,0.28122253820234633,3.0,-1.0476454436543674,-1.007736362405932,1.4084861866318823,157,77,80,1,-0.05983508244547061,-0.1170500554541026,0.0,0.503664148319107,-2.160408916609217,2.160408916609217,0.0,-0.1170500554541026,0,1,0,1,-0.1170500554541026,0.0
2183,10,24,27,80,91,0,2034.764,84,1354.076,LESS,-220,1412,1192,3,2,11.0,1.0311493067419364,11.0,0.34921514788478913,0.7075595736041649,-0.4149882845216668,171,80,91,1,0.21939530230005888,0.0,0.4291835366650429,-0.11623018807364008,-0.6057474392862848,0.6057474392862848,0.4291835366650429,0.0,1,0,0,1,0.4291835366650429,0.0
2184,10,25,16,44,50,0,2222.526,100,1764.0179999999998,LESS,690,1288,1978,2,2,6.0,0.5624450764046927,6.0,-0.5238227218271837,1.2564542731273958,-0.28842286143599905,94,44,50,1,-1.3163718138003533,-1.4046006654492311,-1.170500554541026,-0.7361245244663871,0.5188487009075692,0.5188487009075692,-1.170500554541026,-1.4046006654492311,1,0,1,0,-1.4046006654492311,-1.170500554541026
2185,10,26,7,50,57,0,1637.05,94,1629.701,LESS,328,1172,1500,3,2,7.0,0.6561859224721414,7.0,-0.34921514788478913,1.0506187608061843,-0.6830768257445621,107,50,57,1,-1.0570864565366473,-1.170500554541026,-0.8973837584814532,-0.11623018807364008,0.0714818846985855,0.0714818846985855,-0.8973837584814532,-1.170500554541026,1,0,1,0,-1.170500554541026,-0.8973837584814532
2186,10,27,14,50,46,1,3165.539,100,1852.443,LESS,966,1356,2322,3,2,-4.0,-0.3749633842697951,4.0,-0.8730378697119728,1.2564542731273958,0.34723738568687385,96,50,46,0,-1.2764817588367063,-1.170500554541026,-1.3265672951464962,-0.11623018807364008,0.8599350027685623,0.8599350027685623,-1.3265672951464962,-1.170500554541026,1,0,1,0,-1.170500554541026,-1.3265672951464962
2187,10,28,51,110,108,0,2209.962,84,1666.16,LESS,128,1758,1886,3,2,-2.0,-0.18748169213489754,2.0,-1.222253017596762,0.7075595736041649,-0.29689192320381314,218,110,108,0,1.156811593945765,1.170500554541026,1.092467184238291,-0.11623018807364008,-0.1756821021572066,0.1756821021572066,1.092467184238291,1.170500554541026,1,0,0,2,1.170500554541026,1.092467184238291
2188,10,29,50,133,110,1,1653.95,44,2038.42,LESS,-238,882,644,2,1,-23.0,-2.1560394595513217,23.0,2.444506035193524,-0.6646771752039125,-0.6716849804822204,243,133,110,0,1.6554372809913533,2.0678843130224793,1.170500554541026,-0.7361245244663871,-0.6279921981033061,0.6279921981033061,1.170500554541026,2.0678843130224793,0,0,0,2,2.0678843130224793,1.170500554541026
2189,10,30,49,131,110,1,1436.418,64,1637.687,LESS,590,388,978,1,2,-21.0,-1.9685577674164243,21.0,2.0952908873087353,0.02144119920012621,-0.8183175771453977,241,131,110,0,1.6155472260277064,1.9898509427197442,1.170500554541026,-1.3560188608591341,0.39526670747967313,0.39526670747967313,1.170500554541026,1.9898509427197442,0,0,1,2,1.9898509427197442,1.170500554541026
2190,10,31,47,126,110,1,1456.691,74,1012.382,LESS,620,486,1106,1,2,-16.0,-1.4998535370791803,16.0,1.222253017596762,0.3645003864021456,-0.8046520813463768,236,126,110,0,1.5158220886185887,1.7947675169629065,1.170500554541026,-1.3560188608591341,0.43234130550804195,0.43234130550804195,1.170500554541026,1.7947675169629065,1,0,1,2,1.7947675169629065,1.170500554541026
2191,10,32,50,110,133,0,1329.32,64,1562.594,LESS,-112,800,688,2,2,23.0,2.1560394595513217,23.0,2.444506035193524,0.02144119920012621,-0.8905095205718037,243,110,133,1,1.6554372809913533,1.170500554541026,2.0678843130224793,-0.7361245244663871,-0.4722788863841571,0.4722788863841571,2.0678843130224793,1.170500554541026,0,0,0,2,2.0678843130224793,1.170500554541026
2192,10,33,47,110,126,0,1237.902,84,1824.671,LESS,94,832,926,2,2,16.0,1.4998535370791803,16.0,1.222253017596762,0.7075595736041649,-0.952131988630546,236,110,126,1,1.5158220886185887,1.170500554541026,1.7947675169629065,-0.7361245244663871,-0.21769997992269124,0.21769997992269124,1.7947675169629065,1.170500554541026,1,0,0,2,1.7947675169629065,1.170500554541026
2193,10,34,12,48,50,0,4309.021,84,1565.826,LESS,810,1776,2586,4,2,2.0,0.18748169213489754,2.0,-1.222253017596762,0.7075595736041649,1.118028510200063,98,48,50,1,-1.2365917038730592,-1.248533924843761,-1.170500554541026,0.503664148319107,0.6671470930210445,0.6671470930210445,-1.170500554541026,-1.248533924843761,1,1,1,0,-1.248533924843761,-1.170500554541026
2194,10,35,32,80,77,1,2360.907,34,1439.884,LESS,192,954,1146,3,2,-3.0,-0.28122253820234633,3.0,-1.0476454436543674,-1.007736362405932,-0.1951438709479459,157,80,77,0,-0.05983508244547061,0.0,-0.1170500554541026,-0.11623018807364008,-0.09658962636335311,0.09658962636335311,-0.1170500554541026,0.0,0,0,0,1,0.0,-0.1170500554541026
2195,10,36,43,117,110,1,2633.718,14,2341.276,LESS,24,1340,1364,3,1,-7.0,-0.6561859224721414,7.0,-0.34921514788478913,-1.6938547368099706,-0.011249155097965246,227,117,110,0,1.3363168412821769,1.4436173506005987,1.170500554541026,-0.11623018807364008,-0.3042073753222185,0.3042073753222185,1.170500554541026,1.4436173506005987,0,1,0,2,1.4436173506005987,1.170500554541026
2196,10,37,40,80,64,1,2069.533,84,2313.408,LESS,966,744,1710,3,2,-16.0,-1.4998535370791803,16.0,1.222253017596762,0.7075595736041649,-0.3915514165970304,144,80,64,0,-0.3191204397091766,0.0,-0.6242669624218805,-0.11623018807364008,0.8599350027685623,0.8599350027685623,-0.6242669624218805,0.0,1,1,1,1,0.0,-0.6242669624218805
2197,10,38,31,80,78,0,1541.861,94,1189.588,LESS,64,1110,1174,2,2,-2.0,-0.18748169213489754,2.0,-1.222253017596762,1.0506187608061843,-0.74724122566628,158,80,78,0,-0.03989005496364707,0.0,-0.07803337030273506,-0.7361245244663871,-0.25477457795106007,0.25477457795106007,-0.07803337030273506,0.0,1,0,0,1,0.0,-0.07803337030273506
2198,10,39,46,124,110,1,2597.874,64,1545.612,LESS,522,1202,1724,3,2,-14.0,-1.3123718449442827,14.0,0.8730378697119728,0.02144119920012621,-0.03541065223307609,234,124,110,0,1.4759320336549415,1.7167341466601715,1.170500554541026,-0.11623018807364008,0.3112309519487038,0.3112309519487038,1.170500554541026,1.7167341466601715,0,1,1,2,1.7167341466601715,1.170500554541026
2199,10,40,58,92,110,0,2669.501,24,1269.011,LESS,-920,1868,948,4,1,18.0,1.6873352292140782,18.0,1.571468165481551,-1.3507955496079511,0.012871223542411906,202,92,110,1,0.8376911542365885,0.4682002218164104,1.170500554541026,0.503664148319107,-1.470821393281557,1.470821393281557,1.170500554541026,0.4682002218164104,0,1,0,2,1.170500554541026,0.4682002218164104
2200,10,41,49,110,131,1,2438.639,54,1205.482,MORE,224,1090,1314,3,2,21.0,1.9685577674164243,21.0,2.0952908873087353,-0.3216179880018931,-0.14274677533064786,241,110,131,0,1.6155472260277064,1.170500554541026,1.9898509427197442,-0.11623018807364008,-0.05704338846642638,0.05704338846642638,1.9898509427197442,1.170500554541026,0,1,0,2,1.9898509427197442,1.170500554541026
2201,10,42,13,47,50,1,1326.879,14,1739.466,MORE,-562,1488,926,1,1,3.0,0.28122253820234633,3.0,-1.0476454436543674,-1.6938547368099706,-0.8921549344348436,97,47,50,0,-1.2565367313548828,-1.2875506099951286,-1.170500554541026,-1.3560188608591341,-1.0283978568096892,1.0283978568096892,-1.170500554541026,-1.2875506099951286,0,0,0,0,-1.2875506099951286,-1.170500554541026
2202,10,43,16,50,44,0,2008.897,94,1260.429,MORE,-90,1502,1412,2,2,-6.0,-0.5624450764046927,6.0,-0.5238227218271837,1.0506187608061843,-0.43242454850989104,94,50,44,1,-1.3163718138003533,-1.170500554541026,-1.4046006654492311,-0.7361245244663871,-0.44509084783001995,0.44509084783001995,-1.4046006654492311,-1.170500554541026,1,0,0,0,-1.170500554541026,-1.4046006654492311
2203,10,44,7,57,50,0,3251.427,54,3243.929,MORE,-586,1756,1170,4,1,-7.0,-0.6561859224721414,7.0,-0.34921514788478913,-0.3216179880018931,0.405132226272199,107,57,50,1,-1.0570864565366473,-0.8973837584814532,-1.170500554541026,0.503664148319107,-1.0580575352323842,1.0580575352323842,-1.170500554541026,-0.8973837584814532,0,1,0,0,-0.8973837584814532,-1.170500554541026
2204,10,45,18,42,50,1,2833.7290000000007,84,2317.96,MORE,1602,1152,2754,3,2,8.0,0.7499267685395902,8.0,-0.17460757394239454,0.7075595736041649,0.1235729965450062,92,42,50,0,-1.3562618687640005,-1.4826340357519663,-1.170500554541026,-0.11623018807364008,1.645916480969981,1.645916480969981,-1.170500554541026,-1.4826340357519663,1,0,1,0,-1.4826340357519663,-1.170500554541026
2205,10,46,51,108,110,0,1694.866,14,2947.836,MORE,-1772,2416,644,2,1,2.0,0.18748169213489754,2.0,-1.222253017596762,-1.6938547368099706,-0.6441045816210388,218,108,110,0,1.156811593945765,1.092467184238291,1.170500554541026,-0.7361245244663871,-2.523739977287231,2.523739977287231,1.170500554541026,1.092467184238291,0,0,0,2,1.170500554541026,1.092467184238291
2206,10,47,31,78,80,0,1296.653,84,2009.749,MORE,-220,1002,782,2,2,2.0,0.18748169213489754,2.0,-1.222253017596762,0.7075595736041649,-0.9125294856123309,158,78,80,0,-0.03989005496364707,-0.07803337030273506,0.0,-0.7361245244663871,-0.6057474392862848,0.6057474392862848,0.0,-0.07803337030273506,1,0,0,1,-0.07803337030273506,0.0
2207,10,48,58,110,92,0,1529.774,100,1032.5739999999996,MORE,264,810,1074,2,2,-18.0,-1.6873352292140782,18.0,1.571468165481551,1.2564542731273958,-0.7553887542867491,202,110,92,1,0.8376911542365885,1.170500554541026,0.4682002218164104,-0.7361245244663871,-0.007610591095267964,0.007610591095267964,0.4682002218164104,1.170500554541026,1,0,0,2,1.170500554541026,0.4682002218164104
2208,10,49,12,50,48,1,1082.362,84,1525.106,MORE,1316,348,1664,1,2,-2.0,-0.18748169213489754,2.0,-1.222253017596762,0.7075595736041649,-1.0569774094651383,98,50,48,1,-1.2365917038730592,-1.170500554541026,-1.248533924843761,-1.3560188608591341,1.2924719797661985,1.2924719797661985,-1.248533924843761,-1.170500554541026,1,0,1,0,-1.170500554541026,-1.248533924843761
2209,10,50,54,110,101,0,3108.467,34,2214.444,MORE,-526,1692,1166,4,1,-9.0,-0.8436676146070391,9.0,0.0,-1.007736362405932,0.3087666523843673,211,110,101,1,1.0171964015730004,1.170500554541026,0.8193503881787182,0.503664148319107,-0.9839083391756466,0.9839083391756466,0.8193503881787182,1.170500554541026,0,1,0,2,1.170500554541026,0.8193503881787182
2210,10,51,14,46,50,1,4797.563,14,1393.247,MORE,-872,3042,2170,5,1,4.0,0.3749633842697951,4.0,-0.8730378697119728,-1.6938547368099706,1.4473418160080456,96,46,50,0,-1.2764817588367063,-1.3265672951464962,-1.170500554541026,1.123558484711854,-1.411502036436167,1.411502036436167,-1.170500554541026,-1.3265672951464962,0,1,0,0,-1.3265672951464962,-1.170500554541026
2211,10,52,22,80,83,0,3431.024000000001,74,1129.424,MORE,110,1792,1902,4,2,3.0,0.28122253820234633,3.0,-1.0476454436543674,0.3645003864021456,0.5261938377266827,163,80,83,0,0.05983508244547061,0.0,0.1170500554541026,0.503664148319107,-0.19792686097422788,0.19792686097422788,0.1170500554541026,0.0,1,1,0,1,0.1170500554541026,0.0
2212,10,53,6,50,56,1,1124.577,94,2447.918,MORE,1866,342,2208,1,2,6.0,0.5624450764046927,6.0,-0.5238227218271837,1.0506187608061843,-1.02852138888823,106,50,56,0,-1.077031484018471,-1.170500554541026,-0.9364004436328208,-1.3560188608591341,1.9721729436196267,1.9721729436196267,-0.9364004436328208,-1.170500554541026,1,0,1,0,-1.170500554541026,-0.9364004436328208
2213,10,54,13,50,47,0,4441.4540000000015,14,1300.208,MORE,-1418,3164,1746,6,1,-3.0,-0.28122253820234633,3.0,-1.0476454436543674,-1.6938547368099706,1.207298110414721,97,50,47,1,-1.2565367313548828,-1.170500554541026,-1.2875506099951286,1.743452821104601,-2.086259720552479,2.086259720552479,-1.2875506099951286,-1.170500554541026,0,1,0,0,-1.170500554541026,-1.2875506099951286
2214,10,55,46,110,124,1,4632.202,4,2030.28,MORE,-80,2430,2350,4,1,14.0,1.3123718449442827,14.0,0.8730378697119728,-2.0369139240119902,1.3358763175212958,234,110,124,0,1.4759320336549415,1.170500554541026,1.7167341466601715,0.503664148319107,-0.43273264848723036,0.43273264848723036,1.7167341466601715,1.170500554541026,0,1,0,2,1.7167341466601715,1.170500554541026
2215,10,56,27,91,80,0,1632.6129999999996,84,1330.665,MORE,-80,1338,1258,3,2,-11.0,-1.0311493067419364,11.0,0.34921514788478913,0.7075595736041649,-0.6860676906811901,171,91,80,1,0.21939530230005888,0.4291835366650429,0.0,-0.11623018807364008,-0.43273264848723036,0.43273264848723036,0.0,0.4291835366650429,1,0,0,1,0.4291835366650429,0.0
2216,10,57,40,64,80,1,4819.272,24,1100.93,MORE,818,1736,2554,5,2,16.0,1.4998535370791803,16.0,1.222253017596762,-1.3507955496079511,1.461975281617523,144,64,80,0,-0.3191204397091766,-0.6242669624218805,0.0,1.123558484711854,0.6770336524952761,0.6770336524952761,0.0,-0.6242669624218805,0,1,1,1,-0.6242669624218805,0.0
2217,10,58,22,83,80,0,3039.931,74,941.295,MORE,6,1514,1520,3,2,-3.0,-0.28122253820234633,3.0,-1.0476454436543674,0.3645003864021456,0.26256833836662496,163,83,80,1,0.05983508244547061,0.1170500554541026,0.0,-0.11623018807364008,-0.32645213413923974,0.32645213413923974,0.0,0.1170500554541026,1,0,0,1,0.1170500554541026,0.0
2218,10,59,54,101,110,1,3590.044000000001,94,777.368,MORE,922,1448,2370,5,2,9.0,0.8436676146070391,9.0,0.0,1.0506187608061843,0.6333850349821597,211,101,110,0,1.0171964015730004,0.8193503881787182,1.170500554541026,1.123558484711854,0.8055589256602881,0.8055589256602881,1.170500554541026,0.8193503881787182,1,1,1,2,1.170500554541026,0.8193503881787182
2219,10,60,6,56,50,1,2701.356,64,1215.755,MORE,878,774,1652,3,2,-6.0,-0.5624450764046927,6.0,-0.5238227218271837,0.02144119920012621,0.03434384075139961,106,56,50,1,-1.077031484018471,-0.9364004436328208,-1.170500554541026,-0.11623018807364008,0.7511828485520138,0.7511828485520138,-1.170500554541026,-0.9364004436328208,0,0,1,0,-0.9364004436328208,-1.170500554541026
2220,10,61,18,50,42,0,1980.89,100,915.516,MORE,-284,1444,1160,3,2,-8.0,-0.7499267685395902,8.0,-0.17460757394239454,1.2564542731273958,-0.4513033301822224,92,50,42,1,-1.3562618687640005,-1.170500554541026,-1.4826340357519663,-0.11623018807364008,-0.6848399150801382,0.6848399150801382,-1.4826340357519663,-1.170500554541026,1,0,0,0,-1.170500554541026,-1.4826340357519663
2221,10,62,43,110,117,1,4704.146,64,1413.996,MORE,880,1844,2724,3,2,7.0,0.6561859224721414,7.0,-0.34921514788478913,0.02144119920012621,1.3843718746546627,227,110,117,0,1.3363168412821769,1.170500554541026,1.4436173506005987,-0.11623018807364008,0.7536544884205717,0.7536544884205717,1.4436173506005987,1.170500554541026,1,1,1,2,1.4436173506005987,1.170500554541026
2222,10,63,32,77,80,1,2282.415,100,585.636,MORE,584,972,1556,3,2,3.0,0.28122253820234633,3.0,-1.0476454436543674,1.2564542731273958,-0.24805326256520746,157,77,80,0,-0.05983508244547061,-0.1170500554541026,0.0,-0.11623018807364008,0.3878517878739994,0.3878517878739994,0.0,-0.1170500554541026,1,1,1,1,-0.1170500554541026,0.0
2223,10,64,27,80,91,1,2126.651,100,1042.765,MORE,1138,878,2016,3,2,11.0,1.0311493067419364,11.0,0.34921514788478913,1.2564542731273958,-0.3530496759050524,171,80,91,0,0.21939530230005888,0.0,0.4291835366650429,-0.11623018807364008,1.0724960314645435,1.0724960314645435,0.4291835366650429,0.0,1,1,1,1,0.4291835366650429,0.0
2224,10,65,16,44,50,1,2219.879,24,1466.542,MORE,-662,1614,952,3,1,6.0,0.5624450764046927,6.0,-0.5238227218271837,-1.3507955496079511,-0.2902071344779764,94,44,50,0,-1.3163718138003533,-1.4046006654492311,-1.170500554541026,-0.11623018807364008,-1.1519798502375853,1.1519798502375853,-1.170500554541026,-1.4046006654492311,0,1,0,0,-1.4046006654492311,-1.170500554541026
2225,10,66,7,50,57,1,1361.906,90,1979.051,MORE,1468,390,1858,1,2,7.0,0.6561859224721414,7.0,-0.34921514788478913,0.9133950859253764,-0.8685441554996933,107,50,57,0,-1.0570864565366473,-1.170500554541026,-0.8973837584814532,-1.3560188608591341,1.4803166097766005,1.4803166097766005,-0.8973837584814532,-1.170500554541026,1,0,1,0,-1.170500554541026,-0.8973837584814532
2226,10,67,14,50,46,1,1211.06,14,968.429,MORE,-36,780,744,1,1,-4.0,-0.3749633842697951,4.0,-0.8730378697119728,-1.6938547368099706,-0.9702254744608284,96,50,46,1,-1.2764817588367063,-1.170500554541026,-1.3265672951464962,-1.3560188608591341,-0.37835657137895606,0.37835657137895606,-1.3265672951464962,-1.170500554541026,0,0,0,0,-1.170500554541026,-1.3265672951464962
2227,10,68,51,110,108,0,5025.44,34,1583.941,MORE,-644,2572,1928,6,2,-2.0,-0.18748169213489754,2.0,-1.222253017596762,-1.007736362405932,1.6009477049338807,218,110,108,1,1.156811593945765,1.170500554541026,1.092467184238291,1.743452821104601,-1.129735091420564,1.129735091420564,1.092467184238291,1.170500554541026,0,1,0,2,1.170500554541026,1.092467184238291
2228,10,69,50,133,110,0,1668.819,80,1025.504,MORE,158,832,990,2,2,-23.0,-2.1560394595513217,23.0,2.444506035193524,0.5703358987233571,-0.6616621788724123,243,133,110,1,1.6554372809913533,2.0678843130224793,1.170500554541026,-0.7361245244663871,-0.13860750412883777,0.13860750412883777,1.170500554541026,2.0678843130224793,1,0,0,2,2.0678843130224793,1.170500554541026
2229,10,70,49,131,110,0,1902.992,54,4619.235,MORE,448,1140,1588,2,2,-21.0,-1.9685577674164243,21.0,2.0952908873087353,-0.3216179880018931,-0.5038123220310915,241,131,110,1,1.6155472260277064,1.9898509427197442,1.170500554541026,-0.7361245244663871,0.21978027681206075,0.21978027681206075,1.170500554541026,1.9898509427197442,0,0,1,2,1.9898509427197442,1.170500554541026
2230,10,71,47,126,110,0,2614.701,24,2535.193,MORE,-450,1470,1020,3,1,-16.0,-1.4998535370791803,16.0,1.222253017596762,-1.3507955496079511,-0.024068014349678167,236,126,110,1,1.5158220886185887,1.7947675169629065,1.170500554541026,-0.11623018807364008,-0.8899860241704456,0.8899860241704456,1.170500554541026,1.7947675169629065,0,1,0,2,1.7947675169629065,1.170500554541026
2231,10,72,50,110,133,1,2018.169,84,1963.96,MORE,1914,778,2692,2,2,23.0,2.1560394595513217,23.0,2.444506035193524,0.7075595736041649,-0.4261745373103388,243,110,133,0,1.6554372809913533,1.170500554541026,2.0678843130224793,-0.7361245244663871,2.031492300465017,2.031492300465017,2.0678843130224793,1.170500554541026,1,0,1,2,2.0678843130224793,1.170500554541026
2232,10,73,47,110,126,1,3067.38,100,597.419,MORE,552,1252,1804,3,2,16.0,1.4998535370791803,16.0,1.222253017596762,1.2564542731273958,0.28107098692319393,236,110,126,0,1.5158220886185887,1.170500554541026,1.7947675169629065,-0.11623018807364008,0.34830554997707264,0.34830554997707264,1.7947675169629065,1.170500554541026,1,1,1,2,1.7947675169629065,1.170500554541026
2233,10,74,12,48,50,1,2779.135,64,2205.3720000000008,MORE,1018,1044,2062,2,2,2.0,0.18748169213489754,2.0,-1.222253017596762,0.02144119920012621,0.08677261783185332,98,48,50,0,-1.2365917038730592,-1.248533924843761,-1.170500554541026,-0.7361245244663871,0.9241976393510682,0.9241976393510682,-1.170500554541026,-1.248533924843761,1,0,1,0,-1.248533924843761,-1.170500554541026
2234,10,75,32,80,77,1,2203.819,34,2011.567,MORE,-176,1426,1250,4,1,-3.0,-0.28122253820234633,3.0,-1.0476454436543674,-1.007736362405932,-0.3010327578456217,157,80,77,1,-0.05983508244547061,0.0,-0.1170500554541026,0.503664148319107,-0.5513713621780105,0.5513713621780105,-0.1170500554541026,0.0,0,1,0,1,0.0,-0.1170500554541026
2235,10,76,43,117,110,0,1712.826,94,975.243,MORE,-230,1124,894,2,2,-7.0,-0.6561859224721414,7.0,-0.34921514788478913,1.0506187608061843,-0.6319982182534852,227,117,110,1,1.3363168412821769,1.4436173506005987,1.170500554541026,-0.7361245244663871,-0.6181056386290744,0.6181056386290744,1.170500554541026,1.4436173506005987,1,0,0,2,1.4436173506005987,1.170500554541026
2236,10,77,40,80,64,0,1686.734,14,1244.821,MORE,-1262,1810,548,2,1,-16.0,-1.4998535370791803,16.0,1.222253017596762,-1.6938547368099706,-0.649586148820646,144,80,64,1,-0.3191204397091766,0.0,-0.6242669624218805,-0.7361245244663871,-1.8934718108049615,1.8934718108049615,-0.6242669624218805,0.0,0,0,0,1,0.0,-0.6242669624218805
2237,10,78,31,80,78,0,1807.809,34,1380.053,MORE,-370,1168,798,2,2,-2.0,-0.18748169213489754,2.0,-1.222253017596762,-1.007736362405932,-0.5679726775107046,158,80,78,1,-0.03989005496364707,0.0,-0.07803337030273506,-0.7361245244663871,-0.7911204294281288,0.7911204294281288,-0.07803337030273506,0.0,0,0,0,1,0.0,-0.07803337030273506
2238,10,79,46,124,110,0,1473.981,44,2871.692,MORE,-864,1366,502,2,1,-14.0,-1.3123718449442827,14.0,0.8730378697119728,-0.6646771752039125,-0.792997347347212,234,124,110,1,1.4759320336549415,1.7167341466601715,1.170500554541026,-0.7361245244663871,-1.4016154769619353,1.4016154769619353,1.170500554541026,1.7167341466601715,0,0,0,2,1.7167341466601715,1.170500554541026
2239,10,80,58,92,110,1,2004.33,74,1405.061,MORE,804,1084,1888,3,1,18.0,1.6873352292140782,18.0,1.571468165481551,0.3645003864021456,-0.4355030430254599,202,92,110,0,0.8376911542365885,0.4682002218164104,1.170500554541026,-0.11623018807364008,0.6597321734153707,0.6597321734153707,1.170500554541026,0.4682002218164104,1,1,1,2,1.170500554541026,0.4682002218164104
2240,10,81,48,128,110,1,2336.6910000000007,84,1215.806,LESS,298,1120,1418,3,2,-18.0,-1.6873352292140782,18.0,1.571468165481551,0.7075595736041649,-0.211467239283618,238,128,110,0,1.5557121435822359,1.8728008872656416,1.170500554541026,-0.11623018807364008,0.03440728667021669,0.03440728667021669,1.170500554541026,1.8728008872656416,1,1,0,2,1.8728008872656416,1.170500554541026
2241,10,82,8,50,58,0,2502.564,84,1732.685,LESS,160,1798,1958,5,2,8.0,0.7499267685395902,8.0,-0.17460757394239454,0.7075595736041649,-0.09965661507057776,108,50,58,1,-1.0371414290548238,-1.170500554541026,-0.8583670733300858,1.123558484711854,-0.13613586426027985,0.13613586426027985,-0.8583670733300858,-1.170500554541026,1,1,0,0,-1.170500554541026,-0.8583670733300858
2242,10,83,4,54,50,1,3873.099,94,1528.885,LESS,1152,1706,2858,4,2,-4.0,-0.3749633842697951,4.0,-0.8730378697119728,1.0506187608061843,0.8241849616526981,104,54,50,0,-1.116921538982118,-1.0144338139355558,-1.170500554541026,0.503664148319107,1.0897975105444488,1.0897975105444488,-1.170500554541026,-1.0144338139355558,1,1,1,0,-1.0144338139355558,-1.170500554541026
2243,10,84,37,80,69,1,2825.664,64,1391.63,LESS,176,1196,1372,3,2,-11.0,-1.0311493067419364,11.0,0.34921514788478913,0.02144119920012621,0.11813659228223752,149,80,69,0,-0.21939530230005888,0.0,-0.4291835366650429,-0.11623018807364008,-0.11636274531181648,0.11636274531181648,-0.4291835366650429,0.0,0,1,0,1,0.0,-0.4291835366650429
2244,10,85,52,105,110,1,3008.745,54,1063.586,LESS,-18,1488,1470,3,2,5.0,0.4687042303372438,5.0,-0.6984302957695783,-0.3216179880018931,0.2415466764523417,215,105,110,1,1.0969765115002945,0.9754171287841883,1.170500554541026,-0.11623018807364008,-0.3561118125619348,0.3561118125619348,1.170500554541026,0.9754171287841883,0,1,0,2,1.170500554541026,0.9754171287841883
2245,10,86,5,55,50,0,1636.23,94,1337.621,LESS,602,942,1544,3,2,-5.0,-0.4687042303372438,5.0,-0.6984302957695783,1.0506187608061843,-0.6836295661655749,105,55,50,0,-1.0969765115002945,-0.9754171287841883,-1.170500554541026,-0.11623018807364008,0.41009654669102064,0.41009654669102064,-1.170500554541026,-0.9754171287841883,1,1,1,0,-0.9754171287841883,-1.170500554541026
2246,10,87,30,96,80,1,1155.548,4,2294.644,LESS,-1862,2438,576,1,1,-16.0,-1.4998535370791803,16.0,1.222253017596762,-2.0369139240119902,-1.007644652816042,176,96,80,0,0.3191204397091766,0.6242669624218805,0.0,-1.3560188608591341,-2.634963771372338,2.634963771372338,0.0,0.6242669624218805,0,0,0,1,0.6242669624218805,0.0
2247,10,88,33,80,75,0,3214.475,74,1519.974,LESS,-528,1948,1420,4,2,-5.0,-0.4687042303372438,5.0,-0.6984302957695783,0.3645003864021456,0.3802238554950363,155,80,75,0,-0.09972513740911768,0.0,-0.19508342575683765,0.503664148319107,-0.9863799790442045,0.9863799790442045,-0.19508342575683765,0.0,0,1,0,1,0.0,-0.19508342575683765
2248,10,89,48,110,128,0,3052.139,100,1041.023,LESS,642,1366,2008,3,2,18.0,1.6873352292140782,18.0,1.571468165481551,1.2564542731273958,0.2707974299028775,238,110,128,1,1.5557121435822359,1.170500554541026,1.8728008872656416,-0.11623018807364008,0.45952934406217905,0.45952934406217905,1.8728008872656416,1.170500554541026,1,1,1,2,1.8728008872656416,1.170500554541026
2249,10,90,9,59,50,1,2458.186,84,1035.818,LESS,986,946,1932,3,2,-9.0,-0.8436676146070391,9.0,0.0,0.7075595736041649,-0.12957065702632878,109,59,50,0,-1.0171964015730004,-0.8193503881787182,-1.170500554541026,-0.11623018807364008,0.8846514014541416,0.8846514014541416,-1.170500554541026,-0.8193503881787182,1,1,1,0,-0.8193503881787182,-1.170500554541026
2250,10,91,44,110,119,0,5171.365,74,975.916,LESS,36,2270,2306,7,2,9.0,0.8436676146070391,9.0,0.0,0.3645003864021456,1.6993119072952534,229,110,119,1,1.376206896245824,1.170500554541026,1.5216507209033339,2.363347157497348,-0.2893775361108709,0.2893775361108709,1.5216507209033339,1.170500554541026,1,1,0,2,1.5216507209033339,1.170500554541026
2251,10,92,2,52,50,0,3510.092,54,1122.637,LESS,-304,1806,1502,3,1,-2.0,-0.18748169213489754,2.0,-1.222253017596762,-0.3216179880018931,0.579491495786021,102,52,50,0,-1.156811593945765,-1.092467184238291,-1.170500554541026,-0.11623018807364008,-0.7095563137657174,0.7095563137657174,-1.170500554541026,-1.092467184238291,0,1,0,0,-1.092467184238291,-1.170500554541026
2252,10,93,8,58,50,1,3211.647,64,956.654,LESS,1020,1142,2162,3,2,-8.0,-0.7499267685395902,8.0,-0.17460757394239454,0.02144119920012621,0.3783175751162256,108,58,50,0,-1.0371414290548238,-0.8583670733300858,-1.170500554541026,-0.11623018807364008,0.9266692792196262,0.9266692792196262,-1.170500554541026,-0.8583670733300858,0,1,1,0,-0.8583670733300858,-1.170500554541026
2253,10,94,44,119,110,1,1058.044,100,761.7860000000002,LESS,938,398,1336,1,2,-9.0,-0.8436676146070391,9.0,0.0,1.2564542731273958,-1.0733695333165951,229,119,110,0,1.376206896245824,1.5216507209033339,1.170500554541026,-1.3560188608591341,0.8253320446087514,0.8253320446087514,1.170500554541026,1.5216507209033339,1,0,1,2,1.5216507209033339,1.170500554541026
2254,10,95,34,74,80,0,5221.032,14,1234.061,LESS,-1744,3612,1868,5,1,6.0,0.5624450764046927,6.0,-0.5238227218271837,-1.6938547368099706,1.732791124966539,154,74,80,1,-0.11967016489094122,-0.2341001109082052,0.0,1.123558484711854,-2.4891370191274205,2.4891370191274205,0.0,-0.2341001109082052,0,1,0,1,-0.2341001109082052,0.0
2255,10,96,24,86,80,1,3255.794000000001,54,1777.875,LESS,436,1398,1834,5,2,-6.0,-0.5624450764046927,6.0,-0.5238227218271837,-0.3216179880018931,0.4080759060509359,166,86,80,0,0.11967016489094122,0.2341001109082052,0.0,1.123558484711854,0.20495043760071321,0.20495043760071321,0.0,0.2341001109082052,0,1,1,1,0.2341001109082052,0.0
2256,10,97,39,66,80,0,1430.463,84,3518.32,LESS,314,682,996,2,2,14.0,1.3123718449442827,14.0,0.8730378697119728,0.7075595736041649,-0.8223316859345837,146,66,80,1,-0.2792303847455295,-0.5462335921191455,0.0,-0.7361245244663871,0.05418040561868006,0.05418040561868006,0.0,-0.5462335921191455,1,0,1,1,-0.5462335921191455,0.0
2257,10,98,9,50,59,0,1610.642,94,1679.757,LESS,266,1064,1330,2,2,9.0,0.8436676146070391,9.0,0.0,1.0506187608061843,-0.700877763595918,109,50,59,1,-1.0171964015730004,-1.170500554541026,-0.8193503881787182,-0.7361245244663871,-0.005138951226710043,0.005138951226710043,-0.8193503881787182,-1.170500554541026,1,0,0,0,-1.170500554541026,-0.8193503881787182
2258,10,99,57,94,110,1,2074.197,24,1065.451,LESS,108,968,1076,3,1,16.0,1.4998535370791803,16.0,1.222253017596762,-1.3507955496079511,-0.3884075369340976,204,94,110,1,0.8775812092002355,0.5462335921191455,1.170500554541026,-0.11623018807364008,-0.2003985008427858,0.2003985008427858,1.170500554541026,0.5462335921191455,0,1,0,2,1.170500554541026,0.5462335921191455
2259,10,100,60,110,87,1,1262.237,14,1140.017,LESS,306,664,970,1,1,-23.0,-2.1560394595513217,23.0,2.444506035193524,-1.6938547368099706,-0.935728405526458,197,110,87,0,0.7379660168274708,1.170500554541026,0.27311679605957273,-1.3560188608591341,0.044293846144448375,0.044293846144448375,0.27311679605957273,1.170500554541026,0,0,1,2,1.170500554541026,0.27311679605957273
2260,10,101,33,75,80,0,2945.857,84,776.8839999999999,LESS,-96,1704,1608,4,2,5.0,0.4687042303372438,5.0,-0.6984302957695783,0.7075595736041649,0.1991555306027477,155,75,80,1,-0.09972513740911768,-0.19508342575683765,0.0,0.503664148319107,-0.4525057674356937,0.4525057674356937,0.0,-0.19508342575683765,1,1,0,1,-0.19508342575683765,0.0
2261,10,102,15,50,45,1,7351.654,14,1809.164,LESS,-1090,4356,3266,6,1,-5.0,-0.4687042303372438,5.0,-0.6984302957695783,-1.6938547368099706,3.1689873460636284,95,50,45,0,-1.2964267863185297,-1.170500554541026,-1.3655839802978638,1.743452821104601,-1.6809107821089804,1.6809107821089804,-1.3655839802978638,-1.170500554541026,0,1,0,0,-1.170500554541026,-1.3655839802978638
2262,10,103,59,89,110,0,2482.427,90,1059.954,LESS,336,1390,1726,5,2,21.0,1.9685577674164243,21.0,2.0952908873087353,0.9133950859253764,-0.11323043684855227,199,89,110,1,0.7778560717911179,0.3511501663623078,1.170500554541026,1.123558484711854,0.08136844417281719,0.08136844417281719,1.170500554541026,0.3511501663623078,1,1,1,2,1.170500554541026,0.3511501663623078
2263,10,104,29,80,94,0,1291.3239999999996,84,948.081,LESS,76,930,1006,2,2,14.0,1.3123718449442827,14.0,0.8730378697119728,0.7075595736041649,-0.9161216242752318,174,80,94,1,0.2792303847455295,0.0,0.5462335921191455,-0.7361245244663871,-0.23994473873971253,0.23994473873971253,0.5462335921191455,0.0,1,0,0,1,0.5462335921191455,0.0
2264,10,105,55,110,98,1,2356.395,84,1485.303,LESS,1202,1096,2298,3,2,-12.0,-1.124890152809385,12.0,0.5238227218271837,0.7075595736041649,-0.198185291410886,208,110,98,0,0.9573613191275298,1.170500554541026,0.7023003327246156,-0.11623018807364008,1.151588507258397,1.151588507258397,0.7023003327246156,1.170500554541026,1,1,1,2,1.170500554541026,0.7023003327246156
2265,10,106,29,94,80,0,1330.5870000000002,94,693.7189999999998,LESS,52,874,926,2,2,-14.0,-1.3123718449442827,14.0,0.8730378697119728,1.0506187608061843,-0.8896554692139699,174,94,80,0,0.2792303847455295,0.5462335921191455,0.0,-0.7361245244663871,-0.2696044171624076,0.2696044171624076,0.0,0.5462335921191455,1,0,0,1,0.5462335921191455,0.0
2266,10,107,57,110,94,1,2264.505,64,1311.7820000000004,LESS,778,906,1684,3,2,-16.0,-1.4998535370791803,16.0,1.222253017596762,0.02144119920012621,-0.2601259222485528,204,110,94,0,0.8775812092002355,1.170500554541026,0.5462335921191455,-0.11623018807364008,0.6276008551241177,0.6276008551241177,0.5462335921191455,1.170500554541026,0,1,1,2,1.170500554541026,0.5462335921191455
2267,10,108,39,80,66,1,2100.158,94,1132.706,LESS,1096,762,1858,2,2,-14.0,-1.3123718449442827,14.0,0.8730378697119728,1.0506187608061843,-0.3709079100195622,146,80,66,0,-0.2792303847455295,0.0,-0.5462335921191455,-0.7361245244663871,1.0205915942248271,1.0205915942248271,-0.5462335921191455,0.0,1,0,1,1,0.0,-0.5462335921191455
2268,10,109,4,50,54,0,1496.276,100,1606.333,LESS,922,768,1690,2,2,4.0,0.3749633842697951,4.0,-0.8730378697119728,1.2564542731273958,-0.7779688745588149,104,50,54,1,-1.116921538982118,-1.170500554541026,-1.0144338139355558,-0.7361245244663871,0.8055589256602881,0.8055589256602881,-1.0144338139355558,-1.170500554541026,1,0,1,0,-1.170500554541026,-1.0144338139355558
2269,10,110,55,98,110,0,3162.217,64,2090.402,LESS,-160,1986,1826,5,2,12.0,1.124890152809385,12.0,0.5238227218271837,0.02144119920012621,0.3449981129080869,208,98,110,1,0.9573613191275298,0.7023003327246156,1.170500554541026,1.123558484711854,-0.5315982432295472,0.5315982432295472,1.170500554541026,0.7023003327246156,0,1,0,2,1.170500554541026,0.7023003327246156
2270,10,111,2,50,52,0,1574.379,100,532.181,LESS,340,732,1072,3,2,2.0,0.18748169213489754,2.0,-1.222253017596762,1.2564542731273958,-0.7253216976046929,102,50,52,1,-1.156811593945765,-1.170500554541026,-1.092467184238291,-0.11623018807364008,0.08631172390993302,0.08631172390993302,-1.092467184238291,-1.170500554541026,1,0,1,0,-1.170500554541026,-1.092467184238291
2271,10,112,59,110,89,1,2115.252,54,1479.948,LESS,444,860,1304,3,2,-21.0,-1.9685577674164243,21.0,2.0952908873087353,-0.3216179880018931,-0.3607334418308175,199,110,89,0,0.7778560717911179,1.170500554541026,0.3511501663623078,-0.11623018807364008,0.2148369970749449,0.2148369970749449,0.3511501663623078,1.170500554541026,0,0,1,2,1.170500554541026,0.3511501663623078
2272,10,113,60,87,110,0,2816.294000000001,74,906.701,LESS,-242,1714,1472,5,2,23.0,2.1560394595513217,23.0,2.444506035193524,0.3645003864021456,0.11182052186163784,197,87,110,1,0.7379660168274708,0.27311679605957273,1.170500554541026,1.123558484711854,-0.6329354778404218,0.6329354778404218,1.170500554541026,0.27311679605957273,0,1,0,2,1.170500554541026,0.27311679605957273
2273,10,114,52,110,105,1,2438.37,64,858.345,LESS,644,958,1602,3,2,-5.0,-0.4687042303372438,5.0,-0.6984302957695783,0.02144119920012621,-0.1429281011516876,215,110,105,0,1.0969765115002945,1.170500554541026,0.9754171287841883,-0.11623018807364008,0.462000983930737,0.462000983930737,0.9754171287841883,1.170500554541026,0,0,1,2,1.170500554541026,0.9754171287841883
2274,10,115,30,80,96,0,1997.502,54,1287.442,LESS,-666,1272,606,2,1,16.0,1.4998535370791803,16.0,1.222253017596762,-0.3216179880018931,-0.4401056181409196,176,80,96,1,0.3191204397091766,0.0,0.6242669624218805,-0.7361245244663871,-1.1569231299747011,1.1569231299747011,0.6242669624218805,0.0,0,0,0,1,0.6242669624218805,0.0
2275,10,116,24,80,86,0,1385.691,54,1616.044,LESS,0,952,952,2,2,6.0,0.5624450764046927,6.0,-0.5238227218271837,-0.3216179880018931,-0.8525113129218947,166,80,86,1,0.11967016489094122,0.0,0.2341001109082052,-0.7361245244663871,-0.3338670537449135,0.3338670537449135,0.2341001109082052,0.0,0,0,0,1,0.2341001109082052,0.0
2276,10,117,5,50,55,1,5441.257,54,1074.966,LESS,1144,1968,3112,5,2,5.0,0.4687042303372438,5.0,-0.6984302957695783,-0.3216179880018931,1.881239002061165,105,50,55,1,-1.0969765115002945,-1.170500554541026,-0.9754171287841883,1.123558484711854,1.0799109510702172,1.0799109510702172,-0.9754171287841883,-1.170500554541026,0,1,1,0,-1.170500554541026,-0.9754171287841883
2277,10,118,34,80,74,1,3678.106,34,1437.701,LESS,574,1368,1942,4,2,-6.0,-0.5624450764046927,6.0,-0.5238227218271837,-1.007736362405932,0.6927453117568533,154,80,74,0,-0.11967016489094122,0.0,-0.2341001109082052,0.503664148319107,0.3754935885312098,0.3754935885312098,-0.2341001109082052,0.0,0,1,1,1,0.0,-0.2341001109082052
2278,10,119,15,45,50,0,2843.507,94,646.596,LESS,-256,1424,1168,4,2,5.0,0.4687042303372438,5.0,-0.6984302957695783,1.0506187608061843,0.13016408902874402,95,45,50,1,-1.2964267863185297,-1.3655839802978638,-1.170500554541026,0.503664148319107,-0.6502369569203273,0.6502369569203273,-1.170500554541026,-1.3655839802978638,1,1,0,0,-1.3655839802978638,-1.170500554541026
2279,10,120,37,69,80,0,1709.499,34,1636.519,LESS,-544,954,410,2,1,11.0,1.0311493067419364,11.0,0.34921514788478913,-1.007736362405932,-0.6342408614006929,149,69,80,1,-0.21939530230005888,-0.4291835366650429,0.0,-0.7361245244663871,-1.0061530979926678,1.0061530979926678,0.0,-0.4291835366650429,0,0,0,1,-0.4291835366650429,0.0
2280,10,121,48,128,110,0,1421.8570000000002,94,1409.8339999999996,MORE,472,954,1426,2,2,-18.0,-1.6873352292140782,18.0,1.571468165481551,1.0506187608061843,-0.8281327640604836,238,128,110,1,1.5557121435822359,1.8728008872656416,1.170500554541026,-0.7361245244663871,0.2494399552347558,0.2494399552347558,1.170500554541026,1.8728008872656416,1,0,1,2,1.8728008872656416,1.170500554541026
2281,10,122,8,50,58,1,2683.921,54,1082.511,MORE,946,972,1918,3,2,8.0,0.7499267685395902,8.0,-0.17460757394239454,-0.3216179880018931,0.02259136606803094,108,50,58,0,-1.0371414290548238,-1.170500554541026,-0.8583670733300858,-0.11623018807364008,0.8352186040829831,0.8352186040829831,-0.8583670733300858,-1.170500554541026,0,1,1,0,-1.170500554541026,-0.8583670733300858
2282,10,123,4,54,50,0,2971.482,74,928.766,MORE,-484,1712,1228,4,1,-4.0,-0.3749633842697951,4.0,-0.8730378697119728,0.3645003864021456,0.21642866875940472,104,54,50,1,-1.116921538982118,-1.0144338139355558,-1.170500554541026,0.503664148319107,-0.9320039019359303,0.9320039019359303,-1.170500554541026,-1.0144338139355558,1,1,0,0,-1.0144338139355558,-1.170500554541026
2283,10,124,37,80,69,0,3289.845,54,1167.331,MORE,-546,1836,1290,4,2,-11.0,-1.0311493067419364,11.0,0.34921514788478913,-0.3216179880018931,0.4310287890703432,149,80,69,1,-0.21939530230005888,0.0,-0.4291835366650429,0.503664148319107,-1.0086247378612259,1.0086247378612259,-0.4291835366650429,0.0,0,1,0,1,0.0,-0.4291835366650429
2284,10,125,52,105,110,0,1787.366,94,641.4680000000002,MORE,-174,1228,1054,3,2,5.0,0.4687042303372438,5.0,-0.6984302957695783,1.0506187608061843,-0.581752765836033,215,105,110,0,1.0969765115002945,0.9754171287841883,1.170500554541026,-0.11623018807364008,-0.5488997223094526,0.5488997223094526,1.170500554541026,0.9754171287841883,1,1,0,2,1.170500554541026,0.9754171287841883
2285,10,126,5,55,50,0,1495.821,54,1987.698,MORE,-366,1010,644,2,2,-5.0,-0.4687042303372438,5.0,-0.6984302957695783,-0.3216179880018931,-0.7782755780851089,105,55,50,1,-1.0969765115002945,-0.9754171287841883,-1.170500554541026,-0.7361245244663871,-0.7861771496910129,0.7861771496910129,-1.170500554541026,-0.9754171287841883,0,0,0,0,-0.9754171287841883,-1.170500554541026
2286,10,127,30,96,80,0,1312.34,90,901.484,MORE,124,906,1030,2,2,-16.0,-1.4998535370791803,16.0,1.222253017596762,0.9133950859253764,-0.9019552917288782,176,96,80,1,0.3191204397091766,0.6242669624218805,0.0,-0.7361245244663871,-0.18062538189432242,0.18062538189432242,0.0,0.6242669624218805,1,0,0,1,0.6242669624218805,0.0
2287,10,128,33,80,75,0,1617.595,100,834.2919999999998,MORE,54,1068,1122,3,2,-5.0,-0.4687042303372438,5.0,-0.6984302957695783,1.2564542731273958,-0.6961909292699381,155,80,75,1,-0.09972513740911768,0.0,-0.19508342575683765,-0.11623018807364008,-0.26713277729384965,0.26713277729384965,-0.19508342575683765,0.0,1,1,0,1,0.0,-0.19508342575683765
2288,10,129,48,110,128,1,2641.421,84,1598.861,MORE,1414,960,2374,2,2,18.0,1.6873352292140782,18.0,1.571468165481551,0.7075595736041649,-0.00605676550886364,238,110,128,0,1.5557121435822359,1.170500554541026,1.8728008872656416,-0.7361245244663871,1.4135823333255366,1.4135823333255366,1.8728008872656416,1.170500554541026,1,0,1,2,1.8728008872656416,1.170500554541026
2289,10,130,9,59,50,0,3239.75,74,980.167,MORE,114,1532,1646,3,2,-9.0,-0.8436676146070391,9.0,0.0,0.3645003864021456,0.39726106786223664,109,59,50,1,-1.0171964015730004,-0.8193503881787182,-1.170500554541026,-0.11623018807364008,-0.19298358123711204,0.19298358123711204,-1.170500554541026,-0.8193503881787182,1,1,0,0,-0.8193503881787182,-1.170500554541026
2290,10,131,44,110,119,1,4830.474,54,1283.543,MORE,1902,1246,3148,4,2,9.0,0.8436676146070391,9.0,0.0,-0.3216179880018931,1.4695262550275086,229,110,119,0,1.376206896245824,1.170500554541026,1.5216507209033339,0.503664148319107,2.016662461253669,2.016662461253669,1.5216507209033339,1.170500554541026,0,1,1,2,1.5216507209033339,1.170500554541026
2291,10,132,2,52,50,0,5707.6309999999985,14,2383.802,MORE,-170,3130,2960,8,1,-2.0,-0.18748169213489754,2.0,-1.222253017596762,-1.6938547368099706,2.0607947056061926,102,52,50,1,-1.156811593945765,-1.092467184238291,-1.170500554541026,2.983241493890095,-0.5439564425723368,0.5439564425723368,-1.170500554541026,-1.092467184238291,0,1,0,0,-1.092467184238291,-1.170500554541026
2292,10,133,8,58,50,0,3165.677,54,1784.687,MORE,-188,1622,1434,4,2,-8.0,-0.7499267685395902,8.0,-0.17460757394239454,-0.3216179880018931,0.3473304078552882,108,58,50,1,-1.0371414290548238,-0.8583670733300858,-1.170500554541026,0.503664148319107,-0.566201201389358,0.566201201389358,-1.170500554541026,-0.8583670733300858,0,1,0,0,-0.8583670733300858,-1.170500554541026
2293,10,134,44,119,110,0,1835.798,84,1734.395,MORE,576,634,1210,2,2,-9.0,-0.8436676146070391,9.0,0.0,0.7075595736041649,-0.549106029164688,229,119,110,1,1.376206896245824,1.5216507209033339,1.170500554541026,-0.7361245244663871,0.3779652283997677,0.3779652283997677,1.170500554541026,1.5216507209033339,1,0,1,2,1.5216507209033339,1.170500554541026
2294,10,135,34,74,80,1,2513.012,24,1315.052,MORE,900,754,1654,3,2,6.0,0.5624450764046927,6.0,-0.5238227218271837,-1.3507955496079511,-0.0926138932184506,154,74,80,0,-0.11967016489094122,-0.2341001109082052,0.0,-0.11623018807364008,0.7783708871061509,0.7783708871061509,0.0,-0.2341001109082052,0,1,1,1,-0.2341001109082052,0.0
2295,10,136,24,86,80,0,1628.7179999999996,90,1466.4979999999996,MORE,664,790,1454,2,2,-6.0,-0.5624450764046927,6.0,-0.5238227218271837,0.9133950859253764,-0.6886932076810021,166,86,80,1,0.11967016489094122,0.2341001109082052,0.0,-0.7361245244663871,0.4867173826163162,0.4867173826163162,0.0,0.2341001109082052,1,0,1,1,0.2341001109082052,0.0
2296,10,137,39,66,80,1,2175.323,34,1447.81,MORE,432,762,1194,3,2,14.0,1.3123718449442827,14.0,0.8730378697119728,-1.007736362405932,-0.3202411615495085,146,66,80,0,-0.2792303847455295,-0.5462335921191455,0.0,-0.11623018807364008,0.20000715786359738,0.20000715786359738,0.0,-0.5462335921191455,0,1,0,1,-0.5462335921191455,0.0
2297,10,138,9,50,59,1,2798.844,44,1582.6270000000004,MORE,1074,800,1874,3,2,9.0,0.8436676146070391,9.0,0.0,-0.6646771752039125,0.10005793607300653,109,50,59,0,-1.0171964015730004,-1.170500554541026,-0.8193503881787182,-0.11623018807364008,0.99340355567069,0.99340355567069,-0.8193503881787182,-1.170500554541026,0,1,1,0,-1.170500554541026,-0.8193503881787182
2298,10,139,57,94,110,0,1538.526,94,774.79,MORE,-98,960,862,2,2,16.0,1.4998535370791803,16.0,1.222253017596762,1.0506187608061843,-0.7494892614029609,204,94,110,0,0.8775812092002355,0.5462335921191455,1.170500554541026,-0.7361245244663871,-0.4549774073042516,0.4549774073042516,1.170500554541026,0.5462335921191455,1,0,0,2,1.170500554541026,0.5462335921191455
2299,10,140,60,110,87,0,1389.557,94,1526.5839999999996,MORE,460,984,1444,2,2,-23.0,-2.1560394595513217,23.0,2.444506035193524,1.0506187608061843,-0.8499053440589236,197,110,87,1,0.7379660168274708,1.170500554541026,0.27311679605957273,-0.7361245244663871,0.23461011602340828,0.23461011602340828,0.27311679605957273,1.170500554541026,1,0,1,2,1.170500554541026,0.27311679605957273
2300,10,141,33,75,80,1,1704.155,100,1707.139,MORE,774,844,1618,3,2,5.0,0.4687042303372438,5.0,-0.6984302957695783,1.2564542731273958,-0.6378431111688558,155,75,80,0,-0.09972513740911768,-0.19508342575683765,0.0,-0.11623018807364008,0.6226575753870018,0.6226575753870018,0.0,-0.19508342575683765,1,1,1,1,-0.19508342575683765,0.0
2301,10,142,15,50,45,1,2217.502,84,1301.338,MORE,972,936,1908,3,2,-5.0,-0.4687042303372438,5.0,-0.6984302957695783,0.7075595736041649,-0.29180940762523,95,50,45,1,-1.2964267863185297,-1.170500554541026,-1.3655839802978638,-0.11623018807364008,0.867349922374236,0.867349922374236,-1.3655839802978638,-1.170500554541026,1,1,1,0,-1.170500554541026,-1.3655839802978638
2302,10,143,59,89,110,1,5787.017,54,1316.729,MORE,-16,2410,2394,6,2,21.0,1.9685577674164243,21.0,2.0952908873087353,-0.3216179880018931,2.114306719097096,199,89,110,0,0.7778560717911179,0.3511501663623078,1.170500554541026,1.743452821104601,-0.3536401726933769,0.3536401726933769,1.170500554541026,0.3511501663623078,0,1,0,2,1.170500554541026,0.3511501663623078
2303,10,144,29,80,94,1,2518.364,64,1818.13,MORE,634,892,1526,3,2,14.0,1.3123718449442827,14.0,0.8730378697119728,0.02144119920012621,-0.08900625086081447,174,80,94,0,0.2792303847455295,0.0,0.5462335921191455,-0.11623018807364008,0.4496427845879474,0.4496427845879474,0.5462335921191455,0.0,0,1,1,1,0.5462335921191455,0.0
2304,10,145,55,110,98,0,4822.179,84,2168.931,MORE,624,2406,3030,6,2,-12.0,-1.124890152809385,12.0,0.5238227218271837,0.7075595736041649,1.4639348138173829,208,110,98,1,0.9573613191275298,1.170500554541026,0.7023003327246156,1.743452821104601,0.4372845852451578,0.4372845852451578,0.7023003327246156,1.170500554541026,1,1,1,2,1.170500554541026,0.7023003327246156
2305,10,146,29,94,80,0,2906.668,64,1214.182,MORE,-372,1412,1040,4,2,-14.0,-1.3123718449442827,14.0,0.8730378697119728,0.02144119920012621,0.17273925699411435,174,94,80,1,0.2792303847455295,0.5462335921191455,0.0,0.503664148319107,-0.7935920692966867,0.7935920692966867,0.0,0.5462335921191455,0,1,0,1,0.5462335921191455,0.0
2306,10,147,57,110,94,0,1577.21,94,1893.143,MORE,560,894,1454,2,2,-16.0,-1.4998535370791803,16.0,1.222253017596762,1.0506187608061843,-0.7234133950048295,204,110,94,1,0.8775812092002355,1.170500554541026,0.5462335921191455,-0.7361245244663871,0.3581921094513043,0.3581921094513043,0.5462335921191455,1.170500554541026,1,0,1,2,1.170500554541026,0.5462335921191455
2307,10,148,39,80,66,0,2177.234,100,1787.5870000000002,MORE,742,1380,2122,3,2,-14.0,-1.3123718449442827,14.0,0.8730378697119728,1.2564542731273958,-0.3189530067390745,146,80,66,1,-0.2792303847455295,0.0,-0.5462335921191455,-0.11623018807364008,0.5831113374900752,0.5831113374900752,-0.5462335921191455,0.0,1,0,1,1,0.0,-0.5462335921191455
2308,10,149,4,50,54,1,1134.675,94,2019.675,MORE,1506,544,2050,1,2,4.0,0.3749633842697951,4.0,-0.8730378697119728,1.0506187608061843,-1.0217145928255602,104,50,54,0,-1.116921538982118,-1.170500554541026,-1.0144338139355558,-1.3560188608591341,1.5272777672792008,1.5272777672792008,-1.0144338139355558,-1.170500554541026,1,0,1,0,-1.170500554541026,-1.0144338139355558
2309,10,150,55,98,110,1,2555.015,94,1664.933,MORE,1040,1156,2196,2,2,12.0,1.124890152809385,12.0,0.5238227218271837,1.0506187608061843,-0.06430077626258485,208,98,110,0,0.9573613191275298,0.7023003327246156,1.170500554541026,-0.7361245244663871,0.9513856779052053,0.9513856779052053,1.170500554541026,0.7023003327246156,1,0,1,2,1.170500554541026,0.7023003327246156
2310,10,151,2,50,52,1,3902.862,34,4143.5329999999985,MORE,-300,1962,1662,4,2,2.0,0.18748169213489754,2.0,-1.222253017596762,-1.007736362405932,0.8442474167144183,102,50,52,0,-1.156811593945765,-1.170500554541026,-1.092467184238291,0.503664148319107,-0.7046130340286015,0.7046130340286015,-1.092467184238291,-1.170500554541026,0,1,0,0,-1.170500554541026,-1.092467184238291
2311,10,152,59,110,89,0,2540.732,54,2014.644,MORE,346,788,1134,1,1,-21.0,-1.9685577674164243,21.0,2.0952908873087353,-0.3216179880018931,-0.07392857069347385,199,110,89,1,0.7778560717911179,1.170500554541026,0.3511501663623078,-1.3560188608591341,0.09372664351560679,0.09372664351560679,0.3511501663623078,1.170500554541026,0,0,0,2,1.170500554541026,0.3511501663623078
2312,10,153,60,87,110,1,3994.772,44,1300.547,MORE,740,1480,2220,4,2,23.0,2.1560394595513217,23.0,2.444506035193524,-0.6646771752039125,0.9062015290257684,197,87,110,0,0.7379660168274708,0.27311679605957273,1.170500554541026,0.503664148319107,0.5806396976215172,0.5806396976215172,1.170500554541026,0.27311679605957273,0,1,1,2,1.170500554541026,0.27311679605957273
2313,10,154,52,110,105,1,6138.929,14,1641.245,MORE,74,2756,2830,6,1,-5.0,-0.4687042303372438,5.0,-0.6984302957695783,-1.6938547368099706,2.351521337437993,215,110,105,1,1.0969765115002945,1.170500554541026,0.9754171287841883,1.743452821104601,-0.24241637860827045,0.24241637860827045,0.9754171287841883,1.170500554541026,0,1,0,2,1.170500554541026,0.9754171287841883
2314,10,155,30,80,96,0,1443.82,34,1291.048,MORE,-398,908,510,2,1,16.0,1.4998535370791803,16.0,1.222253017596762,-1.007736362405932,-0.8133280837352288,176,80,96,0,0.3191204397091766,0.0,0.6242669624218805,-0.7361245244663871,-0.8257233875879397,0.8257233875879397,0.6242669624218805,0.0,0,0,0,1,0.6242669624218805,0.0
2315,10,156,24,80,86,0,7491.703,14,1349.8970000000004,MORE,-1416,4262,2846,8,1,6.0,0.5624450764046927,6.0,-0.5238227218271837,-1.6938547368099706,3.263390691456864,166,80,86,0,0.11967016489094122,0.0,0.2341001109082052,2.983241493890095,-2.0837880806839215,2.0837880806839215,0.2341001109082052,0.0,0,1,0,1,0.2341001109082052,0.0
2316,10,157,5,50,55,1,2171.036,64,1106.904,MORE,432,1058,1490,5,2,5.0,0.4687042303372438,5.0,-0.6984302957695783,0.02144119920012621,-0.32313091543351186,105,50,55,0,-1.0969765115002945,-1.170500554541026,-0.9754171287841883,1.123558484711854,0.20000715786359738,0.20000715786359738,-0.9754171287841883,-1.170500554541026,1,1,0,0,-1.170500554541026,-0.9754171287841883
2317,10,158,34,80,74,1,5706.276999999999,44,2547.215,MORE,1124,2022,3146,7,2,-6.0,-0.5624450764046927,6.0,-0.5238227218271837,-0.6646771752039125,2.0598820098378368,154,80,74,1,-0.11967016489094122,0.0,-0.2341001109082052,2.363347157497348,1.055194552384638,1.055194552384638,-0.2341001109082052,0.0,0,1,1,1,0.0,-0.2341001109082052
2318,10,159,15,45,50,1,3753.437,54,1507.582,MORE,450,1470,1920,5,2,5.0,0.4687042303372438,5.0,-0.6984302957695783,-0.3216179880018931,0.7435239564584777,95,45,50,0,-1.2964267863185297,-1.3655839802978638,-1.170500554541026,1.123558484711854,0.22225191668061867,0.22225191668061867,-1.170500554541026,-1.3655839802978638,0,1,1,0,-1.3655839802978638,-1.170500554541026
2319,10,160,37,69,80,1,1171.933,14,2141.878,MORE,-66,1422,1356,1,1,11.0,1.0311493067419364,11.0,0.34921514788478913,-1.6938547368099706,-0.9965999555010436,149,69,80,0,-0.21939530230005888,-0.4291835366650429,0.0,-1.3560188608591341,-0.4154311694073249,0.4154311694073249,0.0,-0.4291835366650429,0,0,0,1,-0.4291835366650429,0.0
2320,10,161,3,50,53,1,3448.474,24,1334.06,LESS,-168,1766,1598,4,1,3.0,0.28122253820234633,3.0,-1.0476454436543674,-1.3507955496079511,0.5379564235153129,103,50,53,1,-1.1368665664639415,-1.170500554541026,-1.0534504990869233,0.503664148319107,-0.5414848027037789,0.5414848027037789,-1.0534504990869233,-1.170500554541026,0,1,0,0,-1.170500554541026,-1.0534504990869233
2321,10,162,20,50,40,1,2001.147,84,1431.677,LESS,734,842,1576,3,2,-10.0,-0.9374084606744876,10.0,0.17460757394239454,0.7075595736041649,-0.4376486195621483,90,50,40,0,-1.3961519237276474,-1.170500554541026,-1.5606674060547012,-0.11623018807364008,0.5732247780158435,0.5732247780158435,-1.5606674060547012,-1.170500554541026,1,0,1,0,-1.170500554541026,-1.5606674060547012
2322,10,163,25,80,88,0,2892.033,34,2003.171,LESS,-978,1942,964,4,1,8.0,0.7499267685395902,8.0,-0.17460757394239454,-1.007736362405932,0.16287418862640005,168,80,88,1,0.1595602198545883,0.0,0.31213348121094026,0.503664148319107,-1.5424989494697368,1.5424989494697368,0.31213348121094026,0.0,0,1,0,1,0.31213348121094026,0.0
2323,10,164,42,115,110,1,1321.444,84,1275.982,LESS,636,678,1314,2,2,-5.0,-0.4687042303372438,5.0,-0.6984302957695783,0.7075595736041649,-0.8958185249082653,225,115,110,0,1.2964267863185297,1.3655839802978638,1.170500554541026,-0.7361245244663871,0.4521144244565053,0.4521144244565053,1.170500554541026,1.3655839802978638,1,0,1,2,1.3655839802978638,1.170500554541026
2324,10,165,53,103,110,0,2314.263,74,1605.217,LESS,12,1380,1392,4,2,7.0,0.6561859224721414,7.0,-0.34921514788478913,0.3645003864021456,-0.2265853638720089,213,103,110,1,1.0570864565366473,0.8973837584814532,1.170500554541026,0.503664148319107,-0.319037214533566,0.319037214533566,1.170500554541026,0.8973837584814532,0,1,0,2,1.170500554541026,0.8973837584814532
2325,10,166,26,90,80,0,6228.2,14,2328.601,LESS,412,2792,3204,9,2,-10.0,-0.9374084606744876,10.0,0.17460757394239454,-1.6938547368099706,2.411696569296839,170,90,80,0,0.19945027481823535,0.3901668515136753,0.0,3.603135830282842,0.17529075917801817,0.17529075917801817,0.0,0.3901668515136753,0,1,1,1,0.3901668515136753,0.0
2326,10,167,35,80,72,1,1066.489,74,1860.841,LESS,-2,1078,1076,2,2,-8.0,-0.7499267685395902,8.0,-0.17460757394239454,0.3645003864021456,-1.0676769810538456,152,80,72,0,-0.1595602198545883,0.0,-0.31213348121094026,-0.7361245244663871,-0.3363386936134714,0.3363386936134714,-0.31213348121094026,0.0,1,0,0,1,0.0,-0.31213348121094026
2327,10,168,28,93,80,1,1764.0320000000004,94,1535.49,LESS,1088,844,1932,3,2,-13.0,-1.218630998876834,13.0,0.6984302957695783,1.0506187608061843,-0.5974816011822739,173,93,80,0,0.25928535726370594,0.5072169069677779,0.0,-0.11623018807364008,1.0107050347505955,1.0107050347505955,0.0,0.5072169069677779,1,0,1,1,0.5072169069677779,0.0
2328,10,169,26,80,90,0,1403.79,74,1231.304,LESS,46,1100,1146,2,2,10.0,0.9374084606744876,10.0,0.17460757394239454,0.3645003864021456,-0.8403112533122428,170,80,90,1,0.19945027481823535,0.0,0.3901668515136753,-0.7361245244663871,-0.2770193367680813,0.2770193367680813,0.3901668515136753,0.0,1,0,0,1,0.3901668515136753,0.0
2329,10,170,25,88,80,0,1236.143,84,1155.197,LESS,596,838,1434,3,2,-8.0,-0.7499267685395902,8.0,-0.17460757394239454,0.7075595736041649,-0.9533176842409872,168,88,80,0,0.1595602198545883,0.31213348121094026,0.0,-0.11623018807364008,0.4026816270853469,0.4026816270853469,0.0,0.31213348121094026,1,0,1,1,0.31213348121094026,0.0
2330,10,171,36,80,70,1,1200.47,100,1152.018,LESS,1252,318,1570,1,2,-10.0,-0.9374084606744876,10.0,0.17460757394239454,1.2564542731273958,-0.9773639147761064,150,80,70,0,-0.19945027481823535,0.0,-0.3901668515136753,-1.3560188608591341,1.213379503972345,1.213379503972345,-0.3901668515136753,0.0,1,0,1,1,0.0,-0.3901668515136753
2331,10,172,28,80,93,0,1443.7620000000004,4,2466.6420000000007,LESS,-1440,2158,718,4,1,13.0,1.218630998876834,13.0,0.6984302957695783,-2.0369139240119902,-0.81336718000891,173,80,93,1,0.25928535726370594,0.0,0.5072169069677779,0.503664148319107,-2.1134477591066165,2.1134477591066165,0.5072169069677779,0.0,0,1,0,1,0.5072169069677779,0.0
2332,10,173,21,82,80,1,1816.375,74,1221.995,LESS,756,852,1608,3,2,-2.0,-0.18748169213489754,2.0,-1.222253017596762,0.3645003864021456,-0.5621985623321709,162,82,80,0,0.03989005496364707,0.07803337030273506,0.0,-0.11623018807364008,0.6004128165699806,0.6004128165699806,0.0,0.07803337030273506,1,0,1,1,0.07803337030273506,0.0
2333,10,174,19,50,41,1,2130.63,84,1219.383,LESS,1084,830,1914,2,2,-9.0,-0.8436676146070391,9.0,0.0,0.7075595736041649,-0.3503675367157707,91,50,41,0,-1.376206896245824,-1.170500554541026,-1.5216507209033339,-0.7361245244663871,1.0057617550134796,1.0057617550134796,-1.5216507209033339,-1.170500554541026,1,0,1,0,-1.170500554541026,-1.5216507209033339
2334,10,175,56,96,110,0,6347.843000000002,0,1574.224,LESS,-2180,4140,1960,6,1,14.0,1.3123718449442827,14.0,0.8730378697119728,-2.1741375988927976,2.492344767091061,206,96,110,1,0.9174712641638826,0.6242669624218805,1.170500554541026,1.743452821104601,-3.027954510473047,3.027954510473047,1.170500554541026,0.6242669624218805,0,1,0,2,1.170500554541026,0.6242669624218805
2335,10,176,23,80,85,0,2640.37,74,789.6060000000001,LESS,100,1264,1364,4,2,5.0,0.4687042303372438,5.0,-0.6984302957695783,0.3645003864021456,-0.006765216950918093,165,80,85,1,0.09972513740911768,0.0,0.19508342575683765,0.503664148319107,-0.21028506031701746,0.21028506031701746,0.19508342575683765,0.0,1,1,0,1,0.19508342575683765,0.0
2336,10,177,10,60,50,1,2216.961,94,657.5939999999998,LESS,758,954,1712,3,2,-10.0,-0.9374084606744876,10.0,0.17460757394239454,1.0506187608061843,-0.2921740814883619,110,60,50,0,-0.9972513740911768,-0.7803337030273506,-1.170500554541026,-0.11623018807364008,0.6028844564385385,0.6028844564385385,-1.170500554541026,-0.7803337030273506,1,1,1,0,-0.7803337030273506,-1.170500554541026
2337,10,178,19,41,50,0,1285.889,94,863.68,LESS,378,852,1230,3,2,9.0,0.8436676146070391,9.0,0.0,1.0506187608061843,-0.9197852147486532,91,41,50,1,-1.376206896245824,-1.5216507209033339,-1.170500554541026,-0.11623018807364008,0.13327288141253352,0.13327288141253352,-1.170500554541026,-1.5216507209033339,1,0,1,0,-1.5216507209033339,-1.170500554541026
2338,10,179,56,110,96,1,1833.967,54,1916.476,LESS,146,780,926,3,2,-14.0,-1.3123718449442827,14.0,0.8730378697119728,-0.3216179880018931,-0.550340258080389,206,110,96,0,0.9174712641638826,1.170500554541026,0.6242669624218805,-0.11623018807364008,-0.1534373433401853,0.1534373433401853,0.6242669624218805,1.170500554541026,0,0,0,2,1.170500554541026,0.6242669624218805
2339,10,180,35,72,80,1,2042.111,74,1699.071,LESS,346,928,1274,3,2,8.0,0.7499267685395902,8.0,-0.17460757394239454,0.3645003864021456,-0.4100358651641268,152,72,80,1,-0.1595602198545883,-0.31213348121094026,0.0,-0.11623018807364008,0.09372664351560679,0.09372664351560679,0.0,-0.31213348121094026,1,0,1,1,-0.31213348121094026,0.0
2340,10,181,11,49,50,0,1562.155,90,1095.238,LESS,184,866,1050,2,2,1.0,0.09374084606744876,1.0,-1.3968605915391563,0.9133950859253764,-0.7335615743198919,99,49,50,1,-1.2166466763912356,-1.2095172396923934,-1.170500554541026,-0.7361245244663871,-0.1064761858375848,0.1064761858375848,-1.170500554541026,-1.2095172396923934,1,0,0,0,-1.2095172396923934,-1.170500554541026
2341,10,182,17,43,50,0,1721.177,94,2030.981,LESS,1084,906,1990,3,2,7.0,0.6561859224721414,7.0,-0.34921514788478913,1.0506187608061843,-0.6263690289170465,93,43,50,1,-1.3363168412821769,-1.4436173506005987,-1.170500554541026,-0.11623018807364008,1.0057617550134796,1.0057617550134796,-1.170500554541026,-1.4436173506005987,1,0,1,0,-1.4436173506005987,-1.170500554541026
2342,10,183,1,51,50,0,1232.152,80,1179.728,LESS,524,860,1384,2,2,-1.0,-0.09374084606744876,1.0,-1.3968605915391563,0.5703358987233571,-0.9560079123144788,101,51,50,0,-1.1767566214275886,-1.1314838693896585,-1.170500554541026,-0.7361245244663871,0.31370259181726173,0.31370259181726173,-1.170500554541026,-1.1314838693896585,1,0,1,0,-1.1314838693896585,-1.170500554541026
2343,10,184,41,112,110,0,3342.02,44,1744.984,LESS,-620,2034,1414,5,2,-2.0,-0.18748169213489754,2.0,-1.222253017596762,-0.6646771752039125,0.4661985835415074,222,112,110,0,1.2365917038730592,1.248533924843761,1.170500554541026,1.123558484711854,-1.100075412997869,1.100075412997869,1.170500554541026,1.248533924843761,0,1,0,2,1.248533924843761,1.170500554541026
2344,10,185,20,40,50,0,1865.652,94,1729.5929999999996,LESS,272,1352,1624,3,2,10.0,0.9374084606744876,10.0,0.17460757394239454,1.0506187608061843,-0.5289822333977089,90,40,50,1,-1.3961519237276474,-1.5606674060547012,-1.170500554541026,-0.11623018807364008,0.0022759683789637195,0.0022759683789637195,-1.170500554541026,-1.5606674060547012,1,0,0,0,-1.5606674060547012,-1.170500554541026
2345,10,186,1,50,51,0,4279.312,44,2042.34,LESS,-178,2004,1826,6,1,1.0,0.09374084606744876,1.0,-1.3968605915391563,-0.6646771752039125,1.098002455117288,101,50,51,1,-1.1767566214275886,-1.170500554541026,-1.1314838693896585,1.743452821104601,-0.5538430020465684,0.5538430020465684,-1.1314838693896585,-1.170500554541026,0,1,0,0,-1.170500554541026,-1.1314838693896585
2346,10,187,23,85,80,1,2332.379,84,1361.6070000000002,LESS,1090,790,1880,2,2,-5.0,-0.4687042303372438,5.0,-0.6984302957695783,0.7075595736041649,-0.21437384500972606,165,85,80,0,0.09972513740911768,0.19508342575683765,0.0,-0.7361245244663871,1.0131766746191535,1.0131766746191535,0.0,0.19508342575683765,1,0,1,1,0.19508342575683765,0.0
2347,10,188,11,50,49,0,2874.983,84,2193.465,LESS,324,1604,1928,4,2,-1.0,-0.09374084606744876,1.0,-1.3968605915391563,0.7075595736041649,0.15138123231143427,99,50,49,0,-1.2166466763912356,-1.170500554541026,-1.2095172396923934,0.503664148319107,0.06653860496146966,0.06653860496146966,-1.2095172396923934,-1.170500554541026,1,1,1,0,-1.170500554541026,-1.2095172396923934
2348,10,189,17,50,43,1,2588.425,64,1157.522,LESS,480,958,1438,3,2,-7.0,-0.6561859224721414,7.0,-0.34921514788478913,0.02144119920012621,-0.041779974474724695,93,50,43,0,-1.3363168412821769,-1.170500554541026,-1.4436173506005987,-0.11623018807364008,0.2593265147089875,0.2593265147089875,-1.4436173506005987,-1.170500554541026,0,0,1,0,-1.170500554541026,-1.4436173506005987
2349,10,190,21,80,82,1,1532.4,84,1404.019,LESS,1104,644,1748,2,2,2.0,0.18748169213489754,2.0,-1.222253017596762,0.7075595736041649,-0.7536186367921388,162,80,82,1,0.03989005496364707,0.0,0.07803337030273506,-0.7361245244663871,1.0304781536990588,1.0304781536990588,0.07803337030273506,0.0,1,0,1,1,0.07803337030273506,0.0
2350,10,191,10,50,60,0,1241.75,100,1497.358,LESS,596,986,1582,3,2,10.0,0.9374084606744876,10.0,0.17460757394239454,1.2564542731273958,-0.9495381530938896,110,50,60,1,-0.9972513740911768,-1.170500554541026,-0.7803337030273506,-0.11623018807364008,0.4026816270853469,0.4026816270853469,-0.7803337030273506,-1.170500554541026,1,1,1,0,-1.170500554541026,-0.7803337030273506
2351,10,192,3,53,50,0,4626.554,34,1565.711,LESS,-780,2526,1746,6,1,-3.0,-0.28122253820234633,3.0,-1.0476454436543674,-1.007736362405932,1.3320691493531476,103,53,50,0,-1.1368665664639415,-1.0534504990869233,-1.170500554541026,1.743452821104601,-1.2978066024825026,1.2978066024825026,-1.170500554541026,-1.0534504990869233,0,1,0,0,-1.0534504990869233,-1.170500554541026
2352,10,193,45,122,110,1,1099.336,84,2137.125,LESS,1722,398,2120,1,2,-12.0,-1.124890152809385,12.0,0.5238227218271837,0.7075595736041649,-1.045535682750169,232,122,110,0,1.4360419786912946,1.6387007763574364,1.170500554541026,-1.3560188608591341,1.7942148730834564,1.7942148730834564,1.170500554541026,1.6387007763574364,1,0,1,2,1.6387007763574364,1.170500554541026
2353,10,194,38,67,80,0,1693.148,54,3763.236,LESS,-548,1136,588,2,1,13.0,1.218630998876834,13.0,0.6984302957695783,-0.3216179880018931,-0.6452626402104296,147,67,80,1,-0.25928535726370594,-0.5072169069677779,0.0,-0.7361245244663871,-1.0110963777297837,1.0110963777297837,0.0,-0.5072169069677779,0,0,0,1,-0.5072169069677779,0.0
2354,10,195,38,80,67,1,1188.2,94,2249.616,LESS,1884,276,2160,1,2,-13.0,-1.218630998876834,13.0,0.6984302957695783,1.0506187608061843,-0.9856347988807768,147,80,67,0,-0.25928535726370594,0.0,-0.5072169069677779,-1.3560188608591341,1.994417702436648,1.994417702436648,-0.5072169069677779,0.0,1,0,1,1,0.0,-0.5072169069677779
2355,10,196,36,70,80,0,2188.882,100,1966.649,LESS,562,1340,1902,3,2,10.0,0.9374084606744876,10.0,0.17460757394239454,1.2564542731273958,-0.3111013964659528,150,70,80,1,-0.19945027481823535,-0.3901668515136753,0.0,-0.11623018807364008,0.3606637493198622,0.3606637493198622,0.0,-0.3901668515136753,1,1,1,1,-0.3901668515136753,0.0
2356,10,197,45,110,122,0,1153.027,64,3276.059,LESS,-914,1522,608,1,1,12.0,1.124890152809385,12.0,0.5238227218271837,0.02144119920012621,-1.0093439925738148,232,110,122,1,1.4360419786912946,1.170500554541026,1.6387007763574364,-1.3560188608591341,-1.4634064736758832,1.4634064736758832,1.6387007763574364,1.170500554541026,0,0,0,2,1.6387007763574364,1.170500554541026
2357,10,198,42,110,115,0,3372.397,14,2402.45,LESS,-478,2254,1776,5,1,5.0,0.4687042303372438,5.0,-0.6984302957695783,-1.6938547368099706,0.4866749198453033,225,110,115,1,1.2964267863185297,1.170500554541026,1.3655839802978638,1.123558484711854,-0.9245889823302565,0.9245889823302565,1.3655839802978638,1.170500554541026,0,1,0,2,1.3655839802978638,1.170500554541026
2358,10,199,41,110,112,1,2141.581,84,2520.01,LESS,3078,364,3442,1,2,2.0,0.18748169213489754,2.0,-1.222253017596762,0.7075595736041649,-0.34298575580051016,222,110,112,1,1.2365917038730592,1.170500554541026,1.248533924843761,-1.3560188608591341,3.4699867039657266,3.4699867039657266,1.248533924843761,1.170500554541026,1,0,1,2,1.248533924843761,1.170500554541026
2359,10,200,53,110,103,1,1306.07,94,1680.204,LESS,1564,262,1826,1,2,-7.0,-0.6561859224721414,7.0,-0.34921514788478913,1.0506187608061843,-0.9061817337285754,213,110,103,0,1.0570864565366473,1.170500554541026,0.8973837584814532,-1.3560188608591341,1.5989553234673806,1.5989553234673806,0.8973837584814532,1.170500554541026,1,0,1,2,1.170500554541026,0.8973837584814532
2360,10,201,3,50,53,1,1227.903,84,2300.4770000000008,MORE,1912,406,2318,1,2,3.0,0.28122253820234633,3.0,-1.0476454436543674,0.7075595736041649,-0.958872051398484,103,50,53,0,-1.1368665664639415,-1.170500554541026,-1.0534504990869233,-1.3560188608591341,2.029020660596459,2.029020660596459,-1.0534504990869233,-1.170500554541026,1,0,1,0,-1.170500554541026,-1.0534504990869233
2361,10,202,20,50,40,0,2017.013,100,1403.976,MORE,830,1006,1836,3,2,-10.0,-0.9374084606744876,10.0,0.17460757394239454,1.2564542731273958,-0.4269537664892304,90,50,40,1,-1.3961519237276474,-1.170500554541026,-1.5606674060547012,-0.11623018807364008,0.6918634917066236,0.6918634917066236,-1.5606674060547012,-1.170500554541026,1,0,1,0,-1.170500554541026,-1.5606674060547012
2362,10,203,25,80,88,1,2611.379,74,1032.497,MORE,736,1232,1968,2,2,8.0,0.7499267685395902,8.0,-0.17460757394239454,0.3645003864021456,-0.02630728712846516,168,80,88,0,0.1595602198545883,0.0,0.31213348121094026,-0.7361245244663871,0.5756964178844014,0.5756964178844014,0.31213348121094026,0.0,1,0,1,1,0.31213348121094026,0.0
2363,10,204,42,115,110,1,2512.763,4,2295.234,MORE,-1266,2178,912,3,1,-5.0,-0.4687042303372438,5.0,-0.6984302957695783,-2.0369139240119902,-0.09278173756580717,225,115,110,1,1.2964267863185297,1.3655839802978638,1.170500554541026,-0.11623018807364008,-1.8984150905420774,1.8984150905420774,1.170500554541026,1.3655839802978638,0,0,0,2,1.3655839802978638,1.170500554541026
2364,10,205,53,103,110,1,1766.796,74,1186.948,MORE,800,534,1334,2,2,7.0,0.6561859224721414,7.0,-0.34921514788478913,0.3645003864021456,-0.5956184615192499,213,103,110,0,1.0570864565366473,0.8973837584814532,1.170500554541026,-0.7361245244663871,0.6547888936782549,0.6547888936782549,1.170500554541026,0.8973837584814532,1,0,1,2,1.170500554541026,0.8973837584814532
2365,10,206,26,90,80,0,1995.841,94,1141.454,MORE,506,934,1440,1,2,-10.0,-0.9374084606744876,10.0,0.17460757394239454,1.0506187608061843,-0.4412252545303131,170,90,80,1,0.19945027481823535,0.3901668515136753,0.0,-1.3560188608591341,0.2914578330002405,0.2914578330002405,0.0,0.3901668515136753,1,0,1,1,0.3901668515136753,0.0
2366,10,207,35,80,72,0,1143.188,100,2460.065,MORE,1006,788,1794,2,2,-8.0,-0.7499267685395902,8.0,-0.17460757394239454,1.2564542731273958,-1.0159762035522868,152,80,72,1,-0.1595602198545883,0.0,-0.31213348121094026,-0.7361245244663871,0.9093678001397207,0.9093678001397207,-0.31213348121094026,0.0,1,0,1,1,0.0,-0.31213348121094026
2367,10,208,28,93,80,1,1491.604,0,1756.204,MORE,-908,1344,436,1,1,-13.0,-1.218630998876834,13.0,0.6984302957695783,-2.1741375988927976,-0.7811181468112209,173,93,80,1,0.25928535726370594,0.5072169069677779,0.0,-1.3560188608591341,-1.4559915540702095,1.4559915540702095,0.0,0.5072169069677779,0,0,0,1,0.5072169069677779,0.0
2368,10,209,26,80,90,1,2656.389,34,1994.52,MORE,484,980,1464,3,2,10.0,0.9374084606744876,10.0,0.17460757394239454,-1.007736362405932,0.004032769395676753,170,80,90,0,0.19945027481823535,0.0,0.3901668515136753,-0.11623018807364008,0.2642697944461033,0.2642697944461033,0.3901668515136753,0.0,0,0,1,1,0.3901668515136753,0.0
2369,10,210,25,88,80,0,1688.155,100,732.942,MORE,-216,1020,804,2,2,-8.0,-0.7499267685395902,8.0,-0.17460757394239454,1.2564542731273958,-0.6486282901154515,168,88,80,1,0.1595602198545883,0.31213348121094026,0.0,-0.7361245244663871,-0.600804159549169,0.600804159549169,0.0,0.31213348121094026,1,0,0,1,0.31213348121094026,0.0
2370,10,211,36,80,70,0,1190.659,94,2438.019,MORE,614,862,1476,1,2,-10.0,-0.9374084606744876,10.0,0.17460757394239454,1.0506187608061843,-0.983977251691422,150,80,70,1,-0.19945027481823535,0.0,-0.3901668515136753,-1.3560188608591341,0.4249263859023682,0.4249263859023682,-0.3901668515136753,0.0,1,0,1,1,0.0,-0.3901668515136753
2371,10,212,28,80,93,1,2803.53,54,1154.808,MORE,514,982,1496,4,2,13.0,1.218630998876834,13.0,0.6984302957695783,-0.3216179880018931,0.1032166453569908,173,80,93,0,0.25928535726370594,0.0,0.5072169069677779,0.503664148319107,0.30134439247447214,0.30134439247447214,0.5072169069677779,0.0,0,1,1,1,0.5072169069677779,0.0
2372,10,213,21,82,80,1,2437.721,44,2047.078,MORE,628,822,1450,4,2,-2.0,-0.18748169213489754,2.0,-1.222253017596762,-0.6646771752039125,-0.14336557497270885,162,82,80,1,0.03989005496364707,0.07803337030273506,0.0,0.503664148319107,0.4422278649822736,0.4422278649822736,0.0,0.07803337030273506,0,1,1,1,0.07803337030273506,0.0
2373,10,214,19,50,41,0,3223.498,34,1151.242,MORE,-530,1656,1126,4,1,-9.0,-0.8436676146070391,9.0,0.0,-1.007736362405932,0.38630602234723216,91,50,41,1,-1.376206896245824,-1.170500554541026,-1.5216507209033339,0.503664148319107,-0.9888516189127624,0.9888516189127624,-1.5216507209033339,-1.170500554541026,0,1,0,0,-1.170500554541026,-1.5216507209033339
2374,10,215,56,96,110,1,2559.688,94,2277.924,MORE,2312,1008,3320,4,2,14.0,1.3123718449442827,14.0,0.8730378697119728,1.0506187608061843,-0.06115082993649462,206,96,110,0,0.9174712641638826,0.6242669624218805,1.170500554541026,0.503664148319107,2.523348634308043,2.523348634308043,1.170500554541026,0.6242669624218805,1,1,1,2,1.170500554541026,0.6242669624218805
2375,10,216,23,80,85,1,3473.292,44,1301.227,MORE,482,1254,1736,5,2,5.0,0.4687042303372438,5.0,-0.6984302957695783,-0.6646771752039125,0.5546855842088511,165,80,85,0,0.09972513740911768,0.0,0.19508342575683765,1.123558484711854,0.2617981545775454,0.2617981545775454,0.19508342575683765,0.0,0,1,1,1,0.19508342575683765,0.0
2376,10,217,10,60,50,0,2095.43,34,1414.422,MORE,-332,1184,852,2,1,-10.0,-0.9374084606744876,10.0,0.17460757394239454,-1.007736362405932,-0.3740949303982812,110,60,50,1,-0.9972513740911768,-0.7803337030273506,-1.170500554541026,-0.7361245244663871,-0.7441592719255283,0.7441592719255283,-1.170500554541026,-0.7803337030273506,0,0,0,0,-0.7803337030273506,-1.170500554541026
2377,10,218,19,41,50,0,3955.994,14,1887.047,MORE,-656,2504,1848,6,1,9.0,0.8436676146070391,9.0,0.0,-1.6938547368099706,0.8800622997013257,91,41,50,0,-1.376206896245824,-1.5216507209033339,-1.170500554541026,1.743452821104601,-1.1445649306319114,1.1445649306319114,-1.170500554541026,-1.5216507209033339,0,1,0,0,-1.5216507209033339,-1.170500554541026
2378,10,219,56,110,96,1,3932.331,64,1389.207,MORE,514,1578,2092,6,2,-14.0,-1.3123718449442827,14.0,0.8730378697119728,0.02144119920012621,0.8641116941129949,206,110,96,1,0.9174712641638826,1.170500554541026,0.6242669624218805,1.743452821104601,0.30134439247447214,0.30134439247447214,0.6242669624218805,1.170500554541026,0,1,1,2,1.170500554541026,0.6242669624218805
2379,10,220,35,72,80,1,1386.995,94,831.197,MORE,974,474,1448,2,2,8.0,0.7499267685395902,8.0,-0.17460757394239454,1.0506187608061843,-0.8516323208377473,152,72,80,0,-0.1595602198545883,-0.31213348121094026,0.0,-0.7361245244663871,0.8698215622427939,0.8698215622427939,0.0,-0.31213348121094026,1,0,1,1,-0.31213348121094026,0.0
2380,10,221,11,49,50,0,2313.741,64,1118.255,MORE,-174,1082,908,3,2,1.0,0.09374084606744876,1.0,-1.3968605915391563,0.02144119920012621,-0.22693723033514154,99,49,50,0,-1.2166466763912356,-1.2095172396923934,-1.170500554541026,-0.11623018807364008,-0.5488997223094526,0.5488997223094526,-1.170500554541026,-1.2095172396923934,0,0,0,0,-1.2095172396923934,-1.170500554541026
2381,10,222,17,43,50,1,3087.358,74,1363.184,MORE,1640,990,2630,4,2,7.0,0.6561859224721414,7.0,-0.34921514788478913,0.3645003864021456,0.2945376309853869,93,43,50,0,-1.3363168412821769,-1.4436173506005987,-1.170500554541026,0.503664148319107,1.6928776384725817,1.6928776384725817,-1.170500554541026,-1.4436173506005987,1,1,1,0,-1.4436173506005987,-1.170500554541026
2382,10,223,1,51,50,0,2405.645,84,1133.452,MORE,502,1298,1800,3,2,-1.0,-0.09374084606744876,1.0,-1.3968605915391563,0.7075595736041649,-0.1649871624658964,101,51,50,1,-1.1767566214275886,-1.1314838693896585,-1.170500554541026,-0.11623018807364008,0.28651455326312464,0.28651455326312464,-1.170500554541026,-1.1314838693896585,1,0,1,0,-1.1314838693896585,-1.170500554541026
2383,10,224,41,112,110,1,5096.262,44,2452.001,MORE,1272,1390,2662,3,2,-2.0,-0.18748169213489754,2.0,-1.222253017596762,-0.6646771752039125,1.6486869513936178,222,112,110,1,1.2365917038730592,1.248533924843761,1.170500554541026,-0.11623018807364008,1.2380959026579241,1.2380959026579241,1.170500554541026,1.248533924843761,0,0,1,2,1.248533924843761,1.170500554541026
2384,10,225,20,40,50,1,4183.426,74,1546.207,MORE,1364,1666,3030,5,2,10.0,0.9374084606744876,10.0,0.17460757394239454,0.3645003864021456,1.0333682258377093,90,40,50,0,-1.3961519237276474,-1.5606674060547012,-1.170500554541026,1.123558484711854,1.3517913366115886,1.3517913366115886,-1.170500554541026,-1.5606674060547012,1,1,1,0,-1.5606674060547012,-1.170500554541026
2385,10,226,1,50,51,0,1491.33,84,1121.5410000000004,MORE,-52,1124,1072,2,2,1.0,0.09374084606744876,1.0,-1.3968605915391563,0.7075595736041649,-0.7813028430006815,101,50,51,0,-1.1767566214275886,-1.170500554541026,-1.1314838693896585,-0.7361245244663871,-0.39812969032741946,0.39812969032741946,-1.1314838693896585,-1.170500554541026,1,0,0,0,-1.170500554541026,-1.1314838693896585
2386,10,227,23,85,80,0,1781.244,100,1111.655,MORE,472,968,1440,3,2,-5.0,-0.4687042303372438,5.0,-0.6984302957695783,1.2564542731273958,-0.5858794449304742,165,85,80,1,0.09972513740911768,0.19508342575683765,0.0,-0.11623018807364008,0.2494399552347558,0.2494399552347558,0.0,0.19508342575683765,1,0,1,1,0.19508342575683765,0.0
2387,10,228,11,50,49,1,11001.154,24,1440.886,MORE,2046,3538,5584,13,1,-1.0,-0.09374084606744876,1.0,-1.3968605915391563,-1.3507955496079511,5.6290192564136685,99,50,49,1,-1.2166466763912356,-1.170500554541026,-1.2095172396923934,6.08271317585383,2.1946205317898397,2.1946205317898397,-1.2095172396923934,-1.170500554541026,0,1,1,0,-1.170500554541026,-1.2095172396923934
2388,10,229,17,50,43,0,5732.735,4,2101.386,MORE,-2198,4046,1848,6,1,-7.0,-0.6561859224721414,7.0,-0.34921514788478913,-2.0369139240119902,2.077716651373402,93,50,43,1,-1.3363168412821769,-1.170500554541026,-1.4436173506005987,1.743452821104601,-3.0501992692900686,3.0501992692900686,-1.4436173506005987,-1.170500554541026,0,1,0,0,-1.170500554541026,-1.4436173506005987
2389,10,230,21,80,82,0,4565.044,24,1769.465,MORE,-244,1948,1704,5,1,2.0,0.18748169213489754,2.0,-1.222253017596762,-1.3507955496079511,1.2906068770403292,162,80,82,0,0.03989005496364707,0.0,0.07803337030273506,1.123558484711854,-0.6354071177089797,0.6354071177089797,0.07803337030273506,0.0,0,1,0,1,0.07803337030273506,0.0
2390,10,231,10,50,60,1,1287.406,70,1367.783,MORE,724,390,1114,2,2,10.0,0.9374084606744876,10.0,0.17460757394239454,0.22727671152133785,-0.9187626449697792,110,50,60,0,-0.9972513740911768,-1.170500554541026,-0.7803337030273506,-0.7361245244663871,0.5608665786730538,0.5608665786730538,-0.7803337030273506,-1.170500554541026,1,0,1,0,-1.170500554541026,-0.7803337030273506
2391,10,232,3,53,50,0,1760.896,44,1505.808,MORE,-170,942,772,3,1,-3.0,-0.28122253820234633,3.0,-1.0476454436543674,-0.6646771752039125,-0.5995954962558071,103,53,50,1,-1.1368665664639415,-1.0534504990869233,-1.170500554541026,-0.11623018807364008,-0.5439564425723368,0.5439564425723368,-1.170500554541026,-1.0534504990869233,0,0,0,0,-1.0534504990869233,-1.170500554541026
2392,10,233,45,122,110,0,6325.959,34,1908.706,MORE,-956,2894,1938,5,1,-12.0,-1.124890152809385,12.0,0.5238227218271837,-1.007736362405932,2.477593338586854,232,122,110,1,1.4360419786912946,1.6387007763574364,1.170500554541026,1.123558484711854,-1.5153109109155996,1.5153109109155996,1.170500554541026,1.6387007763574364,0,1,0,2,1.6387007763574364,1.170500554541026
2393,10,234,38,67,80,1,3826.767,84,1903.734,MORE,1526,1336,2862,5,2,13.0,1.218630998876834,13.0,0.6984302957695783,0.7075595736041649,0.7929537797180936,147,67,80,0,-0.25928535726370594,-0.5072169069677779,0.0,1.123558484711854,1.5519941659647802,1.5519941659647802,0.0,-0.5072169069677779,1,1,1,1,-0.5072169069677779,0.0
2394,10,235,38,80,67,0,2005.404,94,1260.568,MORE,540,910,1450,3,2,-13.0,-1.218630998876834,13.0,0.6984302957695783,1.0506187608061843,-0.4347790878886697,147,80,67,1,-0.25928535726370594,0.0,-0.5072169069677779,-0.11623018807364008,0.33347571076572513,0.33347571076572513,-0.5072169069677779,0.0,1,0,1,1,0.0,-0.5072169069677779
2395,10,236,36,70,80,1,1723.4920000000004,100,1569.247,MORE,1452,636,2088,3,2,10.0,0.9374084606744876,10.0,0.17460757394239454,1.2564542731273958,-0.6248085483382106,150,70,80,0,-0.19945027481823535,-0.3901668515136753,0.0,-0.11623018807364008,1.4605434908281372,1.4605434908281372,0.0,-0.3901668515136753,1,0,1,1,-0.3901668515136753,0.0
2396,10,237,45,110,122,1,3657.047,44,2029.524,MORE,416,1538,1954,5,2,12.0,1.124890152809385,12.0,0.5238227218271837,-0.6646771752039125,0.6785499940420808,232,110,122,0,1.4360419786912946,1.170500554541026,1.6387007763574364,1.123558484711854,0.180234038915134,0.180234038915134,1.6387007763574364,1.170500554541026,0,1,0,2,1.6387007763574364,1.170500554541026
2397,10,238,42,110,115,0,8016.802,4,2193.68,MORE,-394,3490,3096,7,1,5.0,0.4687042303372438,5.0,-0.6984302957695783,-2.0369139240119902,3.617346108936764,225,110,115,0,1.2964267863185297,1.170500554541026,1.3655839802978638,2.363347157497348,-0.8207801078508239,0.8207801078508239,1.3655839802978638,1.170500554541026,0,1,0,2,1.3655839802978638,1.170500554541026
2398,10,239,41,110,112,0,2172.586,54,909.094,MORE,-348,1126,778,3,1,2.0,0.18748169213489754,2.0,-1.222253017596762,-0.3216179880018931,-0.3220861012230606,222,110,112,0,1.2365917038730592,1.170500554541026,1.248533924843761,-0.11623018807364008,-0.7639323908739917,0.7639323908739917,1.248533924843761,1.170500554541026,0,1,0,2,1.248533924843761,1.170500554541026
2399,10,240,53,110,103,0,1299.215,74,2356.527,MORE,1430,876,2306,2,2,-7.0,-0.6561859224721414,7.0,-0.34921514788478913,0.3645003864021456,-0.9108025088335074,213,110,103,1,1.0570864565366473,1.170500554541026,0.8973837584814532,-0.7361245244663871,1.433355452274,1.433355452274,0.8973837584814532,1.170500554541026,1,0,1,2,1.170500554541026,0.8973837584814532
2400,11,1,49,110,131,1,8564.741,70,2387.6620000000007,MORE,1340,3240,4580,5,1,21.0,1.9685577674164243,21.0,2.0952908873087353,0.5661570743407132,0.7220556609393607,241,110,131,0,1.6155472260277064,1.170500554541026,1.9898509427197442,0.762628202512403,1.0965394742297976,1.0965394742297976,1.9898509427197442,1.170500554541026,1,1,1,2,1.9898509427197442,1.170500554541026
2401,11,2,13,47,50,0,13211.21,40,2683.764,MORE,-2832,6398,3566,7,1,3.0,0.28122253820234633,3.0,-1.0476454436543674,-0.5355539892412153,1.842779655384281,97,47,50,0,-1.2565367313548828,-1.2875506099951286,-1.170500554541026,1.7466645928509879,-2.1627090333749512,2.1627090333749512,-1.170500554541026,-1.2875506099951286,0,1,0,0,-1.2875506099951286,-1.170500554541026
2402,11,3,16,50,44,1,3541.179,80,1877.262,MORE,802,1226,2028,2,2,-6.0,-0.5624450764046927,6.0,-0.5238227218271837,0.9333940955346892,-0.4896228138296981,94,50,44,1,-1.3163718138003533,-1.170500554541026,-1.4046006654492311,-0.713426382995474,0.6762432860487442,0.6762432860487442,-1.4046006654492311,-1.170500554541026,1,0,1,0,-1.170500554541026,-1.4046006654492311
2403,11,4,7,57,50,0,3412.393,70,2596.234,MORE,-198,2010,1812,4,2,-7.0,-0.6561859224721414,7.0,-0.34921514788478913,0.5661570743407132,-0.5206858770608492,107,57,50,1,-1.0570864565366473,-0.8973837584814532,-1.170500554541026,0.2706100073431107,-0.10497639458518411,0.10497639458518411,-1.170500554541026,-0.8973837584814532,1,1,0,0,-0.8973837584814532,-1.170500554541026
2404,11,5,18,42,50,1,4174.505,40,1060.438,MORE,-222,1856,1634,5,2,8.0,0.7499267685395902,8.0,-0.17460757394239454,-0.5355539892412153,-0.3368651725959303,92,42,50,0,-1.3562618687640005,-1.4826340357519663,-1.170500554541026,0.762628202512403,-0.1237256669203984,0.1237256669203984,-1.170500554541026,-1.4826340357519663,0,1,0,0,-1.4826340357519663,-1.170500554541026
2405,11,6,51,108,110,1,7675.66,30,1045.287,MORE,1314,2824,4138,7,1,2.0,0.18748169213489754,2.0,-1.222253017596762,-0.9027910104351916,0.5076101519506889,218,108,110,0,1.156811593945765,1.092467184238291,1.170500554541026,1.7466645928509879,1.0762277625333154,1.0762277625333154,1.170500554541026,1.092467184238291,0,1,1,2,1.170500554541026,1.092467184238291
2406,11,7,31,78,80,0,14244.499,60,4169.227,MORE,-952,6214,5262,9,2,2.0,0.18748169213489754,2.0,-1.222253017596762,0.198920053146737,2.092007999637949,158,78,80,0,-0.03989005496364707,-0.07803337030273506,0.0,2.7307009831895726,-0.694016033783166,0.694016033783166,0.0,-0.07803337030273506,0,1,0,1,-0.07803337030273506,0.0
2407,11,8,58,110,92,0,5214.058,70,2479.289,MORE,-1066,2144,1078,2,1,-18.0,-1.6873352292140782,18.0,1.571468165481551,0.5661570743407132,-0.08612595737740622,202,110,92,1,0.8376911542365885,1.170500554541026,0.4682002218164104,-0.713426382995474,-0.7830750773754338,0.7830750773754338,0.4682002218164104,1.170500554541026,1,0,0,2,1.170500554541026,0.4682002218164104
2408,11,9,12,50,48,0,6897.868,30,2542.375,MORE,-1286,3580,2294,6,1,-2.0,-0.18748169213489754,2.0,-1.222253017596762,-0.9027910104351916,0.3200074460922612,98,50,48,1,-1.2365917038730592,-1.170500554541026,-1.248533924843761,1.2546463976816955,-0.9549434071148981,0.9549434071148981,-1.248533924843761,-1.170500554541026,0,1,0,0,-1.170500554541026,-1.248533924843761
2409,11,10,54,110,101,0,1021.941,10,6089.425,MORE,-1738,2090,352,0,1,-9.0,-0.8436676146070391,9.0,0.0,-1.6372650528231438,-1.0972606726677605,211,110,101,1,1.0171964015730004,1.170500554541026,0.8193503881787182,-1.6974627733340588,-1.3080547027614335,1.3080547027614335,0.8193503881787182,1.170500554541026,0,0,0,2,1.170500554541026,0.8193503881787182
2410,11,11,14,46,50,0,13861.923,30,2470.007,MORE,1368,4980,6348,5,1,4.0,0.3749633842697951,4.0,-0.8730378697119728,-0.9027910104351916,1.9997310248214253,96,46,50,0,-1.2764817588367063,-1.3265672951464962,-1.170500554541026,0.762628202512403,1.1184136252875476,1.1184136252875476,-1.170500554541026,-1.3265672951464962,0,1,1,0,-1.3265672951464962,-1.170500554541026
2411,11,12,22,80,83,1,4414.5459999999985,90,5301.606,MORE,88,1826,1914,2,2,3.0,0.28122253820234633,3.0,-1.0476454436543674,1.3006311167286655,-0.27896750700286355,163,80,83,0,0.05983508244547061,0.0,0.1170500554541026,-0.713426382995474,0.11845243407611937,0.11845243407611937,0.1170500554541026,0.0,1,0,1,1,0.1170500554541026,0.0
2412,11,13,6,50,56,1,13654.764,20,3358.572,MORE,650,4636,5286,6,2,6.0,0.5624450764046927,6.0,-0.5238227218271837,-1.2700280316291677,1.949764466997577,106,50,56,0,-1.077031484018471,-1.170500554541026,-0.9364004436328208,1.2546463976816955,0.5574978945923871,0.5574978945923871,-0.9364004436328208,-1.170500554541026,0,1,1,0,-1.170500554541026,-0.9364004436328208
2413,11,14,13,50,47,1,3961.79,80,2250.048,MORE,1202,1322,2524,3,2,-3.0,-0.28122253820234633,3.0,-1.0476454436543674,0.9333940955346892,-0.3881718324441616,97,50,47,1,-1.2565367313548828,-1.170500554541026,-1.2875506099951286,-0.22140818782618166,0.9887311583023155,0.9887311583023155,-1.2875506099951286,-1.170500554541026,1,1,1,0,-1.170500554541026,-1.2875506099951286
2414,11,15,46,110,124,1,3624.73,80,1715.7420000000004,MORE,158,1376,1534,1,2,14.0,1.3123718449442827,14.0,0.8730378697119728,0.9333940955346892,-0.4694703904604972,234,110,124,0,1.4759320336549415,1.170500554541026,1.7167341466601715,-1.2054445781647665,0.17313781172049436,0.17313781172049436,1.7167341466601715,1.170500554541026,1,0,1,2,1.7167341466601715,1.170500554541026
2415,11,16,27,91,80,0,18057.753,0,735.2339999999998,MORE,-4638,9252,4614,7,1,-11.0,-1.0311493067419364,11.0,0.34921514788478913,-2.00450207401712,3.0117613122529847,171,91,80,1,0.21939530230005888,0.4291835366650429,0.0,1.7466645928509879,-3.5735917765998257,3.5735917765998257,0.0,0.4291835366650429,0,1,0,1,0.4291835366650429,0.0
2416,11,17,40,64,80,1,2921.995,30,2893.5170000000007,MORE,868,852,1720,2,2,16.0,1.4998535370791803,16.0,1.222253017596762,-0.9027910104351916,-0.6389694178372539,144,64,80,0,-0.3191204397091766,-0.6242669624218805,0.0,-0.713426382995474,0.7278037849705834,0.7278037849705834,0.0,-0.6242669624218805,0,0,1,1,-0.6242669624218805,0.0
2417,11,18,22,83,80,0,9394.374,60,4310.239000000001,MORE,1300,2278,3578,4,1,-3.0,-0.28122253820234633,3.0,-1.0476454436543674,0.198920053146737,0.9221623677060092,163,83,80,1,0.05983508244547061,0.1170500554541026,0.0,0.2706100073431107,1.0652906870044405,1.0652906870044405,0.0,0.1170500554541026,0,1,1,1,0.1170500554541026,0.0
2418,11,19,54,101,110,1,12000.368,80,1428.138,MORE,1604,3400,5004,4,2,9.0,0.8436676146070391,9.0,0.0,0.9333940955346892,1.5507256929276985,211,101,110,0,1.0171964015730004,0.8193503881787182,1.170500554541026,0.2706100073431107,1.3027814699171547,1.3027814699171547,1.170500554541026,0.8193503881787182,1,1,1,2,1.170500554541026,0.8193503881787182
2419,11,20,6,56,50,1,5792.883000000002,60,1460.286,MORE,-548,2772,2224,3,2,-6.0,-0.5624450764046927,6.0,-0.5238227218271837,0.198920053146737,0.053486093426028135,106,56,50,1,-1.077031484018471,-0.9364004436328208,-1.170500554541026,-0.22140818782618166,-0.378403282807059,0.378403282807059,-1.170500554541026,-0.9364004436328208,0,1,0,0,-0.9364004436328208,-1.170500554541026
2420,11,21,18,50,42,1,11095.371,60,4954.37,MORE,-366,2714,2348,2,2,-8.0,-0.7499267685395902,8.0,-0.17460757394239454,0.198920053146737,1.33244125956536,92,50,42,1,-1.3562618687640005,-1.170500554541026,-1.4826340357519663,-0.713426382995474,-0.23622130093168406,0.23622130093168406,-1.4826340357519663,-1.170500554541026,0,0,0,0,-1.170500554541026,-1.4826340357519663
2421,11,22,43,110,117,0,4784.801,70,2222.79,MORE,-1102,2512,1410,4,2,7.0,0.6561859224721414,7.0,-0.34921514788478913,0.5661570743407132,-0.1896623459088788,227,110,117,0,1.3363168412821769,1.170500554541026,1.4436173506005987,0.2706100073431107,-0.8111989858782552,0.8111989858782552,1.4436173506005987,1.170500554541026,1,1,0,2,1.4436173506005987,1.170500554541026
2422,11,23,32,77,80,1,1362.3629999999996,10,6231.609,MORE,-2626,2942,316,2,1,3.0,0.28122253820234633,3.0,-1.0476454436543674,-1.6372650528231438,-1.0151512033832504,157,77,80,0,-0.05983508244547061,-0.1170500554541026,0.0,-0.713426382995474,-2.001777779164362,2.001777779164362,0.0,-0.1170500554541026,0,0,0,1,-0.1170500554541026,0.0
2423,11,24,27,80,91,1,7178.638000000001,80,1675.616,MORE,2120,1556,3676,3,2,11.0,1.0311493067419364,11.0,0.34921514788478913,0.9333940955346892,0.38772890854478176,171,80,91,0,0.21939530230005888,0.0,0.4291835366650429,-0.22140818782618166,1.7058908251242617,1.7058908251242617,0.4291835366650429,0.0,1,0,1,1,0.4291835366650429,0.0
2424,11,25,16,44,50,0,6065.669,30,1694.489,MORE,-1232,1936,704,1,1,6.0,0.5624450764046927,6.0,-0.5238227218271837,-0.9027910104351916,0.11928182251593493,94,44,50,0,-1.3163718138003533,-1.4046006654492311,-1.170500554541026,-1.2054445781647665,-0.9127575443606659,0.9127575443606659,-1.170500554541026,-1.4046006654492311,0,0,0,0,-1.4046006654492311,-1.170500554541026
2425,11,26,7,50,57,1,8251.75,50,2188.525,MORE,86,2334,2420,3,2,7.0,0.6561859224721414,7.0,-0.34921514788478913,-0.16831696804723914,0.646562523301875,107,50,57,0,-1.0570864565366473,-1.170500554541026,-0.8973837584814532,-0.22140818782618166,0.11688999471485152,0.11688999471485152,-0.8973837584814532,-1.170500554541026,0,0,1,0,-1.170500554541026,-0.8973837584814532
2426,11,27,14,50,46,1,2260.1910000000007,30,8295.867,MORE,218,778,996,1,2,-4.0,-0.3749633842697951,4.0,-0.8730378697119728,-0.9027910104351916,-0.7985959261427275,96,50,46,1,-1.2764817588367063,-1.170500554541026,-1.3265672951464962,-1.2054445781647665,0.22001099255853004,0.22001099255853004,-1.3265672951464962,-1.170500554541026,0,0,1,0,-1.170500554541026,-1.3265672951464962
2427,11,28,51,110,108,1,5917.833000000001,80,1584.888,MORE,74,1560,1634,1,2,-2.0,-0.18748169213489754,2.0,-1.222253017596762,0.9333940955346892,0.08362391703055291,218,110,108,1,1.156811593945765,1.170500554541026,1.092467184238291,-1.2054445781647665,0.10751535854724438,0.10751535854724438,1.092467184238291,1.170500554541026,1,0,1,2,1.170500554541026,1.092467184238291
2428,11,29,50,133,110,0,3524.994,100,2471.063,MORE,-618,1694,1076,2,2,-23.0,-2.1560394595513217,23.0,2.444506035193524,1.6678681379226417,-0.4935266207527812,243,133,110,1,1.6554372809913533,2.0678843130224793,1.170500554541026,-0.713426382995474,-0.43308866045143396,0.43308866045143396,1.170500554541026,2.0678843130224793,1,0,0,2,2.0678843130224793,1.170500554541026
2429,11,30,49,131,110,0,16783.433,70,417.033,MORE,-448,4870,4422,6,1,-21.0,-1.9685577674164243,21.0,2.0952908873087353,0.5661570743407132,2.7043965153284706,241,131,110,1,1.6155472260277064,1.9898509427197442,1.170500554541026,1.2546463976816955,-0.30028131474366615,0.30028131474366615,1.170500554541026,1.9898509427197442,1,1,0,2,1.9898509427197442,1.170500554541026
2430,11,31,47,126,110,1,10903.898,30,2268.281,MORE,2996,1868,4864,2,2,-16.0,-1.4998535370791803,16.0,1.222253017596762,-0.9027910104351916,1.286258150329432,236,126,110,1,1.5158220886185887,1.7947675169629065,1.170500554541026,-0.713426382995474,2.390239265359583,2.390239265359583,1.170500554541026,1.7947675169629065,0,0,1,2,1.7947675169629065,1.170500554541026
2431,11,32,50,110,133,1,3587.717,70,3748.262,MORE,1132,550,1682,0,2,23.0,2.1560394595513217,23.0,2.444506035193524,0.5661570743407132,-0.4783978915815398,243,110,133,0,1.6554372809913533,1.170500554541026,2.0678843130224793,-1.6974627733340588,0.9340457806579405,0.9340457806579405,2.0678843130224793,1.170500554541026,1,0,1,2,2.0678843130224793,1.170500554541026
2432,11,33,47,110,126,1,7358.151999999999,70,2493.855,MORE,-108,1336,1228,1,2,16.0,1.4998535370791803,16.0,1.222253017596762,0.5661570743407132,0.4310275181209531,236,110,126,0,1.5158220886185887,1.170500554541026,1.7947675169629065,-1.2054445781647665,-0.034666623328130565,0.034666623328130565,1.7947675169629065,1.170500554541026,1,0,0,2,1.7947675169629065,1.170500554541026
2433,11,34,12,48,50,0,9287.089,10,7673.335999999998,MORE,-1470,3370,1900,3,1,2.0,0.18748169213489754,2.0,-1.222253017596762,-1.6372650528231438,0.8962853256458936,98,48,50,0,-1.2365917038730592,-1.248533924843761,-1.170500554541026,-0.22140818782618166,-1.0986878283515409,1.0986878283515409,-1.170500554541026,-1.248533924843761,0,1,0,0,-1.248533924843761,-1.170500554541026
2434,11,35,32,80,77,0,8693.901,50,4197.663,MORE,-904,1784,880,0,2,-3.0,-0.28122253820234633,3.0,-1.0476454436543674,-0.16831696804723914,0.7532089326221172,157,80,77,1,-0.05983508244547061,0.0,-0.1170500554541026,-1.6974627733340588,-0.6565174891127374,0.6565174891127374,-0.1170500554541026,0.0,0,0,0,1,0.0,-0.1170500554541026
2435,11,36,43,117,110,0,4052.565,60,5061.21,MORE,-558,1152,594,1,1,-7.0,-0.6561859224721414,7.0,-0.34921514788478913,0.198920053146737,-0.3662769870043798,227,117,110,1,1.3363168412821769,1.4436173506005987,1.170500554541026,-1.2054445781647665,-0.3862154796133983,0.3862154796133983,1.170500554541026,1.4436173506005987,0,0,0,2,1.4436173506005987,1.170500554541026
2436,11,37,40,80,64,0,6860.493,70,7891.607,MORE,-632,1790,1158,3,2,-16.0,-1.4998535370791803,16.0,1.222253017596762,0.5661570743407132,0.3109926309084347,144,80,64,1,-0.3191204397091766,0.0,-0.6242669624218805,-0.22140818782618166,-0.444025735980309,0.444025735980309,-0.6242669624218805,0.0,1,1,0,1,0.0,-0.6242669624218805
2437,11,38,31,80,78,0,9173.561,40,1191.787,MORE,-164,1912,1748,1,1,-2.0,-0.18748169213489754,2.0,-1.222253017596762,-0.5355539892412153,0.8689024778013598,158,80,78,1,-0.03989005496364707,0.0,-0.07803337030273506,-1.2054445781647665,-0.07841492544363055,0.07841492544363055,-0.07803337030273506,0.0,0,0,0,1,0.0,-0.07803337030273506
2438,11,39,46,124,110,0,15333.791,30,4962.628,MORE,-1660,4396,2736,5,2,-14.0,-1.3123718449442827,14.0,0.8730378697119728,-0.9027910104351916,2.3547442153227838,234,124,110,1,1.4759320336549415,1.7167341466601715,1.170500554541026,0.762628202512403,-1.2471195676719873,1.2471195676719873,1.170500554541026,1.7167341466601715,0,1,0,2,1.7167341466601715,1.170500554541026
2439,11,40,58,92,110,1,17237.613,80,4056.991,MORE,3712,2652,6364,3,2,18.0,1.6873352292140782,18.0,1.571468165481551,0.9333940955346892,2.8139443082432614,202,92,110,0,0.8376911542365885,0.4682002218164104,1.170500554541026,-0.22140818782618166,2.9495925566934753,2.9495925566934753,1.170500554541026,0.4682002218164104,1,0,1,2,1.170500554541026,0.4682002218164104
2440,11,41,49,110,131,0,7205.983,20,7028.549,LESS,-1280,3760,2480,4,2,21.0,1.9685577674164243,21.0,2.0952908873087353,-1.2700280316291677,0.3943244970719183,241,110,131,1,1.6155472260277064,1.170500554541026,1.9898509427197442,0.2706100073431107,-0.9502560890310945,0.9502560890310945,1.9898509427197442,1.170500554541026,0,1,0,2,1.9898509427197442,1.170500554541026
2441,11,42,13,47,50,0,19998.593,90,4289.138,LESS,1518,3478,4996,2,2,3.0,0.28122253820234633,3.0,-1.0476454436543674,1.3006311167286655,3.479890112289848,97,47,50,1,-1.2565367313548828,-1.2875506099951286,-1.170500554541026,-0.713426382995474,1.2355965773826367,1.2355965773826367,-1.170500554541026,-1.2875506099951286,1,0,1,0,-1.2875506099951286,-1.170500554541026
2442,11,43,16,50,44,1,7137.775,80,1310.405,LESS,1296,1612,2908,3,2,-6.0,-0.5624450764046927,6.0,-0.5238227218271837,0.9333940955346892,0.377872791010154,94,50,44,0,-1.3163718138003533,-1.170500554541026,-1.4046006654492311,-0.22140818782618166,1.0621658082819048,1.0621658082819048,-1.4046006654492311,-1.170500554541026,1,1,1,0,-1.170500554541026,-1.4046006654492311
2443,11,44,7,57,50,0,25257.305,50,2096.043,LESS,2406,4490,6896,8,1,-7.0,-0.6561859224721414,7.0,-0.34921514788478913,-0.16831696804723914,4.748286548008118,107,57,50,0,-1.0570864565366473,-0.8973837584814532,-1.170500554541026,2.23868278802028,1.929319653785565,1.929319653785565,-1.170500554541026,-0.8973837584814532,0,1,1,0,-0.8973837584814532,-1.170500554541026
2444,11,45,18,42,50,0,3362.208,80,1615.389,LESS,256,1792,2048,3,2,8.0,0.7499267685395902,8.0,-0.17460757394239454,0.9333940955346892,-0.5327904523116942,92,42,50,1,-1.3562618687640005,-1.4826340357519663,-1.170500554541026,-0.22140818782618166,0.24969734042261932,0.24969734042261932,-1.170500554541026,-1.4826340357519663,1,1,1,0,-1.4826340357519663,-1.170500554541026
2445,11,46,51,108,110,0,7017.678000000001,30,2633.782,LESS,-1510,3626,2116,3,2,2.0,0.18748169213489754,2.0,-1.222253017596762,-0.9027910104351916,0.3489055064848833,218,108,110,1,1.156811593945765,1.092467184238291,1.170500554541026,-0.22140818782618166,-1.129936615576898,1.129936615576898,1.170500554541026,1.092467184238291,0,0,0,2,1.170500554541026,1.092467184238291
2446,11,47,31,78,80,1,6164.984,70,1772.1229999999996,LESS,1512,1572,3084,3,2,2.0,0.18748169213489754,2.0,-1.222253017596762,0.5661570743407132,0.1432365080003959,158,78,80,1,-0.03989005496364707,-0.07803337030273506,0.0,-0.22140818782618166,1.2309092592988333,1.2309092592988333,0.0,-0.07803337030273506,1,0,1,1,-0.07803337030273506,0.0
2447,11,48,58,110,92,1,5119.36,80,2456.075,LESS,826,1936,2762,5,2,-18.0,-1.6873352292140782,18.0,1.571468165481551,0.9333940955346892,-0.1089670267627708,202,110,92,0,0.8376911542365885,1.170500554541026,0.4682002218164104,0.762628202512403,0.6949925583839585,0.6949925583839585,0.4682002218164104,1.170500554541026,1,1,1,2,1.170500554541026,0.4682002218164104
2448,11,49,12,50,48,0,2237.529,30,3666.12,LESS,-1438,2284,846,3,1,-2.0,-0.18748169213489754,2.0,-1.222253017596762,-0.9027910104351916,-0.8040619794322493,98,50,48,0,-1.2365917038730592,-1.170500554541026,-1.248533924843761,-0.22140818782618166,-1.073688798571255,1.073688798571255,-1.248533924843761,-1.170500554541026,0,0,0,0,-1.170500554541026,-1.248533924843761
2449,11,50,54,110,101,0,6762.066999999999,10,4217.248,LESS,-640,3588,2948,6,1,-9.0,-0.8436676146070391,9.0,0.0,-1.6372650528231438,0.2872523713958377,211,110,101,0,1.0171964015730004,1.170500554541026,0.8193503881787182,1.2546463976816955,-0.4502754934253804,0.4502754934253804,0.8193503881787182,1.170500554541026,0,1,0,2,1.170500554541026,0.8193503881787182
2450,11,51,14,46,50,0,2311.99,80,953.66,LESS,-860,1570,710,3,2,4.0,0.3749633842697951,4.0,-0.8730378697119728,0.9333940955346892,-0.7861020555953825,96,46,50,1,-1.2764817588367063,-1.3265672951464962,-1.170500554541026,-0.22140818782618166,-0.6221438231648446,0.6221438231648446,-1.170500554541026,-1.3265672951464962,1,0,0,0,-1.3265672951464962,-1.170500554541026
2451,11,52,22,80,83,0,5385.946,10,3190.429,LESS,-2438,4514,2076,6,1,3.0,0.28122253820234633,3.0,-1.0476454436543674,-1.6372650528231438,-0.04466673189733774,163,80,83,1,0.05983508244547061,0.0,0.1170500554541026,1.2546463976816955,-1.8549084792051833,1.8549084792051833,0.1170500554541026,0.0,0,1,0,1,0.1170500554541026,0.0
2452,11,53,6,50,56,0,5013.436,40,1821.039,LESS,-260,2262,2002,6,2,6.0,0.5624450764046927,6.0,-0.5238227218271837,-0.5355539892412153,-0.13451579689070745,106,50,56,1,-1.077031484018471,-1.170500554541026,-0.9364004436328208,1.2546463976816955,-0.15341201478448765,0.15341201478448765,-0.9364004436328208,-1.170500554541026,0,1,0,0,-1.170500554541026,-0.9364004436328208
2453,11,54,13,50,47,1,10141.241,20,2560.759,LESS,-2374,4310,1936,5,1,-3.0,-0.28122253820234633,3.0,-1.0476454436543674,-1.2700280316291677,1.1023059923722007,97,50,47,0,-1.2565367313548828,-1.170500554541026,-1.2875506099951286,0.762628202512403,-1.804910419644612,1.804910419644612,-1.2875506099951286,-1.170500554541026,0,1,0,0,-1.170500554541026,-1.2875506099951286
2454,11,55,46,110,124,0,1752.273,60,2010.709,LESS,-442,1160,718,2,2,14.0,1.3123718449442827,14.0,0.8730378697119728,0.198920053146737,-0.9211052745986142,234,110,124,1,1.4759320336549415,1.170500554541026,1.7167341466601715,-0.713426382995474,-0.29559399665986263,0.29559399665986263,1.7167341466601715,1.170500554541026,1,0,0,2,1.7167341466601715,1.170500554541026
2455,11,56,27,91,80,1,2370.396,80,1052.986,LESS,906,918,1824,3,2,-11.0,-1.0311493067419364,11.0,0.34921514788478913,0.9333940955346892,-0.7720145828026983,171,91,80,0,0.21939530230005888,0.4291835366650429,0.0,-0.22140818782618166,0.7574901328346727,0.7574901328346727,0.0,0.4291835366650429,1,1,1,1,0.4291835366650429,0.0
2456,11,57,40,64,80,0,2708.692,40,3833.568,LESS,-984,1842,858,2,2,16.0,1.4998535370791803,16.0,1.222253017596762,-0.5355539892412153,-0.6904179027377417,144,64,80,1,-0.3191204397091766,-0.6242669624218805,0.0,-0.713426382995474,-0.7190150635634517,0.7190150635634517,0.0,-0.6242669624218805,0,0,0,1,-0.6242669624218805,0.0
2457,11,58,22,83,80,1,10099.824,30,2769.094,LESS,236,4014,4250,9,2,-3.0,-0.28122253820234633,3.0,-1.0476454436543674,-0.9027910104351916,1.0923162505536446,163,83,80,0,0.05983508244547061,0.1170500554541026,0.0,2.7307009831895726,0.23407294680994076,0.23407294680994076,0.0,0.1170500554541026,0,1,1,1,0.1170500554541026,0.0
2458,11,59,54,101,110,0,4645.418,40,6505.392,LESS,-3380,4930,1550,6,1,9.0,0.8436676146070391,9.0,0.0,-0.5355539892412153,-0.22328139566853872,211,101,110,1,1.0171964015730004,0.8193503881787182,1.170500554541026,1.2546463976816955,-2.590817418362344,2.590817418362344,1.170500554541026,0.8193503881787182,0,1,0,2,1.170500554541026,0.8193503881787182
2459,11,60,6,56,50,1,12998.986,40,1729.8370000000002,LESS,-266,5390,5124,10,2,-6.0,-0.5624450764046927,6.0,-0.5238227218271837,-0.5355539892412153,1.7915914242786657,106,56,50,0,-1.077031484018471,-0.9364004436328208,-1.170500554541026,3.2227191783588647,-0.15809933286829123,0.15809933286829123,-1.170500554541026,-0.9364004436328208,0,1,0,0,-0.9364004436328208,-1.170500554541026
2460,11,61,18,50,42,0,5211.9540000000015,70,824.18,LESS,-720,2442,1722,5,1,-8.0,-0.7499267685395902,8.0,-0.17460757394239454,0.5661570743407132,-0.08663344021745324,92,50,42,0,-1.3562618687640005,-1.170500554541026,-1.4826340357519663,0.762628202512403,-0.5127730678760947,0.5127730678760947,-1.4826340357519663,-1.170500554541026,1,1,0,0,-1.170500554541026,-1.4826340357519663
2461,11,62,43,110,117,0,3743.349,90,1168.1660000000004,LESS,-246,1950,1704,4,2,7.0,0.6561859224721414,7.0,-0.34921514788478913,1.3006311167286655,-0.4408595981584153,227,110,117,1,1.3363168412821769,1.170500554541026,1.4436173506005987,0.2706100073431107,-0.14247493925561266,0.14247493925561266,1.4436173506005987,1.170500554541026,1,1,0,2,1.4436173506005987,1.170500554541026
2462,11,63,32,77,80,0,3109.717,70,2846.1620000000007,LESS,-996,2034,1038,4,1,3.0,0.28122253820234633,3.0,-1.0476454436543674,0.5661570743407132,-0.5936910463071329,157,77,80,1,-0.05983508244547061,-0.1170500554541026,0.0,0.2706100073431107,-0.7283896997310588,0.7283896997310588,0.0,-0.1170500554541026,1,1,0,1,-0.1170500554541026,0.0
2463,11,64,27,80,91,0,3173.591,100,1610.114,LESS,874,1542,2416,2,2,11.0,1.0311493067419364,11.0,0.34921514788478913,1.6678681379226417,-0.5782846970080899,171,80,91,1,0.21939530230005888,0.0,0.4291835366650429,-0.713426382995474,0.732491103054387,0.732491103054387,0.4291835366650429,0.0,1,0,1,1,0.4291835366650429,0.0
2464,11,65,16,44,50,0,1860.656,90,4834.995,LESS,1342,1358,2700,2,2,6.0,0.5624450764046927,6.0,-0.5238227218271837,1.3006311167286655,-0.8949633959613257,94,44,50,1,-1.3163718138003533,-1.4046006654492311,-1.170500554541026,-0.713426382995474,1.0981019135910655,1.0981019135910655,-1.170500554541026,-1.4046006654492311,1,0,1,0,-1.4046006654492311,-1.170500554541026
2465,11,66,7,50,57,0,2084.243,100,1197.066,LESS,158,1108,1266,2,2,7.0,0.6561859224721414,7.0,-0.34921514788478913,1.6678681379226417,-0.8410344198407583,107,50,57,1,-1.0570864565366473,-1.170500554541026,-0.8973837584814532,-0.713426382995474,0.17313781172049436,0.17313781172049436,-0.8973837584814532,-1.170500554541026,1,0,1,0,-1.170500554541026,-0.8973837584814532
2466,11,67,14,50,46,1,3787.501,10,3670.758,LESS,-798,2720,1922,5,1,-4.0,-0.3749633842697951,4.0,-0.8730378697119728,-1.6372650528231438,-0.4302101768876112,96,50,46,0,-1.2764817588367063,-1.170500554541026,-1.3265672951464962,0.762628202512403,-0.573708202965541,0.573708202965541,-1.3265672951464962,-1.170500554541026,0,1,0,0,-1.170500554541026,-1.3265672951464962
2467,11,68,51,110,108,0,6420.634,70,2398.31,LESS,1010,2872,3882,8,2,-2.0,-0.18748169213489754,2.0,-1.222253017596762,0.5661570743407132,0.20489904985311105,218,110,108,0,1.156811593945765,1.170500554541026,1.092467184238291,2.23868278802028,0.8387369796206012,0.8387369796206012,1.092467184238291,1.170500554541026,1,1,1,2,1.170500554541026,1.092467184238291
2468,11,69,50,133,110,1,4208.008,60,2758.338,LESS,488,1684,2172,5,2,-23.0,-2.1560394595513217,23.0,2.444506035193524,0.198920053146737,-0.32878428020519496,243,133,110,0,1.6554372809913533,2.0678843130224793,1.170500554541026,0.762628202512403,0.43094030632969066,0.43094030632969066,1.170500554541026,2.0678843130224793,1,1,1,2,2.0678843130224793,1.170500554541026
2469,11,70,49,131,110,1,2605.177,80,3670.807,LESS,2780,1130,3910,3,2,-21.0,-1.9685577674164243,21.0,2.0952908873087353,0.9333940955346892,-0.7153856243097496,241,131,110,0,1.6155472260277064,1.9898509427197442,1.170500554541026,-0.22140818782618166,2.221495814342654,2.221495814342654,1.170500554541026,1.9898509427197442,1,0,1,2,1.9898509427197442,1.170500554541026
2470,11,71,47,126,110,1,2968.402,90,2777.917,LESS,2424,936,3360,3,2,-16.0,-1.4998535370791803,16.0,1.222253017596762,1.3006311167286655,-0.6277760926670644,236,126,110,0,1.5158220886185887,1.7947675169629065,1.170500554541026,-0.22140818782618166,1.943381608036976,1.943381608036976,1.170500554541026,1.7947675169629065,1,0,1,2,1.7947675169629065,1.170500554541026
2471,11,72,50,110,133,0,1895.45,80,2906.006,LESS,1100,958,2058,2,2,23.0,2.1560394595513217,23.0,2.444506035193524,0.9333940955346892,-0.8865711155732038,243,110,133,1,1.6554372809913533,1.170500554541026,2.0678843130224793,-0.713426382995474,0.9090467508776547,0.9090467508776547,2.0678843130224793,1.170500554541026,1,0,1,2,2.0678843130224793,1.170500554541026
2472,11,73,47,110,126,0,1802.158,70,2110.862,LESS,-188,858,670,3,2,16.0,1.4998535370791803,16.0,1.222253017596762,0.5661570743407132,-0.9090730590683084,236,110,126,1,1.5158220886185887,1.170500554541026,1.7947675169629065,-0.22140818782618166,-0.09716419777884483,0.09716419777884483,1.7947675169629065,1.170500554541026,1,1,1,2,1.7947675169629065,1.170500554541026
2473,11,74,12,48,50,0,1937.962,40,1721.939,LESS,-266,1018,752,3,2,2.0,0.18748169213489754,2.0,-1.222253017596762,-0.5355539892412153,-0.8763172607746799,98,48,50,1,-1.2365917038730592,-1.248533924843761,-1.170500554541026,-0.22140818782618166,-0.15809933286829123,0.15809933286829123,-1.170500554541026,-1.248533924843761,0,1,0,0,-1.248533924843761,-1.170500554541026
2474,11,75,32,80,77,0,5061.215,60,3055.2990000000004,LESS,130,2418,2548,5,2,-3.0,-0.28122253820234633,3.0,-1.0476454436543674,0.198920053146737,-0.12299154659858574,157,80,77,0,-0.05983508244547061,0.0,-0.1170500554541026,0.762628202512403,0.15126366066274435,0.15126366066274435,-0.1170500554541026,0.0,0,1,1,1,0.0,-0.1170500554541026
2475,11,76,43,117,110,1,3229.7790000000005,30,3332.991,LESS,844,1286,2130,3,2,-7.0,-0.6561859224721414,7.0,-0.34921514788478913,-0.9027910104351916,-0.5647322037492579,227,117,110,0,1.3363168412821769,1.4436173506005987,1.170500554541026,-0.22140818782618166,0.7090545126353691,0.7090545126353691,1.170500554541026,1.4436173506005987,0,1,1,2,1.4436173506005987,1.170500554541026
2476,11,77,40,80,64,1,2795.056,70,1218.027,LESS,192,1090,1282,3,2,-16.0,-1.4998535370791803,16.0,1.222253017596762,0.5661570743407132,-0.6695869863889528,144,80,64,0,-0.3191204397091766,0.0,-0.6242669624218805,-0.22140818782618166,0.1996992808620479,0.1996992808620479,-0.6242669624218805,0.0,1,1,1,1,0.0,-0.6242669624218805
2477,11,78,31,80,78,0,1881.78,40,1824.618,LESS,-720,1200,480,2,1,-2.0,-0.18748169213489754,2.0,-1.222253017596762,-0.5355539892412153,-0.8898683068391009,158,80,78,0,-0.03989005496364707,0.0,-0.07803337030273506,-0.713426382995474,-0.5127730678760947,0.5127730678760947,-0.07803337030273506,0.0,0,0,0,1,0.0,-0.07803337030273506
2478,11,79,46,124,110,1,3240.899000000001,0,2378.246,LESS,70,1532,1602,4,2,-14.0,-1.3123718449442827,14.0,0.8730378697119728,-2.00450207401712,-0.562050070107943,234,124,110,0,1.4759320336549415,1.7167341466601715,1.170500554541026,0.2706100073431107,0.10439047982470867,0.10439047982470867,1.170500554541026,1.7167341466601715,0,1,1,2,1.7167341466601715,1.170500554541026
2479,11,80,58,92,110,0,4477.226,80,1926.274,LESS,-442,2544,2102,4,2,18.0,1.6873352292140782,18.0,1.571468165481551,0.9333940955346892,-0.26384914939156584,202,92,110,1,0.8376911542365885,0.4682002218164104,1.170500554541026,0.2706100073431107,-0.29559399665986263,0.29559399665986263,1.170500554541026,0.4682002218164104,1,1,0,2,1.170500554541026,0.4682002218164104
2480,11,81,48,128,110,0,4100.337,10,1699.149,MORE,-1578,3034,1456,4,1,-18.0,-1.6873352292140782,18.0,1.571468165481551,-1.6372650528231438,-0.3547544251057373,238,128,110,1,1.5557121435822359,1.8728008872656416,1.170500554541026,0.2706100073431107,-1.183059553860005,1.183059553860005,1.170500554541026,1.8728008872656416,0,1,0,2,1.8728008872656416,1.170500554541026
2481,11,82,8,50,58,1,4154.866,60,2754.7090000000007,MORE,522,1046,1568,3,2,8.0,0.7499267685395902,8.0,-0.17460757394239454,0.198920053146737,-0.34160208110148665,108,50,58,0,-1.0371414290548238,-1.170500554541026,-0.8583670733300858,-0.22140818782618166,0.45750177547124427,0.45750177547124427,-0.8583670733300858,-1.170500554541026,0,1,1,0,-1.170500554541026,-0.8583670733300858
2482,11,83,4,54,50,0,3758.666,30,2400.604,MORE,-714,2090,1376,4,1,-4.0,-0.3749633842697951,4.0,-0.8730378697119728,-0.9027910104351916,-0.4371651520267586,104,54,50,1,-1.116921538982118,-1.0144338139355558,-1.170500554541026,0.2706100073431107,-0.508085749792291,0.508085749792291,-1.170500554541026,-1.0144338139355558,0,1,0,0,-1.0144338139355558,-1.170500554541026
2483,11,84,37,80,69,0,7170.361999999999,50,565.841,MORE,-408,3204,2796,8,1,-11.0,-1.0311493067419364,11.0,0.34921514788478913,-0.16831696804723914,0.3857327450541767,149,80,69,1,-0.21939530230005888,0.0,-0.4291835366650429,2.23868278802028,-0.26903252751830903,0.26903252751830903,-0.4291835366650429,0.0,0,1,0,1,0.0,-0.4291835366650429
2484,11,85,52,105,110,1,13068.882,70,2181.0,MORE,3026,3650,6676,8,2,5.0,0.4687042303372438,5.0,-0.6984302957695783,0.5661570743407132,1.808450274367996,215,105,110,0,1.0969765115002945,0.9754171287841883,1.170500554541026,2.23868278802028,2.4136758557786004,2.4136758557786004,1.170500554541026,0.9754171287841883,1,1,1,2,1.170500554541026,0.9754171287841883
2485,11,86,5,55,50,1,7234.3319999999985,90,1439.0770000000002,MORE,2012,2500,4512,7,2,-5.0,-0.4687042303372438,5.0,-0.6984302957695783,1.3006311167286655,0.401162249463792,105,55,50,1,-1.0969765115002945,-0.9754171287841883,-1.170500554541026,1.7466645928509879,1.6215190996157973,1.6215190996157973,-1.170500554541026,-0.9754171287841883,1,1,1,0,-0.9754171287841883,-1.170500554541026
2486,11,87,30,96,80,0,3331.992,90,1894.732,MORE,816,1842,2658,5,2,-16.0,-1.4998535370791803,16.0,1.222253017596762,1.3006311167286655,-0.5400785233643898,176,96,80,1,0.3191204397091766,0.6242669624218805,0.0,0.762628202512403,0.6871803615776192,0.6871803615776192,0.0,0.6242669624218805,1,1,1,1,0.6242669624218805,0.0
2487,11,88,33,80,75,0,9521.081,80,6096.007,MORE,5668,3288,8956,7,2,-5.0,-0.4687042303372438,5.0,-0.6984302957695783,0.9333940955346892,0.9527239780738246,155,80,75,1,-0.09972513740911768,0.0,-0.19508342575683765,1.7466645928509879,4.477658252013439,4.477658252013439,-0.19508342575683765,0.0,1,1,1,1,0.0,-0.19508342575683765
2488,11,89,48,110,128,1,5705.359,80,2354.408,MORE,750,2778,3528,2,2,18.0,1.6873352292140782,18.0,1.571468165481551,0.9333940955346892,0.032375386157821116,238,110,128,0,1.5557121435822359,1.170500554541026,1.8728008872656416,-0.713426382995474,0.6356198626557799,0.6356198626557799,1.8728008872656416,1.170500554541026,1,0,1,2,1.8728008872656416,1.170500554541026
2489,11,90,9,59,50,0,3063.55,40,1709.659,MORE,-564,1558,994,4,1,-9.0,-0.8436676146070391,9.0,0.0,-0.5355539892412153,-0.6048264837008912,109,59,50,1,-1.0171964015730004,-0.8193503881787182,-1.170500554541026,0.2706100073431107,-0.3909027976972019,0.3909027976972019,-1.170500554541026,-0.8193503881787182,0,1,0,0,-0.8193503881787182,-1.170500554541026
2490,11,91,44,110,119,1,2528.952,0,1852.366,MORE,-950,2310,1360,3,1,9.0,0.8436676146070391,9.0,0.0,-2.00450207401712,-0.7337710233033863,229,110,119,0,1.376206896245824,1.170500554541026,1.5216507209033339,-0.22140818782618166,-0.6924535944218981,0.6924535944218981,1.5216507209033339,1.170500554541026,0,1,0,2,1.5216507209033339,1.170500554541026
2491,11,92,2,52,50,1,4839.29,70,1823.604,MORE,984,1720,2704,5,2,-2.0,-0.18748169213489754,2.0,-1.222253017596762,0.5661570743407132,-0.17651964986736668,102,52,50,1,-1.156811593945765,-1.092467184238291,-1.170500554541026,0.762628202512403,0.8184252679241191,0.8184252679241191,-1.170500554541026,-1.092467184238291,1,1,1,0,-1.092467184238291,-1.170500554541026
2492,11,93,8,58,50,0,3404.93,80,2023.691,MORE,406,2148,2554,5,2,-8.0,-0.7499267685395902,8.0,-0.17460757394239454,0.9333940955346892,-0.5224859457087929,108,58,50,1,-1.0371414290548238,-0.8583670733300858,-1.170500554541026,0.762628202512403,0.36688029251770854,0.36688029251770854,-1.170500554541026,-0.8583670733300858,1,1,1,0,-0.8583670733300858,-1.170500554541026
2493,11,94,44,119,110,0,4739.4079999999985,60,1927.706,MORE,236,2314,2550,6,2,-9.0,-0.8436676146070391,9.0,0.0,0.198920053146737,-0.20061109522364676,229,119,110,1,1.376206896245824,1.5216507209033339,1.170500554541026,1.2546463976816955,0.23407294680994076,0.23407294680994076,1.170500554541026,1.5216507209033339,1,1,1,2,1.5216507209033339,1.170500554541026
2494,11,95,34,74,80,1,4685.584,70,2096.584,MORE,2312,1134,3446,3,2,6.0,0.5624450764046927,6.0,-0.5238227218271837,0.5661570743407132,-0.2135933938846304,154,74,80,0,-0.11967016489094122,-0.2341001109082052,0.0,-0.22140818782618166,1.8558850038059758,1.8558850038059758,0.0,-0.2341001109082052,1,1,1,1,-0.2341001109082052,0.0
2495,11,96,24,86,80,0,3521.992,100,1646.685,MORE,846,1586,2432,5,2,-6.0,-0.5624450764046927,6.0,-0.5238227218271837,1.6678681379226417,-0.4942507003563089,166,86,80,1,0.11967016489094122,0.2341001109082052,0.0,0.762628202512403,0.710616951996637,0.710616951996637,0.0,0.2341001109082052,1,1,1,1,0.2341001109082052,0.0
2496,11,97,39,66,80,0,5351.809,20,3141.7140000000004,MORE,-3314,5234,1920,5,1,14.0,1.3123718449442827,14.0,0.8730378697119728,-1.2700280316291677,-0.05290054449747904,146,66,80,0,-0.2792303847455295,-0.5462335921191455,0.0,0.762628202512403,-2.5392569194405046,2.5392569194405046,0.0,-0.5462335921191455,0,1,0,1,-0.5462335921191455,0.0
2497,11,98,9,50,59,1,4520.589,0,1418.4129999999998,MORE,-552,2532,1980,6,1,9.0,0.8436676146070391,9.0,0.0,-2.00450207401712,-0.2533900341857794,109,50,59,0,-1.0171964015730004,-1.170500554541026,-0.8193503881787182,1.2546463976816955,-0.38152816152959473,0.38152816152959473,-0.8193503881787182,-1.170500554541026,0,1,0,0,-1.170500554541026,-0.8193503881787182
2498,11,99,57,94,110,1,3687.303,30,1587.581,MORE,-160,1534,1374,3,2,16.0,1.4998535370791803,16.0,1.222253017596762,-0.9027910104351916,-0.4543778411495254,204,94,110,0,0.8775812092002355,0.5462335921191455,1.170500554541026,-0.22140818782618166,-0.07529004672109484,0.07529004672109484,1.170500554541026,0.5462335921191455,0,1,0,2,1.170500554541026,0.5462335921191455
2499,11,100,60,110,87,0,7342.482,20,3543.0840000000007,MORE,570,2900,3470,4,1,-23.0,-2.1560394595513217,23.0,2.444506035193524,-1.2700280316291677,0.42724792871812894,197,110,87,1,0.7379660168274708,1.170500554541026,0.27311679605957273,0.2706100073431107,0.4950003201416728,0.4950003201416728,0.27311679605957273,1.170500554541026,0,1,1,2,1.170500554541026,0.27311679605957273
2500,11,101,33,75,80,1,4831.263,80,5305.735,MORE,2054,1602,3656,5,2,5.0,0.4687042303372438,5.0,-0.6984302957695783,0.9333940955346892,-0.17845575478992387,155,75,80,0,-0.09972513740911768,-0.19508342575683765,0.0,0.762628202512403,1.6543303262024223,1.6543303262024223,0.0,-0.19508342575683765,1,1,1,1,-0.19508342575683765,0.0
2501,11,102,15,50,45,1,11852.555,0,4447.569,MORE,-2438,6508,4070,5,1,-5.0,-0.4687042303372438,5.0,-0.6984302957695783,-2.00450207401712,1.5150733350208907,95,50,45,1,-1.2964267863185297,-1.170500554541026,-1.3655839802978638,0.762628202512403,-1.8549084792051833,1.8549084792051833,-1.3655839802978638,-1.170500554541026,0,1,0,0,-1.170500554541026,-1.3655839802978638
2502,11,103,59,89,110,1,14659.758,60,2919.795,MORE,-190,4500,4310,6,2,21.0,1.9685577674164243,21.0,2.0952908873087353,0.198920053146737,2.1921680836090687,199,89,110,0,0.7778560717911179,0.3511501663623078,1.170500554541026,1.2546463976816955,-0.09872663714011269,0.09872663714011269,1.170500554541026,0.3511501663623078,0,1,0,2,1.170500554541026,0.3511501663623078
2503,11,104,29,80,94,1,3897.805,70,922.024,MORE,548,1328,1876,3,2,14.0,1.3123718449442827,14.0,0.8730378697119728,0.5661570743407132,-0.4036049548398041,174,80,94,0,0.2792303847455295,0.0,0.5462335921191455,-0.22140818782618166,0.47781348716772637,0.47781348716772637,0.5462335921191455,0.0,1,1,1,1,0.5462335921191455,0.0
2504,11,105,55,110,98,1,3527.5640000000008,70,1732.616,MORE,198,1400,1598,3,1,-12.0,-1.124890152809385,12.0,0.5238227218271837,0.5661570743407132,-0.4929067391468296,208,110,98,1,0.9573613191275298,1.170500554541026,0.7023003327246156,-0.22140818782618166,0.20438659894585148,0.20438659894585148,0.7023003327246156,1.170500554541026,1,0,1,2,1.170500554541026,0.7023003327246156
2505,11,106,29,94,80,0,2773.033,60,2700.617,MORE,-1230,1818,588,2,1,-14.0,-1.3123718449442827,14.0,0.8730378697119728,0.198920053146737,-0.6748989134737263,174,94,80,1,0.2792303847455295,0.5462335921191455,0.0,-0.713426382995474,-0.911195104999398,0.911195104999398,0.0,0.5462335921191455,0,0,0,1,0.5462335921191455,0.0
2506,11,107,57,110,94,0,2300.7,60,1453.689,MORE,-840,1402,562,2,1,-16.0,-1.4998535370791803,16.0,1.222253017596762,0.198920053146737,-0.7888251930783363,204,110,94,1,0.8775812092002355,1.170500554541026,0.5462335921191455,-0.713426382995474,-0.6065194295521661,0.6065194295521661,0.5462335921191455,1.170500554541026,0,0,0,2,1.170500554541026,0.5462335921191455
2507,11,108,39,80,66,0,14388.758,60,2616.549,MORE,566,3860,4426,5,2,-14.0,-1.3123718449442827,14.0,0.8730378697119728,0.198920053146737,2.1268031360554374,146,80,66,1,-0.2792303847455295,0.0,-0.5462335921191455,0.762628202512403,0.4918754414191371,0.4918754414191371,-0.5462335921191455,0.0,0,1,1,1,0.0,-0.5462335921191455
2508,11,109,4,50,54,1,2212.062,40,3403.055,MORE,46,752,798,1,1,4.0,0.3749633842697951,4.0,-0.8730378697119728,-0.5355539892412153,-0.8102045961088115,104,50,54,0,-1.116921538982118,-1.170500554541026,-1.0144338139355558,-1.2054445781647665,0.08564120748949439,0.08564120748949439,-1.0144338139355558,-1.170500554541026,0,0,0,0,-1.170500554541026,-1.0144338139355558
2509,11,110,55,98,110,1,2736.71,60,1357.4,MORE,164,1132,1296,3,2,12.0,1.124890152809385,12.0,0.5238227218271837,0.198920053146737,-0.6836599872375291,208,98,110,0,0.9573613191275298,0.7023003327246156,1.170500554541026,-0.22140818782618166,0.17782512980429793,0.17782512980429793,1.170500554541026,0.7023003327246156,1,0,1,2,1.170500554541026,0.7023003327246156
2510,11,111,2,50,52,1,23605.39,70,1476.935,MORE,-572,5726,5154,7,2,2.0,0.18748169213489754,2.0,-1.222253017596762,0.5661570743407132,4.3498461888270965,102,50,52,0,-1.156811593945765,-1.170500554541026,-1.092467184238291,1.7466645928509879,-0.39715255514227327,0.39715255514227327,-1.092467184238291,-1.170500554541026,1,1,0,0,-1.170500554541026,-1.092467184238291
2511,11,112,59,110,89,0,2208.33,80,2372.64,MORE,212,1580,1792,2,2,-21.0,-1.9685577674164243,21.0,2.0952908873087353,0.9333940955346892,-0.8111047510323176,199,110,89,1,0.7778560717911179,1.170500554541026,0.3511501663623078,-0.713426382995474,0.21532367447472647,0.21532367447472647,0.3511501663623078,1.170500554541026,1,0,1,2,1.170500554541026,0.3511501663623078
2512,11,113,60,87,110,1,3031.786,100,1961.076,MORE,1498,1010,2508,2,2,23.0,2.1560394595513217,23.0,2.444506035193524,1.6678681379226417,-0.6124879309115685,197,87,110,0,0.7379660168274708,0.27311679605957273,1.170500554541026,-0.713426382995474,1.2199721837699582,1.2199721837699582,1.170500554541026,0.27311679605957273,1,0,1,2,1.170500554541026,0.27311679605957273
2513,11,114,52,110,105,0,2181.58,70,1996.841,MORE,-310,1362,1052,2,2,-5.0,-0.4687042303372438,5.0,-0.6984302957695783,0.5661570743407132,-0.8175568261137184,215,110,105,1,1.0969765115002945,1.170500554541026,0.9754171287841883,-0.713426382995474,-0.19247299881618407,0.19247299881618407,0.9754171287841883,1.170500554541026,1,0,0,2,1.170500554541026,0.9754171287841883
2514,11,115,30,80,96,1,2422.26,70,3498.9440000000004,MORE,1682,900,2582,1,2,16.0,1.4998535370791803,16.0,1.222253017596762,0.5661570743407132,-0.7595050343159029,176,80,96,0,0.3191204397091766,0.0,0.6242669624218805,-1.2054445781647665,1.363716605006601,1.363716605006601,0.6242669624218805,0.0,1,0,1,1,0.6242669624218805,0.0
2515,11,116,24,80,86,0,5657.024,70,1515.515,MORE,8,1878,1886,5,2,6.0,0.5624450764046927,6.0,-0.5238227218271837,0.5661570743407132,0.02071702918363378,166,80,86,0,0.11967016489094122,0.0,0.2341001109082052,0.762628202512403,0.05595485962540511,0.05595485962540511,0.2341001109082052,0.0,1,1,0,1,0.2341001109082052,0.0
2516,11,117,5,50,55,1,1928.941,30,4522.567,MORE,958,1010,1968,1,2,5.0,0.4687042303372438,5.0,-0.6984302957695783,-0.9027910104351916,-0.8784931175712899,105,50,55,0,-1.0969765115002945,-1.170500554541026,-0.9754171287841883,-1.2054445781647665,0.7981135562276369,0.7981135562276369,-0.9754171287841883,-1.170500554541026,0,0,1,0,-1.170500554541026,-0.9754171287841883
2517,11,118,34,80,74,1,5892.906,60,3627.184,MORE,1562,1538,3100,4,2,-6.0,-0.5624450764046927,6.0,-0.5238227218271837,0.198920053146737,0.07761154785096079,154,80,74,1,-0.11967016489094122,0.0,-0.2341001109082052,0.2706100073431107,1.2699702433305295,1.2699702433305295,-0.2341001109082052,0.0,0,1,1,1,0.0,-0.2341001109082052
2518,11,119,15,45,50,1,3976.784,20,7303.232,MORE,580,1330,1910,4,2,5.0,0.4687042303372438,5.0,-0.6984302957695783,-1.2700280316291677,-0.3845552936116186,95,45,50,0,-1.2964267863185297,-1.3655839802978638,-1.170500554541026,0.2706100073431107,0.5028125169480121,0.5028125169480121,-1.170500554541026,-1.3655839802978638,0,1,1,0,-1.3655839802978638,-1.170500554541026
2519,11,120,37,69,80,1,2766.983,10,773.707,MORE,40,1304,1344,3,1,11.0,1.0311493067419364,11.0,0.34921514788478913,-1.6372650528231438,-0.6763581678379309,149,69,80,0,-0.21939530230005888,-0.4291835366650429,0.0,-0.22140818782618166,0.08095388940569082,0.08095388940569082,0.0,-0.4291835366650429,0,0,0,1,-0.4291835366650429,0.0
2520,11,121,48,128,110,1,2687.762,40,2912.947,LESS,892,1054,1946,3,2,-18.0,-1.6873352292140782,18.0,1.571468165481551,-0.5355539892412153,-0.6954661992406845,238,128,110,0,1.5557121435822359,1.8728008872656416,1.170500554541026,-0.22140818782618166,0.7465530573057977,0.7465530573057977,1.170500554541026,1.8728008872656416,0,1,1,2,1.8728008872656416,1.170500554541026
2521,11,122,8,50,58,0,2689.618,70,2372.179,LESS,-1448,1908,460,2,1,8.0,0.7499267685395902,8.0,-0.17460757394239454,0.5661570743407132,-0.6950185337696162,108,50,58,1,-1.0371414290548238,-1.170500554541026,-0.8583670733300858,-0.713426382995474,-1.0815009953775945,1.0815009953775945,-0.8583670733300858,-1.170500554541026,1,0,0,0,-1.170500554541026,-0.8583670733300858
2522,11,123,4,54,50,0,1769.454,60,2274.196,LESS,-930,1422,492,2,1,-4.0,-0.3749633842697951,4.0,-0.8730378697119728,0.198920053146737,-0.9169612334033416,104,54,50,0,-1.116921538982118,-1.0144338139355558,-1.170500554541026,-0.713426382995474,-0.6768292008092196,0.6768292008092196,-1.170500554541026,-1.0144338139355558,1,0,0,0,-1.0144338139355558,-1.170500554541026
2523,11,124,37,80,69,0,4536.286,30,1549.974,LESS,-1852,2514,662,1,1,-11.0,-1.0311493067419364,11.0,0.34921514788478913,-0.9027910104351916,-0.2496039324081065,149,80,69,0,-0.21939530230005888,0.0,-0.4291835366650429,-1.2054445781647665,-1.3971137463537016,1.3971137463537016,-0.4291835366650429,0.0,0,0,0,1,0.0,-0.4291835366650429
2524,11,125,52,105,110,1,2743.343,80,1846.331,LESS,1756,1066,2822,3,2,5.0,0.4687042303372438,5.0,-0.6984302957695783,0.9333940955346892,-0.6820601138164102,215,105,110,1,1.0969765115002945,0.9754171287841883,1.170500554541026,-0.22140818782618166,1.4215268613735117,1.4215268613735117,1.170500554541026,0.9754171287841883,1,1,1,2,1.170500554541026,0.9754171287841883
2525,11,126,5,55,50,1,2843.907,60,8105.4180000000015,LESS,1546,1064,2610,3,2,-5.0,-0.4687042303372438,5.0,-0.6984302957695783,0.198920053146737,-0.6578041706954382,105,55,50,0,-1.0969765115002945,-0.9754171287841883,-1.170500554541026,-0.22140818782618166,1.2574707284403868,1.2574707284403868,-1.170500554541026,-0.9754171287841883,0,1,1,0,-0.9754171287841883,-1.170500554541026
2526,11,127,30,96,80,1,7210.607,70,4481.54,LESS,1912,1328,3240,1,2,-16.0,-1.4998535370791803,16.0,1.222253017596762,0.5661570743407132,0.3954398015644939,176,96,80,0,0.3191204397091766,0.6242669624218805,0.0,-1.2054445781647665,1.5433971315524044,1.5433971315524044,0.0,0.6242669624218805,1,0,1,1,0.6242669624218805,0.0
2527,11,128,33,80,75,1,8377.961,70,1609.999,LESS,2056,2460,4516,8,2,-5.0,-0.4687042303372438,5.0,-0.6984302957695783,0.5661570743407132,0.6770044989317323,155,80,75,0,-0.09972513740911768,0.0,-0.19508342575683765,2.23868278802028,1.6558927655636901,1.6558927655636901,-0.19508342575683765,0.0,1,1,1,1,0.0,-0.19508342575683765
2528,11,129,48,110,128,0,3886.863,80,1355.537,LESS,-224,1734,1510,2,2,18.0,1.6873352292140782,18.0,1.571468165481551,0.9333940955346892,-0.4062441550469326,238,110,128,1,1.5557121435822359,1.170500554541026,1.8728008872656416,-0.713426382995474,-0.12528810628166626,0.12528810628166626,1.8728008872656416,1.170500554541026,1,0,1,2,1.8728008872656416,1.170500554541026
2529,11,130,9,59,50,0,1763.849,20,1423.8529999999996,LESS,-1340,1766,426,2,1,-9.0,-0.8436676146070391,9.0,0.0,-1.2700280316291677,-0.9183131541820798,109,59,50,0,-1.0171964015730004,-0.8193503881787182,-1.170500554541026,-0.713426382995474,-0.9971292698691302,0.9971292698691302,-1.170500554541026,-0.8193503881787182,0,0,0,0,-0.8193503881787182,-1.170500554541026
2530,11,131,44,110,119,1,7303.895,20,1511.428,LESS,54,3196,3250,6,1,9.0,0.8436676146070391,9.0,0.0,-1.2700280316291677,0.4179407802633248,229,110,119,1,1.376206896245824,1.170500554541026,1.5216507209033339,1.2546463976816955,0.0918909649345658,0.0918909649345658,1.5216507209033339,1.170500554541026,0,1,1,2,1.5216507209033339,1.170500554541026
2531,11,132,2,52,50,1,3534.082000000001,80,1310.214,LESS,924,1512,2436,5,2,-2.0,-0.18748169213489754,2.0,-1.222253017596762,0.9333940955346892,-0.491334603618584,102,52,50,0,-1.156811593945765,-1.092467184238291,-1.170500554541026,0.762628202512403,0.7715520870860834,0.7715520870860834,-1.170500554541026,-1.092467184238291,1,1,1,0,-1.092467184238291,-1.170500554541026
2532,11,133,8,58,50,1,2148.839,60,1794.216,LESS,314,896,1210,3,2,-8.0,-0.7499267685395902,8.0,-0.17460757394239454,0.198920053146737,-0.8254539248142846,108,58,50,0,-1.0371414290548238,-0.8583670733300858,-1.170500554541026,-0.22140818782618166,0.29500808189938715,0.29500808189938715,-1.170500554541026,-0.8583670733300858,0,1,1,0,-0.8583670733300858,-1.170500554541026
2533,11,134,44,119,110,1,2791.337,80,887.5419999999998,LESS,436,1152,1588,3,2,-9.0,-0.8436676146070391,9.0,0.0,0.9333940955346892,-0.6704840057245689,229,119,110,0,1.376206896245824,1.5216507209033339,1.170500554541026,-0.22140818782618166,0.3903168829367264,0.3903168829367264,1.170500554541026,1.5216507209033339,1,0,1,2,1.5216507209033339,1.170500554541026
2534,11,135,34,74,80,0,2028.795,10,3734.974,LESS,-270,1448,1178,2,2,6.0,0.5624450764046927,6.0,-0.5238227218271837,-1.6372650528231438,-0.8544084257889271,154,74,80,1,-0.11967016489094122,-0.2341001109082052,0.0,-0.713426382995474,-0.16122421159082695,0.16122421159082695,0.0,-0.2341001109082052,0,0,0,1,-0.2341001109082052,0.0
2535,11,136,24,86,80,1,3088.72,50,3057.891,LESS,-198,1056,858,2,2,-6.0,-0.5624450764046927,6.0,-0.5238227218271837,-0.16831696804723914,-0.5987555031476629,166,86,80,0,0.11967016489094122,0.2341001109082052,0.0,-0.713426382995474,-0.10497639458518411,0.10497639458518411,0.0,0.2341001109082052,0,0,1,1,0.2341001109082052,0.0
2536,11,137,39,66,80,0,4853.714,70,2899.621,LESS,-1014,2250,1236,2,1,14.0,1.3123718449442827,14.0,0.8730378697119728,0.5661570743407132,-0.17304059450384796,146,66,80,1,-0.2792303847455295,-0.5462335921191455,0.0,-0.713426382995474,-0.7424516539824696,0.7424516539824696,0.0,-0.5462335921191455,1,0,0,1,-0.5462335921191455,0.0
2537,11,138,9,50,59,0,1864.535,80,1176.165,LESS,-2,1162,1160,2,2,9.0,0.8436676146070391,9.0,0.0,0.9333940955346892,-0.8940277847747554,109,50,59,1,-1.0171964015730004,-1.170500554541026,-0.8193503881787182,-0.713426382995474,0.04814266281906583,0.04814266281906583,-0.8193503881787182,-1.170500554541026,1,0,1,0,-1.170500554541026,-0.8193503881787182
2538,11,139,57,94,110,0,2078.99,80,1271.222,LESS,-222,1104,882,1,2,16.0,1.4998535370791803,16.0,1.222253017596762,0.9333940955346892,-0.8423014385473976,204,94,110,1,0.8775812092002355,0.5462335921191455,1.170500554541026,-1.2054445781647665,-0.1237256669203984,0.1237256669203984,1.170500554541026,0.5462335921191455,1,0,1,2,1.170500554541026,0.5462335921191455
2539,11,140,60,110,87,1,7112.401999999999,80,1676.642,LESS,1320,1046,2366,2,2,-23.0,-2.1560394595513217,23.0,2.444506035193524,0.9333940955346892,0.3717528470460274,197,110,87,0,0.7379660168274708,1.170500554541026,0.27311679605957273,-0.713426382995474,1.080915080617119,1.080915080617119,0.27311679605957273,1.170500554541026,1,0,1,2,1.170500554541026,0.27311679605957273
2540,11,141,33,75,80,0,5146.265,90,1833.452,LESS,-634,2544,1910,4,2,5.0,0.4687042303372438,5.0,-0.6984302957695783,1.3006311167286655,-0.10247756582575793,155,75,80,1,-0.09972513740911768,-0.19508342575683765,0.0,0.2706100073431107,-0.44558817534157685,0.44558817534157685,0.0,-0.19508342575683765,1,1,0,1,-0.19508342575683765,0.0
2541,11,142,15,50,45,1,3957.137,80,4310.071,LESS,1466,964,2430,3,2,-5.0,-0.4687042303372438,5.0,-0.6984302957695783,0.9333940955346892,-0.3892941317097226,95,50,45,0,-1.2964267863185297,-1.170500554541026,-1.3655839802978638,-0.22140818782618166,1.1949731539896726,1.1949731539896726,-1.3655839802978638,-1.170500554541026,1,0,1,0,-1.170500554541026,-1.3655839802978638
2542,11,143,59,89,110,0,5605.633000000002,70,2224.17,LESS,-404,1740,1336,0,2,21.0,1.9685577674164243,21.0,2.0952908873087353,0.5661570743407132,0.008321567856222045,199,89,110,1,0.7778560717911179,0.3511501663623078,1.170500554541026,-1.6974627733340588,-0.26590764879577333,0.26590764879577333,1.170500554541026,0.3511501663623078,1,0,0,2,1.170500554541026,0.3511501663623078
2543,11,144,29,80,94,0,3858.917,30,412.202,LESS,-1668,2592,924,3,1,14.0,1.3123718449442827,14.0,0.8730378697119728,-0.9027910104351916,-0.4129847042142159,174,80,94,1,0.2792303847455295,0.0,0.5462335921191455,-0.22140818782618166,-1.2533693251170586,1.2533693251170586,0.5462335921191455,0.0,0,0,0,1,0.5462335921191455,0.0
2544,11,145,55,110,98,1,3866.477,60,1081.685,LESS,-88,950,862,2,1,-12.0,-1.124890152809385,12.0,0.5238227218271837,0.198920053146737,-0.4111612392566312,208,110,98,0,0.9573613191275298,1.170500554541026,0.7023003327246156,-0.713426382995474,-0.019042229715452,0.019042229715452,0.7023003327246156,1.170500554541026,1,0,1,2,1.170500554541026,0.7023003327246156
2545,11,146,29,94,80,0,10090.541,60,1806.394,LESS,-1734,2900,1166,1,2,-14.0,-1.3123718449442827,14.0,0.8730378697119728,0.198920053146737,1.0900771996010972,174,94,80,0,0.2792303847455295,0.5462335921191455,0.0,-1.2054445781647665,-1.304929824038898,1.304929824038898,0.0,0.5462335921191455,1,0,0,1,0.5462335921191455,0.0
2546,11,147,57,110,94,1,4324.304,80,1189.803,LESS,920,1340,2260,3,2,-16.0,-1.4998535370791803,16.0,1.222253017596762,0.9333940955346892,-0.3007337933391539,204,110,94,0,0.8775812092002355,1.170500554541026,0.5462335921191455,-0.22140818782618166,0.7684272083635477,0.7684272083635477,0.5462335921191455,1.170500554541026,1,0,1,2,1.170500554541026,0.5462335921191455
2547,11,148,39,80,66,1,21413.362,70,1050.09,LESS,586,3012,3598,5,2,-14.0,-1.3123718449442827,14.0,0.8730378697119728,0.5661570743407132,3.821131077181004,146,80,66,0,-0.2792303847455295,0.0,-0.5462335921191455,0.762628202512403,0.5074998350318156,0.5074998350318156,-0.5462335921191455,0.0,1,1,1,1,0.0,-0.5462335921191455
2548,11,149,4,50,54,0,6232.021,70,2038.435,LESS,-1244,2428,1184,2,2,4.0,0.3749633842697951,4.0,-0.8730378697119728,0.5661570743407132,0.15940576995298902,104,50,54,1,-1.116921538982118,-1.170500554541026,-1.0144338139355558,-0.713426382995474,-0.9221321805282731,0.9221321805282731,-1.0144338139355558,-1.170500554541026,1,0,0,0,-1.170500554541026,-1.0144338139355558
2549,11,150,55,98,110,0,1966.864,30,1258.792,LESS,-320,890,570,2,1,12.0,1.124890152809385,12.0,0.5238227218271837,-0.9027910104351916,-0.8693461252979453,208,98,110,1,0.9573613191275298,0.7023003327246156,1.170500554541026,-0.713426382995474,-0.20028519562252337,0.20028519562252337,1.170500554541026,0.7023003327246156,0,0,0,2,1.170500554541026,0.7023003327246156
2550,11,151,2,50,52,0,2071.327,70,2607.444,LESS,214,1060,1274,2,2,2.0,0.18748169213489754,2.0,-1.222253017596762,0.5661570743407132,-0.8441497470090339,102,50,52,1,-1.156811593945765,-1.170500554541026,-1.092467184238291,-0.713426382995474,0.21688611383599432,0.21688611383599432,-1.092467184238291,-1.170500554541026,1,0,1,0,-1.170500554541026,-1.092467184238291
2551,11,152,59,110,89,1,2515.235,40,2634.793,LESS,1242,44,1286,1,2,-21.0,-1.9685577674164243,21.0,2.0952908873087353,-0.5355539892412153,-0.7370795509255013,199,110,89,0,0.7778560717911179,1.170500554541026,0.3511501663623078,-1.2054445781647665,1.0199799455276726,1.0199799455276726,0.3511501663623078,1.170500554541026,0,0,1,2,1.170500554541026,0.3511501663623078
2552,11,153,60,87,110,0,7100.414000000002,70,911.177,LESS,364,1880,2244,1,2,23.0,2.1560394595513217,23.0,2.444506035193524,0.5661570743407132,0.36886135261328656,197,87,110,1,0.7379660168274708,0.27311679605957273,1.170500554541026,-1.2054445781647665,0.3340690659310836,0.3340690659310836,1.170500554541026,0.27311679605957273,1,0,1,2,1.170500554541026,0.27311679605957273
2553,11,154,52,110,105,0,2024.837,80,1196.509,LESS,-648,1258,610,2,2,-5.0,-0.4687042303372438,5.0,-0.6984302957695783,0.9333940955346892,-0.8553630917019059,215,110,105,0,1.0969765115002945,1.170500554541026,0.9754171287841883,-0.713426382995474,-0.4565252508704518,0.4565252508704518,0.9754171287841883,1.170500554541026,1,0,0,2,1.170500554541026,0.9754171287841883
2554,11,155,30,80,96,0,13906.223999999998,30,1290.264,LESS,-378,2552,2174,2,1,16.0,1.4998535370791803,16.0,1.222253017596762,-0.9027910104351916,2.0104163847534298,176,80,96,1,0.3191204397091766,0.0,0.6242669624218805,-0.713426382995474,-0.2455959370992912,0.2455959370992912,0.6242669624218805,0.0,0,0,0,1,0.6242669624218805,0.0
2555,11,156,24,80,86,1,3782.858,60,1339.641,LESS,-576,1430,854,2,2,6.0,0.5624450764046927,6.0,-0.5238227218271837,0.198920053146737,-0.4313300641624876,166,80,86,1,0.11967016489094122,0.0,0.2341001109082052,-0.713426382995474,-0.400277433864809,0.400277433864809,0.2341001109082052,0.0,0,0,0,1,0.2341001109082052,0.0
2556,11,157,5,50,55,0,2844.036,100,2484.58,LESS,-246,1526,1280,2,2,5.0,0.4687042303372438,5.0,-0.6984302957695783,1.6678681379226417,-0.6577730560156064,105,50,55,1,-1.0969765115002945,-1.170500554541026,-0.9754171287841883,-0.713426382995474,-0.14247493925561266,0.14247493925561266,-0.9754171287841883,-1.170500554541026,1,0,0,0,-1.170500554541026,-0.9754171287841883
2557,11,158,34,80,74,0,3896.436,20,1828.174,LESS,-1152,1810,658,0,1,-6.0,-0.5624450764046927,6.0,-0.5238227218271837,-1.2700280316291677,-0.40393515636453065,154,80,74,0,-0.11967016489094122,0.0,-0.2341001109082052,-1.6974627733340588,-0.8502599699099517,0.8502599699099517,-0.2341001109082052,0.0,0,0,0,1,0.0,-0.2341001109082052
2558,11,159,15,45,50,0,9063.275,70,2463.632,LESS,-102,3510,3408,7,2,5.0,0.4687042303372438,5.0,-0.6984302957695783,0.5661570743407132,0.842301597336785,95,45,50,1,-1.2964267863185297,-1.3655839802978638,-1.170500554541026,1.7466645928509879,-0.029979305244326997,0.029979305244326997,-1.170500554541026,-1.3655839802978638,1,1,1,0,-1.3655839802978638,-1.170500554541026
2559,11,160,37,69,80,0,9224.087,0,3967.197,LESS,-3130,5432,2302,6,1,11.0,1.0311493067419364,11.0,0.34921514788478913,-2.00450207401712,0.8810893019345508,149,69,80,1,-0.21939530230005888,-0.4291835366650429,0.0,1.2546463976816955,-2.395512498203862,2.395512498203862,0.0,-0.4291835366650429,0,1,0,1,-0.4291835366650429,0.0
2560,11,161,3,50,53,1,2360.284,90,1356.2820000000004,MORE,1152,820,1972,3,2,3.0,0.28122253820234633,3.0,-1.0476454436543674,1.3006311167286655,-0.7744535877830021,103,50,53,0,-1.1368665664639415,-1.170500554541026,-1.0534504990869233,-0.22140818782618166,0.9496701742706191,0.9496701742706191,-1.0534504990869233,-1.170500554541026,1,0,1,0,-1.170500554541026,-1.0534504990869233
2561,11,162,20,50,40,1,5328.319,20,1494.77,MORE,504,1412,1916,5,2,-10.0,-0.9374084606744876,10.0,0.17460757394239454,-1.2700280316291677,-0.05856631061568857,90,50,40,1,-1.3961519237276474,-1.170500554541026,-1.5606674060547012,0.762628202512403,0.44343982121983355,0.44343982121983355,-1.5606674060547012,-1.170500554541026,0,1,1,0,-1.170500554541026,-1.5606674060547012
2562,11,163,25,80,88,1,2798.265,80,2119.569,MORE,416,1188,1604,3,2,8.0,0.7499267685395902,8.0,-0.17460757394239454,0.9333940955346892,-0.6688129785782532,168,80,88,0,0.1595602198545883,0.0,0.31213348121094026,-0.22140818782618166,0.37469248932404786,0.37469248932404786,0.31213348121094026,0.0,1,1,1,1,0.31213348121094026,0.0
2563,11,164,42,115,110,0,16547.093,60,1189.565,MORE,-1596,4642,3046,10,1,-5.0,-0.4687042303372438,5.0,-0.6984302957695783,0.198920053146737,2.6473915274877875,225,115,110,1,1.2964267863185297,1.3655839802978638,1.170500554541026,3.2227191783588647,-1.197121508111416,1.197121508111416,1.170500554541026,1.3655839802978638,0,1,0,2,1.3655839802978638,1.170500554541026
2564,11,165,53,103,110,0,3215.762,50,1853.989,MORE,-580,1352,772,2,1,7.0,0.6561859224721414,7.0,-0.34921514788478913,-0.16831696804723914,-0.5681130910919122,213,103,110,0,1.0570864565366473,0.8973837584814532,1.170500554541026,-0.713426382995474,-0.4034023125873447,0.4034023125873447,1.170500554541026,0.8973837584814532,0,0,0,2,1.170500554541026,0.8973837584814532
2565,11,166,26,90,80,0,4805.152,70,954.333,MORE,-1194,2216,1022,3,1,-10.0,-0.9374084606744876,10.0,0.17460757394239454,0.5661570743407132,-0.1847537036665765,170,90,80,1,0.19945027481823535,0.3901668515136753,0.0,-0.22140818782618166,-0.8830711964965766,0.8830711964965766,0.0,0.3901668515136753,1,1,0,1,0.3901668515136753,0.0
2566,11,167,35,80,72,1,3876.601,80,920.129,MORE,282,1616,1898,5,2,-8.0,-0.7499267685395902,8.0,-0.17460757394239454,0.9333940955346892,-0.4087193398875058,152,80,72,1,-0.1595602198545883,0.0,-0.31213348121094026,0.762628202512403,0.2700090521191015,0.2700090521191015,-0.31213348121094026,0.0,1,1,1,1,0.0,-0.31213348121094026
2567,11,168,28,93,80,1,3662.945,40,470.249,MORE,766,890,1656,2,2,-13.0,-1.218630998876834,13.0,0.6984302957695783,-0.5355539892412153,-0.4602529680591613,173,93,80,1,0.25928535726370594,0.5072169069677779,0.0,-0.713426382995474,0.6481193775459227,0.6481193775459227,0.0,0.5072169069677779,0,0,1,1,0.5072169069677779,0.0
2568,11,169,26,80,90,1,7214.56,60,3785.701,MORE,1440,1336,2776,2,2,10.0,0.9374084606744876,10.0,0.17460757394239454,0.198920053146737,0.3963932614821305,170,80,90,0,0.19945027481823535,0.0,0.3901668515136753,-0.713426382995474,1.1746614422931905,1.1746614422931905,0.3901668515136753,0.0,0,0,1,1,0.3901668515136753,0.0
2569,11,170,25,88,80,0,2799.691,100,2210.324,MORE,-56,1766,1710,2,2,-8.0,-0.7499267685395902,8.0,-0.17460757394239454,1.6678681379226417,-0.6684690287066242,168,88,80,1,0.1595602198545883,0.31213348121094026,0.0,-0.713426382995474,0.005956800064833703,0.005956800064833703,0.0,0.31213348121094026,1,0,0,1,0.31213348121094026,0.0
2570,11,171,36,80,70,0,3203.563,60,944.314,MORE,-764,1246,482,2,1,-10.0,-0.9374084606744876,10.0,0.17460757394239454,0.198920053146737,-0.5710554785280995,150,80,70,1,-0.19945027481823535,0.0,-0.3901668515136753,-0.713426382995474,-0.5471467338239875,0.5471467338239875,-0.3901668515136753,0.0,0,0,0,1,0.0,-0.3901668515136753
2571,11,172,28,80,93,1,2004.114,80,850.049,MORE,508,662,1170,3,2,13.0,1.218630998876834,13.0,0.6984302957695783,0.9333940955346892,-0.8603614599976768,173,80,93,0,0.25928535726370594,0.0,0.5072169069677779,-0.22140818782618166,0.44656469994236925,0.44656469994236925,0.5072169069677779,0.0,1,1,1,1,0.5072169069677779,0.0
2572,11,173,21,82,80,0,6071.469,30,1967.618,MORE,-2034,3702,1668,3,1,-2.0,-0.18748169213489754,2.0,-1.222253017596762,-0.9027910104351916,0.12068077711302375,162,82,80,1,0.03989005496364707,0.07803337030273506,0.0,-0.22140818782618166,-1.5392957282290765,1.5392957282290765,0.0,0.07803337030273506,0,1,0,1,0.07803337030273506,0.0
2573,11,174,19,50,41,1,1447.59,70,3648.81,MORE,-406,1110,704,1,2,-9.0,-0.8436676146070391,9.0,0.0,0.5661570743407132,-0.9945945303753044,91,50,41,1,-1.376206896245824,-1.170500554541026,-1.5216507209033339,-1.2054445781647665,-0.2674700881570412,0.2674700881570412,-1.5216507209033339,-1.170500554541026,1,0,0,0,-1.170500554541026,-1.5216507209033339
2574,11,175,56,96,110,1,2234.9210000000007,60,1301.798,MORE,98,796,894,3,2,14.0,1.3123718449442827,14.0,0.8730378697119728,0.198920053146737,-0.8046910266028022,206,96,110,0,0.9174712641638826,0.6242669624218805,1.170500554541026,-0.22140818782618166,0.12626463088245865,0.12626463088245865,1.170500554541026,0.6242669624218805,0,0,1,2,1.170500554541026,0.6242669624218805
2575,11,176,23,80,85,1,3708.76,80,9590.479,MORE,496,980,1476,0,2,5.0,0.4687042303372438,5.0,-0.6984302957695783,0.9333940955346892,-0.4492024327375022,165,80,85,0,0.09972513740911768,0.0,0.19508342575683765,-1.6974627733340588,0.4371900637747621,0.4371900637747621,0.19508342575683765,0.0,1,0,1,1,0.19508342575683765,0.0
2576,11,177,10,60,50,0,3523.153,80,842.342,MORE,-316,1584,1268,4,2,-10.0,-0.9374084606744876,10.0,0.17460757394239454,0.9333940955346892,-0.4939706682378228,110,60,50,1,-0.9972513740911768,-0.7803337030273506,-1.170500554541026,0.2706100073431107,-0.19716031689998764,0.19716031689998764,-1.170500554541026,-0.7803337030273506,1,1,0,0,-0.7803337030273506,-1.170500554541026
2577,11,178,19,41,50,0,7845.473000000001,50,1328.931,MORE,654,1720,2374,5,2,9.0,0.8436676146070391,9.0,0.0,-0.16831696804723914,0.5485688893636957,91,41,50,0,-1.376206896245824,-1.5216507209033339,-1.170500554541026,0.762628202512403,0.5606227733149227,0.5606227733149227,-1.170500554541026,-1.5216507209033339,0,1,1,0,-1.5216507209033339,-1.170500554541026
2578,11,179,56,110,96,0,5287.708000000001,100,2112.6420000000007,MORE,-730,2440,1710,2,2,-14.0,-1.3123718449442827,14.0,0.8730378697119728,1.6678681379226417,-0.06836164598506292,206,110,96,1,0.9174712641638826,1.170500554541026,0.6242669624218805,-0.713426382995474,-0.5205852646824339,0.5205852646824339,0.6242669624218805,1.170500554541026,1,0,0,2,1.170500554541026,0.6242669624218805
2579,11,180,35,72,80,1,1772.283,70,1153.106,MORE,304,600,904,3,2,8.0,0.7499267685395902,8.0,-0.17460757394239454,0.5661570743407132,-0.916278881238658,152,72,80,0,-0.1595602198545883,-0.31213348121094026,0.0,-0.22140818782618166,0.2871958850930479,0.2871958850930479,0.0,-0.31213348121094026,1,0,1,1,-0.31213348121094026,0.0
2580,11,181,11,49,50,0,2435.127,40,10552.329,MORE,-530,1262,732,1,1,1.0,0.09374084606744876,1.0,-1.3968605915391563,-0.5355539892412153,-0.7564015259019821,99,49,50,0,-1.2166466763912356,-1.2095172396923934,-1.170500554541026,-1.2054445781647665,-0.36434132855564827,0.36434132855564827,-1.170500554541026,-1.2095172396923934,0,0,0,0,-1.2095172396923934,-1.170500554541026
2581,11,182,17,43,50,1,1368.463,20,471.462,MORE,338,468,806,1,2,7.0,0.6561859224721414,7.0,-0.34921514788478913,-1.2700280316291677,-1.0136798890656225,93,43,50,0,-1.3363168412821769,-1.4436173506005987,-1.170500554541026,-1.2054445781647665,0.31375735423460144,0.31375735423460144,-1.170500554541026,-1.4436173506005987,0,0,1,0,-1.4436173506005987,-1.170500554541026
2582,11,183,1,51,50,0,2530.144,80,7106.213000000002,MORE,-1602,3048,1446,1,2,-1.0,-0.09374084606744876,1.0,-1.3968605915391563,0.9333940955346892,-0.7334835140137778,101,51,50,1,-1.1767566214275886,-1.1314838693896585,-1.170500554541026,-1.2054445781647665,-1.2018088261952193,1.2018088261952193,-1.170500554541026,-1.1314838693896585,1,0,0,0,-1.1314838693896585,-1.170500554541026
2583,11,184,41,112,110,0,5170.237,80,695.328,MORE,-552,2368,1816,3,2,-2.0,-0.18748169213489754,2.0,-1.222253017596762,0.9333940955346892,-0.09669554175654893,222,112,110,1,1.2365917038730592,1.248533924843761,1.170500554541026,-0.22140818782618166,-0.38152816152959473,0.38152816152959473,1.170500554541026,1.248533924843761,1,1,0,2,1.248533924843761,1.170500554541026
2584,11,185,20,40,50,0,14426.898,10,3623.897,MORE,-532,2756,2224,5,1,10.0,0.9374084606744876,10.0,0.17460757394239454,-1.6372650528231438,2.1360024685266383,90,40,50,0,-1.3961519237276474,-1.5606674060547012,-1.170500554541026,0.762628202512403,-0.36590376791691614,0.36590376791691614,-1.170500554541026,-1.5606674060547012,0,1,0,0,-1.5606674060547012,-1.170500554541026
2585,11,186,1,50,51,1,10303.299,60,2725.503,MORE,222,1904,2126,6,2,1.0,0.09374084606744876,1.0,-1.3968605915391563,0.198920053146737,1.1413942310092724,101,50,51,0,-1.1767566214275886,-1.170500554541026,-1.1314838693896585,1.2546463976816955,0.22313587128106577,0.22313587128106577,-1.1314838693896585,-1.170500554541026,0,1,1,0,-1.170500554541026,-1.1314838693896585
2586,11,187,23,85,80,1,5913.5,70,7392.936,MORE,1260,1376,2636,1,2,-5.0,-0.4687042303372438,5.0,-0.6984302957695783,0.5661570743407132,0.08257880146689986,165,85,80,1,0.09972513740911768,0.19508342575683765,0.0,-1.2054445781647665,1.0340418997790832,1.0340418997790832,0.0,0.19508342575683765,1,0,1,1,0.19508342575683765,0.0
2587,11,188,11,50,49,0,8980.201,0,2617.276,MORE,-530,1774,1244,2,1,-1.0,-0.09374084606744876,1.0,-1.3968605915391563,-2.00450207401712,0.8222642259232411,99,50,49,1,-1.2166466763912356,-1.170500554541026,-1.2095172396923934,-0.713426382995474,-0.36434132855564827,0.36434132855564827,-1.2095172396923934,-1.170500554541026,0,0,0,0,-1.170500554541026,-1.2095172396923934
2588,11,189,17,50,43,1,2652.93,80,2817.775,MORE,254,896,1150,1,2,-7.0,-0.6561859224721414,7.0,-0.34921514788478913,0.9333940955346892,-0.7038676451934082,93,50,43,1,-1.3363168412821769,-1.170500554541026,-1.4436173506005987,-1.2054445781647665,0.24813490106135147,0.24813490106135147,-1.4436173506005987,-1.170500554541026,1,0,1,0,-1.170500554541026,-1.4436173506005987
2589,11,190,21,80,82,1,3262.577,20,1843.789,MORE,-1484,2482,998,2,1,2.0,0.18748169213489754,2.0,-1.222253017596762,-1.2700280316291677,-0.5568213567017894,162,80,82,0,0.03989005496364707,0.0,0.07803337030273506,-0.713426382995474,-1.1096249038804158,1.1096249038804158,0.07803337030273506,0.0,0,0,0,1,0.07803337030273506,0.0
2590,11,191,10,50,60,1,9705.507,60,1521.534,MORE,-396,1874,1478,4,2,10.0,0.9374084606744876,10.0,0.17460757394239454,0.198920053146737,0.9972073574742896,110,50,60,0,-0.9972513740911768,-1.170500554541026,-0.7803337030273506,0.2706100073431107,-0.2596578913507019,0.2596578913507019,-0.7803337030273506,-1.170500554541026,0,1,0,0,-1.170500554541026,-0.7803337030273506
2591,11,192,3,53,50,1,4653.63,80,984.214,MORE,1584,486,2070,0,2,-3.0,-0.28122253820234633,3.0,-1.0476454436543674,0.9333940955346892,-0.22130066891831565,103,53,50,1,-1.1368665664639415,-1.0534504990869233,-1.170500554541026,-1.6974627733340588,1.287157076304476,1.287157076304476,-1.170500554541026,-1.0534504990869233,1,0,1,0,-1.0534504990869233,-1.170500554541026
2592,11,193,45,122,110,0,2075.242,80,1271.917,MORE,-74,898,824,1,2,-12.0,-1.124890152809385,12.0,0.5238227218271837,0.9333940955346892,-0.8432054526559991,232,122,110,1,1.4360419786912946,1.6387007763574364,1.170500554541026,-1.2054445781647665,-0.008105154186577005,0.008105154186577005,1.170500554541026,1.6387007763574364,1,0,0,2,1.6387007763574364,1.170500554541026
2593,11,194,38,67,80,1,1184.873,90,1091.627,MORE,-110,568,458,1,2,13.0,1.218630998876834,13.0,0.6984302957695783,1.3006311167286655,-1.0579616260448517,147,67,80,0,-0.25928535726370594,-0.5072169069677779,0.0,-1.2054445781647665,-0.03622906268939843,0.03622906268939843,0.0,-0.5072169069677779,1,0,0,1,-0.5072169069677779,0.0
2594,11,195,38,80,67,1,10564.16,80,1133.308,MORE,406,1760,2166,2,2,-13.0,-1.218630998876834,13.0,0.6984302957695783,0.9333940955346892,1.2043136612077512,147,80,67,1,-0.25928535726370594,0.0,-0.5072169069677779,-0.713426382995474,0.36688029251770854,0.36688029251770854,-0.5072169069677779,0.0,1,0,1,1,0.0,-0.5072169069677779
2595,11,196,36,70,80,1,1824.847,70,1155.896,MORE,718,336,1054,0,2,10.0,0.9374084606744876,10.0,0.17460757394239454,0.5661570743407132,-0.9036004934039382,150,70,80,0,-0.19945027481823535,-0.3901668515136753,0.0,-1.6974627733340588,0.6106208328754942,0.6106208328754942,0.0,-0.3901668515136753,1,0,1,1,-0.3901668515136753,0.0
2596,11,197,45,110,122,0,2398.761,80,4046.389,MORE,-832,1440,608,2,2,12.0,1.124890152809385,12.0,0.5238227218271837,0.9333940955346892,-0.7651729712257288,232,110,122,0,1.4360419786912946,1.170500554541026,1.6387007763574364,-0.713426382995474,-0.6002696721070946,0.6002696721070946,1.6387007763574364,1.170500554541026,1,0,0,2,1.6387007763574364,1.170500554541026
2597,11,198,42,110,115,0,4017.863,80,1689.9589999999996,MORE,-520,1202,682,2,2,5.0,0.4687042303372438,5.0,-0.6984302957695783,0.9333940955346892,-0.3746470770782031,225,110,115,0,1.2964267863185297,1.170500554541026,1.3655839802978638,-0.713426382995474,-0.356529131749309,0.356529131749309,1.3655839802978638,1.170500554541026,1,0,0,2,1.3655839802978638,1.170500554541026
2598,11,199,41,110,112,0,2069.535,40,475.299,MORE,-532,1104,572,2,1,2.0,0.18748169213489754,2.0,-1.222253017596762,-0.5355539892412153,-0.8445819757397207,222,110,112,0,1.2365917038730592,1.170500554541026,1.248533924843761,-0.713426382995474,-0.36590376791691614,0.36590376791691614,1.248533924843761,1.170500554541026,0,0,0,2,1.248533924843761,1.170500554541026
2599,11,200,53,110,103,1,6801.251,90,2074.711,MORE,1598,1266,2864,2,2,-7.0,-0.6561859224721414,7.0,-0.34921514788478913,1.3006311167286655,0.29670351569451503,213,110,103,1,1.0570864565366473,1.170500554541026,0.8973837584814532,-0.713426382995474,1.298094151833351,1.298094151833351,0.8973837584814532,1.170500554541026,1,0,1,2,1.170500554541026,0.8973837584814532
2600,11,201,3,50,53,0,5934.0430000000015,30,2755.857,LESS,-2096,4032,1936,4,1,3.0,0.28122253820234633,3.0,-1.0476454436543674,-0.9027910104351916,0.08753375393034762,103,50,53,1,-1.1368665664639415,-1.170500554541026,-1.0534504990869233,0.2706100073431107,-1.58773134842838,1.58773134842838,-1.0534504990869233,-1.170500554541026,0,1,0,0,-1.170500554541026,-1.0534504990869233
2601,11,202,20,50,40,1,5620.092,70,1593.672,LESS,2756,1204,3960,2,2,-10.0,-0.9374084606744876,10.0,0.17460757394239454,0.5661570743407132,0.011809065187136527,90,50,40,0,-1.3961519237276474,-1.170500554541026,-1.5606674060547012,-0.713426382995474,2.20274654200744,2.20274654200744,-1.5606674060547012,-1.170500554541026,1,0,1,0,-1.170500554541026,-1.5606674060547012
2602,11,203,25,80,88,0,4725.86,70,1548.096,LESS,-312,2578,2266,6,2,8.0,0.7499267685395902,8.0,-0.17460757394239454,0.5661570743407132,-0.20387886020319107,168,80,88,1,0.1595602198545883,0.0,0.31213348121094026,1.2546463976816955,-0.19403543817745195,0.19403543817745195,0.31213348121094026,0.0,1,1,0,1,0.31213348121094026,0.0
2603,11,204,42,115,110,0,2458.088,40,704.7719999999998,LESS,-1098,1734,636,2,1,-5.0,-0.4687042303372438,5.0,-0.6984302957695783,-0.5355539892412153,-0.7508633540909897,225,115,110,0,1.2964267863185297,1.3655839802978638,1.170500554541026,-0.713426382995474,-0.8080741071557196,0.8080741071557196,1.170500554541026,1.3655839802978638,0,0,0,2,1.3655839802978638,1.170500554541026
2604,11,205,53,103,110,0,4713.656,70,1135.4160000000004,LESS,838,1614,2452,4,2,7.0,0.6561859224721414,7.0,-0.34921514788478913,0.5661570743407132,-0.2068224536347206,213,103,110,1,1.0570864565366473,0.8973837584814532,1.170500554541026,0.2706100073431107,0.7043671945515656,0.7043671945515656,1.170500554541026,0.8973837584814532,1,1,1,2,1.170500554541026,0.8973837584814532
2605,11,206,26,90,80,0,5889.694,0,1598.054,LESS,-1612,3748,2136,6,1,-10.0,-0.9374084606744876,10.0,0.17460757394239454,-2.00450207401712,0.07683681644305587,170,90,80,0,0.19945027481823535,0.3901668515136753,0.0,1.2546463976816955,-1.2096210230015587,1.2096210230015587,0.0,0.3901668515136753,0,1,0,1,0.3901668515136753,0.0
2606,11,207,35,80,72,1,7370.666,50,1709.969,LESS,152,3094,3246,6,1,-8.0,-0.7499267685395902,8.0,-0.17460757394239454,-0.16831696804723914,0.4340458832637067,152,80,72,0,-0.1595602198545883,0.0,-0.31213348121094026,1.2546463976816955,0.1684504936366908,0.1684504936366908,-0.31213348121094026,0.0,0,1,1,1,0.0,-0.31213348121094026
2607,11,208,28,93,80,1,4335.509,70,1990.538,LESS,-24,1836,1812,5,2,-13.0,-1.218630998876834,13.0,0.6984302957695783,0.5661570743407132,-0.29803115777701944,173,93,80,0,0.25928535726370594,0.5072169069677779,0.0,0.762628202512403,0.03095582984511941,0.03095582984511941,0.0,0.5072169069677779,1,1,1,1,0.5072169069677779,0.0
2608,11,209,26,80,90,0,6086.482,30,1687.52,LESS,-1128,3078,1950,5,1,10.0,0.9374084606744876,10.0,0.17460757394239454,-0.9027910104351916,0.12430189872786755,170,80,90,1,0.19945027481823535,0.0,0.3901668515136753,0.762628202512403,-0.8315106975747374,0.8315106975747374,0.3901668515136753,0.0,0,1,0,1,0.3901668515136753,0.0
2609,11,210,25,88,80,1,7796.757,0,3438.723,LESS,-3376,5262,1886,6,1,-8.0,-0.7499267685395902,8.0,-0.17460757394239454,-2.00450207401712,0.5368186355444236,168,88,80,0,0.1595602198545883,0.31213348121094026,0.0,1.2546463976816955,-2.587692539639808,2.587692539639808,0.0,0.31213348121094026,0,1,0,1,0.31213348121094026,0.0
2610,11,211,36,80,70,1,2339.991,20,1416.294,LESS,-190,1282,1092,2,1,-10.0,-0.9374084606744876,10.0,0.17460757394239454,-1.2700280316291677,-0.7793482404793336,150,80,70,0,-0.19945027481823535,0.0,-0.3901668515136753,-0.713426382995474,-0.09872663714011269,0.09872663714011269,-0.3901668515136753,0.0,0,0,1,1,0.0,-0.3901668515136753
2611,11,212,28,80,93,1,17110.889,10,3045.182,LESS,-994,4148,3154,7,1,13.0,1.218630998876834,13.0,0.6984302957695783,-1.6372650528231438,2.7833785974912817,173,80,93,1,0.25928535726370594,0.0,0.5072169069677779,1.7466645928509879,-0.7268272603697911,0.7268272603697911,0.5072169069677779,0.0,0,1,0,1,0.5072169069677779,0.0
2612,11,213,21,82,80,1,3283.169000000001,20,5562.655,LESS,-588,1560,972,3,1,-2.0,-0.18748169213489754,2.0,-1.222253017596762,-1.2700280316291677,-0.5518545854839872,162,82,80,0,0.03989005496364707,0.07803337030273506,0.0,-0.22140818782618166,-0.40965207003241616,0.40965207003241616,0.0,0.07803337030273506,0,0,0,1,0.07803337030273506,0.0
2613,11,214,19,50,41,1,8189.443,80,2272.829,LESS,10,2834,2844,3,2,-9.0,-0.8436676146070391,9.0,0.0,0.9333940955346892,0.6315341329431146,91,50,41,0,-1.376206896245824,-1.170500554541026,-1.5216507209033339,-0.22140818782618166,0.05751729898667297,0.05751729898667297,-1.5216507209033339,-1.170500554541026,1,0,1,0,-1.170500554541026,-1.5216507209033339
2614,11,215,56,96,110,0,9023.685,30,2913.708,LESS,-1670,3794,2124,7,2,14.0,1.3123718449442827,14.0,0.8730378697119728,-0.9027910104351916,0.8327525262163117,206,96,110,1,0.9174712641638826,0.6242669624218805,1.170500554541026,1.7466645928509879,-1.2549317644783264,1.2549317644783264,1.170500554541026,0.6242669624218805,0,1,0,2,1.170500554541026,0.6242669624218805
2615,11,216,23,80,85,0,2890.884,40,359.801,LESS,-1294,1658,364,2,1,5.0,0.4687042303372438,5.0,-0.6984302957695783,-0.5355539892412153,-0.6464733620562244,165,80,85,1,0.09972513740911768,0.0,0.19508342575683765,-0.713426382995474,-0.9611931645599695,0.9611931645599695,0.19508342575683765,0.0,0,0,0,1,0.19508342575683765,0.0
2616,11,217,10,60,50,1,2341.4120000000007,20,1480.965,LESS,180,1104,1284,3,1,-10.0,-0.9374084606744876,10.0,0.17460757394239454,-1.2700280316291677,-0.7790054966030467,110,60,50,0,-0.9972513740911768,-0.7803337030273506,-1.170500554541026,-0.22140818782618166,0.19032464469444077,0.19032464469444077,-1.170500554541026,-0.7803337030273506,0,0,1,0,-0.7803337030273506,-1.170500554541026
2617,11,218,19,41,50,0,1701.515,90,2918.758,LESS,1920,850,2770,3,2,9.0,0.8436676146070391,9.0,0.0,1.3006311167286655,-0.9333480569156888,91,41,50,1,-1.376206896245824,-1.5216507209033339,-1.170500554541026,-0.22140818782618166,1.549646888997476,1.549646888997476,-1.170500554541026,-1.5216507209033339,1,0,1,0,-1.5216507209033339,-1.170500554541026
2618,11,219,56,110,96,1,5335.5340000000015,0,3129.199,LESS,-1868,3648,1780,5,1,-14.0,-1.3123718449442827,14.0,0.8730378697119728,-2.00450207401712,-0.056826059336723564,206,110,96,0,0.9174712641638826,1.170500554541026,0.6242669624218805,0.762628202512403,-1.4096132612438443,1.4096132612438443,0.6242669624218805,1.170500554541026,0,1,0,2,1.170500554541026,0.6242669624218805
2619,11,220,35,72,80,1,3426.286,60,2917.255,LESS,1046,1286,2332,4,2,8.0,0.7499267685395902,8.0,-0.17460757394239454,0.198920053146737,-0.5173348984026847,152,72,80,1,-0.1595602198545883,-0.31213348121094026,0.0,0.2706100073431107,0.8668608881234227,0.8668608881234227,0.0,-0.31213348121094026,1,1,1,1,-0.31213348121094026,0.0
2620,11,221,11,49,50,0,1762.0079999999996,30,3551.302,LESS,-458,1500,1042,1,1,1.0,0.09374084606744876,1.0,-1.3968605915391563,-0.9027910104351916,-0.9187572016671212,99,49,50,1,-1.2166466763912356,-1.2095172396923934,-1.170500554541026,-1.2054445781647665,-0.30809351155000547,0.30809351155000547,-1.170500554541026,-1.2095172396923934,0,0,0,0,-1.2095172396923934,-1.170500554541026
2621,11,222,17,43,50,0,1917.575,70,2679.3459999999995,LESS,-944,1506,562,2,1,7.0,0.6561859224721414,7.0,-0.34921514788478913,0.5661570743407132,-0.8812345861834471,93,43,50,1,-1.3363168412821769,-1.4436173506005987,-1.170500554541026,-0.713426382995474,-0.6877662763380946,0.6877662763380946,-1.170500554541026,-1.4436173506005987,1,0,0,0,-1.4436173506005987,-1.170500554541026
2622,11,223,1,51,50,0,4289.202,20,540.755,LESS,-1146,2322,1176,3,1,-1.0,-0.09374084606744876,1.0,-1.3968605915391563,-1.2700280316291677,-0.3092003630403626,101,51,50,0,-1.1767566214275886,-1.1314838693896585,-1.170500554541026,-0.22140818782618166,-0.8455726518261482,0.8455726518261482,-1.170500554541026,-1.1314838693896585,0,0,0,0,-1.1314838693896585,-1.170500554541026
2623,11,224,41,112,110,1,5466.972,0,840.712,LESS,-270,2514,2244,6,1,-2.0,-0.18748169213489754,2.0,-1.222253017596762,-2.00450207401712,-0.025123336176007423,222,112,110,0,1.2365917038730592,1.248533924843761,1.170500554541026,1.2546463976816955,-0.16122421159082695,0.16122421159082695,1.170500554541026,1.248533924843761,0,1,0,2,1.248533924843761,1.170500554541026
2624,11,225,20,40,50,0,5389.663000000001,90,2090.325,LESS,508,1932,2440,5,2,10.0,0.9374084606744876,10.0,0.17460757394239454,1.3006311167286655,-0.04377019495985825,90,40,50,1,-1.3961519237276474,-1.5606674060547012,-1.170500554541026,0.762628202512403,0.44656469994236925,0.44656469994236925,-1.170500554541026,-1.5606674060547012,1,1,1,0,-1.5606674060547012,-1.170500554541026
2625,11,226,1,50,51,0,5505.255,70,1457.158,LESS,16,2388,2404,7,2,1.0,0.09374084606744876,1.0,-1.3968605915391563,0.5661570743407132,-0.015889512238015952,101,50,51,1,-1.1767566214275886,-1.170500554541026,-1.1314838693896585,1.7466645928509879,0.06220461707047654,0.06220461707047654,-1.1314838693896585,-1.170500554541026,1,1,1,0,-1.170500554541026,-1.1314838693896585
2626,11,227,23,85,80,1,7281.303000000001,30,2482.47,LESS,-292,2720,2428,4,2,-5.0,-0.4687042303372438,5.0,-0.6984302957695783,-0.9027910104351916,0.4124916109085956,165,85,80,0,0.09972513740911768,0.19508342575683765,0.0,0.2706100073431107,-0.17841104456477336,0.17841104456477336,0.0,0.19508342575683765,0,1,0,1,0.19508342575683765,0.0
2627,11,228,11,50,49,0,3460.741,40,1590.2820000000004,LESS,-1152,1564,412,2,1,-1.0,-0.09374084606744876,1.0,-1.3968605915391563,-0.5355539892412153,-0.5090243844987719,99,50,49,0,-1.2166466763912356,-1.170500554541026,-1.2095172396923934,-0.713426382995474,-0.8502599699099517,0.8502599699099517,-1.2095172396923934,-1.170500554541026,0,0,0,0,-1.170500554541026,-1.2095172396923934
2628,11,229,17,50,43,0,2174.413,10,425.049,LESS,-490,1034,544,2,1,-7.0,-0.6561859224721414,7.0,-0.34921514788478913,-1.6372650528231438,-0.8192854998373971,93,50,43,0,-1.3363168412821769,-1.170500554541026,-1.4436173506005987,-0.713426382995474,-0.33309254133029115,0.33309254133029115,-1.4436173506005987,-1.170500554541026,0,0,0,0,-1.170500554541026,-1.4436173506005987
2629,11,230,21,80,82,0,5571.986999999999,80,5303.346,LESS,-358,3022,2664,6,2,2.0,0.18748169213489754,2.0,-1.222253017596762,0.9333940955346892,0.00020618399869570616,162,80,82,1,0.03989005496364707,0.0,0.07803337030273506,1.2546463976816955,-0.22997154348661264,0.22997154348661264,0.07803337030273506,0.0,1,1,0,1,0.07803337030273506,0.0
2630,11,231,10,50,60,0,2261.369,90,2112.558,LESS,-148,1668,1520,2,2,10.0,0.9374084606744876,10.0,0.17460757394239454,1.3006311167286655,-0.7983117936400774,110,50,60,1,-0.9972513740911768,-1.170500554541026,-0.7803337030273506,-0.713426382995474,-0.0659154105534877,0.0659154105534877,-0.7803337030273506,-1.170500554541026,1,0,1,0,-1.170500554541026,-0.7803337030273506
2631,11,232,3,53,50,0,2294.443,40,3756.723,LESS,-240,988,748,3,1,-3.0,-0.28122253820234633,3.0,-1.0476454436543674,-0.5355539892412153,-0.7903343756497129,103,53,50,0,-1.1368665664639415,-1.0534504990869233,-1.170500554541026,-0.22140818782618166,-0.1377876211718091,0.1377876211718091,-1.170500554541026,-1.0534504990869233,0,0,1,0,-1.0534504990869233,-1.170500554541026
2632,11,233,45,122,110,1,6211.309,10,3905.231,LESS,-2526,4272,1746,4,1,-12.0,-1.124890152809385,12.0,0.5238227218271837,-1.6372650528231438,0.15441005484697135,232,122,110,0,1.4360419786912946,1.6387007763574364,1.170500554541026,0.2706100073431107,-1.9236558111009692,1.9236558111009692,1.170500554541026,1.6387007763574364,0,1,0,2,1.6387007763574364,1.170500554541026
2633,11,234,38,67,80,0,3827.236,70,2527.863,LESS,474,2130,2604,4,2,13.0,1.218630998876834,13.0,0.6984302957695783,0.5661570743407132,-0.4206261319022107,147,67,80,1,-0.25928535726370594,-0.5072169069677779,0.0,0.2706100073431107,0.4200032308008157,0.4200032308008157,0.0,-0.5072169069677779,1,1,1,1,-0.5072169069677779,0.0
2634,11,235,38,80,67,1,5168.678,30,2674.828,LESS,-224,2434,2210,8,1,-13.0,-1.218630998876834,13.0,0.6984302957695783,-0.9027910104351916,-0.0970715711042837,147,80,67,0,-0.25928535726370594,0.0,-0.5072169069677779,2.23868278802028,-0.12528810628166626,0.12528810628166626,-0.5072169069677779,0.0,0,1,1,1,0.0,-0.5072169069677779
2635,11,236,36,70,80,0,6455.771,10,543.2909999999998,LESS,-1326,3006,1680,3,1,10.0,0.9374084606744876,10.0,0.17460757394239454,-1.6372650528231438,0.21337406152171592,150,70,80,1,-0.19945027481823535,-0.3901668515136753,0.0,-0.22140818782618166,-0.9861921943402552,0.9861921943402552,0.0,-0.3901668515136753,0,0,0,1,-0.3901668515136753,0.0
2636,11,237,45,110,122,1,5957.186,10,2775.257,LESS,-782,2910,2128,6,1,12.0,1.124890152809385,12.0,0.5238227218271837,-1.6372650528231438,0.09311582397179992,232,110,122,1,1.4360419786912946,1.170500554541026,1.6387007763574364,1.2546463976816955,-0.5612086880753983,0.5612086880753983,1.6387007763574364,1.170500554541026,0,1,0,2,1.6387007763574364,1.170500554541026
2637,11,238,42,110,115,1,3704.989,30,1290.233,LESS,8,1510,1518,5,1,5.0,0.4687042303372438,5.0,-0.6984302957695783,-0.9027910104351916,-0.4501119944246784,225,110,115,1,1.2964267863185297,1.170500554541026,1.3655839802978638,0.762628202512403,0.05595485962540511,0.05595485962540511,1.3655839802978638,1.170500554541026,0,1,1,2,1.3655839802978638,1.170500554541026
2638,11,239,41,110,112,1,4106.09,30,1427.1629999999998,LESS,-466,2104,1638,5,1,2.0,0.18748169213489754,2.0,-1.222253017596762,-0.9027910104351916,-0.3533668068648664,222,110,112,1,1.2365917038730592,1.170500554541026,1.248533924843761,0.762628202512403,-0.31434326899507686,0.31434326899507686,1.248533924843761,1.170500554541026,0,1,0,2,1.248533924843761,1.170500554541026
2639,11,240,53,110,103,1,2312.514,40,711.3610000000001,LESS,-142,914,772,3,1,-7.0,-0.6561859224721414,7.0,-0.34921514788478913,-0.5355539892412153,-0.7859756672835075,213,110,103,0,1.0570864565366473,1.170500554541026,0.8973837584814532,-0.22140818782618166,-0.06122809246968413,0.06122809246968413,0.8973837584814532,1.170500554541026,0,0,1,2,1.170500554541026,0.8973837584814532
2640,12,1,49,110,131,1,5012.3809999999985,70,720.22,MORE,36,2072,2108,3,2,21.0,1.9685577674164243,21.0,2.0952908873087353,-0.2708306234342558,3.1434433457157693,241,110,131,0,1.6155472260277064,1.170500554541026,1.9898509427197442,0.35980815346359446,-0.5867746449994088,0.5867746449994088,1.9898509427197442,1.170500554541026,0,1,0,2,1.9898509427197442,1.170500554541026
2641,12,2,13,47,50,1,4646.738,60,2400.817,MORE,-112,2244,2132,5,1,3.0,0.28122253820234633,3.0,-1.0476454436543674,-0.7866984775947429,2.741844161397124,97,47,50,0,-1.2565367313548828,-1.2875506099951286,-1.170500554541026,1.9589555021906802,-0.8204162766203646,0.8204162766203646,-1.170500554541026,-1.2875506099951286,0,1,0,0,-1.2875506099951286,-1.170500554541026
2642,12,3,16,50,44,1,4092.891,70,1007.862,MORE,308,1646,1954,5,2,-6.0,-0.5624450764046927,6.0,-0.5238227218271837,-0.2708306234342558,2.133533586772887,94,50,44,1,-1.3163718138003533,-1.170500554541026,-1.4046006654492311,1.9589555021906802,-0.1573792139122464,0.1573792139122464,-1.4046006654492311,-1.170500554541026,0,1,0,0,-1.170500554541026,-1.4046006654492311
2643,12,4,7,57,50,1,2190.67,80,795.299,MORE,676,786,1462,3,2,-7.0,-0.6561859224721414,7.0,-0.34921514788478913,0.24503723072623146,0.04425414755539458,107,57,50,1,-1.0570864565366473,-0.8973837584814532,-1.170500554541026,0.35980815346359446,0.4235675457939144,0.4235675457939144,-1.170500554541026,-0.8973837584814532,0,1,1,0,-0.8973837584814532,-1.170500554541026
2644,12,5,18,42,50,1,5622.538000000001,70,652.572,MORE,2986,692,3678,3,2,8.0,0.7499267685395902,8.0,-0.17460757394239454,-0.2708306234342558,3.8136012688985295,92,42,50,0,-1.3562618687640005,-1.4826340357519663,-1.170500554541026,0.35980815346359446,4.070271390688565,4.070271390688565,-1.170500554541026,-1.4826340357519663,0,1,1,0,-1.4826340357519663,-1.170500554541026
2645,12,6,51,108,110,0,2724.52,80,587.944,MORE,96,1150,1246,4,2,2.0,0.18748169213489754,2.0,-1.222253017596762,0.24503723072623146,0.6306012800001831,218,108,110,0,1.156811593945765,1.092467184238291,1.170500554541026,1.1593818278271373,-0.4920550646125347,0.4920550646125347,1.170500554541026,1.092467184238291,0,1,0,2,1.170500554541026,1.092467184238291
2646,12,7,31,78,80,1,2449.388,60,1932.387,MORE,1090,406,1496,1,2,2.0,0.18748169213489754,2.0,-1.222253017596762,-0.7866984775947429,0.3284136631718613,158,78,80,0,-0.03989005496364707,-0.07803337030273506,0.0,-1.2393391952634913,1.0771326504633454,1.0771326504633454,0.0,-0.07803337030273506,0,0,1,1,-0.07803337030273506,0.0
2647,12,8,58,110,92,0,1639.989,60,567.327,MORE,-414,942,528,2,1,-18.0,-1.6873352292140782,18.0,1.571468165481551,-0.7866984775947429,-0.560579092571661,202,110,92,1,0.8376911542365885,1.170500554541026,0.4682002218164104,-0.43976552089994847,-1.297171497900964,1.297171497900964,0.4682002218164104,1.170500554541026,0,1,0,2,1.170500554541026,0.4682002218164104
2648,12,9,12,50,48,0,3432.606,60,738.952,MORE,-168,1250,1082,3,1,-2.0,-0.18748169213489754,2.0,-1.222253017596762,-0.7866984775947429,1.4083182334970468,98,50,48,1,-1.2365917038730592,-1.170500554541026,-1.248533924843761,0.35980815346359446,-0.9088212183147804,0.9088212183147804,-1.248533924843761,-1.170500554541026,0,1,0,0,-1.170500554541026,-1.248533924843761
2649,12,10,54,110,101,0,2934.281,70,1325.34,MORE,-194,1442,1248,4,1,-9.0,-0.8436676146070391,9.0,0.0,-0.2708306234342558,0.860989517986043,211,110,101,1,1.0171964015730004,1.170500554541026,0.8193503881787182,1.1593818278271373,-0.9498663698157591,0.9498663698157591,0.8193503881787182,1.170500554541026,0,1,0,2,1.170500554541026,0.8193503881787182
2650,12,11,14,46,50,1,1190.89,70,601.621,MORE,430,398,828,1,2,4.0,0.3749633842697951,4.0,-0.8730378697119728,-0.2708306234342558,-1.053841077836852,96,46,50,0,-1.2764817588367063,-1.3265672951464962,-1.170500554541026,-1.2393391952634913,0.035217266207730816,0.035217266207730816,-1.170500554541026,-1.3265672951464962,0,0,0,0,-1.3265672951464962,-1.170500554541026
2651,12,12,22,80,83,1,1767.183,60,1712.5929999999996,MORE,324,438,762,1,2,3.0,0.28122253820234633,3.0,-1.0476454436543674,-0.7866984775947429,-0.4208772340642481,163,80,83,0,0.05983508244547061,0.0,0.1170500554541026,-1.2393391952634913,-0.13212065914241333,0.13212065914241333,0.1170500554541026,0.0,0,0,0,1,0.1170500554541026,0.0
2652,12,13,6,50,56,1,1294.651,60,1791.231,MORE,380,348,728,1,2,6.0,0.5624450764046927,6.0,-0.5238227218271837,-0.7866984775947429,-0.9398765469581336,106,50,56,0,-1.077031484018471,-1.170500554541026,-0.9364004436328208,-1.2393391952634913,-0.04371571744799756,0.04371571744799756,-0.9364004436328208,-1.170500554541026,0,0,0,0,-1.170500554541026,-0.9364004436328208
2653,12,14,13,50,47,0,2238.074,70,1701.206,MORE,-472,1258,786,2,1,-3.0,-0.28122253820234633,3.0,-1.0476454436543674,-0.2708306234342558,0.09631970804319594,97,50,47,1,-1.2565367313548828,-1.170500554541026,-1.2875506099951286,-0.43976552089994847,-1.3887337589416089,1.3887337589416089,-1.2875506099951286,-1.170500554541026,0,1,0,0,-1.170500554541026,-1.2875506099951286
2654,12,15,46,110,124,0,6584.98,70,1347.056,MORE,394,2104,2498,3,1,14.0,1.3123718449442827,14.0,0.8730378697119728,-0.2708306234342558,4.870686792630713,234,110,124,0,1.4759320336549415,1.170500554541026,1.7167341466601715,0.35980815346359446,-0.021614482024393613,0.021614482024393613,1.7167341466601715,1.170500554541026,0,1,0,2,1.7167341466601715,1.170500554541026
2655,12,16,27,91,80,1,1428.599,60,677.9739999999998,MORE,564,362,926,1,2,-11.0,-1.0311493067419364,11.0,0.34921514788478913,-0.7866984775947429,-0.7927565213016488,171,91,80,1,0.21939530230005888,0.4291835366650429,0.0,-1.2393391952634913,0.24675766240508284,0.24675766240508284,0.0,0.4291835366650429,0,0,0,1,0.4291835366650429,0.0
2656,12,17,40,64,80,1,1490.428,70,1395.0020000000004,MORE,684,470,1154,1,2,16.0,1.4998535370791803,16.0,1.222253017596762,-0.2708306234342558,-0.7248474516155404,144,64,80,0,-0.3191204397091766,-0.6242669624218805,0.0,-1.2393391952634913,0.43619682317883096,0.43619682317883096,0.0,-0.6242669624218805,0,0,1,1,-0.6242669624218805,0.0
2657,12,18,22,83,80,1,2125.862,50,1513.774,MORE,444,610,1054,2,2,-3.0,-0.28122253820234633,3.0,-1.0476454436543674,-1.3025663317552305,-0.026926867635168043,163,83,80,1,0.05983508244547061,0.1170500554541026,0.0,-0.43976552089994847,0.057318501631334756,0.057318501631334756,0.0,0.1170500554541026,0,1,0,1,0.1170500554541026,0.0
2658,12,19,54,101,110,1,1668.862,70,809.275,MORE,738,366,1104,1,2,9.0,0.8436676146070391,9.0,0.0,-0.2708306234342558,-0.528866812427279,211,101,110,0,1.0171964015730004,0.8193503881787182,1.170500554541026,-1.2393391952634913,0.5214444455270176,0.5214444455270176,1.170500554541026,0.8193503881787182,0,0,1,2,1.170500554541026,0.8193503881787182
2659,12,20,6,56,50,0,3030.588,70,1572.139,MORE,-486,1572,1086,4,2,-6.0,-0.5624450764046927,6.0,-0.5238227218271837,-0.2708306234342558,0.9667670459140384,106,56,50,1,-1.077031484018471,-0.9364004436328208,-1.170500554541026,1.1593818278271373,-1.4108349943652128,1.4108349943652128,-1.170500554541026,-0.9364004436328208,0,1,0,0,-0.9364004436328208,-1.170500554541026
2660,12,21,18,50,42,0,4424.91,80,658.199,MORE,38,2130,2168,4,2,-8.0,-0.7499267685395902,8.0,-0.17460757394239454,0.24503723072623146,2.4982022925276612,92,50,42,1,-1.3562618687640005,-1.170500554541026,-1.4826340357519663,1.1593818278271373,-0.5836173256531796,0.5836173256531796,-1.4826340357519663,-1.170500554541026,1,1,0,0,-1.170500554541026,-1.4826340357519663
2661,12,22,43,110,117,1,2969.178,70,580.9259999999998,MORE,810,834,1644,2,2,7.0,0.6561859224721414,7.0,-0.34921514788478913,-0.2708306234342558,0.8993181793720609,227,110,117,0,1.3363168412821769,1.170500554541026,1.4436173506005987,-0.43976552089994847,0.6351079419912664,0.6351079419912664,1.4436173506005987,1.170500554541026,0,1,1,2,1.4436173506005987,1.170500554541026
2662,12,23,32,77,80,1,1303.4489999999996,70,1539.59,MORE,762,294,1056,1,2,3.0,0.28122253820234633,3.0,-1.0476454436543674,-0.2708306234342558,-0.9302133792682414,157,77,80,0,-0.05983508244547061,-0.1170500554541026,0.0,-1.2393391952634913,0.5593322776817672,0.5593322776817672,0.0,-0.1170500554541026,0,0,1,1,-0.1170500554541026,0.0
2663,12,24,27,80,91,1,1357.856,70,531.259,MORE,812,300,1112,1,2,11.0,1.0311493067419364,11.0,0.34921514788478913,-0.2708306234342558,-0.8704561657533517,171,80,91,0,0.21939530230005888,0.0,0.4291835366650429,-1.2393391952634913,0.6382652613374956,0.6382652613374956,0.4291835366650429,0.0,0,0,1,1,0.4291835366650429,0.0
2664,12,25,16,44,50,1,2354.092,70,1549.766,MORE,634,816,1450,3,2,6.0,0.5624450764046927,6.0,-0.5238227218271837,-0.2708306234342558,0.22374655380882205,94,44,50,0,-1.3163718138003533,-1.4046006654492311,-1.170500554541026,0.35980815346359446,0.3572638395231026,0.3572638395231026,-1.170500554541026,-1.4046006654492311,0,1,0,0,-1.4046006654492311,-1.170500554541026
2665,12,26,7,50,57,1,2004.533,80,637.016,MORE,722,684,1406,3,2,7.0,0.6561859224721414,7.0,-0.34921514788478913,0.24503723072623146,-0.16018698046160593,107,50,57,0,-1.0570864565366473,-1.170500554541026,-0.8973837584814532,0.35980815346359446,0.4961858907571845,0.4961858907571845,-0.8973837584814532,-1.170500554541026,1,1,1,0,-1.170500554541026,-0.8973837584814532
2666,12,27,14,50,46,0,3356.951,70,475.594,MORE,424,1056,1480,2,2,-4.0,-0.3749633842697951,4.0,-0.8730378697119728,-0.2708306234342558,1.3252235583914729,96,50,46,1,-1.2764817588367063,-1.170500554541026,-1.3265672951464962,-0.43976552089994847,0.02574530816904341,0.02574530816904341,-1.3265672951464962,-1.170500554541026,0,1,0,0,-1.170500554541026,-1.3265672951464962
2667,12,28,51,110,108,1,1521.511,80,686.9019999999998,MORE,430,474,904,1,2,-2.0,-0.18748169213489754,2.0,-1.222253017596762,0.24503723072623146,-0.6907078470116605,218,110,108,1,1.156811593945765,1.170500554541026,1.092467184238291,-1.2393391952634913,0.035217266207730816,0.035217266207730816,1.092467184238291,1.170500554541026,0,0,0,2,1.170500554541026,1.092467184238291
2668,12,29,50,133,110,1,1888.712,70,2557.294,MORE,-2,826,824,1,2,-23.0,-2.1560394595513217,23.0,2.444506035193524,-0.2708306234342558,-0.2873974538659101,243,133,110,1,1.6554372809913533,2.0678843130224793,1.170500554541026,-1.2393391952634913,-0.6467637125777623,0.6467637125777623,1.170500554541026,2.0678843130224793,0,0,0,2,2.0678843130224793,1.170500554541026
2669,12,30,49,131,110,0,3473.523,80,564.7869999999998,MORE,192,1444,1636,3,2,-21.0,-1.9685577674164243,21.0,2.0952908873087353,0.24503723072623146,1.4532588827772632,241,131,110,1,1.6155472260277064,1.9898509427197442,1.170500554541026,0.35980815346359446,-0.3405037359935362,0.3405037359935362,1.170500554541026,1.9898509427197442,1,1,0,2,1.9898509427197442,1.170500554541026
2670,12,31,47,126,110,1,1729.091,60,1518.692,MORE,444,676,1120,1,2,-16.0,-1.4998535370791803,16.0,1.222253017596762,-0.7866984775947429,-0.4627150817163731,236,126,110,1,1.5158220886185887,1.7947675169629065,1.170500554541026,-1.2393391952634913,0.057318501631334756,0.057318501631334756,1.170500554541026,1.7947675169629065,0,0,0,2,1.7947675169629065,1.170500554541026
2671,12,32,50,110,133,1,2395.127,70,1458.256,MORE,36,746,782,2,2,23.0,2.1560394595513217,23.0,2.444506035193524,-0.2708306234342558,0.2688168068384593,243,110,133,0,1.6554372809913533,1.170500554541026,2.0678843130224793,-0.43976552089994847,-0.5867746449994088,0.5867746449994088,2.0678843130224793,1.170500554541026,0,1,0,2,2.0678843130224793,1.170500554541026
2672,12,33,47,110,126,1,1582.4129999999998,80,565.764,MORE,874,316,1190,1,2,16.0,1.4998535370791803,16.0,1.222253017596762,0.24503723072623146,-0.6238169355943103,236,110,126,0,1.5158220886185887,1.170500554541026,1.7947675169629065,-1.2393391952634913,0.7361421610705987,0.7361421610705987,1.7947675169629065,1.170500554541026,1,0,1,2,1.7947675169629065,1.170500554541026
2673,12,34,12,48,50,1,3903.343,60,985.443,MORE,1608,792,2400,3,2,2.0,0.18748169213489754,2.0,-1.222253017596762,-0.7866984775947429,1.9253460317281272,98,48,50,0,-1.2365917038730592,-1.248533924843761,-1.170500554541026,0.35980815346359446,1.8948783611366913,1.8948783611366913,-1.170500554541026,-1.248533924843761,0,1,1,0,-1.248533924843761,-1.170500554541026
2674,12,35,32,80,77,0,2663.144,60,362.908,MORE,-470,1414,944,4,2,-3.0,-0.28122253820234633,3.0,-1.0476454436543674,-0.7866984775947429,0.5631897569114288,157,80,77,1,-0.05983508244547061,0.0,-0.1170500554541026,1.1593818278271373,-1.3855764395953798,1.3855764395953798,-0.1170500554541026,0.0,0,1,0,1,0.0,-0.1170500554541026
2675,12,36,43,117,110,1,1934.49,80,635.7,MORE,522,690,1212,3,2,-7.0,-0.6561859224721414,7.0,-0.34921514788478913,0.24503723072623146,-0.23711778911165796,227,117,110,1,1.3363168412821769,1.4436173506005987,1.170500554541026,0.35980815346359446,0.180453956134271,0.180453956134271,1.170500554541026,1.4436173506005987,1,1,0,2,1.4436173506005987,1.170500554541026
2676,12,37,40,80,64,0,2405.19,70,1514.385,MORE,-148,1208,1060,2,2,-16.0,-1.4998535370791803,16.0,1.222253017596762,-0.2708306234342558,0.2798693706556213,144,80,64,1,-0.3191204397091766,0.0,-0.6242669624218805,-0.43976552089994847,-0.8772480248524891,0.8772480248524891,-0.6242669624218805,0.0,0,1,0,1,0.0,-0.6242669624218805
2677,12,38,31,80,78,1,1545.105,70,812.57,MORE,852,398,1250,1,2,-2.0,-0.18748169213489754,2.0,-1.222253017596762,-0.2708306234342558,-0.6647936871485859,158,80,78,1,-0.03989005496364707,0.0,-0.07803337030273506,-1.2393391952634913,0.7014116482620782,0.7014116482620782,-0.07803337030273506,0.0,0,0,1,1,0.0,-0.07803337030273506
2678,12,39,46,124,110,0,2604.714,70,1988.39,MORE,-1998,1998,0,0,1,-14.0,-1.3123718449442827,14.0,0.8730378697119728,-0.2708306234342558,0.4990139342107659,234,124,110,1,1.4759320336549415,1.7167341466601715,1.170500554541026,-2.038912869627034,-3.797768420114439,3.797768420114439,1.170500554541026,1.7167341466601715,0,0,0,2,1.7167341466601715,1.170500554541026
2679,12,40,58,92,110,1,1120.327,80,1225.977,MORE,766,302,1068,1,2,18.0,1.6873352292140782,18.0,1.571468165481551,0.24503723072623146,-1.1313430216538447,202,92,110,0,0.8376911542365885,0.4682002218164104,1.170500554541026,-1.2393391952634913,0.5656469163742255,0.5656469163742255,1.170500554541026,0.4682002218164104,1,0,1,2,1.170500554541026,0.4682002218164104
2680,12,41,49,110,131,0,4133.502,100,2319.173,LESS,-178,2108,1930,3,2,21.0,1.9685577674164243,21.0,2.0952908873087353,1.2767729390472058,2.178138144974096,241,110,131,1,1.6155472260277064,1.170500554541026,1.9898509427197442,0.35980815346359446,-0.924607815045926,0.924607815045926,1.9898509427197442,1.170500554541026,1,1,0,2,1.9898509427197442,1.170500554541026
2681,12,42,13,47,50,0,2344.901,80,1289.56,LESS,532,1006,1538,4,2,3.0,0.28122253820234633,3.0,-1.0476454436543674,0.24503723072623146,0.21365173973314497,97,47,50,1,-1.2565367313548828,-1.2875506099951286,-1.170500554541026,1.1593818278271373,0.1962405528654167,0.1962405528654167,-1.170500554541026,-1.2875506099951286,1,1,1,0,-1.2875506099951286,-1.170500554541026
2682,12,43,16,50,44,0,4172.514,80,1289.197,LESS,-426,1950,1524,4,2,-6.0,-0.5624450764046927,6.0,-0.5238227218271837,0.24503723072623146,2.220986462536962,94,50,44,0,-1.3163718138003533,-1.170500554541026,-1.4046006654492311,1.1593818278271373,-1.3161154139783389,1.3161154139783389,-1.4046006654492311,-1.170500554541026,1,1,0,0,-1.170500554541026,-1.4046006654492311
2683,12,44,7,57,50,1,2683.681,80,1270.562,LESS,992,610,1602,2,2,-7.0,-0.6561859224721414,7.0,-0.34921514788478913,0.24503723072623146,0.5857463009950079,107,57,50,0,-1.0570864565366473,-0.8973837584814532,-1.170500554541026,-0.43976552089994847,0.9224240024981177,0.9224240024981177,-1.170500554541026,-0.8973837584814532,1,0,1,0,-0.8973837584814532,-1.170500554541026
2684,12,45,18,42,50,0,2372.649,80,661.3789999999998,LESS,142,992,1134,2,2,8.0,0.7499267685395902,8.0,-0.17460757394239454,0.24503723072623146,0.2441283909105881,92,42,50,1,-1.3562618687640005,-1.4826340357519663,-1.170500554541026,-0.43976552089994847,-0.4194367196492646,0.4194367196492646,-1.170500554541026,-1.4826340357519663,1,0,0,0,-1.4826340357519663,-1.170500554541026
2685,12,46,51,108,110,1,2718.9709999999995,80,996.493,LESS,604,1100,1704,3,2,2.0,0.18748169213489754,2.0,-1.222253017596762,0.24503723072623146,0.6245066087668097,218,108,110,1,1.156811593945765,1.092467184238291,1.170500554541026,0.35980815346359446,0.30990404932966553,0.30990404932966553,1.170500554541026,1.092467184238291,1,1,1,2,1.170500554541026,1.092467184238291
2686,12,47,31,78,80,0,2275.609,80,1149.489,LESS,-112,1156,1044,4,2,2.0,0.18748169213489754,2.0,-1.222253017596762,0.24503723072623146,0.13754578206457846,158,78,80,1,-0.03989005496364707,-0.07803337030273506,0.0,1.1593818278271373,-0.8204162766203646,0.8204162766203646,0.0,-0.07803337030273506,1,1,0,1,-0.07803337030273506,0.0
2687,12,48,58,110,92,1,3663.207,80,1724.11,LESS,914,1514,2428,3,2,-18.0,-1.6873352292140782,18.0,1.571468165481551,0.24503723072623146,1.6615958116349143,202,110,92,0,0.8376911542365885,1.170500554541026,0.4682002218164104,0.35980815346359446,0.7992885479951815,0.7992885479951815,0.4682002218164104,1.170500554541026,1,1,1,2,1.170500554541026,0.4682002218164104
2688,12,49,12,50,48,0,4535.443,80,636.239,LESS,72,1924,1996,5,2,-2.0,-0.18748169213489754,2.0,-1.222253017596762,0.24503723072623146,2.6196047606189232,98,50,48,0,-1.2365917038730592,-1.170500554541026,-1.248533924843761,1.9589555021906802,-0.5299428967672843,0.5299428967672843,-1.248533924843761,-1.170500554541026,1,1,0,0,-1.170500554541026,-1.248533924843761
2689,12,50,54,110,101,1,3811.3,70,756.81,LESS,524,1236,1760,2,2,-9.0,-0.8436676146070391,9.0,0.0,-0.2708306234342558,1.8242518121690459,211,110,101,0,1.0171964015730004,1.170500554541026,0.8193503881787182,-0.43976552089994847,0.18361127548050016,0.18361127548050016,0.8193503881787182,1.170500554541026,0,0,1,2,1.170500554541026,0.8193503881787182
2690,12,51,14,46,50,0,1867.991,70,1906.049,LESS,-218,928,710,1,2,4.0,0.3749633842697951,4.0,-0.8730378697119728,-0.2708306234342558,-0.3101560919316373,96,46,50,1,-1.2764817588367063,-1.3265672951464962,-1.170500554541026,-1.2393391952634913,-0.9877542019705088,0.9877542019705088,-1.170500554541026,-1.3265672951464962,0,0,0,0,-1.3265672951464962,-1.170500554541026
2691,12,52,22,80,83,0,3144.909,80,584.543,LESS,626,866,1492,4,2,3.0,0.28122253820234633,3.0,-1.0476454436543674,0.24503723072623146,1.0923300140290906,163,80,83,1,0.05983508244547061,0.0,0.1170500554541026,1.1593818278271373,0.34463456213818605,0.34463456213818605,0.1170500554541026,0.0,1,1,1,1,0.1170500554541026,0.0
2692,12,53,6,50,56,0,1893.776,80,2028.186,LESS,-142,978,836,2,2,6.0,0.5624450764046927,6.0,-0.5238227218271837,0.24503723072623146,-0.2818354760093953,106,50,56,1,-1.077031484018471,-1.170500554541026,-0.9364004436328208,-0.43976552089994847,-0.8677760668138017,0.8677760668138017,-0.9364004436328208,-1.170500554541026,1,0,0,0,-1.170500554541026,-0.9364004436328208
2693,12,54,13,50,47,0,1612.25,80,1674.87,LESS,160,762,922,2,2,-3.0,-0.28122253820234633,3.0,-1.0476454436543674,0.24503723072623146,-0.5910458587173687,97,50,47,0,-1.2565367313548828,-1.170500554541026,-1.2875506099951286,-0.43976552089994847,-0.3910208455332024,0.3910208455332024,-1.2875506099951286,-1.170500554541026,1,0,0,0,-1.170500554541026,-1.2875506099951286
2694,12,55,46,110,124,0,3018.789,80,2861.926,LESS,-522,2086,1564,4,2,14.0,1.3123718449442827,14.0,0.8730378697119728,0.24503723072623146,0.9538077693087822,234,110,124,1,1.4759320336549415,1.170500554541026,1.7167341466601715,1.1593818278271373,-1.4676667425973373,1.4676667425973373,1.7167341466601715,1.170500554541026,1,1,0,2,1.7167341466601715,1.170500554541026
2695,12,56,27,91,80,0,3229.2209999999995,80,722.196,LESS,432,1384,1816,4,2,-11.0,-1.0311493067419364,11.0,0.34921514788478913,0.24503723072623146,1.1849329913273667,171,91,80,0,0.21939530230005888,0.4291835366650429,0.0,1.1593818278271373,0.03837458555395995,0.03837458555395995,0.0,0.4291835366650429,1,1,1,1,0.4291835366650429,0.0
2696,12,57,40,64,80,0,2085.74,80,1544.729,LESS,-276,1278,1002,3,2,16.0,1.4998535370791803,16.0,1.222253017596762,0.24503723072623146,-0.070994339112081,144,64,80,1,-0.3191204397091766,-0.6242669624218805,0.0,0.35980815346359446,-1.0793164630111536,1.0793164630111536,0.0,-0.6242669624218805,0,1,0,1,-0.6242669624218805,0.0
2697,12,58,22,83,80,0,3047.369,70,1949.011,LESS,508,1214,1722,4,2,-3.0,-0.28122253820234633,3.0,-1.0476454436543674,-0.2708306234342558,0.9851982367533304,163,83,80,0,0.05983508244547061,0.1170500554541026,0.0,1.1593818278271373,0.15835272071066708,0.15835272071066708,0.0,0.1170500554541026,0,1,1,1,0.1170500554541026,0.0
2698,12,59,54,101,110,0,2189.348,70,1784.322,LESS,578,1086,1664,4,1,9.0,0.8436676146070391,9.0,0.0,-0.2708306234342558,0.042802146227133686,211,101,110,1,1.0171964015730004,0.8193503881787182,1.170500554541026,1.1593818278271373,0.26885889782868677,0.26885889782868677,1.170500554541026,0.8193503881787182,0,1,1,2,1.170500554541026,0.8193503881787182
2699,12,60,6,56,50,0,2105.953,80,1307.251,LESS,790,656,1446,3,2,-6.0,-0.5624450764046927,6.0,-0.5238227218271837,0.24503723072623146,-0.04879365617098028,106,56,50,0,-1.077031484018471,-0.9364004436328208,-1.170500554541026,0.35980815346359446,0.603534748528975,0.603534748528975,-1.170500554541026,-0.9364004436328208,0,1,1,0,-0.9364004436328208,-1.170500554541026
2700,12,61,18,50,42,0,2914.9240000000004,80,1803.093,LESS,112,1294,1406,4,2,-8.0,-0.7499267685395902,8.0,-0.17460757394239454,0.24503723072623146,0.8397290113966761,92,50,42,0,-1.3562618687640005,-1.170500554541026,-1.4826340357519663,1.1593818278271373,-0.4667965098427016,0.4667965098427016,-1.4826340357519663,-1.170500554541026,1,1,0,0,-1.170500554541026,-1.4826340357519663
2701,12,62,43,110,117,0,2821.451,80,2165.512,LESS,482,1352,1834,3,2,7.0,0.6561859224721414,7.0,-0.34921514788478913,0.24503723072623146,0.7370641701285072,227,110,117,1,1.3363168412821769,1.170500554541026,1.4436173506005987,0.35980815346359446,0.11730756920968832,0.11730756920968832,1.4436173506005987,1.170500554541026,1,1,1,2,1.4436173506005987,1.170500554541026
2702,12,63,32,77,80,0,1907.541,70,596.931,LESS,386,792,1178,4,2,3.0,0.28122253820234633,3.0,-1.0476454436543674,-0.2708306234342558,-0.2667168691383595,157,77,80,1,-0.05983508244547061,-0.1170500554541026,0.0,1.1593818278271373,-0.034243759409310154,0.034243759409310154,0.0,-0.1170500554541026,0,1,1,1,-0.1170500554541026,0.0
2703,12,64,27,80,91,0,2266.263,90,2359.055,LESS,122,1336,1458,4,2,11.0,1.0311493067419364,11.0,0.34921514788478913,0.7609050848867186,0.12728072577567895,171,80,91,1,0.21939530230005888,0.0,0.4291835366650429,1.1593818278271373,-0.45100991311155597,0.45100991311155597,0.4291835366650429,0.0,1,1,0,1,0.4291835366650429,0.0
2704,12,65,16,44,50,0,1622.7179999999996,90,2520.128,LESS,520,830,1350,2,2,6.0,0.5624450764046927,6.0,-0.5238227218271837,0.7609050848867186,-0.5795484684721092,94,44,50,1,-1.3163718138003533,-1.4046006654492311,-1.170500554541026,-0.43976552089994847,0.1772966367880419,0.1772966367880419,-1.170500554541026,-1.4046006654492311,1,0,1,0,-1.4046006654492311,-1.170500554541026
2705,12,66,7,50,57,0,1739.322,90,2308.085,LESS,358,658,1016,4,2,7.0,0.6561859224721414,7.0,-0.34921514788478913,0.7609050848867186,-0.45147799730681504,107,50,57,1,-1.0570864565366473,-1.170500554541026,-0.8973837584814532,1.1593818278271373,-0.07844623025651803,0.07844623025651803,-0.8973837584814532,-1.170500554541026,1,1,1,0,-1.170500554541026,-0.8973837584814532
2706,12,67,14,50,46,0,1307.09,90,1128.469,LESS,430,686,1116,2,2,-4.0,-0.3749633842697951,4.0,-0.8730378697119728,0.7609050848867186,-0.9262143347627968,96,50,46,0,-1.2764817588367063,-1.170500554541026,-1.3265672951464962,-0.43976552089994847,0.035217266207730816,0.035217266207730816,-1.3265672951464962,-1.170500554541026,1,0,1,0,-1.170500554541026,-1.3265672951464962
2707,12,68,51,110,108,1,2422.374,80,533.872,LESS,558,738,1296,3,2,-2.0,-0.18748169213489754,2.0,-1.222253017596762,0.24503723072623146,0.298743191249292,218,110,108,0,1.156811593945765,1.170500554541026,1.092467184238291,0.35980815346359446,0.23728570436639546,0.23728570436639546,1.092467184238291,1.170500554541026,0,1,1,2,1.170500554541026,1.092467184238291
2708,12,69,50,133,110,1,1741.7620000000004,90,634.54,LESS,1270,396,1666,1,2,-23.0,-2.1560394595513217,23.0,2.444506035193524,0.7609050848867186,-0.4487980553696311,243,133,110,0,1.6554372809913533,2.0678843130224793,1.170500554541026,-1.2393391952634913,1.3612913916239675,1.3612913916239675,1.170500554541026,2.0678843130224793,1,0,1,2,2.0678843130224793,1.170500554541026
2709,12,70,49,131,110,1,2127.148,80,2722.119,LESS,742,838,1580,4,2,-21.0,-1.9685577674164243,21.0,2.0952908873087353,0.24503723072623146,-0.025514406433849262,241,131,110,0,1.6155472260277064,1.9898509427197442,1.170500554541026,1.1593818278271373,0.5277590842194758,0.5277590842194758,1.170500554541026,1.9898509427197442,0,1,1,2,1.9898509427197442,1.170500554541026
2710,12,71,47,126,110,0,1678.1470000000004,80,1357.464,LESS,-282,920,638,2,2,-16.0,-1.4998535370791803,16.0,1.222253017596762,0.24503723072623146,-0.5186687546868087,236,126,110,0,1.5158220886185887,1.7947675169629065,1.170500554541026,-0.43976552089994847,-1.088788421049841,1.088788421049841,1.170500554541026,1.7947675169629065,0,0,0,2,1.7947675169629065,1.170500554541026
2711,12,72,50,110,133,0,1387.816,80,936.644,LESS,-180,722,542,3,2,23.0,2.1560394595513217,23.0,2.444506035193524,0.24503723072623146,-0.8375499934426917,243,110,133,1,1.6554372809913533,1.170500554541026,2.0678843130224793,0.35980815346359446,-0.9277651343921552,0.9277651343921552,2.0678843130224793,1.170500554541026,0,1,0,2,2.0678843130224793,1.170500554541026
2712,12,73,47,110,126,0,3761.125,80,994.934,LESS,64,1564,1628,4,1,16.0,1.4998535370791803,16.0,1.222253017596762,0.24503723072623146,1.7691427602435663,236,110,126,1,1.5158220886185887,1.170500554541026,1.7947675169629065,1.1593818278271373,-0.5425721741522008,0.5425721741522008,1.7947675169629065,1.170500554541026,0,1,0,2,1.7947675169629065,1.170500554541026
2713,12,74,12,48,50,0,2172.223,80,1052.427,LESS,-126,1054,928,5,2,2.0,0.18748169213489754,2.0,-1.222253017596762,0.24503723072623146,0.02399312750817329,98,48,50,1,-1.2365917038730592,-1.248533924843761,-1.170500554541026,1.9589555021906802,-0.8425175120439686,0.8425175120439686,-1.170500554541026,-1.248533924843761,0,1,0,0,-1.248533924843761,-1.170500554541026
2714,12,75,32,80,77,0,1835.106,80,2054.531,LESS,-442,1162,720,2,2,-3.0,-0.28122253820234633,3.0,-1.0476454436543674,0.24503723072623146,-0.3462748995563388,157,80,77,0,-0.05983508244547061,0.0,-0.1170500554541026,-0.43976552089994847,-1.3413739687481718,1.3413739687481718,-0.1170500554541026,0.0,0,0,0,1,0.0,-0.1170500554541026
2715,12,76,43,117,110,0,1694.167,80,675.811,LESS,-418,1100,682,2,2,-7.0,-0.6561859224721414,7.0,-0.34921514788478913,0.24503723072623146,-0.5010733981975978,227,117,110,0,1.3363168412821769,1.4436173506005987,1.170500554541026,-0.43976552089994847,-1.3034861365934223,1.3034861365934223,1.170500554541026,1.4436173506005987,0,0,0,2,1.4436173506005987,1.170500554541026
2716,12,77,40,80,64,0,1639.164,40,437.917,LESS,-340,904,564,3,2,-16.0,-1.4998535370791803,16.0,1.222253017596762,-1.8184341859157171,-0.5614852204807498,144,80,64,0,-0.3191204397091766,0.0,-0.6242669624218805,0.35980815346359446,-1.180350682090486,1.180350682090486,-0.6242669624218805,0.0,0,1,0,1,0.0,-0.6242669624218805
2717,12,78,31,80,78,0,1822.856,80,728.9960000000002,LESS,98,786,884,2,2,-2.0,-0.18748169213489754,2.0,-1.222253017596762,0.24503723072623146,-0.3597295260852302,158,80,78,0,-0.03989005496364707,0.0,-0.07803337030273506,-0.43976552089994847,-0.4888977452663056,0.4888977452663056,-0.07803337030273506,0.0,0,0,0,1,0.0,-0.07803337030273506
2718,12,79,46,124,110,0,1955.912,90,576.611,LESS,62,1134,1196,2,2,-14.0,-1.3123718449442827,14.0,0.8730378697119728,0.7609050848867186,-0.21358921690742028,234,124,110,0,1.4759320336549415,1.7167341466601715,1.170500554541026,-0.43976552089994847,-0.54572949349843,0.54572949349843,1.170500554541026,1.7167341466601715,1,0,0,2,1.7167341466601715,1.170500554541026
2719,12,80,58,92,110,0,1829.862,90,1200.454,LESS,370,1028,1398,2,2,18.0,1.6873352292140782,18.0,1.571468165481551,0.7609050848867186,-0.3520345780475637,202,92,110,1,0.8376911542365885,0.4682002218164104,1.170500554541026,-0.43976552089994847,-0.05950231417914323,0.05950231417914323,1.170500554541026,0.4682002218164104,1,0,1,2,1.170500554541026,0.4682002218164104
2720,12,81,48,128,110,0,2319.583,90,3620.087,MORE,506,1434,1940,4,2,-18.0,-1.6873352292140782,18.0,1.571468165481551,0.7609050848867186,0.1858440471242904,238,128,110,1,1.5557121435822359,1.8728008872656416,1.170500554541026,1.1593818278271373,0.15519540136443793,0.15519540136443793,1.170500554541026,1.8728008872656416,1,1,0,2,1.8728008872656416,1.170500554541026
2721,12,82,8,50,58,1,2658.008,90,1733.719,MORE,1026,922,1948,3,2,8.0,0.7499267685395902,8.0,-0.17460757394239454,0.7609050848867186,0.55754869880103,108,50,58,0,-1.0371414290548238,-1.170500554541026,-0.8583670733300858,0.35980815346359446,0.9760984313840131,0.9760984313840131,-0.8583670733300858,-1.170500554541026,1,1,1,0,-1.170500554541026,-0.8583670733300858
2722,12,83,4,54,50,0,4644.769,90,1073.908,MORE,460,2076,2536,6,2,-4.0,-0.3749633842697951,4.0,-0.8730378697119728,0.7609050848867186,2.7396815361207656,104,54,50,1,-1.116921538982118,-1.0144338139355558,-1.170500554541026,2.758529176554223,0.08257705640116783,0.08257705640116783,-1.170500554541026,-1.0144338139355558,1,1,0,0,-1.0144338139355558,-1.170500554541026
2723,12,84,37,80,69,0,2336.904,20,1689.57,MORE,-636,1380,744,2,1,-11.0,-1.0311493067419364,11.0,0.34921514788478913,-2.850169894236692,0.20486833986771294,149,80,69,1,-0.21939530230005888,0.0,-0.4291835366650429,-0.43976552089994847,-1.647633945332398,1.647633945332398,-0.4291835366650429,0.0,0,1,0,1,0.0,-0.4291835366650429
2724,12,85,52,105,110,1,2232.262,70,1564.033,MORE,442,808,1250,3,2,5.0,0.4687042303372438,5.0,-0.6984302957695783,-0.2708306234342558,0.08993617421577428,215,105,110,0,1.0969765115002945,0.9754171287841883,1.170500554541026,0.35980815346359446,0.05416118228510562,0.05416118228510562,1.170500554541026,0.9754171287841883,0,1,0,2,1.170500554541026,0.9754171287841883
2725,12,86,5,55,50,0,2404.233,60,1460.526,MORE,-582,1316,734,2,1,-5.0,-0.4687042303372438,5.0,-0.6984302957695783,-0.7866984775947429,0.27881826228107864,105,55,50,1,-1.0969765115002945,-0.9754171287841883,-1.170500554541026,-0.43976552089994847,-1.5623863229842112,1.5623863229842112,-1.170500554541026,-0.9754171287841883,0,0,0,0,-0.9754171287841883,-1.170500554541026
2726,12,87,30,96,80,0,3773.941,80,1247.405,MORE,290,2010,2300,5,2,-16.0,-1.4998535370791803,16.0,1.222253017596762,0.24503723072623146,1.7832190454349353,176,96,80,1,0.3191204397091766,0.6242669624218805,0.0,1.9589555021906802,-0.18579508802830863,0.18579508802830863,0.0,0.6242669624218805,1,1,0,1,0.6242669624218805,0.0
2727,12,88,33,80,75,0,1389.338,80,2212.317,MORE,244,892,1136,2,2,-5.0,-0.4687042303372438,5.0,-0.6984302957695783,0.24503723072623146,-0.8358783247425308,155,80,75,1,-0.09972513740911768,0.0,-0.19508342575683765,-0.43976552089994847,-0.2584134329915787,0.2584134329915787,-0.19508342575683765,0.0,1,0,0,1,0.0,-0.19508342575683765
2728,12,89,48,110,128,1,1345.217,90,2604.087,MORE,1216,326,1542,1,2,18.0,1.6873352292140782,18.0,1.571468165481551,0.7609050848867186,-0.8843380453205891,238,110,128,0,1.5557121435822359,1.170500554541026,1.8728008872656416,-1.2393391952634913,1.276043769275781,1.276043769275781,1.8728008872656416,1.170500554541026,1,0,1,2,1.8728008872656416,1.170500554541026
2729,12,90,9,59,50,0,2517.299,80,2631.09,MORE,-236,1608,1372,1,2,-9.0,-0.8436676146070391,9.0,0.0,0.24503723072623146,0.4030028176374566,109,59,50,1,-1.0171964015730004,-0.8193503881787182,-1.170500554541026,-1.2393391952634913,-1.016170076086571,1.016170076086571,-1.170500554541026,-0.8193503881787182,1,0,0,0,-0.8193503881787182,-1.170500554541026
2730,12,91,44,110,119,1,1667.654,80,1497.9589999999996,MORE,1600,362,1962,1,2,9.0,0.8436676146070391,9.0,0.0,0.24503723072623146,-0.5301936033535566,229,110,119,0,1.376206896245824,1.170500554541026,1.5216507209033339,-1.2393391952634913,1.8822490837517747,1.8822490837517747,1.5216507209033339,1.170500554541026,1,0,1,2,1.5216507209033339,1.170500554541026
2731,12,92,2,52,50,0,2896.692,80,1982.463,MORE,150,1312,1462,4,2,-2.0,-0.18748169213489754,2.0,-1.222253017596762,0.24503723072623146,0.8197041337742472,102,52,50,1,-1.156811593945765,-1.092467184238291,-1.170500554541026,1.1593818278271373,-0.40680744226434806,0.40680744226434806,-1.170500554541026,-1.092467184238291,1,1,0,0,-1.092467184238291,-1.170500554541026
2732,12,93,8,58,50,1,1162.424,90,702.6,MORE,936,256,1192,1,2,-8.0,-0.7499267685395902,8.0,-0.17460757394239454,0.7609050848867186,-1.085106334879417,108,58,50,1,-1.0371414290548238,-0.8583670733300858,-1.170500554541026,-1.2393391952634913,0.834019060803702,0.834019060803702,-1.170500554541026,-0.8583670733300858,1,0,1,0,-0.8583670733300858,-1.170500554541026
2733,12,94,44,119,110,0,1708.8370000000002,90,1104.725,MORE,-202,988,786,2,2,-9.0,-0.8436676146070391,9.0,0.0,0.7609050848867186,-0.4849607964687129,229,119,110,1,1.376206896245824,1.5216507209033339,1.170500554541026,-0.43976552089994847,-0.9624956472006757,0.9624956472006757,1.170500554541026,1.5216507209033339,1,1,0,2,1.5216507209033339,1.170500554541026
2734,12,95,34,74,80,1,1290.039,90,597.066,MORE,982,302,1284,1,2,6.0,0.5624450764046927,6.0,-0.5238227218271837,0.7609050848867186,-0.944942076554154,154,74,80,0,-0.11967016489094122,-0.2341001109082052,0.0,-1.2393391952634913,0.9066374057669722,0.9066374057669722,0.0,-0.2341001109082052,1,0,1,1,-0.2341001109082052,0.0
2735,12,96,24,86,80,1,1770.544,80,1630.783,MORE,1484,374,1858,1,2,-6.0,-0.5624450764046927,6.0,-0.5238227218271837,0.24503723072623146,-0.41718572387946395,166,86,80,1,0.11967016489094122,0.2341001109082052,0.0,-1.2393391952634913,1.6991245616704849,1.6991245616704849,0.0,0.2341001109082052,1,0,1,1,0.2341001109082052,0.0
2736,12,97,39,66,80,1,1432.934,90,2238.265,MORE,2130,254,2384,1,2,14.0,1.3123718449442827,14.0,0.8730378697119728,0.7609050848867186,-0.7879952310157105,146,66,80,0,-0.2792303847455295,-0.5462335921191455,0.0,-1.2393391952634913,2.7189387105024956,2.7189387105024956,0.0,-0.5462335921191455,1,0,1,1,-0.5462335921191455,0.0
2737,12,98,9,50,59,1,3000.278,40,1272.109,MORE,712,864,1576,3,2,9.0,0.8436676146070391,9.0,0.0,-1.8184341859157171,0.9334764557025526,109,50,59,0,-1.0171964015730004,-1.170500554541026,-0.8193503881787182,0.35980815346359446,0.4803992940260388,0.4803992940260388,-0.8193503881787182,-1.170500554541026,0,1,1,0,-1.170500554541026,-0.8193503881787182
2738,12,99,57,94,110,1,1799.973,80,1601.246,MORE,670,642,1312,3,2,16.0,1.4998535370791803,16.0,1.222253017596762,0.24503723072623146,-0.3848627684411993,204,94,110,0,0.8775812092002355,0.5462335921191455,1.170500554541026,0.35980815346359446,0.414095587755227,0.414095587755227,1.170500554541026,0.5462335921191455,1,1,1,2,1.170500554541026,0.5462335921191455
2739,12,100,60,110,87,0,1775.2,80,1134.16,MORE,160,786,946,3,2,-23.0,-2.1560394595513217,23.0,2.444506035193524,0.24503723072623146,-0.4120718674616258,197,110,87,1,0.7379660168274708,1.170500554541026,0.27311679605957273,0.35980815346359446,-0.3910208455332024,0.3910208455332024,0.27311679605957273,1.170500554541026,1,1,0,2,1.170500554541026,0.27311679605957273
2740,12,101,33,75,80,1,1256.005,90,614.303,MORE,938,224,1162,1,2,5.0,0.4687042303372438,5.0,-0.6984302957695783,0.7609050848867186,-0.9823228732304224,155,75,80,0,-0.09972513740911768,-0.19508342575683765,0.0,-1.2393391952634913,0.8371763801499311,0.8371763801499311,0.0,-0.19508342575683765,1,0,1,1,-0.19508342575683765,0.0
2741,12,102,15,50,45,0,3209.321,90,585.4630000000002,MORE,122,1470,1592,4,2,-5.0,-0.4687042303372438,5.0,-0.6984302957695783,0.7609050848867186,1.1630760878232906,95,50,45,1,-1.2964267863185297,-1.170500554541026,-1.3655839802978638,1.1593818278271373,-0.45100991311155597,0.45100991311155597,-1.3655839802978638,-1.170500554541026,1,1,0,0,-1.170500554541026,-1.3655839802978638
2742,12,103,59,89,110,1,1909.739,80,1443.4720000000002,MORE,592,680,1272,1,2,21.0,1.9685577674164243,21.0,2.0952908873087353,0.24503723072623146,-0.2643027247211755,199,89,110,0,0.7778560717911179,0.3511501663623078,1.170500554541026,-1.2393391952634913,0.29096013325229075,0.29096013325229075,1.170500554541026,0.3511501663623078,1,0,0,2,1.170500554541026,0.3511501663623078
2743,12,104,29,80,94,1,1389.695,80,666.4069999999998,MORE,638,270,908,1,2,14.0,1.3123718449442827,14.0,0.8730378697119728,0.24503723072623146,-0.8354862184836888,174,80,94,0,0.2792303847455295,0.0,0.5462335921191455,-1.2393391952634913,0.36357847821556083,0.36357847821556083,0.5462335921191455,0.0,1,0,0,1,0.5462335921191455,0.0
2744,12,105,55,110,98,1,1464.614,80,658.5189999999999,MORE,770,360,1130,1,2,-12.0,-1.124890152809385,12.0,0.5238227218271837,0.24503723072623146,-0.7531999193067079,208,110,98,1,0.9573613191275298,1.170500554541026,0.7023003327246156,-1.2393391952634913,0.5719615550666838,0.5719615550666838,0.7023003327246156,1.170500554541026,1,0,1,2,1.170500554541026,0.7023003327246156
2745,12,106,29,94,80,1,2393.765,90,1283.431,MORE,890,874,1764,3,2,-14.0,-1.3123718449442827,14.0,0.8730378697119728,0.7609050848867186,0.26732087203581834,174,94,80,1,0.2792303847455295,0.5462335921191455,0.0,0.35980815346359446,0.7614007158404318,0.7614007158404318,0.0,0.5462335921191455,1,1,1,1,0.5462335921191455,0.0
2746,12,107,57,110,94,1,1465.825,80,1432.394,MORE,1452,388,1840,1,2,-16.0,-1.4998535370791803,16.0,1.222253017596762,0.24503723072623146,-0.7518698333698519,204,110,94,1,0.8775812092002355,1.170500554541026,0.5462335921191455,-1.2393391952634913,1.6486074521308187,1.6486074521308187,0.5462335921191455,1.170500554541026,1,0,1,2,1.170500554541026,0.5462335921191455
2747,12,108,39,80,66,1,1234.519,80,1415.7,MORE,776,332,1108,1,2,-14.0,-1.3123718449442827,14.0,0.8730378697119728,0.24503723072623146,-1.0059217389936679,146,80,66,1,-0.2792303847455295,0.0,-0.5462335921191455,-1.2393391952634913,0.5814335131053712,0.5814335131053712,-0.5462335921191455,0.0,1,0,1,1,0.0,-0.5462335921191455
2748,12,109,4,50,54,1,2530.536,70,573.753,MORE,592,696,1288,3,2,4.0,0.3749633842697951,4.0,-0.8730378697119728,-0.2708306234342558,0.4175415026466759,104,50,54,0,-1.116921538982118,-1.170500554541026,-1.0144338139355558,0.35980815346359446,0.29096013325229075,0.29096013325229075,-1.0144338139355558,-1.170500554541026,0,1,0,0,-1.170500554541026,-1.0144338139355558
2749,12,110,55,98,110,1,1402.307,80,517.159,MORE,820,344,1164,1,2,12.0,1.124890152809385,12.0,0.5238227218271837,0.24503723072623146,-0.8216339940116578,208,98,110,0,0.9573613191275298,0.7023003327246156,1.170500554541026,-1.2393391952634913,0.6508945387224121,0.6508945387224121,1.170500554541026,0.7023003327246156,0,0,1,2,1.170500554541026,0.7023003327246156
2750,12,111,2,50,52,1,1189.071,90,878.807,MORE,1264,294,1558,1,2,2.0,0.18748169213489754,2.0,-1.222253017596762,0.7609050848867186,-1.055838952584285,102,50,52,0,-1.156811593945765,-1.170500554541026,-1.092467184238291,-1.2393391952634913,1.3518194335852802,1.3518194335852802,-1.092467184238291,-1.170500554541026,1,0,1,0,-1.170500554541026,-1.092467184238291
2751,12,112,59,110,89,0,2251.736,80,1881.041,MORE,-16,934,918,2,2,-21.0,-1.9685577674164243,21.0,2.0952908873087353,0.24503723072623146,0.111325186217703,199,110,89,1,0.7778560717911179,1.170500554541026,0.3511501663623078,-0.43976552089994847,-0.6688649480013662,0.6688649480013662,0.3511501663623078,1.170500554541026,0,1,0,2,1.170500554541026,0.3511501663623078
2752,12,113,60,87,110,1,1241.553,80,1138.797,MORE,858,292,1150,1,2,23.0,2.1560394595513217,23.0,2.444506035193524,0.24503723072623146,-0.9981960375239356,197,87,110,0,0.7379660168274708,0.27311679605957273,1.170500554541026,-1.2393391952634913,0.7108836063007656,0.7108836063007656,1.170500554541026,0.27311679605957273,0,0,1,2,1.170500554541026,0.27311679605957273
2753,12,114,52,110,105,1,1491.138,80,620.984,MORE,1050,282,1332,1,2,-5.0,-0.4687042303372438,5.0,-0.6984302957695783,0.24503723072623146,-0.7240676324452947,215,110,105,1,1.0969765115002945,1.170500554541026,0.9754171287841883,-1.2393391952634913,1.0139862635387626,1.0139862635387626,0.9754171287841883,1.170500554541026,0,0,1,2,1.170500554541026,0.9754171287841883
2754,12,115,30,80,96,1,1117.673,80,1314.295,MORE,800,262,1062,1,2,16.0,1.4998535370791803,16.0,1.222253017596762,0.24503723072623146,-1.1342580076789612,176,80,96,0,0.3191204397091766,0.0,0.6242669624218805,-1.2393391952634913,0.6193213452601207,0.6193213452601207,0.6242669624218805,0.0,1,0,1,1,0.6242669624218805,0.0
2755,12,116,24,80,86,1,1573.281,90,716.1469999999998,MORE,160,616,776,1,2,6.0,0.5624450764046927,6.0,-0.5238227218271837,0.7609050848867186,-0.6338469477952764,166,80,86,0,0.11967016489094122,0.0,0.2341001109082052,-1.2393391952634913,-0.3910208455332024,0.3910208455332024,0.2341001109082052,0.0,1,0,0,1,0.2341001109082052,0.0
2756,12,117,5,50,55,1,4591.682,80,1914.617,MORE,-1096,2912,1816,3,2,5.0,0.4687042303372438,5.0,-0.6984302957695783,0.24503723072623146,2.6813741272604177,105,50,55,0,-1.0969765115002945,-1.170500554541026,-0.9754171287841883,0.35980815346359446,-2.373817394965099,2.373817394965099,-0.9754171287841883,-1.170500554541026,0,1,0,0,-1.170500554541026,-0.9754171287841883
2757,12,118,34,80,74,1,1523.109,80,1091.4160000000004,MORE,1206,310,1516,1,2,-6.0,-0.5624450764046927,6.0,-0.5238227218271837,0.24503723072623146,-0.6889527047101774,154,80,74,1,-0.11967016489094122,0.0,-0.2341001109082052,-1.2393391952634913,1.2602571725446352,1.2602571725446352,-0.2341001109082052,0.0,0,0,1,1,0.0,-0.2341001109082052
2758,12,119,15,45,50,1,1425.348,80,537.178,MORE,668,342,1010,1,2,5.0,0.4687042303372438,5.0,-0.6984302957695783,0.24503723072623146,-0.7963272144318876,95,45,50,0,-1.2964267863185297,-1.3655839802978638,-1.170500554541026,-1.2393391952634913,0.41093826840899783,0.41093826840899783,-1.170500554541026,-1.3655839802978638,0,0,0,0,-1.3655839802978638,-1.170500554541026
2759,12,120,37,69,80,1,1289.357,80,1150.871,MORE,1684,340,2024,1,2,11.0,1.0311493067419364,11.0,0.34921514788478913,0.24503723072623146,-0.945691142292334,149,69,80,0,-0.21939530230005888,-0.4291835366650429,0.0,-1.2393391952634913,2.0148564962933984,2.0148564962933984,0.0,-0.4291835366650429,0,0,1,1,-0.4291835366650429,0.0
2760,12,121,48,128,110,1,2394.368,90,1076.126,LESS,378,866,1244,3,2,-18.0,-1.6873352292140782,18.0,1.571468165481551,0.7609050848867186,0.2679831691620977,238,128,110,0,1.5557121435822359,1.8728008872656416,1.170500554541026,0.35980815346359446,-0.04687303679422669,0.04687303679422669,1.170500554541026,1.8728008872656416,1,1,1,2,1.8728008872656416,1.170500554541026
2761,12,122,8,50,58,0,2603.083,90,2095.939,LESS,556,1178,1734,2,2,8.0,0.7499267685395902,8.0,-0.17460757394239454,0.7609050848867186,0.4972225467929194,108,50,58,1,-1.0371414290548238,-1.170500554541026,-0.8583670733300858,-0.43976552089994847,0.2341283850201663,0.2341283850201663,-0.8583670733300858,-1.170500554541026,1,0,1,0,-1.170500554541026,-0.8583670733300858
2762,12,123,4,54,50,0,1765.114,80,2092.154,LESS,-170,1106,936,2,2,-4.0,-0.3749633842697951,4.0,-0.8730378697119728,0.24503723072623146,-0.4231496930265563,104,54,50,0,-1.116921538982118,-1.0144338139355558,-1.170500554541026,-0.43976552089994847,-0.9119785376610096,0.9119785376610096,-1.170500554541026,-1.0144338139355558,1,0,0,0,-1.0144338139355558,-1.170500554541026
2763,12,124,37,80,69,1,2620.021,70,1894.58,LESS,1114,814,1928,3,2,-11.0,-1.0311493067419364,11.0,0.34921514788478913,-0.2708306234342558,0.5158261765191531,149,80,69,0,-0.21939530230005888,0.0,-0.4291835366650429,0.35980815346359446,1.115020482618095,1.115020482618095,-0.4291835366650429,0.0,0,1,1,1,0.0,-0.4291835366650429
2764,12,125,52,105,110,0,2092.026,80,2013.372,LESS,96,938,1034,4,2,5.0,0.4687042303372438,5.0,-0.6984302957695783,0.24503723072623146,-0.06409019361325552,215,105,110,1,1.0969765115002945,0.9754171287841883,1.170500554541026,1.1593818278271373,-0.4920550646125347,0.4920550646125347,1.170500554541026,0.9754171287841883,1,1,0,2,1.170500554541026,0.9754171287841883
2765,12,126,5,55,50,0,1375.6029999999996,90,1446.296,LESS,234,698,932,3,2,-5.0,-0.4687042303372438,5.0,-0.6984302957695783,0.7609050848867186,-0.8509639815077821,105,55,50,0,-1.0969765115002945,-0.9754171287841883,-1.170500554541026,0.35980815346359446,-0.2742000297227244,0.2742000297227244,-1.170500554541026,-0.9754171287841883,1,1,1,0,-0.9754171287841883,-1.170500554541026
2766,12,127,30,96,80,0,1931.041,90,1777.3770000000004,LESS,1206,858,2064,5,2,-16.0,-1.4998535370791803,16.0,1.222253017596762,0.7609050848867186,-0.2409059529400781,176,96,80,0,0.3191204397091766,0.6242669624218805,0.0,1.9589555021906802,1.2602571725446352,1.2602571725446352,0.0,0.6242669624218805,1,1,1,1,0.6242669624218805,0.0
2767,12,128,33,80,75,1,2155.306,80,1271.057,LESS,680,790,1470,3,2,-5.0,-0.4687042303372438,5.0,-0.6984302957695783,0.24503723072623146,0.005412562855989271,155,80,75,0,-0.09972513740911768,0.0,-0.19508342575683765,0.35980815346359446,0.42988218448637266,0.42988218448637266,-0.19508342575683765,0.0,0,1,1,1,0.0,-0.19508342575683765
2768,12,129,48,110,128,0,1245.369,90,1273.703,LESS,340,750,1090,3,2,18.0,1.6873352292140782,18.0,1.571468165481551,0.7609050848867186,-0.9940047840680788,238,110,128,1,1.5557121435822359,1.170500554541026,1.8728008872656416,0.35980815346359446,-0.10686210437258026,0.10686210437258026,1.8728008872656416,1.170500554541026,1,1,1,2,1.8728008872656416,1.170500554541026
2769,12,130,9,59,50,1,1689.2320000000002,90,1612.0079999999996,LESS,904,638,1542,3,2,-9.0,-0.8436676146070391,9.0,0.0,0.7609050848867186,-0.5064936905992365,109,59,50,0,-1.0171964015730004,-0.8193503881787182,-1.170500554541026,0.35980815346359446,0.7835019512640358,0.7835019512640358,-1.170500554541026,-0.8193503881787182,1,1,1,0,-0.8193503881787182,-1.170500554541026
2770,12,131,44,110,119,0,1911.731,90,1805.699,LESS,456,1054,1510,3,2,9.0,0.8436676146070391,9.0,0.0,0.7609050848867186,-0.26211483769704885,229,110,119,1,1.376206896245824,1.170500554541026,1.5216507209033339,0.35980815346359446,0.07626241770870956,0.07626241770870956,1.5216507209033339,1.170500554541026,1,1,1,2,1.5216507209033339,1.170500554541026
2771,12,132,2,52,50,0,1341.89,80,1202.417,LESS,266,712,978,3,2,-2.0,-0.18748169213489754,2.0,-1.222253017596762,0.24503723072623146,-0.8879922120521501,102,52,50,0,-1.156811593945765,-1.092467184238291,-1.170500554541026,0.35980815346359446,-0.22368292018305824,0.22368292018305824,-1.170500554541026,-1.092467184238291,0,1,1,0,-1.092467184238291,-1.170500554541026
2772,12,133,8,58,50,0,1148.135,90,636.795,LESS,152,686,838,3,2,-8.0,-0.7499267685395902,8.0,-0.17460757394239454,0.7609050848867186,-1.1008004702648315,108,58,50,0,-1.0371414290548238,-0.8583670733300858,-1.170500554541026,0.35980815346359446,-0.4036501229181189,0.4036501229181189,-1.170500554541026,-0.8583670733300858,1,1,0,0,-0.8583670733300858,-1.170500554541026
2773,12,134,44,119,110,1,2136.489,80,1842.865,LESS,1014,714,1728,3,2,-9.0,-0.8436676146070391,9.0,0.0,0.24503723072623146,-0.015254841829247391,229,119,110,0,1.376206896245824,1.5216507209033339,1.170500554541026,0.35980815346359446,0.9571545153066383,0.9571545153066383,1.170500554541026,1.5216507209033339,0,1,1,2,1.5216507209033339,1.170500554541026
2774,12,135,34,74,80,0,2217.437,90,1426.058,LESS,-92,1516,1424,3,2,6.0,0.5624450764046927,6.0,-0.5238227218271837,0.7609050848867186,0.07365333027366666,154,74,80,1,-0.11967016489094122,-0.2341001109082052,0.0,0.35980815346359446,-0.7888430831580734,0.7888430831580734,0.0,-0.2341001109082052,1,1,0,1,-0.2341001109082052,0.0
2775,12,136,24,86,80,0,1448.725,80,2038.094,LESS,302,1002,1304,5,2,-6.0,-0.5624450764046927,6.0,-0.5238227218271837,0.24503723072623146,-0.7706513936673249,166,86,80,0,0.11967016489094122,0.2341001109082052,0.0,1.9589555021906802,-0.16685117195093382,0.16685117195093382,0.0,0.2341001109082052,0,1,1,1,0.2341001109082052,0.0
2776,12,137,39,66,80,0,1879.483,80,1521.099,LESS,356,788,1144,1,2,14.0,1.3123718449442827,14.0,0.8730378697119728,0.24503723072623146,-0.2975340047422481,146,66,80,1,-0.2792303847455295,-0.5462335921191455,0.0,-1.2393391952634913,-0.08160354960274717,0.08160354960274717,0.0,-0.5462335921191455,0,0,1,1,-0.5462335921191455,0.0
2777,12,138,9,50,59,0,1172.7,80,1716.861,LESS,64,650,714,2,2,9.0,0.8436676146070391,9.0,0.0,0.24503723072623146,-1.0738198253111813,109,50,59,1,-1.0171964015730004,-1.170500554541026,-0.8193503881787182,-0.43976552089994847,-0.5425721741522008,0.5425721741522008,-0.8193503881787182,-1.170500554541026,0,0,0,0,-1.170500554541026,-0.8193503881787182
2778,12,139,57,94,110,0,2866.332000000001,90,2538.774,LESS,238,1450,1688,3,2,16.0,1.4998535370791803,16.0,1.222253017596762,0.7609050848867186,0.7863586267197875,204,94,110,1,0.8775812092002355,0.5462335921191455,1.170500554541026,0.35980815346359446,-0.26788539103026615,0.26788539103026615,1.170500554541026,0.5462335921191455,1,1,1,2,1.170500554541026,0.5462335921191455
2779,12,140,60,110,87,0,3222.9120000000007,80,1511.411,LESS,284,1506,1790,2,2,-23.0,-2.1560394595513217,23.0,2.444506035193524,0.24503723072623146,1.178003584080774,197,110,87,0,0.7379660168274708,1.170500554541026,0.27311679605957273,-0.43976552089994847,-0.19526704606699602,0.19526704606699602,0.27311679605957273,1.170500554541026,0,0,1,2,1.170500554541026,0.27311679605957273
2780,12,141,33,75,80,0,1398.0120000000004,90,2172.259,LESS,480,806,1286,3,2,5.0,0.4687042303372438,5.0,-0.6984302957695783,0.7609050848867186,-0.8263513508232156,155,75,80,1,-0.09972513740911768,-0.19508342575683765,0.0,0.35980815346359446,0.11415024986345919,0.11415024986345919,0.0,-0.19508342575683765,1,1,1,1,-0.19508342575683765,0.0
2781,12,142,15,50,45,0,2513.735,80,631.674,LESS,676,834,1510,2,2,-5.0,-0.4687042303372438,5.0,-0.6984302957695783,0.24503723072623146,0.39908834507019403,95,50,45,0,-1.2964267863185297,-1.170500554541026,-1.3655839802978638,-0.43976552089994847,0.4235675457939144,0.4235675457939144,-1.3655839802978638,-1.170500554541026,0,0,1,0,-1.170500554541026,-1.3655839802978638
2782,12,143,59,89,110,1,4561.14,80,956.052,LESS,1228,1432,2660,4,2,21.0,1.9685577674164243,21.0,2.0952908873087353,0.24503723072623146,2.647828722897529,199,89,110,1,0.7778560717911179,0.3511501663623078,1.170500554541026,1.1593818278271373,1.2949876853531557,1.2949876853531557,1.170500554541026,0.3511501663623078,0,1,1,2,1.170500554541026,0.3511501663623078
2783,12,144,29,80,94,0,1761.128,80,768.9010000000002,LESS,80,720,800,5,2,14.0,1.3123718449442827,14.0,0.8730378697119728,0.24503723072623146,-0.4275276637485288,174,80,94,1,0.2792303847455295,0.0,0.5462335921191455,1.9589555021906802,-0.5173136193823678,0.5173136193823678,0.5462335921191455,0.0,0,1,0,1,0.5462335921191455,0.0
2784,12,145,55,110,98,1,2467.72,90,1252.951,LESS,2048,678,2726,3,2,-12.0,-1.124890152809385,12.0,0.5238227218271837,0.7609050848867186,0.3485483744802396,208,110,98,0,0.9573613191275298,1.170500554541026,0.7023003327246156,0.35980815346359446,2.589488617307101,2.589488617307101,0.7023003327246156,1.170500554541026,1,1,1,2,1.170500554541026,0.7023003327246156
2785,12,146,29,94,80,1,2671.93,90,603.4169999999998,LESS,974,656,1630,3,2,-14.0,-1.3123718449442827,14.0,0.8730378697119728,0.7609050848867186,0.5728397445590077,174,94,80,0,0.2792303847455295,0.5462335921191455,0.0,0.35980815346359446,0.8940081283820556,0.8940081283820556,0.0,0.5462335921191455,1,1,1,1,0.5462335921191455,0.0
2786,12,147,57,110,94,0,1884.568,80,2078.634,LESS,676,656,1332,2,2,-16.0,-1.4998535370791803,16.0,1.222253017596762,0.24503723072623146,-0.2919489618116837,204,110,94,0,0.8775812092002355,1.170500554541026,0.5462335921191455,-0.43976552089994847,0.4235675457939144,0.4235675457939144,0.5462335921191455,1.170500554541026,0,0,1,2,1.170500554541026,0.5462335921191455
2787,12,148,39,80,66,1,2232.173,30,1256.239,LESS,-82,988,906,3,2,-14.0,-1.3123718449442827,14.0,0.8730378697119728,-2.3343020400762047,0.08983842223527823,146,80,66,0,-0.2792303847455295,0.0,-0.5462335921191455,0.35980815346359446,-0.7730564864269277,0.7730564864269277,-0.5462335921191455,0.0,0,0,0,1,0.0,-0.5462335921191455
2788,12,149,4,50,54,0,1105.443,60,572.646,LESS,-194,610,416,2,1,4.0,0.3749633842697951,4.0,-0.8730378697119728,-0.7866984775947429,-1.1476906674706626,104,50,54,1,-1.116921538982118,-1.170500554541026,-1.0144338139355558,-0.43976552089994847,-0.9498663698157591,0.9498663698157591,-1.0144338139355558,-1.170500554541026,0,0,0,0,-1.170500554541026,-1.0144338139355558
2789,12,150,55,98,110,0,3727.982,70,1186.579,LESS,-24,1598,1574,3,2,12.0,1.124890152809385,12.0,0.5238227218271837,-0.2708306234342558,1.7327405817091135,208,98,110,1,0.9573613191275298,0.7023003327246156,1.170500554541026,0.35980815346359446,-0.6814942253862828,0.6814942253862828,1.170500554541026,0.7023003327246156,0,0,0,2,1.170500554541026,0.7023003327246156
2790,12,151,2,50,52,0,1173.489,60,1458.409,LESS,-430,808,378,2,1,2.0,0.18748169213489754,2.0,-1.222253017596762,-0.7866984775947429,-1.0729532375290347,102,50,52,1,-1.156811593945765,-1.170500554541026,-1.092467184238291,-0.43976552089994847,-1.322430052670797,1.322430052670797,-1.092467184238291,-1.170500554541026,0,0,0,0,-1.170500554541026,-1.092467184238291
2791,12,152,59,110,89,1,2806.945,70,1113.046,LESS,698,974,1672,3,2,-21.0,-1.9685577674164243,21.0,2.0952908873087353,-0.2708306234342558,0.7211316956445809,199,110,89,0,0.7778560717911179,1.170500554541026,0.3511501663623078,0.35980815346359446,0.4582980586024349,0.4582980586024349,0.3511501663623078,1.170500554541026,0,0,1,2,1.170500554541026,0.3511501663623078
2792,12,153,60,87,110,0,2102.418,80,624.232,LESS,136,1154,1290,3,2,23.0,2.1560394595513217,23.0,2.444506035193524,0.24503723072623146,-0.052676276969317336,197,87,110,1,0.7379660168274708,0.27311679605957273,1.170500554541026,0.35980815346359446,-0.428908677687952,0.428908677687952,1.170500554541026,0.27311679605957273,0,1,0,2,1.170500554541026,0.27311679605957273
2793,12,154,52,110,105,0,2204.2270000000008,80,699.248,LESS,226,1120,1346,2,2,-5.0,-0.4687042303372438,5.0,-0.6984302957695783,0.24503723072623146,0.059144300359654976,215,110,105,0,1.0969765115002945,1.170500554541026,0.9754171287841883,-0.43976552089994847,-0.28682930710764093,0.28682930710764093,0.9754171287841883,1.170500554541026,0,0,1,2,1.170500554541026,0.9754171287841883
2794,12,155,30,80,96,0,1929.529,80,2096.966,LESS,504,684,1188,3,2,16.0,1.4998535370791803,16.0,1.222253017596762,0.24503723072623146,-0.2425666382716441,176,80,96,1,0.3191204397091766,0.0,0.6242669624218805,0.35980815346359446,0.15203808201820881,0.15203808201820881,0.6242669624218805,0.0,0,0,1,1,0.6242669624218805,0.0
2795,12,156,24,80,86,0,2294.689,70,2115.1620000000007,LESS,336,1046,1382,5,2,6.0,0.5624450764046927,6.0,-0.5238227218271837,-0.2708306234342558,0.1585020493438639,166,80,86,1,0.11967016489094122,0.0,0.2341001109082052,1.9589555021906802,-0.11317674306503853,0.11317674306503853,0.2341001109082052,0.0,0,1,1,1,0.2341001109082052,0.0
2796,12,157,5,50,55,0,1277.845,100,1804.857,LESS,630,490,1120,2,2,5.0,0.4687042303372438,5.0,-0.6984302957695783,1.2767729390472058,-0.9583351962189132,105,50,55,1,-1.0969765115002945,-1.170500554541026,-0.9754171287841883,-0.43976552089994847,0.3509492008306443,0.3509492008306443,-0.9754171287841883,-1.170500554541026,1,0,1,0,-1.170500554541026,-0.9754171287841883
2797,12,158,34,80,74,1,3445.291,90,1656.761,LESS,1462,1186,2648,5,2,-6.0,-0.5624450764046927,6.0,-0.5238227218271837,0.7609050848867186,1.422250636559821,154,80,74,0,-0.11967016489094122,0.0,-0.2341001109082052,1.9589555021906802,1.6643940488619644,1.6643940488619644,-0.2341001109082052,0.0,1,1,1,1,0.0,-0.2341001109082052
2798,12,159,15,45,50,0,2538.5660000000007,90,1261.635,LESS,562,1396,1958,4,2,5.0,0.4687042303372438,5.0,-0.6984302957695783,0.7609050848867186,0.4263611476284723,95,45,50,1,-1.2964267863185297,-1.3655839802978638,-1.170500554541026,1.1593818278271373,0.24360034305885372,0.24360034305885372,-1.170500554541026,-1.3655839802978638,1,1,1,0,-1.3655839802978638,-1.170500554541026
2799,12,160,37,69,80,0,2016.201,90,820.0139999999999,LESS,78,1032,1110,5,2,11.0,1.0311493067419364,11.0,0.34921514788478913,0.7609050848867186,-0.1473715859849442,149,69,80,1,-0.21939530230005888,-0.4291835366650429,0.0,1.9589555021906802,-0.520470938728597,0.520470938728597,0.0,-0.4291835366650429,1,1,0,1,-0.4291835366650429,0.0
2800,12,161,3,50,53,0,1246.182,90,2200.3920000000007,MORE,-818,1234,416,1,2,3.0,0.28122253820234633,3.0,-1.0476454436543674,0.7609050848867186,-0.993111836201304,103,50,53,0,-1.1368665664639415,-1.170500554541026,-1.0534504990869233,-1.2393391952634913,-1.9349500058392493,1.9349500058392493,-1.0534504990869233,-1.170500554541026,1,0,0,0,-1.170500554541026,-1.0534504990869233
2801,12,162,20,50,40,1,2715.792,100,848.732,MORE,644,984,1628,3,2,-10.0,-0.9374084606744876,10.0,0.17460757394239454,1.2767729390472058,0.6210149958904554,90,50,40,1,-1.3961519237276474,-1.170500554541026,-1.5606674060547012,0.35980815346359446,0.3730504362542482,0.3730504362542482,-1.5606674060547012,-1.170500554541026,1,1,0,0,-1.170500554541026,-1.5606674060547012
2802,12,163,25,80,88,1,1603.725,90,1023.181,MORE,1626,372,1998,1,2,8.0,0.7499267685395902,8.0,-0.17460757394239454,0.7609050848867186,-0.6004091804446177,168,80,88,0,0.1595602198545883,0.0,0.31213348121094026,-1.2393391952634913,1.9232942352527536,1.9232942352527536,0.31213348121094026,0.0,1,0,1,1,0.31213348121094026,0.0
2803,12,164,42,115,110,1,3490.857,80,2275.406,MORE,1038,1518,2556,6,2,-5.0,-0.4687042303372438,5.0,-0.6984302957695783,0.24503723072623146,1.4722974538998592,225,115,110,1,1.2964267863185297,1.3655839802978638,1.170500554541026,2.758529176554223,0.9950423474613879,0.9950423474613879,1.170500554541026,1.3655839802978638,0,1,1,2,1.3655839802978638,1.170500554541026
2804,12,165,53,103,110,1,2474.318,100,1380.717,MORE,1316,606,1922,2,2,7.0,0.6561859224721414,7.0,-0.34921514788478913,1.2767729390472058,0.3557952010792299,213,103,110,0,1.0570864565366473,0.8973837584814532,1.170500554541026,-0.43976552089994847,1.4339097365872375,1.4339097365872375,1.170500554541026,0.8973837584814532,1,0,1,2,1.170500554541026,0.8973837584814532
2805,12,166,26,90,80,0,3312.936,50,1119.404,MORE,328,1254,1582,5,2,-10.0,-0.9374084606744876,10.0,0.17460757394239454,-1.3025663317552305,1.276880261520522,170,90,80,1,0.19945027481823535,0.3901668515136753,0.0,1.9589555021906802,-0.12580602044995506,0.12580602044995506,0.0,0.3901668515136753,0,1,0,1,0.3901668515136753,0.0
2806,12,167,35,80,72,1,2107.919,70,1719.5,MORE,928,622,1550,3,2,-8.0,-0.7499267685395902,8.0,-0.17460757394239454,-0.2708306234342558,-0.046634325905200766,152,80,72,1,-0.1595602198545883,0.0,-0.31213348121094026,0.35980815346359446,0.8213897834187854,0.8213897834187854,-0.31213348121094026,0.0,0,1,1,1,0.0,-0.31213348121094026
2807,12,168,28,93,80,0,1611.534,90,1774.256,MORE,610,906,1516,3,2,-13.0,-1.218630998876834,13.0,0.6984302957695783,0.7609050848867186,-0.5918322679087715,173,93,80,1,0.25928535726370594,0.5072169069677779,0.0,0.35980815346359446,0.3193760073683529,0.3193760073683529,0.0,0.5072169069677779,1,1,0,1,0.5072169069677779,0.0
2808,12,169,26,80,90,1,1120.909,90,1608.675,MORE,1492,214,1706,1,2,10.0,0.9374084606744876,10.0,0.17460757394239454,0.7609050848867186,-1.1307037896016148,170,80,90,0,0.19945027481823535,0.0,0.3901668515136753,-1.2393391952634913,1.7117538390554015,1.7117538390554015,0.3901668515136753,0.0,1,0,1,1,0.3901668515136753,0.0
2809,12,170,25,88,80,0,1756.3470000000002,90,1752.424,MORE,38,796,834,1,2,-8.0,-0.7499267685395902,8.0,-0.17460757394239454,0.7609050848867186,-0.4327788122738043,168,88,80,1,0.1595602198545883,0.31213348121094026,0.0,-1.2393391952634913,-0.5836173256531796,0.5836173256531796,0.0,0.31213348121094026,1,0,0,1,0.31213348121094026,0.0
2810,12,171,36,80,70,1,1201.742,90,860.75,MORE,958,210,1168,1,2,-10.0,-0.9374084606744876,10.0,0.17460757394239454,0.7609050848867186,-1.0419219262375434,150,80,70,1,-0.19945027481823535,0.0,-0.3901668515136753,-1.2393391952634913,0.8687495736122225,0.8687495736122225,-0.3901668515136753,0.0,1,0,1,1,0.0,-0.3901668515136753
2811,12,172,28,80,93,1,1355.249,90,576.539,MORE,884,320,1204,1,2,13.0,1.218630998876834,13.0,0.6984302957695783,0.7609050848867186,-0.8733195299460718,173,80,93,0,0.25928535726370594,0.0,0.5072169069677779,-1.2393391952634913,0.7519287578017444,0.7519287578017444,0.5072169069677779,0.0,1,0,1,1,0.5072169069677779,0.0
2812,12,173,21,82,80,1,1976.005,90,1092.912,MORE,1456,380,1836,1,2,-2.0,-0.18748169213489754,2.0,-1.222253017596762,0.7609050848867186,-0.19152033438945984,162,82,80,1,0.03989005496364707,0.07803337030273506,0.0,-1.2393391952634913,1.6549220908232771,1.6549220908232771,0.0,0.07803337030273506,1,0,1,1,0.07803337030273506,0.0
2813,12,174,19,50,41,0,3158.077,90,660.8939999999999,MORE,20,1548,1568,5,2,-9.0,-0.8436676146070391,9.0,0.0,0.7609050848867186,1.1067929137950043,91,50,41,1,-1.376206896245824,-1.170500554541026,-1.5216507209033339,1.9589555021906802,-0.6120331997692419,0.6120331997692419,-1.5216507209033339,-1.170500554541026,1,1,0,0,-1.170500554541026,-1.5216507209033339
2814,12,175,56,96,110,1,1300.309,80,808.1339999999999,MORE,1102,304,1406,1,2,14.0,1.3123718449442827,14.0,0.8730378697119728,0.24503723072623146,-0.9336621570070752,206,96,110,0,0.9174712641638826,0.6242669624218805,1.170500554541026,-1.2393391952634913,1.0960765665407202,1.0960765665407202,1.170500554541026,0.6242669624218805,1,0,1,2,1.170500554541026,0.6242669624218805
2815,12,176,23,80,85,1,1160.845,90,690.685,MORE,956,200,1156,1,2,5.0,0.4687042303372438,5.0,-0.6984302957695783,0.7609050848867186,-1.0868406087805695,165,80,85,0,0.09972513740911768,0.0,0.19508342575683765,-1.2393391952634913,0.8655922542659934,0.8655922542659934,0.19508342575683765,0.0,1,0,1,1,0.19508342575683765,0.0
2816,12,177,10,60,50,0,1980.262,90,932.531,MORE,288,846,1134,2,2,-10.0,-0.9374084606744876,10.0,0.17460757394239454,0.7609050848867186,-0.1868447143785628,110,60,50,1,-0.9972513740911768,-0.7803337030273506,-1.170500554541026,-0.43976552089994847,-0.18895240737453775,0.18895240737453775,-1.170500554541026,-0.7803337030273506,1,1,0,0,-0.7803337030273506,-1.170500554541026
2817,12,178,19,41,50,1,1208.765,80,1333.45,MORE,1172,316,1488,1,2,9.0,0.8436676146070391,9.0,0.0,0.24503723072623146,-1.0342083064732654,91,41,50,0,-1.376206896245824,-1.5216507209033339,-1.170500554541026,-1.2393391952634913,1.20658274365874,1.20658274365874,-1.170500554541026,-1.5216507209033339,0,0,1,0,-1.5216507209033339,-1.170500554541026
2818,12,179,56,110,96,0,1475.131,90,964.467,MORE,-136,806,670,3,2,-14.0,-1.3123718449442827,14.0,0.8730378697119728,0.7609050848867186,-0.7416487105553324,206,110,96,1,0.9174712641638826,1.170500554541026,0.6242669624218805,0.35980815346359446,-0.8583041087751142,0.8583041087751142,0.6242669624218805,1.170500554541026,1,1,0,2,1.170500554541026,0.6242669624218805
2819,12,180,35,72,80,1,1204.252,80,849.868,MORE,1460,206,1666,1,2,8.0,0.7499267685395902,8.0,-0.17460757394239454,0.24503723072623146,-1.0391651007201952,152,72,80,0,-0.1595602198545883,-0.31213348121094026,0.0,-1.2393391952634913,1.6612367295157353,1.6612367295157353,0.0,-0.31213348121094026,0,0,1,1,-0.31213348121094026,0.0
2820,12,181,11,49,50,0,1540.564,80,1362.181,MORE,434,1062,1496,3,2,1.0,0.09374084606744876,1.0,-1.3968605915391563,0.24503723072623146,-0.6697812348275815,99,49,50,0,-1.2166466763912356,-1.2095172396923934,-1.170500554541026,0.35980815346359446,0.041531904900189084,0.041531904900189084,-1.170500554541026,-1.2095172396923934,0,1,0,0,-1.2095172396923934,-1.170500554541026
2821,12,182,17,43,50,1,2375.858,70,1392.776,MORE,834,794,1628,3,2,7.0,0.6561859224721414,7.0,-0.34921514788478913,-0.2708306234342558,0.24765295389272826,93,43,50,0,-1.3363168412821769,-1.4436173506005987,-1.170500554541026,0.35980815346359446,0.6729957741460161,0.6729957741460161,-1.170500554541026,-1.4436173506005987,0,1,1,0,-1.4436173506005987,-1.170500554541026
2822,12,183,1,51,50,1,3069.2470000000008,100,1362.9779999999996,MORE,1040,1350,2390,3,2,-1.0,-0.09374084606744876,1.0,-1.3968605915391563,1.2767729390472058,1.0092276505655011,101,51,50,1,-1.1767566214275886,-1.1314838693896585,-1.170500554541026,0.35980815346359446,0.9981996668076171,0.9981996668076171,-1.170500554541026,-1.1314838693896585,1,1,1,0,-1.1314838693896585,-1.170500554541026
2823,12,184,41,112,110,1,3198.568,70,1153.218,MORE,450,1182,1632,4,2,-2.0,-0.18748169213489754,2.0,-1.222253017596762,-0.2708306234342558,1.1512656715730731,222,112,110,1,1.2365917038730592,1.248533924843761,1.170500554541026,1.1593818278271373,0.06679045967002216,0.06679045967002216,1.170500554541026,1.248533924843761,0,1,0,2,1.248533924843761,1.170500554541026
2824,12,185,20,40,50,1,1931.763,70,983.552,MORE,480,602,1082,3,2,10.0,0.9374084606744876,10.0,0.17460757394239454,-0.2708306234342558,-0.24011295372751815,90,40,50,0,-1.3961519237276474,-1.5606674060547012,-1.170500554541026,0.35980815346359446,0.11415024986345919,0.11415024986345919,-1.170500554541026,-1.5606674060547012,0,1,0,0,-1.5606674060547012,-1.170500554541026
2825,12,186,1,50,51,1,1189.781,80,1302.335,MORE,1074,250,1324,1,2,1.0,0.09374084606744876,1.0,-1.3968605915391563,0.24503723072623146,-1.0550591334140391,101,50,51,0,-1.1767566214275886,-1.170500554541026,-1.1314838693896585,-1.2393391952634913,1.0518740956935124,1.0518740956935124,-1.1314838693896585,-1.170500554541026,1,0,1,0,-1.170500554541026,-1.1314838693896585
2826,12,187,23,85,80,0,3198.531,90,652.972,MORE,138,1584,1722,4,2,-5.0,-0.4687042303372438,5.0,-0.6984302957695783,0.7609050848867186,1.1512250331092713,165,85,80,1,0.09972513740911768,0.19508342575683765,0.0,1.1593818278271373,-0.4257513583417229,0.4257513583417229,0.0,0.19508342575683765,1,1,0,1,0.19508342575683765,0.0
2827,12,188,11,50,49,1,1332.856,80,1617.4160000000004,MORE,1190,266,1456,1,2,-1.0,-0.09374084606744876,1.0,-1.3968605915391563,0.24503723072623146,-0.8979145872408851,99,50,49,1,-1.2166466763912356,-1.170500554541026,-1.2095172396923934,-1.2393391952634913,1.2349986177748022,1.2349986177748022,-1.2095172396923934,-1.170500554541026,1,0,1,0,-1.170500554541026,-1.2095172396923934
2828,12,189,17,50,43,1,2105.839,80,1180.186,MORE,1022,722,1744,3,2,-7.0,-0.6561859224721414,7.0,-0.34921514788478913,0.24503723072623146,-0.04891886657296346,93,50,43,1,-1.3363168412821769,-1.170500554541026,-1.4436173506005987,0.35980815346359446,0.9697837926915548,0.9697837926915548,-1.4436173506005987,-1.170500554541026,1,1,1,0,-1.170500554541026,-1.4436173506005987
2829,12,190,21,80,82,1,2128.659,80,2000.424,MORE,1520,724,2244,3,2,2.0,0.18748169213489754,2.0,-1.222253017596762,0.24503723072623146,-0.023854819439142774,162,80,82,0,0.03989005496364707,0.0,0.07803337030273506,0.35980815346359446,1.7559563099026094,1.7559563099026094,0.07803337030273506,0.0,1,1,1,1,0.07803337030273506,0.0
2830,12,191,10,50,60,1,1234.054,80,1222.164,MORE,1258,362,1620,1,2,10.0,0.9374084606744876,10.0,0.17460757394239454,0.24503723072623146,-1.006432465633336,110,50,60,0,-0.9972513740911768,-1.170500554541026,-0.7803337030273506,-1.2393391952634913,1.3423474755465927,1.3423474755465927,-0.7803337030273506,-1.170500554541026,1,0,1,0,-1.170500554541026,-0.7803337030273506
2831,12,192,3,53,50,1,1231.836,80,1756.3829999999996,MORE,796,366,1162,1,2,-3.0,-0.28122253820234633,3.0,-1.0476454436543674,0.24503723072623146,-1.00886857678771,103,53,50,1,-1.1368665664639415,-1.0534504990869233,-1.170500554541026,-1.2393391952634913,0.6130067065676625,0.6130067065676625,-1.170500554541026,-1.0534504990869233,0,0,1,0,-1.0534504990869233,-1.170500554541026
2832,12,193,45,122,110,1,2939.993,80,1027.246,MORE,476,1382,1858,3,2,-12.0,-1.124890152809385,12.0,0.5238227218271837,0.24503723072623146,0.8672632181275146,232,122,110,1,1.4360419786912946,1.6387007763574364,1.170500554541026,0.35980815346359446,0.10783561117100092,0.10783561117100092,1.170500554541026,1.6387007763574364,1,1,0,2,1.6387007763574364,1.170500554541026
2833,12,194,38,67,80,1,1417.895,80,2046.029,MORE,1212,256,1468,1,2,13.0,1.218630998876834,13.0,0.6984302957695783,0.24503723072623146,-0.8045131190457511,147,67,80,0,-0.25928535726370594,-0.5072169069677779,0.0,-1.2393391952634913,1.2697291305833227,1.2697291305833227,0.0,-0.5072169069677779,0,0,1,1,-0.5072169069677779,0.0
2834,12,195,38,80,67,1,1590.047,50,1031.149,MORE,724,266,990,1,2,-13.0,-1.218630998876834,13.0,0.6984302957695783,-1.3025663317552305,-0.6154322320088769,147,80,67,1,-0.25928535726370594,0.0,-0.5072169069677779,-1.2393391952634913,0.49934321010341365,0.49934321010341365,-0.5072169069677779,0.0,0,0,1,1,0.0,-0.5072169069677779
2835,12,196,36,70,80,1,1628.809,100,1549.63,MORE,1116,604,1720,3,2,10.0,0.9374084606744876,10.0,0.17460757394239454,1.2767729390472058,-0.5728584986608861,150,70,80,0,-0.19945027481823535,-0.3901668515136753,0.0,0.35980815346359446,1.118177801964324,1.118177801964324,0.0,-0.3901668515136753,1,1,1,1,-0.3901668515136753,0.0
2836,12,197,45,110,122,1,1363.523,100,575.852,MORE,1240,226,1466,1,2,12.0,1.124890152809385,12.0,0.5238227218271837,1.2767729390472058,-0.8642318907705577,232,110,122,0,1.4360419786912946,1.170500554541026,1.6387007763574364,-1.2393391952634913,1.3139316014305304,1.3139316014305304,1.6387007763574364,1.170500554541026,1,0,1,2,1.6387007763574364,1.170500554541026
2837,12,198,42,110,115,1,1978.787,100,761.005,MORE,1052,676,1728,3,2,5.0,0.4687042303372438,5.0,-0.6984302957695783,1.2767729390472058,-0.1884647612463272,225,110,115,0,1.2964267863185297,1.170500554541026,1.3655839802978638,0.35980815346359446,1.0171435828849917,1.0171435828849917,1.3655839802978638,1.170500554541026,1,1,1,2,1.3655839802978638,1.170500554541026
2838,12,199,41,110,112,1,1261.728,90,2059.158,MORE,1788,304,2092,1,2,2.0,0.18748169213489754,2.0,-1.222253017596762,0.7609050848867186,-0.976037091383496,222,110,112,0,1.2365917038730592,1.170500554541026,1.248533924843761,-1.2393391952634913,2.1790371022973134,2.1790371022973134,1.248533924843761,1.170500554541026,1,0,1,2,1.248533924843761,1.170500554541026
2839,12,200,53,110,103,0,2846.988,50,1533.7979999999998,MORE,-238,1422,1184,4,1,-7.0,-0.6561859224721414,7.0,-0.34921514788478913,-1.3025663317552305,0.7651123985095927,213,110,103,1,1.0570864565366473,1.170500554541026,0.8973837584814532,1.1593818278271373,-1.0193273954328002,1.0193273954328002,0.8973837584814532,1.170500554541026,0,1,0,2,1.170500554541026,0.8973837584814532
2840,12,201,3,50,53,0,1864.1,90,1026.0839999999996,LESS,-22,1054,1032,2,2,3.0,0.28122253820234633,3.0,-1.0476454436543674,0.7609050848867186,-0.3144297206519571,103,50,53,1,-1.1368665664639415,-1.170500554541026,-1.0534504990869233,-0.43976552089994847,-0.6783369060400537,0.6783369060400537,-1.0534504990869233,-1.170500554541026,1,0,0,0,-1.170500554541026,-1.0534504990869233
2841,12,202,20,50,40,0,2652.956,40,760.7510000000002,LESS,-220,1296,1076,5,2,-10.0,-0.9374084606744876,10.0,0.17460757394239454,-1.8184341859157171,0.5519999009868296,90,50,40,0,-1.3961519237276474,-1.170500554541026,-1.5606674060547012,1.9589555021906802,-0.9909115213167379,0.9909115213167379,-1.5606674060547012,-1.170500554541026,0,1,0,0,-1.170500554541026,-1.5606674060547012
2842,12,203,25,80,88,0,2208.343,90,695.596,LESS,98,1146,1244,5,2,8.0,0.7499267685395902,8.0,-0.17460757394239454,0.7609050848867186,0.06366505487336145,168,80,88,1,0.1595602198545883,0.0,0.31213348121094026,1.9589555021906802,-0.4888977452663056,0.4888977452663056,0.31213348121094026,0.0,1,1,0,1,0.31213348121094026,0.0
2843,12,204,42,115,110,0,3470.655,90,1271.269,LESS,-150,2120,1970,5,2,-5.0,-0.4687042303372438,5.0,-0.6984302957695783,0.7609050848867186,1.4501088526642132,225,115,110,0,1.2964267863185297,1.3655839802978638,1.170500554541026,1.9589555021906802,-0.8804053441987182,0.8804053441987182,1.170500554541026,1.3655839802978638,1,1,0,2,1.3655839802978638,1.170500554541026
2844,12,205,53,103,110,0,1891.715,80,1737.183,LESS,220,1152,1372,2,2,7.0,0.6561859224721414,7.0,-0.34921514788478913,0.24503723072623146,-0.2840991482768277,213,103,110,1,1.0570864565366473,0.8973837584814532,1.170500554541026,-0.43976552089994847,-0.2963012651463283,0.2963012651463283,1.170500554541026,0.8973837584814532,0,0,1,2,1.170500554541026,0.8973837584814532
2845,12,206,26,90,80,0,1603.93,90,1502.1170000000004,LESS,-378,1358,980,2,2,-10.0,-0.9374084606744876,10.0,0.17460757394239454,0.7609050848867186,-0.6001840213884198,170,90,80,0,0.19945027481823535,0.3901668515136753,0.0,-0.43976552089994847,-1.2403397496688395,1.2403397496688395,0.0,0.3901668515136753,1,0,0,1,0.3901668515136753,0.0
2846,12,207,35,80,72,0,1766.97,90,787.8,LESS,-772,1430,658,2,2,-8.0,-0.7499267685395902,8.0,-0.17460757394239454,0.7609050848867186,-0.42111117981532187,152,80,72,0,-0.1595602198545883,0.0,-0.31213348121094026,-0.43976552089994847,-1.862331660875979,1.862331660875979,-0.31213348121094026,0.0,1,0,0,1,0.0,-0.31213348121094026
2847,12,208,28,93,80,1,3594.639,90,1170.223,LESS,1224,1384,2608,5,2,-13.0,-1.218630998876834,13.0,0.6984302957695783,0.7609050848867186,1.5862850498526269,173,93,80,0,0.25928535726370594,0.5072169069677779,0.0,1.9589555021906802,1.2886730466606975,1.2886730466606975,0.0,0.5072169069677779,1,1,1,1,0.5072169069677779,0.0
2848,12,209,26,80,90,0,1325.091,100,2668.485,LESS,770,906,1676,2,2,10.0,0.9374084606744876,10.0,0.17460757394239454,1.2767729390472058,-0.9064431729549132,170,80,90,1,0.19945027481823535,0.0,0.3901668515136753,-0.43976552089994847,0.5719615550666838,0.5719615550666838,0.3901668515136753,0.0,1,0,1,1,0.3901668515136753,0.0
2849,12,210,25,88,80,0,1278.315,100,1069.163,LESS,192,748,940,3,2,-8.0,-0.7499267685395902,8.0,-0.17460757394239454,1.2767729390472058,-0.9578189778949476,168,88,80,0,0.1595602198545883,0.31213348121094026,0.0,0.35980815346359446,-0.3405037359935362,0.3405037359935362,0.0,0.31213348121094026,1,0,1,1,0.31213348121094026,0.0
2850,12,211,36,80,70,1,3239.257,90,1355.211,LESS,562,1532,2094,5,2,-10.0,-0.9374084606744876,10.0,0.17460757394239454,0.7609050848867186,1.1959559000493227,150,80,70,0,-0.19945027481823535,0.0,-0.3901668515136753,1.9589555021906802,0.24360034305885372,0.24360034305885372,-0.3901668515136753,0.0,1,1,1,1,0.0,-0.3901668515136753
2851,12,212,28,80,93,0,1261.593,90,1192.847,LESS,-60,718,658,3,2,13.0,1.218630998876834,13.0,0.6984302957695783,0.7609050848867186,-0.9761853668595288,173,80,93,1,0.25928535726370594,0.0,0.5072169069677779,0.35980815346359446,-0.7383259736184072,0.7383259736184072,0.5072169069677779,0.0,1,1,0,1,0.5072169069677779,0.0
2852,12,213,21,82,80,0,1838.701,50,646.871,LESS,-298,838,540,3,2,-2.0,-0.18748169213489754,2.0,-1.222253017596762,-1.3025663317552305,-0.34232637854643144,162,82,80,0,0.03989005496364707,0.07803337030273506,0.0,0.35980815346359446,-1.1140469758196743,1.1140469758196743,0.0,0.07803337030273506,0,0,0,1,0.07803337030273506,0.0
2853,12,214,19,50,41,1,1856.837,10,1572.058,LESS,72,836,908,3,1,-9.0,-0.8436676146070391,9.0,0.0,-3.366037748397179,-0.32240694126251523,91,50,41,0,-1.376206896245824,-1.170500554541026,-1.5216507209033339,0.35980815346359446,-0.5299428967672843,0.5299428967672843,-1.5216507209033339,-1.170500554541026,0,1,0,0,-1.170500554541026,-1.5216507209033339
2854,12,215,56,96,110,0,2209.429,40,1035.442,LESS,-516,1108,592,2,1,14.0,1.3123718449442827,14.0,0.8730378697119728,-1.8184341859157171,0.06485784870278018,206,96,110,1,0.9174712641638826,0.6242669624218805,1.170500554541026,-0.43976552089994847,-1.4581947845586498,1.4581947845586498,1.170500554541026,0.6242669624218805,0,0,0,2,1.170500554541026,0.6242669624218805
2855,12,216,23,80,85,0,1270.56,30,735.1489999999999,LESS,-192,592,400,2,1,5.0,0.4687042303372438,5.0,-0.6984302957695783,-2.3343020400762047,-0.9663365802403804,165,80,85,1,0.09972513740911768,0.0,0.19508342575683765,-0.43976552089994847,-0.94670905046953,0.94670905046953,0.19508342575683765,0.0,0,0,0,1,0.19508342575683765,0.0
2856,12,217,10,60,50,0,1256.982,20,1017.65,LESS,-366,776,410,2,1,-10.0,-0.9374084606744876,10.0,0.17460757394239454,-2.850169894236692,-0.9812497981186896,110,60,50,0,-0.9972513740911768,-0.7803337030273506,-1.170500554541026,-0.43976552089994847,-1.2213958335914648,1.2213958335914648,-1.170500554541026,-0.7803337030273506,0,0,0,0,-0.7803337030273506,-1.170500554541026
2857,12,218,19,41,50,0,1452.656,20,1013.245,LESS,-476,862,386,2,1,9.0,0.8436676146070391,9.0,0.0,-2.850169894236692,-0.7663338314726251,91,41,50,1,-1.376206896245824,-1.5216507209033339,-1.170500554541026,-0.43976552089994847,-1.395048397634067,1.395048397634067,-1.170500554541026,-1.5216507209033339,0,0,0,0,-1.5216507209033339,-1.170500554541026
2858,12,219,56,110,96,1,2016.06,20,897.819,LESS,860,402,1262,1,2,-14.0,-1.3123718449442827,14.0,0.8730378697119728,-2.850169894236692,-0.14752645148213395,206,110,96,0,0.9174712641638826,1.170500554541026,0.6242669624218805,-1.2393391952634913,0.7140409256469948,0.7140409256469948,0.6242669624218805,1.170500554541026,0,0,1,2,1.170500554541026,0.6242669624218805
2859,12,220,35,72,80,0,1395.569,10,976.476,LESS,-1032,1466,434,2,1,8.0,0.7499267685395902,8.0,-0.17460757394239454,-3.366037748397179,-0.8290345877709779,152,72,80,1,-0.1595602198545883,-0.31213348121094026,0.0,-0.43976552089994847,-2.272783175885767,2.272783175885767,0.0,-0.31213348121094026,0,0,0,1,-0.31213348121094026,0.0
2860,12,221,11,49,50,0,1502.5320000000004,90,895.548,LESS,-42,906,864,2,2,1.0,0.09374084606744876,1.0,-1.3968605915391563,0.7609050848867186,-0.7115531822681359,99,49,50,1,-1.2166466763912356,-1.2095172396923934,-1.170500554541026,-0.43976552089994847,-0.709910099502345,0.709910099502345,-1.170500554541026,-1.2095172396923934,1,0,0,0,-1.2095172396923934,-1.170500554541026
2861,12,222,17,43,50,0,1211.473,50,758.336,LESS,-318,702,384,2,1,7.0,0.6561859224721414,7.0,-0.34921514788478913,-1.3025663317552305,-1.031234010257736,93,43,50,1,-1.3363168412821769,-1.4436173506005987,-1.170500554541026,-0.43976552089994847,-1.1456201692819654,1.1456201692819654,-1.170500554541026,-1.4436173506005987,0,0,0,0,-1.4436173506005987,-1.170500554541026
2862,12,223,1,51,50,0,1307.368,40,1106.567,LESS,-410,804,394,2,1,-1.0,-0.09374084606744876,1.0,-1.3968605915391563,-1.8184341859157171,-0.9259089971158552,101,51,50,0,-1.1767566214275886,-1.1314838693896585,-1.170500554541026,-0.43976552089994847,-1.2908568592085057,1.2908568592085057,-1.170500554541026,-1.1314838693896585,0,0,0,0,-1.1314838693896585,-1.170500554541026
2863,12,224,41,112,110,1,2329.4,10,885.102,LESS,186,1110,1296,3,1,-2.0,-0.18748169213489754,2.0,-1.222253017596762,-3.366037748397179,0.19662642007401504,222,112,110,0,1.2365917038730592,1.248533924843761,1.170500554541026,0.35980815346359446,-0.3499756940322236,0.3499756940322236,1.170500554541026,1.248533924843761,0,0,1,2,1.248533924843761,1.170500554541026
2864,12,225,20,40,50,0,1350.66,30,1293.637,LESS,-590,888,298,2,1,10.0,0.9374084606744876,10.0,0.17460757394239454,-2.3343020400762047,-0.8783597977943233,90,40,50,1,-1.3961519237276474,-1.5606674060547012,-1.170500554541026,-0.43976552089994847,-1.5750156003691278,1.5750156003691278,-1.170500554541026,-1.5606674060547012,0,0,0,0,-1.5606674060547012,-1.170500554541026
2865,12,226,1,50,51,0,1188.06,20,1002.733,LESS,-358,702,344,2,1,1.0,0.09374084606744876,1.0,-1.3968605915391563,-2.850169894236692,-1.0569493711492408,101,50,51,1,-1.1767566214275886,-1.170500554541026,-1.1314838693896585,-0.43976552089994847,-1.2087665562065482,1.2087665562065482,-1.1314838693896585,-1.170500554541026,0,0,0,0,-1.170500554541026,-1.1314838693896585
2866,12,227,23,85,80,1,1724.1760000000004,30,1544.6660000000004,LESS,608,574,1182,3,2,-5.0,-0.4687042303372438,5.0,-0.6984302957695783,-2.3343020400762047,-0.4681134073808216,165,85,80,0,0.09972513740911768,0.19508342575683765,0.0,0.35980815346359446,0.31621868802212383,0.31621868802212383,0.0,0.19508342575683765,0,0,1,1,0.19508342575683765,0.0
2867,12,228,11,50,49,0,1287.188,30,868.077,LESS,-330,704,374,2,1,-1.0,-0.09374084606744876,1.0,-1.3968605915391563,-2.3343020400762047,-0.9480734349405922,99,50,49,0,-1.2166466763912356,-1.170500554541026,-1.2095172396923934,-0.43976552089994847,-1.1645640853593404,1.1645640853593404,-1.2095172396923934,-1.170500554541026,0,0,0,0,-1.170500554541026,-1.2095172396923934
2868,12,229,17,50,43,0,1480.7520000000004,20,732.068,LESS,-706,1110,404,2,1,-7.0,-0.6561859224721414,7.0,-0.34921514788478913,-2.850169894236692,-0.7354749590680749,93,50,43,0,-1.3363168412821769,-1.170500554541026,-1.4436173506005987,-0.43976552089994847,-1.7581401224504176,1.7581401224504176,-1.4436173506005987,-1.170500554541026,0,0,0,0,-1.170500554541026,-1.4436173506005987
2869,12,230,21,80,82,0,1532.6,30,1002.641,LESS,-526,1016,490,2,1,2.0,0.18748169213489754,2.0,-1.222253017596762,-2.3343020400762047,-0.6785283895766503,162,80,82,1,0.03989005496364707,0.0,0.07803337030273506,-0.43976552089994847,-1.4739813812897955,1.4739813812897955,0.07803337030273506,0.0,0,0,0,1,0.07803337030273506,0.0
2870,12,231,10,50,60,0,1978.654,90,796.607,LESS,-322,1266,944,4,2,10.0,0.9374084606744876,10.0,0.17460757394239454,0.7609050848867186,-0.18861084004864093,110,50,60,1,-0.9972513740911768,-1.170500554541026,-0.7803337030273506,1.1593818278271373,-1.1519348079744238,1.1519348079744238,-0.7803337030273506,-1.170500554541026,1,1,0,0,-1.170500554541026,-0.7803337030273506
2871,12,232,3,53,50,1,1926.633,90,2387.067,LESS,490,1080,1570,3,2,-3.0,-0.28122253820234633,3.0,-1.0476454436543674,0.7609050848867186,-0.2457474218167599,103,53,50,0,-1.1368665664639415,-1.0534504990869233,-1.170500554541026,0.35980815346359446,0.12993684659460486,0.12993684659460486,-1.170500554541026,-1.0534504990869233,1,0,1,0,-1.0534504990869233,-1.170500554541026
2872,12,233,45,122,110,1,2075.389,80,1043.763,LESS,872,666,1538,3,2,-12.0,-1.124890152809385,12.0,0.5238227218271837,0.24503723072623146,-0.08236322394477896,232,122,110,0,1.4360419786912946,1.6387007763574364,1.170500554541026,0.35980815346359446,0.7329848417243696,0.7329848417243696,1.170500554541026,1.6387007763574364,0,0,1,2,1.6387007763574364,1.170500554541026
2873,12,234,38,67,80,0,1205.748,90,1161.765,LESS,-94,670,576,2,2,13.0,1.218630998876834,13.0,0.6984302957695783,0.7609050848867186,-1.037521988778381,147,67,80,1,-0.25928535726370594,-0.5072169069677779,0.0,-0.43976552089994847,-0.7920004025043025,0.7920004025043025,0.0,-0.5072169069677779,1,0,0,1,-0.5072169069677779,0.0
2874,12,235,38,80,67,0,1598.612,90,1247.384,LESS,170,988,1158,3,2,-13.0,-1.218630998876834,13.0,0.6984302957695783,0.7609050848867186,-0.6060249768072479,147,80,67,0,-0.25928535726370594,0.0,-0.5072169069677779,0.35980815346359446,-0.3752342488020567,0.3752342488020567,-0.5072169069677779,0.0,1,0,1,1,0.0,-0.5072169069677779
2875,12,236,36,70,80,0,1185.141,90,594.812,LESS,194,690,884,3,2,10.0,0.9374084606744876,10.0,0.17460757394239454,0.7609050848867186,-1.060155416442125,150,70,80,1,-0.19945027481823535,-0.3901668515136753,0.0,0.35980815346359446,-0.3373464166473071,0.3373464166473071,0.0,-0.3901668515136753,1,0,1,1,-0.3901668515136753,0.0
2876,12,237,45,110,122,1,1761.099,10,1422.294,LESS,288,674,962,3,2,12.0,1.124890152809385,12.0,0.5238227218271837,-3.366037748397179,-0.4275595155174543,232,110,122,1,1.4360419786912946,1.170500554541026,1.6387007763574364,0.35980815346359446,-0.18895240737453775,0.18895240737453775,1.6387007763574364,1.170500554541026,0,0,1,2,1.6387007763574364,1.170500554541026
2877,12,238,42,110,115,1,1941.056,0,1203.727,LESS,-4,1082,1078,3,1,5.0,0.4687042303372438,5.0,-0.6984302957695783,-3.881905602557666,-0.2299061092921721,225,110,115,1,1.2964267863185297,1.170500554541026,1.3655839802978638,0.35980815346359446,-0.6499210319239914,0.6499210319239914,1.3655839802978638,1.170500554541026,0,0,0,2,1.3655839802978638,1.170500554541026
2878,12,239,41,110,112,0,2288.716,90,597.4119999999998,LESS,-558,1522,964,3,2,2.0,0.18748169213489754,2.0,-1.222253017596762,0.7609050848867186,0.15194168328206245,222,110,112,1,1.2365917038730592,1.170500554541026,1.248533924843761,0.35980815346359446,-1.5244984908294616,1.5244984908294616,1.248533924843761,1.170500554541026,1,1,0,2,1.248533924843761,1.170500554541026
2879,12,240,53,110,103,0,1670.329,100,1109.3010000000004,LESS,-548,1124,576,3,2,-7.0,-0.6561859224721414,7.0,-0.34921514788478913,1.2767729390472058,-0.5272555522543906,213,110,103,0,1.0570864565366473,1.170500554541026,0.8973837584814532,0.35980815346359446,-1.508711894098316,1.508711894098316,0.8973837584814532,1.170500554541026,1,1,0,2,1.170500554541026,0.8973837584814532
2880,13,1,49,110,131,0,4071.551,54,1888.253,LESS,-130,2028,1898,3,2,21.0,1.9685577674164243,21.0,2.0952908873087353,-0.5558699928666215,-1.4096711997923062,241,110,131,1,1.6155472260277064,1.170500554541026,1.9898509427197442,0.47017592428538946,-0.1933271414427091,0.1933271414427091,1.9898509427197442,1.170500554541026,0,1,0,2,1.9898509427197442,1.170500554541026
2881,13,2,13,47,50,0,3803.34,74,1491.027,LESS,232,2012,2244,2,2,3.0,0.28122253820234633,3.0,-1.0476454436543674,0.745679258723517,-1.7287210458654954,97,47,50,1,-1.2565367313548828,-1.2875506099951286,-1.170500554541026,-0.9229379254490983,0.2076148534141267,0.2076148534141267,-1.170500554541026,-1.2875506099951286,1,0,1,0,-1.2875506099951286,-1.170500554541026
2882,13,3,16,50,44,0,5355.137,34,3144.64,LESS,-370,2902,2532,4,2,-6.0,-0.5624450764046927,6.0,-0.5238227218271837,-1.85741924445676,0.11721589925173255,94,50,44,0,-1.3163718138003533,-1.170500554541026,-1.4046006654492311,1.8632897740198773,-0.45914503858536265,0.45914503858536265,-1.4046006654492311,-1.170500554541026,0,1,0,0,-1.170500554541026,-1.4046006654492311
2883,13,4,7,57,50,1,5200.359,54,2735.857,LESS,1058,1680,2738,3,1,-7.0,-0.6561859224721414,7.0,-0.34921514788478913,-0.5558699928666215,-0.06689995384719284,107,57,50,0,-1.0570864565366473,-0.8973837584814532,-1.170500554541026,0.47017592428538946,1.122471449413426,1.122471449413426,-1.170500554541026,-0.8973837584814532,0,1,1,0,-0.8973837584814532,-1.170500554541026
2884,13,5,18,42,50,0,4265.177,84,2626.896,LESS,-90,2472,2382,2,2,8.0,0.7499267685395902,8.0,-0.17460757394239454,1.3964538845185863,-1.179343787807834,92,42,50,1,-1.3562618687640005,-1.4826340357519663,-1.170500554541026,-0.9229379254490983,-0.14902415858560017,0.14902415858560017,-1.170500554541026,-1.4826340357519663,1,0,0,0,-1.4826340357519663,-1.170500554541026
2885,13,6,51,108,110,0,5453.819,44,2430.293,LESS,1410,2268,3678,4,2,2.0,0.18748169213489754,2.0,-1.222253017596762,-1.2066446186616908,0.2346028703684828,218,108,110,1,1.156811593945765,1.092467184238291,1.170500554541026,1.8632897740198773,1.5123376985559847,1.5123376985559847,1.170500554541026,1.092467184238291,0,1,1,2,1.170500554541026,1.092467184238291
2886,13,7,31,78,80,0,5005.561,64,1461.659,LESS,464,1684,2148,2,1,2.0,0.18748169213489754,2.0,-1.222253017596762,0.09490463292844777,-0.29862151603280546,158,78,80,1,-0.03989005496364707,-0.07803337030273506,0.0,-0.9229379254490983,0.46457215398535845,0.46457215398535845,0.0,-0.07803337030273506,1,0,1,1,-0.07803337030273506,0.0
2887,13,8,58,110,92,1,3920.254,64,1901.748,LESS,104,1636,1740,3,2,-18.0,-1.6873352292140782,18.0,1.571468165481551,0.09490463292844777,-1.5896462364661759,202,110,92,0,0.8376911542365885,1.170500554541026,0.4682002218164104,0.47017592428538946,0.06584530827137815,0.06584530827137815,0.4682002218164104,1.170500554541026,1,1,1,2,1.170500554541026,0.4682002218164104
2888,13,9,12,50,48,1,6348.57,64,1644.935,LESS,890,2780,3670,3,2,-2.0,-0.18748169213489754,2.0,-1.222253017596762,0.09490463292844777,1.2989520910336754,98,50,48,0,-1.2365917038730592,-1.170500554541026,-1.248533924843761,0.47017592428538946,0.9363989214135686,0.9363989214135686,-1.248533924843761,-1.170500554541026,1,1,1,0,-1.170500554541026,-1.248533924843761
2889,13,10,54,110,101,1,6490.011,34,1500.315,LESS,-24,2796,2772,3,2,-9.0,-0.8436676146070391,9.0,0.0,-1.85741924445676,1.4672029430809002,211,110,101,0,1.0171964015730004,1.170500554541026,0.8193503881787182,0.47017592428538946,-0.07592423687137043,0.07592423687137043,0.8193503881787182,1.170500554541026,0,1,0,2,1.170500554541026,0.8193503881787182
2890,13,11,14,46,50,0,4763.616,84,2494.4970000000008,LESS,630,1924,2554,1,2,4.0,0.3749633842697951,4.0,-0.8730378697119728,1.3964538845185863,-0.5864266955674915,96,46,50,1,-1.2764817588367063,-1.3265672951464962,-1.170500554541026,-2.316051775183586,0.6484295328423606,0.6484295328423606,-1.170500554541026,-1.3265672951464962,1,0,1,0,-1.3265672951464962,-1.170500554541026
2891,13,12,22,80,83,1,5934.736999999999,64,2153.502,LESS,274,2196,2470,3,2,3.0,0.28122253820234633,3.0,-1.0476454436543674,0.09490463292844777,0.8066778929209718,163,80,83,1,0.05983508244547061,0.0,0.1170500554541026,0.47017592428538946,0.2541329854140911,0.2541329854140911,0.1170500554541026,0.0,0,1,1,1,0.1170500554541026,0.0
2892,13,13,6,50,56,0,5205.076,64,1705.179,LESS,284,2066,2350,3,2,6.0,0.5624450764046927,6.0,-0.5238227218271837,0.09490463292844777,-0.06128885615199345,106,50,56,1,-1.077031484018471,-1.170500554541026,-0.9364004436328208,0.47017592428538946,0.2652087311283683,0.2652087311283683,-0.9364004436328208,-1.170500554541026,0,1,1,0,-1.170500554541026,-0.9364004436328208
2893,13,14,13,50,47,1,4810.081,44,1595.8529999999996,LESS,680,1656,2336,3,2,-3.0,-0.28122253820234633,3.0,-1.0476454436543674,-1.2066446186616908,-0.5311543499224927,97,50,47,0,-1.2565367313548828,-1.170500554541026,-1.2875506099951286,0.47017592428538946,0.7038082614137467,0.7038082614137467,-1.2875506099951286,-1.170500554541026,0,1,1,0,-1.170500554541026,-1.2875506099951286
2894,13,15,46,110,124,0,5431.334,64,987.979,LESS,-1086,2894,1808,4,2,14.0,1.3123718449442827,14.0,0.8730378697119728,0.09490463292844777,0.20785588464099267,234,110,124,1,1.4759320336549415,1.170500554541026,1.7167341466601715,1.8632897740198773,-1.2521684317276123,1.2521684317276123,1.7167341466601715,1.170500554541026,0,1,0,2,1.7167341466601715,1.170500554541026
2895,13,16,27,91,80,0,6128.27,34,1788.0,LESS,-244,2778,2534,4,2,-11.0,-1.0311493067419364,11.0,0.34921514788478913,-1.85741924445676,1.0368946769457992,171,91,80,0,0.21939530230005888,0.4291835366650429,0.0,1.8632897740198773,-0.31959064258546954,0.31959064258546954,0.0,0.4291835366650429,0,1,0,1,0.4291835366650429,0.0
2896,13,17,40,64,80,0,4469.657,74,1308.495,LESS,642,1734,2376,2,2,16.0,1.4998535370791803,16.0,1.222253017596762,0.745679258723517,-0.9361050223394308,144,64,80,1,-0.3191204397091766,-0.6242669624218805,0.0,-0.9229379254490983,0.6617204276994932,0.6617204276994932,0.0,-0.6242669624218805,1,0,1,1,-0.6242669624218805,0.0
2897,13,18,22,83,80,0,5740.029,64,1603.428,LESS,1478,2134,3612,3,2,-3.0,-0.28122253820234633,3.0,-1.0476454436543674,0.09490463292844777,0.5750633900511487,163,83,80,0,0.05983508244547061,0.1170500554541026,0.0,0.47017592428538946,1.5876527694130698,1.5876527694130698,0.0,0.1170500554541026,0,1,1,1,0.1170500554541026,0.0
2898,13,19,54,101,110,1,5992.316,34,1535.374,LESS,-558,2824,2266,3,2,9.0,0.8436676146070391,9.0,0.0,-1.85741924445676,0.8751708745177309,211,101,110,1,1.0171964015730004,0.8193503881787182,1.170500554541026,0.47017592428538946,-0.6673690580137746,0.6673690580137746,1.170500554541026,0.8193503881787182,0,1,0,2,1.170500554541026,0.8193503881787182
2899,13,20,6,56,50,1,5097.172000000001,94,496.407,LESS,550,1910,2460,3,2,-6.0,-0.5624450764046927,6.0,-0.5238227218271837,2.047228510313656,-0.1896458384930644,106,56,50,0,-1.077031484018471,-0.9364004436328208,-1.170500554541026,0.47017592428538946,0.5598235671281426,0.5598235671281426,-1.170500554541026,-0.9364004436328208,1,1,1,0,-0.9364004436328208,-1.170500554541026
2900,13,21,18,50,42,1,4768.77,54,1996.437,LESS,570,2064,2634,3,2,-8.0,-0.7499267685395902,8.0,-0.17460757394239454,-0.5558699928666215,-0.580295765416747,92,50,42,0,-1.3562618687640005,-1.170500554541026,-1.4826340357519663,0.47017592428538946,0.5819750585566972,0.5819750585566972,-1.4826340357519663,-1.170500554541026,0,1,1,0,-1.170500554541026,-1.4826340357519663
2901,13,22,43,110,117,1,6163.882,34,1535.565,LESS,-578,3050,2472,3,2,7.0,0.6561859224721414,7.0,-0.34921514788478913,-1.85741924445676,1.07925685865482,227,110,117,1,1.3363168412821769,1.170500554541026,1.4436173506005987,0.47017592428538946,-0.689520549442329,0.689520549442329,1.4436173506005987,1.170500554541026,0,1,0,2,1.4436173506005987,1.170500554541026
2902,13,23,32,77,80,0,5691.348000000001,64,2195.088,LESS,-136,2556,2420,3,1,3.0,0.28122253820234633,3.0,-1.0476454436543674,0.09490463292844777,0.5171550061418803,157,77,80,1,-0.05983508244547061,-0.1170500554541026,0.0,0.47017592428538946,-0.19997258887127542,0.19997258887127542,0.0,-0.1170500554541026,0,1,0,1,-0.1170500554541026,0.0
2903,13,24,27,80,91,0,5221.368,84,2307.743,LESS,516,2404,2920,3,2,11.0,1.0311493067419364,11.0,0.34921514788478913,1.3964538845185863,-0.041908740898612656,171,80,91,1,0.21939530230005888,0.0,0.4291835366650429,0.47017592428538946,0.5221660316996001,0.5221660316996001,0.4291835366650429,0.0,1,1,1,1,0.4291835366650429,0.0
2904,13,25,16,44,50,0,4817.055,94,1746.2089999999996,LESS,524,2468,2992,2,2,6.0,0.5624450764046927,6.0,-0.5238227218271837,2.047228510313656,-0.5228584424969417,94,44,50,1,-1.3163718138003533,-1.4046006654492311,-1.170500554541026,-0.9229379254490983,0.5310266282710219,0.5310266282710219,-1.170500554541026,-1.4046006654492311,1,0,1,0,-1.4046006654492311,-1.170500554541026
2905,13,26,7,50,57,0,6344.611999999999,74,2135.109,LESS,-992,3684,2692,4,2,7.0,0.6561859224721414,7.0,-0.34921514788478913,0.745679258723517,1.2942438602349466,107,50,57,1,-1.0570864565366473,-1.170500554541026,-0.8973837584814532,1.8632897740198773,-1.1480564220134064,1.1480564220134064,-0.8973837584814532,-1.170500554541026,1,1,0,0,-1.170500554541026,-0.8973837584814532
2906,13,27,14,50,46,1,5554.286,94,1670.851,LESS,1920,2264,4184,3,2,-4.0,-0.3749633842697951,4.0,-0.8730378697119728,2.047228510313656,0.35411318458167684,96,50,46,0,-1.2764817588367063,-1.170500554541026,-1.3265672951464962,0.47017592428538946,2.0772007299841233,2.0772007299841233,-1.3265672951464962,-1.170500554541026,1,1,1,0,-1.170500554541026,-1.3265672951464962
2907,13,28,51,110,108,1,6319.595,44,2476.061,LESS,-622,3330,2708,3,2,-2.0,-0.18748169213489754,2.0,-1.222253017596762,-1.2066446186616908,1.26448493908998,218,110,108,0,1.156811593945765,1.170500554541026,1.092467184238291,0.47017592428538946,-0.7382538305851488,0.7382538305851488,1.092467184238291,1.170500554541026,0,1,0,2,1.170500554541026,1.092467184238291
2908,13,29,50,133,110,0,5996.478,34,1416.059,LESS,-1438,3364,1926,3,1,-23.0,-2.1560394595513217,23.0,2.444506035193524,-1.85741924445676,0.8801217730989104,243,133,110,0,1.6554372809913533,2.0678843130224793,1.170500554541026,0.47017592428538946,-1.642034680870171,1.642034680870171,1.170500554541026,2.0678843130224793,0,1,0,2,2.0678843130224793,1.170500554541026
2909,13,30,49,131,110,1,4910.072,84,1948.192,LESS,1672,2010,3682,2,2,-21.0,-1.9685577674164243,21.0,2.0952908873087353,1.3964538845185863,-0.4122102605350169,241,131,110,0,1.6155472260277064,1.9898509427197442,1.170500554541026,-0.9229379254490983,1.8025222362700482,1.8025222362700482,1.170500554541026,1.9898509427197442,1,0,1,2,1.9898509427197442,1.170500554541026
2910,13,31,47,126,110,1,6431.187,74,2498.042,LESS,1180,2972,4152,3,2,-16.0,-1.4998535370791803,16.0,1.222253017596762,0.745679258723517,1.3972289742824189,236,126,110,0,1.5158220886185887,1.7947675169629065,1.170500554541026,0.47017592428538946,1.2575955471276083,1.2575955471276083,1.170500554541026,1.7947675169629065,1,1,1,2,1.7947675169629065,1.170500554541026
2911,13,32,50,110,133,0,6390.944,74,1497.565,LESS,-190,2844,2654,3,2,23.0,2.1560394595513217,23.0,2.444506035193524,0.745679258723517,1.3493579960021724,243,110,133,1,1.6554372809913533,1.170500554541026,2.0678843130224793,0.47017592428538946,-0.2597816157283725,0.2597816157283725,2.0678843130224793,1.170500554541026,1,1,0,2,2.0678843130224793,1.170500554541026
2912,13,33,47,110,126,0,6172.81,94,1117.015,LESS,406,2906,3312,1,2,16.0,1.4998535370791803,16.0,1.222253017596762,2.047228510313656,1.0898771427809057,236,110,126,1,1.5158220886185887,1.170500554541026,1.7947675169629065,-2.316051775183586,0.4003328288425505,0.4003328288425505,1.7947675169629065,1.170500554541026,1,0,1,2,1.7947675169629065,1.170500554541026
2913,13,34,12,48,50,1,5447.255,74,2500.551,LESS,2016,2218,4234,3,2,2.0,0.18748169213489754,2.0,-1.222253017596762,0.745679258723517,0.2267946776037397,98,48,50,1,-1.2365917038730592,-1.248533924843761,-1.170500554541026,0.47017592428538946,2.183527888841185,2.183527888841185,-1.170500554541026,-1.248533924843761,1,1,1,0,-1.248533924843761,-1.170500554541026
2914,13,35,32,80,77,0,4500.988,34,2182.949,LESS,998,1674,2672,1,2,-3.0,-0.28122253820234633,3.0,-1.0476454436543674,-1.85741924445676,-0.8988352954180177,157,80,77,0,-0.05983508244547061,0.0,-0.1170500554541026,-2.316051775183586,1.0560169751277626,1.0560169751277626,-0.1170500554541026,0.0,0,0,1,1,0.0,-0.1170500554541026
2915,13,36,43,117,110,0,5599.001,44,1765.564,LESS,-640,2762,2122,4,1,-7.0,-0.6561859224721414,7.0,-0.34921514788478913,-1.2066446186616908,0.4073038213085922,227,117,110,0,1.3363168412821769,1.4436173506005987,1.170500554541026,1.8632897740198773,-0.7581901728708479,0.7581901728708479,1.170500554541026,1.4436173506005987,0,1,0,2,1.4436173506005987,1.170500554541026
2916,13,37,40,80,64,1,4918.652,74,1881.549,LESS,746,2096,2842,3,2,-16.0,-1.4998535370791803,16.0,1.222253017596762,0.745679258723517,-0.4020039390966421,144,80,64,0,-0.3191204397091766,0.0,-0.6242669624218805,0.47017592428538946,0.7769081831279765,0.7769081831279765,-0.6242669624218805,0.0,1,1,1,1,0.0,-0.6242669624218805
2917,13,38,31,80,78,1,6631.776999999999,74,1578.112,LESS,-8,3360,3352,2,2,-2.0,-0.18748169213489754,2.0,-1.222253017596762,0.745679258723517,1.6358403982129093,158,80,78,0,-0.03989005496364707,0.0,-0.07803337030273506,-0.9229379254490983,-0.05820304372852685,0.05820304372852685,-0.07803337030273506,0.0,1,0,0,1,0.0,-0.07803337030273506
2918,13,39,46,124,110,1,5534.8290000000015,44,2578.11,LESS,-172,2578,2406,3,2,-14.0,-1.3123718449442827,14.0,0.8730378697119728,-1.2066446186616908,0.3309681500564502,234,124,110,0,1.4759320336549415,1.7167341466601715,1.170500554541026,0.47017592428538946,-0.23984527344267348,0.23984527344267348,1.170500554541026,1.7167341466601715,0,1,0,2,1.7167341466601715,1.170500554541026
2919,13,40,58,92,110,0,6145.396,74,2519.393,LESS,-732,3172,2440,2,1,18.0,1.6873352292140782,18.0,1.571468165481551,0.745679258723517,1.0572668751921397,202,92,110,1,0.8376911542365885,0.4682002218164104,1.170500554541026,-0.9229379254490983,-0.8600870334421984,0.8600870334421984,1.170500554541026,0.4682002218164104,1,0,0,2,1.170500554541026,0.4682002218164104
2920,13,41,49,110,131,1,4728.5340000000015,74,1299.401,MORE,238,2124,2362,3,2,21.0,1.9685577674164243,21.0,2.0952908873087353,0.745679258723517,-0.6281584168613205,241,110,131,0,1.6155472260277064,1.170500554541026,1.9898509427197442,0.47017592428538946,0.21426030084269304,0.21426030084269304,1.9898509427197442,1.170500554541026,1,1,1,2,1.9898509427197442,1.170500554541026
2921,13,42,13,47,50,1,4777.03,64,1168.958,MORE,-118,2118,2000,3,2,3.0,0.28122253820234633,3.0,-1.0476454436543674,0.09490463292844777,-0.5704700993233939,97,47,50,0,-1.2565367313548828,-1.2875506099951286,-1.170500554541026,0.47017592428538946,-0.1800362465855764,0.1800362465855764,-1.170500554541026,-1.2875506099951286,0,1,0,0,-1.2875506099951286,-1.170500554541026
2922,13,43,16,50,44,0,5237.59,44,1806.562,MORE,-468,2642,2174,4,1,-6.0,-0.5624450764046927,6.0,-0.5238227218271837,-1.2066446186616908,-0.022611894001955932,94,50,44,1,-1.3163718138003533,-1.170500554541026,-1.4046006654492311,1.8632897740198773,-0.5676873465852794,0.5676873465852794,-1.4046006654492311,-1.170500554541026,0,1,0,0,-1.170500554541026,-1.4046006654492311
2923,13,44,7,57,50,0,4732.615,54,2192.113,MORE,-914,2418,1504,3,2,-7.0,-0.6561859224721414,7.0,-0.34921514788478913,-0.5558699928666215,-0.6233038716643519,107,57,50,1,-1.0570864565366473,-0.8973837584814532,-1.170500554541026,0.47017592428538946,-1.061665605442044,1.061665605442044,-1.170500554541026,-0.8973837584814532,0,1,0,0,-0.8973837584814532,-1.170500554541026
2924,13,45,18,42,50,1,5130.834,74,844.845,MORE,742,1832,2574,3,2,8.0,0.7499267685395902,8.0,-0.17460757394239454,0.745679258723517,-0.14960327529276612,92,42,50,0,-1.3562618687640005,-1.4826340357519663,-1.170500554541026,0.47017592428538946,0.7724778848422655,0.7724778848422655,-1.170500554541026,-1.4826340357519663,1,1,1,0,-1.4826340357519663,-1.170500554541026
2925,13,46,51,108,110,0,4248.016,70,1916.208,MORE,946,2050,2996,4,2,2.0,0.18748169213489754,2.0,-1.222253017596762,0.4853694084054894,-1.199757620232537,218,108,110,0,1.156811593945765,1.092467184238291,1.170500554541026,1.8632897740198773,0.9984230974135211,0.9984230974135211,1.170500554541026,1.092467184238291,1,1,1,2,1.170500554541026,1.092467184238291
2926,13,47,31,78,80,1,4516.884,74,1258.293,MORE,734,1762,2496,3,2,2.0,0.18748169213489754,2.0,-1.222253017596762,0.745679258723517,-0.8799262411541011,158,78,80,0,-0.03989005496364707,-0.07803337030273506,0.0,0.47017592428538946,0.7636172882708437,0.7636172882708437,0.0,-0.07803337030273506,1,1,1,1,-0.07803337030273506,0.0
2927,13,48,58,110,92,0,4790.279,74,1915.698,MORE,-212,2344,2132,4,2,-18.0,-1.6873352292140782,18.0,1.571468165481551,0.745679258723517,-0.5547097784915714,202,110,92,1,0.8376911542365885,1.170500554541026,0.4682002218164104,1.8632897740198773,-0.2841482562997824,0.2841482562997824,0.4682002218164104,1.170500554541026,1,1,0,2,1.170500554541026,0.4682002218164104
2928,13,49,12,50,48,1,3812.761,44,383.23800000000006,MORE,342,1686,2028,3,2,-2.0,-0.18748169213489754,2.0,-1.222253017596762,-1.2066446186616908,-1.7175143145984872,98,50,48,1,-1.2365917038730592,-1.170500554541026,-1.248533924843761,0.47017592428538946,0.32944805627117624,0.32944805627117624,-1.248533924843761,-1.170500554541026,0,1,1,0,-1.170500554541026,-1.248533924843761
2929,13,50,54,110,101,1,4843.772,74,1003.721,MORE,510,2348,2858,3,2,-9.0,-0.8436676146070391,9.0,0.0,0.745679258723517,-0.4910772898315503,211,110,101,1,1.0171964015730004,1.170500554541026,0.8193503881787182,0.47017592428538946,0.5155205842710338,0.5155205842710338,0.8193503881787182,1.170500554541026,1,1,1,2,1.170500554541026,0.8193503881787182
2930,13,51,14,46,50,0,5095.775,84,1770.5970000000002,MORE,1020,1864,2884,3,2,4.0,0.3749633842697951,4.0,-0.8730378697119728,1.3964538845185863,-0.19130763698367367,96,46,50,0,-1.2764817588367063,-1.3265672951464962,-1.170500554541026,0.47017592428538946,1.0803836156991726,1.0803836156991726,-1.170500554541026,-1.3265672951464962,1,1,1,0,-1.3265672951464962,-1.170500554541026
2931,13,52,22,80,83,1,4325.052,64,1273.75,MORE,1566,1458,3024,2,2,3.0,0.28122253820234633,3.0,-1.0476454436543674,0.09490463292844777,-1.1081196041105499,163,80,83,0,0.05983508244547061,0.0,0.1170500554541026,-0.9229379254490983,1.6851193316987094,1.6851193316987094,0.1170500554541026,0.0,0,0,1,1,0.1170500554541026,0.0
2932,13,53,6,50,56,1,4924.589,34,516.903,MORE,-316,2484,2168,3,2,6.0,0.5624450764046927,6.0,-0.5238227218271837,-1.85741924445676,-0.39494159289855,106,50,56,0,-1.077031484018471,-1.170500554541026,-0.9364004436328208,0.47017592428538946,-0.3993360117282656,0.3993360117282656,-0.9364004436328208,-1.170500554541026,0,1,0,0,-1.170500554541026,-0.9364004436328208
2933,13,54,13,50,47,1,4976.991,74,2123.1,MORE,106,2472,2578,3,2,-3.0,-0.28122253820234633,3.0,-1.0476454436543674,0.745679258723517,-0.332606901055459,97,50,47,1,-1.2565367313548828,-1.170500554541026,-1.2875506099951286,0.47017592428538946,0.0680604574142336,0.0680604574142336,-1.2875506099951286,-1.170500554541026,1,0,1,0,-1.170500554541026,-1.2875506099951286
2934,13,55,46,110,124,1,5782.88,74,1960.536,MORE,1620,1716,3336,3,2,14.0,1.3123718449442827,14.0,0.8730378697119728,0.745679258723517,0.6260367093933163,234,110,124,0,1.4759320336549415,1.170500554541026,1.7167341466601715,0.47017592428538946,1.7449283585558064,1.7449283585558064,1.7167341466601715,1.170500554541026,1,0,1,2,1.7167341466601715,1.170500554541026
2935,13,56,27,91,80,1,6755.802,54,1570.0079999999996,MORE,40,3024,3064,2,2,-11.0,-1.0311493067419364,11.0,0.34921514788478913,-0.5558699928666215,1.7833740831073674,171,91,80,1,0.21939530230005888,0.4291835366650429,0.0,-0.9229379254490983,-0.005039464299996137,0.005039464299996137,0.0,0.4291835366650429,0,0,1,1,0.4291835366650429,0.0
2936,13,57,40,64,80,1,5654.201,64,1625.247,MORE,1636,1874,3510,3,2,16.0,1.4998535370791803,16.0,1.222253017596762,0.09490463292844777,0.4729668683247101,144,64,80,0,-0.3191204397091766,-0.6242669624218805,0.0,0.47017592428538946,1.76264955169865,1.76264955169865,0.0,-0.6242669624218805,1,0,1,1,-0.6242669624218805,0.0
2937,13,58,22,83,80,1,5400.0340000000015,74,1662.944,MORE,656,2432,3088,3,2,-3.0,-0.28122253820234633,3.0,-1.0476454436543674,0.745679258723517,0.17062303370613055,163,83,80,1,0.05983508244547061,0.1170500554541026,0.0,0.47017592428538946,0.6772264716994814,0.6772264716994814,0.0,0.1170500554541026,1,0,1,1,0.1170500554541026,0.0
2938,13,59,54,101,110,1,4913.412,74,1836.388,MORE,1102,1878,2980,3,2,9.0,0.8436676146070391,9.0,0.0,0.745679258723517,-0.4082371703713603,211,101,110,0,1.0171964015730004,0.8193503881787182,1.170500554541026,0.47017592428538946,1.1712047305562459,1.1712047305562459,1.170500554541026,0.8193503881787182,1,0,1,2,1.170500554541026,0.8193503881787182
2939,13,60,6,56,50,1,6080.446,44,3171.574,MORE,1678,2188,3866,3,2,-6.0,-0.5624450764046927,6.0,-0.5238227218271837,-1.2066446186616908,0.980005735632414,106,56,50,1,-1.077031484018471,-0.9364004436328208,-1.170500554541026,0.47017592428538946,1.8091676836986144,1.8091676836986144,-1.170500554541026,-0.9364004436328208,0,1,1,0,-0.9364004436328208,-1.170500554541026
2940,13,61,18,50,42,0,6902.097,64,2366.446,MORE,-1538,3584,2046,3,1,-8.0,-0.7499267685395902,8.0,-0.17460757394239454,0.09490463292844777,1.9573990009193785,92,50,42,1,-1.3562618687640005,-1.170500554541026,-1.4826340357519663,0.47017592428538946,-1.7527921380129432,1.7527921380129432,-1.4826340357519663,-1.170500554541026,1,1,0,0,-1.170500554541026,-1.4826340357519663
2941,13,62,43,110,117,0,6638.75,44,2480.759,MORE,1712,2638,4350,5,2,7.0,0.6561859224721414,7.0,-0.34921514788478913,-1.2066446186616908,1.644135116090508,227,110,117,0,1.3363168412821769,1.170500554541026,1.4436173506005987,3.2564036237543648,1.846825219127157,1.846825219127157,1.4436173506005987,1.170500554541026,0,1,1,2,1.4436173506005987,1.170500554541026
2942,13,63,32,77,80,0,5702.751,64,2751.851,MORE,508,2160,2668,4,1,3.0,0.28122253820234633,3.0,-1.0476454436543674,0.09490463292844777,0.5307194214521113,157,77,80,0,-0.05983508244547061,-0.1170500554541026,0.0,1.8632897740198773,0.5133054351281783,0.5133054351281783,0.0,-0.1170500554541026,1,1,1,1,-0.1170500554541026,0.0
2943,13,64,27,80,91,1,3842.298,84,1403.0,MORE,1494,1580,3074,3,2,11.0,1.0311493067419364,11.0,0.34921514788478913,1.3964538845185863,-1.6823786367050984,171,80,91,0,0.21939530230005888,0.0,0.4291835366650429,0.47017592428538946,1.6053739625559134,1.6053739625559134,0.4291835366650429,0.0,1,1,1,1,0.4291835366650429,0.0
2944,13,65,16,44,50,1,5351.669,84,1485.055,MORE,958,2102,3060,3,2,6.0,0.5624450764046927,6.0,-0.5238227218271837,1.3964538845185863,0.11309054695006795,94,44,50,0,-1.3163718138003533,-1.4046006654492311,-1.170500554541026,0.47017592428538946,1.0117139922706537,1.0117139922706537,-1.170500554541026,-1.4046006654492311,1,1,1,0,-1.4046006654492311,-1.170500554541026
2945,13,66,7,50,57,0,6971.184,44,2676.532,MORE,394,3054,3448,4,2,7.0,0.6561859224721414,7.0,-0.34921514788478913,-1.2066446186616908,2.039581300361454,107,50,57,0,-1.0570864565366473,-1.170500554541026,-0.8973837584814532,1.8632897740198773,0.38704193398541786,0.38704193398541786,-0.8973837584814532,-1.170500554541026,0,1,1,0,-1.170500554541026,-0.8973837584814532
2946,13,67,14,50,46,0,5742.076999999998,74,1448.246,MORE,-360,2870,2510,3,2,-4.0,-0.3749633842697951,4.0,-0.8730378697119728,0.745679258723517,0.5774995842592805,96,50,46,1,-1.2764817588367063,-1.170500554541026,-1.3265672951464962,0.47017592428538946,-0.44806929287108543,0.44806929287108543,-1.3265672951464962,-1.170500554541026,1,1,0,0,-1.170500554541026,-1.3265672951464962
2947,13,68,51,110,108,1,4953.392,74,1486.388,MORE,1392,2124,3516,3,2,-2.0,-0.18748169213489754,2.0,-1.222253017596762,0.745679258723517,-0.3606790432028029,218,110,108,1,1.156811593945765,1.170500554541026,1.092467184238291,0.47017592428538946,1.4924013562702856,1.4924013562702856,1.092467184238291,1.170500554541026,1,1,1,2,1.170500554541026,1.092467184238291
2948,13,69,50,133,110,0,5710.593000000002,44,2180.654,MORE,-944,2970,2026,3,2,-23.0,-2.1560394595513217,23.0,2.444506035193524,-1.2066446186616908,0.5400478565010333,243,133,110,1,1.6554372809913533,2.0678843130224793,1.170500554541026,0.47017592428538946,-1.0948928425848756,1.0948928425848756,1.170500554541026,2.0678843130224793,0,1,0,2,2.0678843130224793,1.170500554541026
2949,13,70,49,131,110,0,5005.606,84,1714.5929999999996,MORE,546,2392,2938,4,2,-21.0,-1.9685577674164243,21.0,2.0952908873087353,1.3964538845185863,-0.2985679863749118,241,131,110,1,1.6155472260277064,1.9898509427197442,1.170500554541026,1.8632897740198773,0.5553932688424318,0.5553932688424318,1.170500554541026,1.9898509427197442,1,1,1,2,1.9898509427197442,1.170500554541026
2950,13,71,47,126,110,1,4991.3,14,419.372,MORE,246,2028,2274,2,2,-16.0,-1.4998535370791803,16.0,1.222253017596762,-3.158968496046899,-0.3155856593932552,236,126,110,1,1.5158220886185887,1.7947675169629065,1.170500554541026,-0.9229379254490983,0.2231208974141148,0.2231208974141148,1.170500554541026,1.7947675169629065,0,0,1,2,1.7947675169629065,1.170500554541026
2951,13,72,50,110,133,1,4425.7559999999985,64,1925.607,MORE,566,1894,2460,3,2,23.0,2.1560394595513217,23.0,2.444506035193524,0.09490463292844777,-0.9883273670324508,243,110,133,0,1.6554372809913533,1.170500554541026,2.0678843130224793,0.47017592428538946,0.5775447602709863,0.5775447602709863,2.0678843130224793,1.170500554541026,1,1,1,2,2.0678843130224793,1.170500554541026
2952,13,73,47,110,126,1,3912.845,74,2227.888,MORE,1822,1664,3486,3,2,16.0,1.4998535370791803,16.0,1.222253017596762,0.745679258723517,-1.5984595972513649,236,110,126,0,1.5158220886185887,1.170500554541026,1.7947675169629065,0.47017592428538946,1.9686584219842067,1.9686584219842067,1.7947675169629065,1.170500554541026,1,1,1,2,1.7947675169629065,1.170500554541026
2953,13,74,12,48,50,1,5197.845,54,1801.159,MORE,22,2028,2050,2,2,2.0,0.18748169213489754,2.0,-1.222253017596762,-0.5558699928666215,-0.06989047740151401,98,48,50,0,-1.2365917038730592,-1.248533924843761,-1.170500554541026,-0.9229379254490983,-0.024975806585695155,0.024975806585695155,-1.170500554541026,-1.248533924843761,0,0,1,0,-1.248533924843761,-1.170500554541026
2954,13,75,32,80,77,1,4044.83,74,1632.973,MORE,320,1902,2222,3,2,-3.0,-0.28122253820234633,3.0,-1.0476454436543674,0.745679258723517,-1.4414571106495109,157,80,77,1,-0.05983508244547061,0.0,-0.1170500554541026,0.47017592428538946,0.3050814156997663,0.3050814156997663,-0.1170500554541026,0.0,1,1,1,1,0.0,-0.1170500554541026
2955,13,76,43,117,110,0,6092.637,74,1871.591,MORE,-174,2872,2698,3,2,-7.0,-0.6561859224721414,7.0,-0.34921514788478913,0.745679258723517,0.9945075147297596,227,117,110,1,1.3363168412821769,1.4436173506005987,1.170500554541026,0.47017592428538946,-0.2420604225855289,0.2420604225855289,1.170500554541026,1.4436173506005987,1,1,0,2,1.4436173506005987,1.170500554541026
2956,13,77,40,80,64,0,4904.838,74,2024.982,MORE,-726,2990,2264,2,2,-16.0,-1.4998535370791803,16.0,1.222253017596762,0.745679258723517,-0.4184363545220167,144,80,64,1,-0.3191204397091766,0.0,-0.6242669624218805,-0.9229379254490983,-0.8534415860136321,0.8534415860136321,-0.6242669624218805,0.0,1,0,0,1,0.0,-0.6242669624218805
2957,13,78,31,80,78,1,5516.299,64,1979.037,MORE,-136,2344,2208,3,2,-2.0,-0.18748169213489754,2.0,-1.222253017596762,0.09490463292844777,0.3089258264838275,158,80,78,1,-0.03989005496364707,0.0,-0.07803337030273506,0.47017592428538946,-0.19997258887127542,0.19997258887127542,-0.07803337030273506,0.0,1,1,0,1,0.0,-0.07803337030273506
2958,13,79,46,124,110,0,6759.424,84,1566.5410000000004,MORE,1248,2780,4028,2,2,-14.0,-1.3123718449442827,14.0,0.8730378697119728,1.3964538845185863,1.787682625793824,234,124,110,1,1.4759320336549415,1.7167341466601715,1.170500554541026,-0.9229379254490983,1.3329106179846935,1.3329106179846935,1.170500554541026,1.7167341466601715,1,0,1,2,1.7167341466601715,1.170500554541026
2959,13,80,58,92,110,1,3572.406,94,2507.649,MORE,1252,1920,3172,3,2,18.0,1.6873352292140782,18.0,1.571468165481551,2.047228510313656,-2.003428112887601,202,92,110,0,0.8376911542365885,0.4682002218164104,1.170500554541026,0.47017592428538946,1.3373409162704044,1.3373409162704044,1.170500554541026,0.4682002218164104,1,0,1,2,1.170500554541026,0.4682002218164104
2960,13,81,48,128,110,1,4088.777,74,1626.484,LESS,-26,2070,2044,3,2,-18.0,-1.6873352292140782,18.0,1.571468165481551,0.745679258723517,-1.3891800467506457,238,128,110,0,1.5557121435822359,1.8728008872656416,1.170500554541026,0.47017592428538946,-0.07813938601422586,0.07813938601422586,1.170500554541026,1.8728008872656416,1,1,0,2,1.8728008872656416,1.170500554541026
2961,13,82,8,50,58,0,4742.607,74,2264.569,LESS,-108,2392,2284,2,2,8.0,0.7499267685395902,8.0,-0.17460757394239454,0.745679258723517,-0.6114179085160717,108,50,58,1,-1.0371414290548238,-1.170500554541026,-0.8583670733300858,-0.9229379254490983,-0.16896050087129919,0.16896050087129919,-0.8583670733300858,-1.170500554541026,1,0,0,0,-1.170500554541026,-0.8583670733300858
2962,13,83,4,54,50,0,6010.044,34,1882.368,LESS,-530,2892,2362,3,2,-4.0,-0.3749633842697951,4.0,-0.8730378697119728,-1.85741924445676,0.896259180631893,104,54,50,0,-1.116921538982118,-1.0144338139355558,-1.170500554541026,0.47017592428538946,-0.6363569700137983,0.6363569700137983,-1.170500554541026,-1.0144338139355558,0,1,0,0,-1.0144338139355558,-1.170500554541026
2963,13,84,37,80,69,1,4972.817,54,2349.769,LESS,1422,1688,3110,3,2,-11.0,-1.0311493067419364,11.0,0.34921514788478913,-0.5558699928666215,-0.3375720742120763,149,80,69,0,-0.21939530230005888,0.0,-0.4291835366650429,0.47017592428538946,1.5256285934131173,1.5256285934131173,-0.4291835366650429,0.0,0,1,1,1,0.0,-0.4291835366650429
2964,13,85,52,105,110,0,5159.719,54,1416.466,LESS,-1160,2626,1466,3,2,5.0,0.4687042303372438,5.0,-0.6984302957695783,-0.5558699928666215,-0.11524318266485695,215,105,110,1,1.0969765115002945,0.9754171287841883,1.170500554541026,0.47017592428538946,-1.3341289500132638,1.3341289500132638,1.170500554541026,0.9754171287841883,0,1,0,2,1.170500554541026,0.9754171287841883
2965,13,86,5,55,50,1,5641.536,74,1144.999,LESS,-380,2720,2340,3,2,-5.0,-0.4687042303372438,5.0,-0.6984302957695783,0.745679258723517,0.4579012434975519,105,55,50,0,-1.0969765115002945,-0.9754171287841883,-1.170500554541026,0.47017592428538946,-0.47022078429963987,0.47022078429963987,-1.170500554541026,-0.9754171287841883,1,1,0,0,-0.9754171287841883,-1.170500554541026
2966,13,87,30,96,80,1,4705.511,64,1542.437,LESS,-748,2216,1468,3,2,-16.0,-1.4998535370791803,16.0,1.222253017596762,0.09490463292844777,-0.6555453793876277,176,96,80,0,0.3191204397091766,0.6242669624218805,0.0,0.47017592428538946,-0.877808226585042,0.877808226585042,0.0,0.6242669624218805,1,1,0,1,0.6242669624218805,0.0
2967,13,88,33,80,75,1,6562.621,44,2408.866,LESS,2102,2126,4228,3,2,-5.0,-0.4687042303372438,5.0,-0.6984302957695783,-1.2066446186616908,1.5535760199620652,155,80,75,0,-0.09972513740911768,0.0,-0.19508342575683765,0.47017592428538946,2.278779301983969,2.278779301983969,-0.19508342575683765,0.0,0,1,1,1,0.0,-0.19508342575683765
2968,13,89,48,110,128,0,5491.312,34,1791.297,LESS,-306,2552,2246,3,2,18.0,1.6873352292140782,18.0,1.571468165481551,-1.85741924445676,0.2792025917774553,238,110,128,1,1.5557121435822359,1.170500554541026,1.8728008872656416,0.47017592428538946,-0.3882602660139884,0.3882602660139884,1.8728008872656416,1.170500554541026,0,1,0,2,1.8728008872656416,1.170500554541026
2969,13,90,9,59,50,1,4989.419,94,1684.944,LESS,434,2548,2982,3,2,-9.0,-0.8436676146070391,9.0,0.0,2.047228510313656,-0.317823199093207,109,59,50,0,-1.0171964015730004,-0.8193503881787182,-1.170500554541026,0.47017592428538946,0.4313449168425268,0.4313449168425268,-1.170500554541026,-0.8193503881787182,1,1,1,0,-0.8193503881787182,-1.170500554541026
2970,13,91,44,110,119,0,5587.143,34,1976.989,LESS,94,2160,2254,3,2,9.0,0.8436676146070391,9.0,0.0,-1.85741924445676,0.39319816167965854,229,110,119,1,1.376206896245824,1.170500554541026,1.5216507209033339,0.47017592428538946,0.054769562557100915,0.054769562557100915,1.5216507209033339,1.170500554541026,0,1,1,2,1.5216507209033339,1.170500554541026
2971,13,92,2,52,50,0,5624.509,24,1635.652,LESS,-1136,3360,2224,3,2,-2.0,-0.18748169213489754,2.0,-1.222253017596762,-2.5081938702518296,0.4376468104985765,102,52,50,0,-1.156811593945765,-1.092467184238291,-1.170500554541026,0.47017592428538946,-1.3075471602989985,1.3075471602989985,-1.170500554541026,-1.092467184238291,0,1,0,0,-1.092467184238291,-1.170500554541026
2972,13,93,8,58,50,1,6289.553000000001,44,2186.41,LESS,1166,2102,3268,2,2,-8.0,-0.7499267685395902,8.0,-0.17460757394239454,-1.2066446186616908,1.2287485394802302,108,58,50,0,-1.0371414290548238,-0.8583670733300858,-1.170500554541026,-0.9229379254490983,1.2420895031276202,1.2420895031276202,-1.170500554541026,-0.8583670733300858,0,0,1,0,-0.8583670733300858,-1.170500554541026
2973,13,94,44,119,110,1,4868.574000000001,64,1852.857,LESS,394,1860,2254,2,2,-9.0,-0.8436676146070391,9.0,0.0,0.09490463292844777,-0.4615741214965166,229,119,110,0,1.376206896245824,1.5216507209033339,1.170500554541026,-0.9229379254490983,0.38704193398541786,0.38704193398541786,1.170500554541026,1.5216507209033339,1,0,1,2,1.5216507209033339,1.170500554541026
2974,13,95,34,74,80,0,5237.417,64,1964.392,LESS,-1006,2684,1678,2,1,6.0,0.5624450764046927,6.0,-0.5238227218271837,0.09490463292844777,-0.022817685797857624,154,74,80,1,-0.11967016489094122,-0.2341001109082052,0.0,-0.9229379254490983,-1.1635624660133945,1.1635624660133945,0.0,-0.2341001109082052,1,0,0,1,-0.2341001109082052,0.0
2975,13,96,24,86,80,1,5083.344,54,1433.2089999999996,LESS,-130,2624,2494,3,2,-6.0,-0.5624450764046927,6.0,-0.5238227218271837,-0.5558699928666215,-0.20609490758978485,166,86,80,0,0.11967016489094122,0.2341001109082052,0.0,0.47017592428538946,-0.1933271414427091,0.1933271414427091,0.0,0.2341001109082052,0,1,0,1,0.2341001109082052,0.0
2976,13,97,39,66,80,0,5152.319,74,3074.9640000000004,LESS,-348,2796,2448,2,2,14.0,1.3123718449442827,14.0,0.8730378697119728,0.745679258723517,-0.12404583751846658,146,66,80,1,-0.2792303847455295,-0.5462335921191455,0.0,-0.9229379254490983,-0.43477839801395274,0.43477839801395274,0.0,-0.5462335921191455,1,0,0,1,-0.5462335921191455,0.0
2977,13,98,9,50,59,0,5295.773,74,1908.106,LESS,538,2862,3400,4,2,9.0,0.8436676146070391,9.0,0.0,0.745679258723517,0.04659957455852955,109,50,59,1,-1.0171964015730004,-1.170500554541026,-0.8193503881787182,1.8632897740198773,0.54653267227101,0.54653267227101,-0.8193503881787182,-1.170500554541026,1,1,1,0,-1.170500554541026,-0.8193503881787182
2978,13,99,57,94,110,1,5441.379,64,1749.741,LESS,-72,2322,2250,3,2,16.0,1.4998535370791803,16.0,1.222253017596762,0.09490463292844777,0.21980489383079174,204,94,110,1,0.8775812092002355,0.5462335921191455,1.170500554541026,0.47017592428538946,-0.12908781629990113,0.12908781629990113,1.170500554541026,0.5462335921191455,1,1,0,2,1.170500554541026,0.5462335921191455
2979,13,100,60,110,87,1,6426.097,34,1529.406,LESS,1498,1606,3104,2,2,-23.0,-2.1560394595513217,23.0,2.444506035193524,-1.85741924445676,1.3911741752006788,197,110,87,0,0.7379660168274708,1.170500554541026,0.27311679605957273,-0.9229379254490983,1.6098042608416243,1.6098042608416243,0.27311679605957273,1.170500554541026,0,0,1,2,1.170500554541026,0.27311679605957273
2980,13,101,33,75,80,1,5147.489000000001,74,2063.675,LESS,954,1962,2916,3,2,5.0,0.4687042303372438,5.0,-0.6984302957695783,0.745679258723517,-0.12979135413237575,155,75,80,1,-0.09972513740911768,-0.19508342575683765,0.0,0.47017592428538946,1.007283693984943,1.007283693984943,0.0,-0.19508342575683765,1,1,1,1,-0.19508342575683765,0.0
2981,13,102,15,50,45,1,6903.816,74,2035.004,LESS,72,3092,3164,3,2,-5.0,-0.4687042303372438,5.0,-0.6984302957695783,0.745679258723517,1.9594438338509128,95,50,45,0,-1.2964267863185297,-1.170500554541026,-1.3655839802978638,0.47017592428538946,0.030402921985691004,0.030402921985691004,-1.3655839802978638,-1.170500554541026,1,1,1,0,-1.170500554541026,-1.3655839802978638
2982,13,103,59,89,110,0,5571.482,74,2285.111,LESS,-2116,3972,1856,2,2,21.0,1.9685577674164243,21.0,2.0952908873087353,0.745679258723517,0.37456865118474136,199,89,110,1,0.7778560717911179,0.3511501663623078,1.170500554541026,-0.9229379254490983,-2.3929702402981676,2.3929702402981676,1.170500554541026,0.3511501663623078,1,0,0,2,1.170500554541026,0.3511501663623078
2983,13,104,29,80,94,0,4844.277,64,1999.376,LESS,-302,2494,2192,2,2,14.0,1.3123718449442827,14.0,0.8730378697119728,0.09490463292844777,-0.4904765681151889,174,80,94,1,0.2792303847455295,0.0,0.5462335921191455,-0.9229379254490983,-0.3838299677282775,0.3838299677282775,0.5462335921191455,0.0,0,0,0,1,0.5462335921191455,0.0
2984,13,105,55,110,98,1,5286.754,84,2878.266,LESS,1340,2556,3896,3,2,-12.0,-1.124890152809385,12.0,0.5238227218271837,1.3964538845185863,0.03587104156870375,208,110,98,0,0.9573613191275298,1.170500554541026,0.7023003327246156,0.47017592428538946,1.434807478556044,1.434807478556044,0.7023003327246156,1.170500554541026,1,1,1,2,1.170500554541026,0.7023003327246156
2985,13,106,29,94,80,1,6952.101,34,1457.03,LESS,-1982,4030,2048,3,2,-14.0,-1.3123718449442827,14.0,0.8730378697119728,-1.85741924445676,2.0168811567707183,174,94,80,0,0.2792303847455295,0.5462335921191455,0.0,0.47017592428538946,-2.2445552477268524,2.2445552477268524,0.0,0.5462335921191455,0,1,0,1,0.5462335921191455,0.0
2986,13,107,57,110,94,1,6356.3809999999985,34,1459.576,LESS,-1268,3104,1836,3,2,-16.0,-1.4998535370791803,16.0,1.222253017596762,-1.85741924445676,1.3082436500960453,204,110,94,0,0.8775812092002355,1.170500554541026,0.5462335921191455,0.47017592428538946,-1.453747003727458,1.453747003727458,0.5462335921191455,1.170500554541026,0,1,0,2,1.170500554541026,0.5462335921191455
2987,13,108,39,80,66,1,5737.051,74,1536.197,LESS,614,2390,3004,3,2,-14.0,-1.3123718449442827,14.0,0.8730378697119728,0.745679258723517,0.5715209162465472,146,80,66,0,-0.2792303847455295,0.0,-0.5462335921191455,0.47017592428538946,0.630708339699517,0.630708339699517,-0.5462335921191455,0.0,1,1,1,1,0.0,-0.5462335921191455
2988,13,109,4,50,54,0,5265.026,64,1923.063,LESS,-1006,3070,2064,3,2,4.0,0.3749633842697951,4.0,-0.8730378697119728,0.09490463292844777,0.010024543641779505,104,50,54,1,-1.116921538982118,-1.170500554541026,-1.0144338139355558,0.47017592428538946,-1.1635624660133945,1.1635624660133945,-1.0144338139355558,-1.170500554541026,0,1,0,0,-1.170500554541026,-1.0144338139355558
2989,13,110,55,98,110,0,5402.866999999998,64,2345.5170000000007,LESS,304,2434,2738,3,2,12.0,1.124890152809385,12.0,0.5238227218271837,0.09490463292844777,0.17399302305751568,208,98,110,1,0.9573613191275298,0.7023003327246156,1.170500554541026,0.47017592428538946,0.2873602225569228,0.2873602225569228,1.170500554541026,0.7023003327246156,0,1,1,2,1.170500554541026,0.7023003327246156
2990,13,111,2,50,52,0,4650.749,94,1906.253,LESS,798,2106,2904,2,2,2.0,0.18748169213489754,2.0,-1.222253017596762,2.047228510313656,-0.7206874044002489,102,50,52,1,-1.156811593945765,-1.170500554541026,-1.092467184238291,-0.9229379254490983,0.8345020608422181,0.8345020608422181,-1.092467184238291,-1.170500554541026,1,0,1,0,-1.170500554541026,-1.092467184238291
2991,13,112,59,110,89,1,2940.232,74,3439.967,LESS,1390,1200,2590,1,2,-21.0,-1.9685577674164243,21.0,2.0952908873087353,0.745679258723517,-2.755429400647881,199,110,89,0,0.7778560717911179,1.170500554541026,0.3511501663623078,-2.316051775183586,1.49018620712743,1.49018620712743,0.3511501663623078,1.170500554541026,1,0,1,2,1.170500554541026,0.3511501663623078
2992,13,113,60,87,110,0,4932.683,54,2101.308,LESS,-1684,2716,1032,2,1,23.0,2.1560394595513217,23.0,2.444506035193524,-0.5558699928666215,-0.3853133917654257,197,87,110,1,0.7379660168274708,0.27311679605957273,1.170500554541026,-0.9229379254490983,-1.9144980254413908,1.9144980254413908,1.170500554541026,0.27311679605957273,0,0,0,2,1.170500554541026,0.27311679605957273
2993,13,114,52,110,105,0,5092.359,74,1899.594,LESS,634,2104,2738,2,2,-5.0,-0.4687042303372438,5.0,-0.6984302957695783,0.745679258723517,-0.1953711327917717,215,110,105,0,1.0969765115002945,1.170500554541026,0.9754171287841883,-0.9229379254490983,0.6528598311280714,0.6528598311280714,0.9754171287841883,1.170500554541026,1,0,1,2,1.170500554541026,0.9754171287841883
2994,13,115,30,80,96,0,4935.015,84,2585.835,LESS,-932,2888,1956,2,2,16.0,1.4998535370791803,16.0,1.222253017596762,1.3964538845185863,-0.3825393659385849,176,80,96,1,0.3191204397091766,0.0,0.6242669624218805,-0.9229379254490983,-1.081601947727743,1.081601947727743,0.6242669624218805,0.0,1,0,0,1,0.6242669624218805,0.0
2995,13,116,24,80,86,0,5036.011,74,2386.95,LESS,-510,2702,2192,4,2,6.0,0.5624450764046927,6.0,-0.5238227218271837,0.745679258723517,-0.2623997808581525,166,80,86,1,0.11967016489094122,0.0,0.2341001109082052,1.8632897740198773,-0.6142054785852439,0.6142054785852439,0.2341001109082052,0.0,1,1,0,1,0.2341001109082052,0.0
2996,13,117,5,50,55,0,4137.873,84,2016.958,LESS,354,2078,2432,1,2,5.0,0.4687042303372438,5.0,-0.6984302957695783,1.3964538845185863,-1.3307780004408032,105,50,55,1,-1.0969765115002945,-1.170500554541026,-0.9754171287841883,-2.316051775183586,0.34273895112830893,0.34273895112830893,-0.9754171287841883,-1.170500554541026,1,0,1,0,-1.170500554541026,-0.9754171287841883
2997,13,118,34,80,74,1,5783.633000000002,74,2097.689,LESS,-104,2740,2636,3,2,-6.0,-0.5624450764046927,6.0,-0.5238227218271837,0.745679258723517,0.6269324390020706,154,80,74,0,-0.11967016489094122,0.0,-0.2341001109082052,0.47017592428538946,-0.1645302025855883,0.1645302025855883,-0.2341001109082052,0.0,1,1,0,1,0.0,-0.2341001109082052
2998,13,119,15,45,50,0,4097.353,84,2526.741,LESS,314,1834,2148,2,2,5.0,0.4687042303372438,5.0,-0.6984302957695783,1.3964538845185863,-1.3789784835040837,95,45,50,1,-1.2964267863185297,-1.3655839802978638,-1.170500554541026,-0.9229379254490983,0.2984359682712,0.2984359682712,-1.170500554541026,-1.3655839802978638,1,0,1,0,-1.3655839802978638,-1.170500554541026
2999,13,120,37,69,80,1,5039.556,34,1635.914,LESS,2484,2152,4636,4,2,11.0,1.0311493067419364,11.0,0.34921514788478913,-1.85741924445676,-0.258182833364093,149,69,80,1,-0.21939530230005888,-0.4291835366650429,0.0,1.8632897740198773,2.701872788269359,2.701872788269359,0.0,-0.4291835366650429,0,1,1,1,-0.4291835366650429,0.0
3000,13,121,48,128,110,0,5230.636,64,2170.737,MORE,-480,2278,1798,2,1,-18.0,-1.6873352292140782,18.0,1.571468165481551,0.09490463292844777,-0.03088401046844265,238,128,110,1,1.5557121435822359,1.8728008872656416,1.170500554541026,-0.9229379254490983,-0.5809782414424122,0.5809782414424122,1.170500554541026,1.8728008872656416,1,0,0,2,1.8728008872656416,1.170500554541026
3001,13,122,8,50,58,1,5874.714,64,1909.032,MORE,-2,2618,2616,3,2,8.0,0.7499267685395902,8.0,-0.17460757394239454,0.09490463292844777,0.7352776561266167,108,50,58,0,-1.0371414290548238,-1.170500554541026,-0.8583670733300858,0.47017592428538946,-0.05155759629996051,0.05155759629996051,-0.8583670733300858,-1.170500554541026,0,1,0,0,-1.170500554541026,-0.8583670733300858
3002,13,123,4,54,50,0,3882.513,60,2870.913,MORE,918,2038,2956,2,2,-4.0,-0.3749633842697951,4.0,-0.8730378697119728,-0.16540521738957994,-1.6345409657675405,104,54,50,1,-1.116921538982118,-1.0144338139355558,-1.170500554541026,-0.9229379254490983,0.9674110094135449,0.9674110094135449,-1.170500554541026,-1.0144338139355558,0,0,1,0,-1.0144338139355558,-1.170500554541026
3003,13,124,37,80,69,1,5160.128,64,1233.857,MORE,-1126,2920,1794,3,2,-11.0,-1.0311493067419364,11.0,0.34921514788478913,0.09490463292844777,-0.11475665755200246,149,80,69,1,-0.21939530230005888,0.0,-0.4291835366650429,0.47017592428538946,-1.2964714145847214,1.2964714145847214,-0.4291835366650429,0.0,1,1,0,1,0.0,-0.4291835366650429
3004,13,125,52,105,110,1,5214.65,74,1596.591,MORE,-22,2714,2692,3,2,5.0,0.4687042303372438,5.0,-0.6984302957695783,0.745679258723517,-0.049900124048147636,215,105,110,0,1.0969765115002945,0.9754171287841883,1.170500554541026,0.47017592428538946,-0.07370908772851498,0.07370908772851498,1.170500554541026,0.9754171287841883,1,1,0,2,1.170500554541026,0.9754171287841883
3005,13,126,5,55,50,1,6416.1680000000015,44,1659.612,MORE,-1554,3686,2132,3,2,-5.0,-0.4687042303372438,5.0,-0.6984302957695783,-1.2066446186616908,1.379363153573452,105,55,50,1,-1.0969765115002945,-0.9754171287841883,-1.170500554541026,0.47017592428538946,-1.7705133311557868,1.7705133311557868,-1.170500554541026,-0.9754171287841883,0,1,0,0,-0.9754171287841883,-1.170500554541026
3006,13,127,30,96,80,0,5839.816,74,1315.911,MORE,530,2908,3438,2,2,-16.0,-1.4998535370791803,16.0,1.222253017596762,0.745679258723517,0.6937648116561729,176,96,80,1,0.3191204397091766,0.6242669624218805,0.0,-0.9229379254490983,0.5376720756995882,0.5376720756995882,0.0,0.6242669624218805,1,0,1,1,0.6242669624218805,0.0
3007,13,128,33,80,75,0,5462.825,64,1537.463,MORE,-106,2574,2468,2,2,-5.0,-0.4687042303372438,5.0,-0.6984302957695783,0.09490463292844777,0.2453159392349161,155,80,75,1,-0.09972513740911768,0.0,-0.19508342575683765,-0.9229379254490983,-0.16674535172844374,0.16674535172844374,-0.19508342575683765,0.0,1,0,0,1,0.0,-0.19508342575683765
3008,13,129,48,110,128,1,5443.724,84,1499.652,MORE,618,2894,3512,3,2,18.0,1.6873352292140782,18.0,1.571468165481551,1.3964538845185863,0.22259438378102392,238,110,128,0,1.5557121435822359,1.170500554541026,1.8728008872656416,0.47017592428538946,0.6351386379852278,0.6351386379852278,1.8728008872656416,1.170500554541026,1,1,1,2,1.8728008872656416,1.170500554541026
3009,13,130,9,59,50,0,4849.737,54,1525.615,MORE,-1306,2862,1556,2,1,-9.0,-0.8436676146070391,9.0,0.0,-0.5558699928666215,-0.4839816362907685,109,59,50,1,-1.0171964015730004,-0.8193503881787182,-1.170500554541026,-0.9229379254490983,-1.4958348374417114,1.4958348374417114,-1.170500554541026,-0.8193503881787182,0,0,0,0,-0.8193503881787182,-1.170500554541026
3010,13,131,44,110,119,1,6404.263000000001,84,1395.516,MORE,498,3256,3754,3,2,9.0,0.8436676146070391,9.0,0.0,1.3964538845185863,1.3652015851907178,229,110,119,0,1.376206896245824,1.170500554541026,1.5216507209033339,0.47017592428538946,0.502229689413901,0.502229689413901,1.5216507209033339,1.170500554541026,1,1,1,2,1.5216507209033339,1.170500554541026
3011,13,132,2,52,50,1,4603.016,44,2099.725,MORE,-678,2320,1642,3,2,-2.0,-0.18748169213489754,2.0,-1.222253017596762,-1.2066446186616908,-0.7774680968498935,102,52,50,1,-1.156811593945765,-1.092467184238291,-1.170500554541026,0.47017592428538946,-0.8002780065851013,0.8002780065851013,-1.170500554541026,-1.092467184238291,0,1,0,0,-1.092467184238291,-1.170500554541026
3012,13,133,8,58,50,0,5106.066,64,1982.875,MORE,-608,2740,2132,4,2,-8.0,-0.7499267685395902,8.0,-0.17460757394239454,0.09490463292844777,-0.1790659989973896,108,58,50,1,-1.0371414290548238,-0.8583670733300858,-1.170500554541026,1.8632897740198773,-0.7227477865851607,0.7227477865851607,-1.170500554541026,-0.8583670733300858,0,1,0,0,-0.8583670733300858,-1.170500554541026
3013,13,134,44,119,110,1,6099.701999999998,64,1391.9820000000002,MORE,140,2634,2774,3,2,-9.0,-0.8436676146070391,9.0,0.0,0.09490463292844777,1.002911671019049,229,119,110,1,1.376206896245824,1.5216507209033339,1.170500554541026,0.47017592428538946,0.10571799284277618,0.10571799284277618,1.170500554541026,1.5216507209033339,1,1,1,2,1.5216507209033339,1.170500554541026
3014,13,135,34,74,80,1,5255.903,54,1348.0120000000004,MORE,-472,2534,2062,3,2,6.0,0.5624450764046927,6.0,-0.5238227218271837,-0.5558699928666215,-0.0008277023351773536,154,74,80,0,-0.11967016489094122,-0.2341001109082052,0.0,0.47017592428538946,-0.5721176448709904,0.5721176448709904,0.0,-0.2341001109082052,0,1,0,1,-0.2341001109082052,0.0
3015,13,136,24,86,80,1,5245.326,44,1546.5279999999998,MORE,-1500,3154,1654,3,2,-6.0,-0.5624450764046927,6.0,-0.5238227218271837,-1.2066446186616908,-0.013409551036074016,166,86,80,1,0.11967016489094122,0.2341001109082052,0.0,0.47017592428538946,-1.7107043042986898,1.7107043042986898,0.0,0.2341001109082052,0,1,0,1,0.2341001109082052,0.0
3016,13,137,39,66,80,1,5599.875,64,1510.37,MORE,-14,3134,3120,3,2,14.0,1.3123718449442827,14.0,0.8730378697119728,0.09490463292844777,0.4083434862196805,146,66,80,0,-0.2792303847455295,-0.5462335921191455,0.0,0.47017592428538946,-0.0648484911570932,0.0648484911570932,0.0,-0.5462335921191455,0,1,0,1,-0.5462335921191455,0.0
3017,13,138,9,50,59,1,5294.956,64,2314.586,MORE,-108,2698,2590,3,2,9.0,0.8436676146070391,9.0,0.0,0.09490463292844777,0.04562771388077287,109,50,59,0,-1.0171964015730004,-1.170500554541026,-0.8193503881787182,0.47017592428538946,-0.16896050087129919,0.16896050087129919,-0.8193503881787182,-1.170500554541026,0,1,0,0,-1.170500554541026,-0.8193503881787182
3018,13,139,57,94,110,1,5642.69,74,1388.1429999999998,MORE,870,2634,3504,2,2,16.0,1.4998535370791803,16.0,1.222253017596762,0.745679258723517,0.4592739818355333,204,94,110,0,0.8775812092002355,0.5462335921191455,1.170500554541026,-0.9229379254490983,0.9142474299850142,0.9142474299850142,1.170500554541026,0.5462335921191455,1,0,1,2,1.170500554541026,0.5462335921191455
3019,13,140,60,110,87,0,4226.286,74,1452.776,MORE,-222,2184,1962,2,2,-23.0,-2.1560394595513217,23.0,2.444506035193524,0.745679258723517,-1.2256064972553669,197,110,87,1,0.7379660168274708,1.170500554541026,0.27311679605957273,-0.9229379254490983,-0.2952240020140596,0.2952240020140596,0.27311679605957273,1.170500554541026,1,0,0,2,1.170500554541026,0.27311679605957273
3020,13,141,33,75,80,1,5756.5459999999985,54,1190.274,MORE,-520,2852,2332,3,2,5.0,0.4687042303372438,5.0,-0.6984302957695783,-0.5558699928666215,0.5947111535939946,155,75,80,0,-0.09972513740911768,-0.19508342575683765,0.0,0.47017592428538946,-0.625281224299521,0.625281224299521,0.0,-0.19508342575683765,0,1,0,1,-0.19508342575683765,0.0
3021,13,142,15,50,45,0,4965.766,54,2253.955,MORE,106,2036,2142,2,2,-5.0,-0.4687042303372438,5.0,-0.6984302957695783,-0.5558699928666215,-0.3459595768300233,95,50,45,1,-1.2964267863185297,-1.170500554541026,-1.3655839802978638,-0.9229379254490983,0.0680604574142336,0.0680604574142336,-1.3655839802978638,-1.170500554541026,0,0,1,0,-1.170500554541026,-1.3655839802978638
3022,13,143,59,89,110,1,7015.627,54,2358.6910000000007,MORE,-1332,3882,2550,3,2,21.0,1.9685577674164243,21.0,2.0952908873087353,-0.5558699928666215,2.0924483800451017,199,89,110,0,0.7778560717911179,0.3511501663623078,1.170500554541026,0.47017592428538946,-1.5246317762988322,1.5246317762988322,1.170500554541026,0.3511501663623078,0,1,0,2,1.170500554541026,0.3511501663623078
3023,13,144,29,80,94,1,5160.893,64,1304.751,MORE,616,2486,3102,3,2,14.0,1.3123718449442827,14.0,0.8730378697119728,0.09490463292844777,-0.1138466533678113,174,80,94,0,0.2792303847455295,0.0,0.5462335921191455,0.47017592428538946,0.6329234888423725,0.6329234888423725,0.5462335921191455,0.0,0,1,1,1,0.5462335921191455,0.0
3024,13,145,55,110,98,0,4337.33,44,1394.9489999999996,MORE,-774,2216,1442,2,1,-12.0,-1.124890152809385,12.0,0.5238227218271837,-1.2066446186616908,-1.0935143343412763,208,110,98,1,0.9573613191275298,1.170500554541026,0.7023003327246156,-0.9229379254490983,-0.9066051654421627,0.9066051654421627,0.7023003327246156,1.170500554541026,0,0,0,2,1.170500554541026,0.7023003327246156
3025,13,146,29,94,80,0,6132.946999999999,64,1543.6529999999998,MORE,-1444,3306,1862,2,1,-14.0,-1.3123718449442827,14.0,0.8730378697119728,0.09490463292844777,1.0424581927228698,174,94,80,1,0.2792303847455295,0.5462335921191455,0.0,-0.9229379254490983,-1.6486801282987373,1.6486801282987373,0.0,0.5462335921191455,0,0,0,1,0.5462335921191455,0.0
3026,13,147,57,110,94,0,4912.862,64,2002.521,MORE,-356,2414,2058,2,2,-16.0,-1.4998535370791803,16.0,1.222253017596762,0.09490463292844777,-0.4088914217456153,204,110,94,1,0.8775812092002355,1.170500554541026,0.5462335921191455,-0.9229379254490983,-0.44363899458537454,0.44363899458537454,0.5462335921191455,1.170500554541026,0,0,0,2,1.170500554541026,0.5462335921191455
3027,13,148,39,80,66,0,4969.93,64,1508.438,MORE,-424,2410,1986,2,1,-14.0,-1.3123718449442827,14.0,0.8730378697119728,0.09490463292844777,-0.34100629915293706,146,80,66,1,-0.2792303847455295,0.0,-0.5462335921191455,-0.9229379254490983,-0.5189540654424597,0.5189540654424597,-0.5462335921191455,0.0,0,0,0,1,0.0,-0.5462335921191455
3028,13,149,4,50,54,1,5976.24,74,2930.43,MORE,1594,2714,4308,3,2,4.0,0.3749633842697951,4.0,-0.8730378697119728,0.745679258723517,0.8560477016222398,104,50,54,0,-1.116921538982118,-1.170500554541026,-1.0144338139355558,0.47017592428538946,1.7161314196986857,1.7161314196986857,-1.0144338139355558,-1.170500554541026,1,1,1,0,-1.170500554541026,-1.0144338139355558
3029,13,150,55,98,110,1,4317.682,64,1194.705,MORE,422,1950,2372,3,2,12.0,1.124890152809385,12.0,0.5238227218271837,0.09490463292844777,-1.1168865725255643,208,98,110,0,0.9573613191275298,0.7023003327246156,1.170500554541026,0.47017592428538946,0.4180540219853941,0.4180540219853941,1.170500554541026,0.7023003327246156,0,1,1,2,1.170500554541026,0.7023003327246156
3030,13,151,2,50,52,1,5316.243,74,1685.309,MORE,628,2154,2782,3,2,2.0,0.18748169213489754,2.0,-1.222253017596762,0.745679258723517,0.07094962116034031,102,50,52,0,-1.156811593945765,-1.170500554541026,-1.092467184238291,0.47017592428538946,0.6462143836995051,0.6462143836995051,-1.092467184238291,-1.170500554541026,1,1,1,0,-1.170500554541026,-1.092467184238291
3031,13,152,59,110,89,0,4742.574000000001,74,1810.522,MORE,-84,2042,1958,2,2,-21.0,-1.9685577674164243,21.0,2.0952908873087353,0.745679258723517,-0.6114571635985253,199,110,89,1,0.7778560717911179,1.170500554541026,0.3511501663623078,-0.9229379254490983,-0.14237871115703382,0.14237871115703382,0.3511501663623078,1.170500554541026,1,0,0,2,1.170500554541026,0.3511501663623078
3032,13,153,60,87,110,1,3871.821,94,2302.663,MORE,574,2110,2684,1,2,23.0,2.1560394595513217,23.0,2.444506035193524,2.047228510313656,-1.647259612483054,197,87,110,0,0.7379660168274708,0.27311679605957273,1.170500554541026,-2.316051775183586,0.5864053568424081,0.5864053568424081,1.170500554541026,0.27311679605957273,1,0,1,2,1.170500554541026,0.27311679605957273
3033,13,154,52,110,105,0,4601.964,64,2037.184,MORE,-524,2242,1718,2,1,-5.0,-0.4687042303372438,5.0,-0.6984302957695783,0.09490463292844777,-0.7787195012966496,215,110,105,1,1.0969765115002945,1.170500554541026,0.9754171287841883,-0.9229379254490983,-0.629711522585232,0.629711522585232,0.9754171287841883,1.170500554541026,0,0,0,2,1.170500554541026,0.9754171287841883
3034,13,155,30,80,96,1,4808.78,84,1931.458,MORE,1258,2140,3398,3,2,16.0,1.4998535370791803,16.0,1.222253017596762,1.3964538845185863,-0.532701951809594,176,80,96,0,0.3191204397091766,0.0,0.6242669624218805,0.47017592428538946,1.3439863636989706,1.3439863636989706,0.6242669624218805,0.0,1,1,1,1,0.6242669624218805,0.0
3035,13,156,24,80,86,1,5201.617,44,1764.0479999999998,MORE,-568,2550,1982,3,2,6.0,0.5624450764046927,6.0,-0.5238227218271837,-1.2066446186616908,-0.06540350252207935,166,80,86,0,0.11967016489094122,0.0,0.2341001109082052,0.47017592428538946,-0.6784448037280518,0.6784448037280518,0.2341001109082052,0.0,0,1,0,1,0.2341001109082052,0.0
3036,13,157,5,50,55,0,4275.368,74,1223.091,MORE,710,1860,2570,2,2,5.0,0.4687042303372438,5.0,-0.6984302957695783,0.745679258723517,-1.1672211046168683,105,50,55,0,-1.0969765115002945,-1.170500554541026,-0.9754171287841883,-0.9229379254490983,0.7370354985565785,0.7370354985565785,-0.9754171287841883,-1.170500554541026,1,0,1,0,-1.170500554541026,-0.9754171287841883
3037,13,158,34,80,74,1,5999.5,54,1620.001,MORE,-808,3170,2362,2,2,-6.0,-0.5624450764046927,6.0,-0.5238227218271837,-0.5558699928666215,0.8837165870134521,154,80,74,1,-0.11967016489094122,0.0,-0.2341001109082052,-0.9229379254490983,-0.9442627008707053,0.9442627008707053,-0.2341001109082052,0.0,0,0,0,1,0.0,-0.2341001109082052
3038,13,159,15,45,50,1,5505.031,54,1463.2879999999998,MORE,-374,2632,2258,3,2,5.0,0.4687042303372438,5.0,-0.6984302957695783,-0.5558699928666215,0.2955220001472764,95,45,50,0,-1.2964267863185297,-1.3655839802978638,-1.170500554541026,0.47017592428538946,-0.46357533687107355,0.46357533687107355,-1.170500554541026,-1.3655839802978638,0,1,0,0,-1.3655839802978638,-1.170500554541026
3039,13,160,37,69,80,0,4913.246,64,2075.104,MORE,-1616,3010,1394,2,2,11.0,1.0311493067419364,11.0,0.34921514788478913,0.09490463292844777,-0.4084346353315901,149,69,80,0,-0.21939530230005888,-0.4291835366650429,0.0,-0.9229379254490983,-1.8391829545843057,1.8391829545843057,0.0,-0.4291835366650429,0,0,0,1,-0.4291835366650429,0.0
3040,13,161,3,50,53,0,4714.41,54,1648.891,LESS,-1100,2572,1472,2,1,3.0,0.28122253820234633,3.0,-1.0476454436543674,-0.5558699928666215,-0.6449595921521857,103,50,53,1,-1.1368665664639415,-1.170500554541026,-1.0534504990869233,-0.9229379254490983,-1.2676744757276006,1.2676744757276006,-1.0534504990869233,-1.170500554541026,0,0,0,0,-1.170500554541026,-1.0534504990869233
3041,13,162,20,50,40,1,5761.401999999999,74,1661.414,LESS,48,3254,3302,3,2,-10.0,-0.9374084606744876,10.0,0.17460757394239454,0.745679258723517,0.6004875984546887,90,50,40,0,-1.3961519237276474,-1.170500554541026,-1.5606674060547012,0.47017592428538946,0.003821132271425648,0.003821132271425648,-1.5606674060547012,-1.170500554541026,1,0,0,0,-1.170500554541026,-1.5606674060547012
3042,13,163,25,80,88,1,5739.5819999999985,64,1699.285,LESS,1502,2296,3798,3,2,8.0,0.7499267685395902,8.0,-0.17460757394239454,0.09490463292844777,0.5745316621160702,168,80,88,1,0.1595602198545883,0.0,0.31213348121094026,0.47017592428538946,1.6142345591273353,1.6142345591273353,0.31213348121094026,0.0,1,0,1,1,0.31213348121094026,0.0
3043,13,164,42,115,110,1,5124.3690000000015,64,1160.848,LESS,208,2020,2228,3,2,-5.0,-0.4687042303372438,5.0,-0.6984302957695783,0.09490463292844777,-0.15729370281014102,225,115,110,0,1.2964267863185297,1.3655839802978638,1.170500554541026,0.47017592428538946,0.18103306369986133,0.18103306369986133,1.170500554541026,1.3655839802978638,0,0,1,2,1.3655839802978638,1.170500554541026
3044,13,165,53,103,110,0,4688.827,64,1651.576,LESS,-66,2270,2204,2,2,7.0,0.6561859224721414,7.0,-0.34921514788478913,0.09490463292844777,-0.675391797438659,213,103,110,1,1.0570864565366473,0.8973837584814532,1.170500554541026,-0.9229379254490983,-0.12244236887133479,0.12244236887133479,1.170500554541026,0.8973837584814532,0,0,0,2,1.170500554541026,0.8973837584814532
3045,13,166,26,90,80,0,5598.042,64,2203.556,LESS,778,2484,3262,3,2,-10.0,-0.9374084606744876,10.0,0.17460757394239454,0.09490463292844777,0.4061630448214827,170,90,80,0,0.19945027481823535,0.3901668515136753,0.0,0.47017592428538946,0.8123505694136636,0.8123505694136636,0.0,0.3901668515136753,0,0,1,1,0.3901668515136753,0.0
3046,13,167,35,80,72,1,4835.5909999999985,64,1718.126,LESS,-162,2054,1892,3,2,-8.0,-0.7499267685395902,8.0,-0.17460757394239454,0.09490463292844777,-0.5008089816366038,152,80,72,0,-0.1595602198545883,0.0,-0.31213348121094026,0.47017592428538946,-0.22876952772839623,0.22876952772839623,-0.31213348121094026,0.0,0,0,0,1,0.0,-0.31213348121094026
3047,13,168,28,93,80,1,5643.044,54,1789.828,LESS,-524,2670,2146,3,2,-13.0,-1.218630998876834,13.0,0.6984302957695783,-0.5558699928666215,0.4596950818109629,173,93,80,0,0.25928535726370594,0.5072169069677779,0.0,0.47017592428538946,-0.629711522585232,0.629711522585232,0.0,0.5072169069677779,0,0,0,1,0.5072169069677779,0.0
3048,13,169,26,80,90,0,3939.683,84,1650.283,LESS,744,1938,2682,2,2,10.0,0.9374084606744876,10.0,0.17460757394239454,1.3964538845185863,-1.5665345092836371,170,80,90,1,0.19945027481823535,0.0,0.3901668515136753,-0.9229379254490983,0.774693033985121,0.774693033985121,0.3901668515136753,0.0,1,0,1,1,0.3901668515136753,0.0
3049,13,170,25,88,80,1,5921.8809999999985,44,1979.976,LESS,-1344,3324,1980,2,1,-8.0,-0.7499267685395902,8.0,-0.17460757394239454,-1.2066446186616908,0.7913850644347534,168,88,80,0,0.1595602198545883,0.31213348121094026,0.0,-0.9229379254490983,-1.537922671155965,1.537922671155965,0.0,0.31213348121094026,0,0,0,1,0.31213348121094026,0.0
3050,13,171,36,80,70,0,6611.578,34,1536.308,LESS,-886,3382,2496,3,2,-10.0,-0.9374084606744876,10.0,0.17460757394239454,-1.85741924445676,1.6118127191064149,150,80,70,0,-0.19945027481823535,0.0,-0.3901668515136753,0.47017592428538946,-1.0306535174420677,1.0306535174420677,-0.3901668515136753,0.0,0,1,0,1,0.0,-0.3901668515136753
3051,13,172,28,80,93,0,5733.983,74,1396.0,LESS,500,2686,3186,2,2,13.0,1.218630998876834,13.0,0.6984302957695783,0.745679258723517,0.5678713831261584,173,80,93,1,0.25928535726370594,0.0,0.5072169069677779,-0.9229379254490983,0.5044448385567565,0.5044448385567565,0.5072169069677779,0.0,1,0,1,1,0.5072169069677779,0.0
3052,13,173,21,82,80,0,5016.054,54,1877.974,LESS,-1224,2808,1584,2,1,-2.0,-0.18748169213489754,2.0,-1.222253017596762,-0.5558699928666215,-0.2861395893599766,162,82,80,0,0.03989005496364707,0.07803337030273506,0.0,-0.9229379254490983,-1.4050137225846382,1.4050137225846382,0.0,0.07803337030273506,0,0,0,1,0.07803337030273506,0.0
3053,13,174,19,50,41,1,6418.795,54,1918.822,LESS,-1738,3476,1738,3,2,-9.0,-0.8436676146070391,9.0,0.0,-0.5558699928666215,1.3824880960464818,91,50,41,0,-1.376206896245824,-1.170500554541026,-1.5216507209033339,0.47017592428538946,-1.9743070522984878,1.9743070522984878,-1.5216507209033339,-1.170500554541026,0,1,0,0,-1.170500554541026,-1.5216507209033339
3054,13,175,56,96,110,1,5317.248000000001,54,1488.406,LESS,470,1912,2382,3,2,14.0,1.3123718449442827,14.0,0.8730378697119728,-0.5558699928666215,0.07214511685329802,206,96,110,1,0.9174712641638826,0.6242669624218805,1.170500554541026,0.47017592428538946,0.4712176014139248,0.4712176014139248,1.170500554541026,0.6242669624218805,0,0,1,2,1.170500554541026,0.6242669624218805
3055,13,176,23,80,85,1,6311.401,44,3335.15,LESS,-104,3012,2908,1,2,5.0,0.4687042303372438,5.0,-0.6984302957695783,-1.2066446186616908,1.2547377831615358,165,80,85,1,0.09972513740911768,0.0,0.19508342575683765,-2.316051775183586,-0.1645302025855883,0.1645302025855883,0.19508342575683765,0.0,0,0,0,1,0.19508342575683765,0.0
3056,13,177,10,60,50,1,3751.359,54,2485.533,LESS,542,1656,2198,3,2,-10.0,-0.9374084606744876,10.0,0.17460757394239454,-0.5558699928666215,-1.7905549380202932,110,60,50,0,-0.9972513740911768,-0.7803337030273506,-1.170500554541026,0.47017592428538946,0.5509629705567208,0.5509629705567208,-1.170500554541026,-0.7803337030273506,0,1,1,0,-0.7803337030273506,-1.170500554541026
3057,13,178,19,41,50,0,4003.975,64,2326.715,LESS,458,1948,2406,2,2,9.0,0.8436676146070391,9.0,0.0,0.09490463292844777,-1.4900560922771104,91,41,50,1,-1.376206896245824,-1.5216507209033339,-1.170500554541026,-0.9229379254490983,0.45792670655679213,0.45792670655679213,-1.170500554541026,-1.5216507209033339,0,0,1,0,-1.5216507209033339,-1.170500554541026
3058,13,179,56,110,96,1,4861.518,74,1943.61,LESS,404,2240,2644,3,2,-14.0,-1.3123718449442827,14.0,0.8730378697119728,0.745679258723517,-0.4699675718542308,206,110,96,0,0.9174712641638826,1.170500554541026,0.6242669624218805,0.47017592428538946,0.3981176796996951,0.3981176796996951,0.6242669624218805,1.170500554541026,1,1,1,2,1.170500554541026,0.6242669624218805
3059,13,180,35,72,80,1,4678.906,64,2302.4210000000007,LESS,2098,1786,3884,3,2,8.0,0.7499267685395902,8.0,-0.17460757394239454,0.09490463292844777,-0.6871933026822626,152,72,80,1,-0.1595602198545883,-0.31213348121094026,0.0,0.47017592428538946,2.274349003698258,2.274349003698258,0.0,-0.31213348121094026,0,0,1,1,-0.31213348121094026,0.0
3060,13,181,11,49,50,1,4940.484,50,2495.1710000000007,LESS,-906,2336,1430,3,2,1.0,0.09374084606744876,1.0,-1.3968605915391563,-0.8161798431846493,-0.37603372818258574,99,49,50,1,-1.2166466763912356,-1.2095172396923934,-1.170500554541026,0.47017592428538946,-1.0528050088706222,1.0528050088706222,-1.170500554541026,-1.2095172396923934,0,0,0,0,-1.2095172396923934,-1.170500554541026
3061,13,182,17,43,50,0,4362.497,44,2099.821,LESS,1188,1364,2552,1,1,7.0,0.6561859224721414,7.0,-0.34921514788478913,-1.2066446186616908,-1.0635769810033295,93,43,50,1,-1.3363168412821769,-1.4436173506005987,-1.170500554541026,-2.316051775183586,1.26645614369903,1.26645614369903,-1.170500554541026,-1.4436173506005987,0,0,1,0,-1.4436173506005987,-1.170500554541026
3062,13,183,1,51,50,1,5849.717,64,1883.844,LESS,-390,2914,2524,3,2,-1.0,-0.09374084606744876,1.0,-1.3968605915391563,0.09490463292844777,0.7055425259407123,101,51,50,0,-1.1767566214275886,-1.1314838693896585,-1.170500554541026,0.47017592428538946,-0.4812965300139171,0.4812965300139171,-1.170500554541026,-1.1314838693896585,1,0,0,0,-1.1314838693896585,-1.170500554541026
3063,13,184,41,112,110,0,4097.076,54,1794.611,LESS,-1062,2010,948,2,1,-2.0,-0.18748169213489754,2.0,-1.222253017596762,-0.5558699928666215,-1.3793079882871175,222,112,110,0,1.2365917038730592,1.248533924843761,1.170500554541026,-0.9229379254490983,-1.225586642013347,1.225586642013347,1.170500554541026,1.248533924843761,0,0,0,2,1.248533924843761,1.170500554541026
3064,13,185,20,40,50,0,9022.497,64,1361.191,LESS,-1910,3540,1630,2,2,10.0,0.9374084606744876,10.0,0.17460757394239454,0.09490463292844777,4.479716480864608,90,40,50,1,-1.3961519237276474,-1.5606674060547012,-1.170500554541026,-0.9229379254490983,-2.164809878584056,2.164809878584056,-1.170500554541026,-1.5606674060547012,1,0,0,0,-1.5606674060547012,-1.170500554541026
3065,13,186,1,50,51,0,6600.863,84,1757.731,LESS,542,3070,3612,2,2,1.0,0.09374084606744876,1.0,-1.3968605915391563,1.3964538845185863,1.5990667127879783,101,50,51,1,-1.1767566214275886,-1.170500554541026,-1.1314838693896585,-0.9229379254490983,0.5509629705567208,0.5509629705567208,-1.1314838693896585,-1.170500554541026,1,0,1,0,-1.170500554541026,-1.1314838693896585
3066,13,187,23,85,80,1,5722.523,64,1558.421,LESS,636,2452,3088,3,2,-5.0,-0.4687042303372438,5.0,-0.6984302957695783,0.09490463292844777,0.5542391635825946,165,85,80,0,0.09972513740911768,0.19508342575683765,0.0,0.47017592428538946,0.6550749802709269,0.6550749802709269,0.0,0.19508342575683765,1,0,1,1,0.19508342575683765,0.0
3067,13,188,11,50,49,0,4758.612,54,1385.23,LESS,-1024,2380,1356,2,1,-1.0,-0.09374084606744876,1.0,-1.3968605915391563,-0.5558699928666215,-0.5923791935252569,99,50,49,0,-1.2166466763912356,-1.170500554541026,-1.2095172396923934,-0.9229379254490983,-1.1834988082990936,1.1834988082990936,-1.2095172396923934,-1.170500554541026,0,0,0,0,-1.170500554541026,-1.2095172396923934
3068,13,189,17,50,43,1,6095.176,74,1513.686,LESS,-218,3128,2910,3,2,-7.0,-0.6561859224721414,7.0,-0.34921514788478913,0.745679258723517,0.9975277769829112,93,50,43,0,-1.3363168412821769,-1.170500554541026,-1.4436173506005987,0.47017592428538946,-0.29079370372834873,0.29079370372834873,-1.4436173506005987,-1.170500554541026,1,0,0,0,-1.170500554541026,-1.4436173506005987
3069,13,190,21,80,82,0,4348.855,64,1505.4070000000004,LESS,104,1836,1940,4,2,2.0,0.18748169213489754,2.0,-1.222253017596762,0.09490463292844777,-1.0798047941807558,162,80,82,1,0.03989005496364707,0.0,0.07803337030273506,1.8632897740198773,0.06584530827137815,0.06584530827137815,0.07803337030273506,0.0,1,1,1,1,0.07803337030273506,0.0
3070,13,191,10,50,60,0,4764.225,64,2446.999,LESS,-1342,2814,1472,2,1,10.0,0.9374084606744876,10.0,0.17460757394239454,0.09490463292844777,-0.5857022608639979,110,50,60,1,-0.9972513740911768,-1.170500554541026,-0.7803337030273506,-0.9229379254490983,-1.5357075220131096,1.5357075220131096,-0.7803337030273506,-1.170500554541026,1,0,0,0,-1.170500554541026,-0.7803337030273506
3071,13,192,3,53,50,0,5247.2959999999985,64,1880.316,LESS,-520,2532,2012,3,2,-3.0,-0.28122253820234633,3.0,-1.0476454436543674,0.09490463292844777,-0.011066141568290505,103,53,50,0,-1.1368665664639415,-1.0534504990869233,-1.170500554541026,0.47017592428538946,-0.625281224299521,0.625281224299521,-1.170500554541026,-1.0534504990869233,1,0,0,0,-1.0534504990869233,-1.170500554541026
3072,13,193,45,122,110,1,4770.371,34,1733.178,LESS,60,2172,2232,3,2,-12.0,-1.124890152809385,12.0,0.5238227218271837,-1.85741924445676,-0.5783912991436893,232,122,110,0,1.4360419786912946,1.6387007763574364,1.170500554541026,0.47017592428538946,0.017112027128558326,0.017112027128558326,1.170500554541026,1.6387007763574364,0,0,0,2,1.6387007763574364,1.170500554541026
3073,13,194,38,67,80,0,4668.312,64,2120.897,LESS,-892,2498,1606,1,1,13.0,1.218630998876834,13.0,0.6984302957695783,0.09490463292844777,-0.6997953736983633,147,67,80,1,-0.25928535726370594,-0.5072169069677779,0.0,-2.316051775183586,-1.037298964870634,1.037298964870634,0.0,-0.5072169069677779,1,0,0,1,-0.5072169069677779,0.0
3074,13,195,38,80,67,1,4745.915,64,1491.841,LESS,560,2130,2690,3,2,-13.0,-1.218630998876834,13.0,0.6984302957695783,0.09490463292844777,-0.6074828838869174,147,80,67,0,-0.25928535726370594,0.0,-0.5072169069677779,0.47017592428538946,0.5708993128424199,0.5708993128424199,-0.5072169069677779,0.0,1,0,1,1,0.0,-0.5072169069677779
3075,13,196,36,70,80,1,4392.422000000001,44,2212.503,LESS,494,2102,2596,3,2,10.0,0.9374084606744876,10.0,0.17460757394239454,-1.2066446186616908,-1.0279797585041008,150,70,80,1,-0.19945027481823535,-0.3901668515136753,0.0,0.47017592428538946,0.49779939112819016,0.49779939112819016,0.0,-0.3901668515136753,0,0,1,1,-0.3901668515136753,0.0
3076,13,197,45,110,122,0,4845.4540000000015,64,2166.355,LESS,698,2236,2934,2,2,12.0,1.124890152809385,12.0,0.5238227218271837,0.09490463292844777,-0.4890764701742818,232,110,122,1,1.4360419786912946,1.170500554541026,1.6387007763574364,-0.9229379254490983,0.7237446036994457,0.7237446036994457,1.6387007763574364,1.170500554541026,1,0,1,2,1.6387007763574364,1.170500554541026
3077,13,198,42,110,115,1,5804.678000000001,54,2728.635,LESS,-152,2430,2278,2,2,5.0,0.4687042303372438,5.0,-0.6984302957695783,-0.5558699928666215,0.6519664756769646,225,110,115,1,1.2964267863185297,1.170500554541026,1.3655839802978638,-0.9229379254490983,-0.217693782014119,0.217693782014119,1.3655839802978638,1.170500554541026,0,0,0,2,1.3655839802978638,1.170500554541026
3078,13,199,41,110,112,0,4870.245,74,1522.717,LESS,-352,2332,1980,2,2,2.0,0.18748169213489754,2.0,-1.222253017596762,0.745679258723517,-0.459586386866737,222,110,112,1,1.2365917038730592,1.170500554541026,1.248533924843761,-0.9229379254490983,-0.43920869629966364,0.43920869629966364,1.248533924843761,1.170500554541026,1,0,0,2,1.248533924843761,1.170500554541026
3079,13,200,53,110,103,0,5993.969,64,2178.255,LESS,724,2282,3006,4,2,-7.0,-0.6561859224721414,7.0,-0.34921514788478913,0.09490463292844777,0.8771371972843552,213,110,103,0,1.0570864565366473,1.170500554541026,0.8973837584814532,1.8632897740198773,0.7525415425565666,0.7525415425565666,0.8973837584814532,1.170500554541026,0,1,1,2,1.170500554541026,0.8973837584814532
3080,13,201,3,50,53,1,4816.5920000000015,74,1271.817,MORE,-1320,2702,1382,2,2,3.0,0.28122253820234633,3.0,-1.0476454436543674,0.745679258723517,-0.5234092031992674,103,50,53,0,-1.1368665664639415,-1.170500554541026,-1.0534504990869233,-0.9229379254490983,-1.5113408814416995,1.5113408814416995,-1.0534504990869233,-1.170500554541026,1,0,0,0,-1.170500554541026,-1.0534504990869233
3081,13,202,20,50,40,0,3511.801,64,2048.345,MORE,1194,1554,2748,2,2,-10.0,-0.9374084606744876,10.0,0.17460757394239454,0.09490463292844777,-2.0755206665907138,90,50,40,1,-1.3961519237276474,-1.170500554541026,-1.5606674060547012,-0.9229379254490983,1.2731015911275965,1.2731015911275965,-1.5606674060547012,-1.170500554541026,1,0,1,0,-1.170500554541026,-1.5606674060547012
3082,13,203,25,80,88,1,5224.515,84,1656.9979999999996,MORE,148,3002,3150,3,2,8.0,0.7499267685395902,8.0,-0.17460757394239454,1.3964538845185863,-0.03816523348992209,168,80,88,0,0.1595602198545883,0.0,0.31213348121094026,0.47017592428538946,0.11457858941419796,0.11457858941419796,0.31213348121094026,0.0,1,0,1,1,0.31213348121094026,0.0
3083,13,204,42,115,110,0,4567.46,84,1180.641,MORE,372,2128,2500,3,2,-5.0,-0.4687042303372438,5.0,-0.6984302957695783,1.3964538845185863,-0.8197636638735358,225,115,110,1,1.2964267863185297,1.3655839802978638,1.170500554541026,0.47017592428538946,0.36267529341400795,0.36267529341400795,1.170500554541026,1.3655839802978638,1,0,1,2,1.3655839802978638,1.170500554541026
3084,13,205,53,103,110,0,6081.765,64,2005.158,MORE,-1078,3298,2220,3,2,7.0,0.6561859224721414,7.0,-0.34921514788478913,0.09490463292844777,0.9815747493826728,213,103,110,0,1.0570864565366473,0.8973837584814532,1.170500554541026,0.47017592428538946,-1.2433078351561906,1.2433078351561906,1.170500554541026,0.8973837584814532,0,0,0,2,1.170500554541026,0.8973837584814532
3085,13,206,26,90,80,1,4722.791,64,1721.39,MORE,-110,2262,2152,3,2,-10.0,-0.9374084606744876,10.0,0.17460757394239454,0.09490463292844777,-0.6349899907564953,170,90,80,1,0.19945027481823535,0.3901668515136753,0.0,0.47017592428538946,-0.17117565001415463,0.17117565001415463,0.0,0.3901668515136753,0,0,0,1,0.3901668515136753,0.0
3086,13,207,35,80,72,0,4314.562,64,1440.7679999999998,MORE,-546,2158,1612,2,1,-8.0,-0.7499267685395902,8.0,-0.17460757394239454,0.09490463292844777,-1.1205979621395188,152,80,72,1,-0.1595602198545883,0.0,-0.31213348121094026,-0.9229379254490983,-0.6540781631566419,0.6540781631566419,-0.31213348121094026,0.0,0,0,0,1,0.0,-0.31213348121094026
3087,13,208,28,93,80,1,6493.06,64,2007.97,MORE,-194,3592,3398,3,2,-13.0,-1.218630998876834,13.0,0.6984302957695783,0.09490463292844777,1.4708298747901782,173,93,80,1,0.25928535726370594,0.5072169069677779,0.0,0.47017592428538946,-0.2642119140140834,0.2642119140140834,0.0,0.5072169069677779,0,0,0,1,0.5072169069677779,0.0
3088,13,209,26,80,90,1,5079.54,54,1699.976,MORE,-804,2698,1894,3,2,10.0,0.9374084606744876,10.0,0.17460757394239454,-0.5558699928666215,-0.2106199480037218,170,80,90,0,0.19945027481823535,0.0,0.3901668515136753,0.47017592428538946,-0.9398324025849945,0.9398324025849945,0.3901668515136753,0.0,0,0,0,1,0.3901668515136753,0.0
3089,13,210,25,88,80,1,4872.122,44,1583.84,MORE,-24,2216,2192,3,2,-8.0,-0.7499267685395902,8.0,-0.17460757394239454,-1.2066446186616908,-0.4573536053585978,168,88,80,1,0.1595602198545883,0.31213348121094026,0.0,0.47017592428538946,-0.07592423687137043,0.07592423687137043,0.0,0.31213348121094026,0,0,0,1,0.31213348121094026,0.0
3090,13,211,36,80,70,0,5923.554,34,1767.921,MORE,-1656,3256,1600,3,2,-10.0,-0.9374084606744876,10.0,0.17460757394239454,-1.85741924445676,0.7933751781604431,150,80,70,1,-0.19945027481823535,0.0,-0.3901668515136753,0.47017592428538946,-1.8834859374414146,1.8834859374414146,-0.3901668515136753,0.0,0,0,0,1,0.0,-0.3901668515136753
3091,13,212,28,80,93,0,5739.701999999998,64,1569.946,MORE,-844,3042,2198,2,2,13.0,1.218630998876834,13.0,0.6984302957695783,0.09490463292844777,0.574674407870453,173,80,93,0,0.25928535726370594,0.0,0.5072169069677779,-0.9229379254490983,-0.9841353854421033,0.9841353854421033,0.5072169069677779,0.0,0,0,0,1,0.5072169069677779,0.0
3092,13,213,21,82,80,0,3609.935,74,1731.466,MORE,-370,1866,1496,0,2,-2.0,-0.18748169213489754,2.0,-1.222253017596762,0.745679258723517,-1.9587855677523134,162,82,80,1,0.03989005496364707,0.07803337030273506,0.0,-3.709165624918074,-0.45914503858536265,0.45914503858536265,0.0,0.07803337030273506,1,0,0,1,0.07803337030273506,0.0
3093,13,214,19,50,41,0,4718.206,60,2437.859,MORE,-166,2904,2738,2,2,-9.0,-0.8436676146070391,9.0,0.0,-0.16540521738957994,-0.640444068121874,91,50,41,1,-1.376206896245824,-1.170500554541026,-1.5216507209033339,-0.9229379254490983,-0.23319982601410713,0.23319982601410713,-1.5216507209033339,-1.170500554541026,0,0,0,0,-1.170500554541026,-1.5216507209033339
3094,13,215,56,96,110,1,5102.42,64,1592.006,MORE,354,2452,2806,3,2,14.0,1.3123718449442827,14.0,0.8730378697119728,0.09490463292844777,-0.183403090834722,206,96,110,0,0.9174712641638826,0.6242669624218805,1.170500554541026,0.47017592428538946,0.34273895112830893,0.34273895112830893,1.170500554541026,0.6242669624218805,1,0,1,2,1.170500554541026,0.6242669624218805
3095,13,216,23,80,85,1,7662.148,54,1566.158,MORE,-1590,4162,2572,3,2,5.0,0.4687042303372438,5.0,-0.6984302957695783,-0.5558699928666215,2.861516112289806,165,80,85,0,0.09972513740911768,0.0,0.19508342575683765,0.47017592428538946,-1.810386015727185,1.810386015727185,0.19508342575683765,0.0,0,0,0,1,0.19508342575683765,0.0
3096,13,217,10,60,50,1,4659.4,64,1602.4679999999996,MORE,-2186,2912,726,1,2,-10.0,-0.9374084606744876,10.0,0.17460757394239454,0.09490463292844777,-0.7103966250571978,110,60,50,1,-0.9972513740911768,-0.7803337030273506,-1.170500554541026,-2.316051775183586,-2.470500460298108,2.470500460298108,-1.170500554541026,-0.7803337030273506,1,0,0,0,-0.7803337030273506,-1.170500554541026
3097,13,218,19,41,50,1,4809.0909999999985,64,1891.063,MORE,1074,1866,2940,2,2,9.0,0.8436676146070391,9.0,0.0,0.09490463292844777,-0.5323320023961532,91,41,50,0,-1.376206896245824,-1.5216507209033339,-1.170500554541026,-0.9229379254490983,1.1401926425562696,1.1401926425562696,-1.170500554541026,-1.5216507209033339,1,0,1,0,-1.5216507209033339,-1.170500554541026
3098,13,219,56,110,96,1,7848.312,64,1441.21,MORE,536,3408,3944,3,2,-14.0,-1.3123718449442827,14.0,0.8730378697119728,0.09490463292844777,3.08296711744757,206,110,96,1,0.9174712641638826,1.170500554541026,0.6242669624218805,0.47017592428538946,0.5443175231281545,0.5443175231281545,0.6242669624218805,1.170500554541026,1,1,1,2,1.170500554541026,0.6242669624218805
3099,13,220,35,72,80,1,4250.151,54,1748.6329999999996,MORE,-406,2000,1594,2,1,8.0,0.7499267685395902,8.0,-0.17460757394239454,-0.5558699928666215,-1.197217935352475,152,72,80,0,-0.1595602198545883,-0.31213348121094026,0.0,-0.9229379254490983,-0.4990177231567607,0.4990177231567607,0.0,-0.31213348121094026,0,0,0,1,-0.31213348121094026,0.0
3100,13,221,11,49,50,1,5007.031,64,1758.6329999999996,MORE,40,2170,2210,3,2,1.0,0.09374084606744876,1.0,-1.3968605915391563,0.09490463292844777,-0.29687288054161504,99,49,50,0,-1.2166466763912356,-1.2095172396923934,-1.170500554541026,0.47017592428538946,-0.005039464299996137,0.005039464299996137,-1.170500554541026,-1.2095172396923934,1,1,1,0,-1.2095172396923934,-1.170500554541026
3101,13,222,17,43,50,0,4118.45,44,2027.419,MORE,-854,2148,1294,2,1,7.0,0.6561859224721414,7.0,-0.34921514788478913,-1.2066446186616908,-1.3538825903356229,93,43,50,0,-1.3363168412821769,-1.4436173506005987,-1.170500554541026,-0.9229379254490983,-0.9952111311563806,0.9952111311563806,-1.170500554541026,-1.4436173506005987,0,0,0,0,-1.4436173506005987,-1.170500554541026
3102,13,223,1,51,50,0,5158.058,44,2255.909,MORE,8,2488,2496,2,2,-1.0,-0.09374084606744876,1.0,-1.3968605915391563,-1.2066446186616908,-0.11721902181510654,101,51,50,1,-1.1767566214275886,-1.1314838693896585,-1.170500554541026,-0.9229379254490983,-0.04048185058568328,0.04048185058568328,-1.170500554541026,-1.1314838693896585,0,0,1,0,-1.1314838693896585,-1.170500554541026
3103,13,224,41,112,110,0,6182.178000000001,44,2259.906,MORE,-1676,3020,1344,1,1,-2.0,-0.18748169213489754,2.0,-1.222253017596762,-1.2066446186616908,1.1010208280063956,222,112,110,1,1.2365917038730592,1.248533924843761,1.170500554541026,-2.316051775183586,-1.9056374288699691,1.9056374288699691,1.170500554541026,1.248533924843761,0,0,0,2,1.248533924843761,1.170500554541026
3104,13,225,20,40,50,1,4159.415,84,1870.659,MORE,404,2424,2828,2,2,10.0,0.9374084606744876,10.0,0.17460757394239454,1.3964538845185863,-1.305152758433172,90,40,50,0,-1.3961519237276474,-1.5606674060547012,-1.170500554541026,-0.9229379254490983,0.3981176796996951,0.3981176796996951,-1.170500554541026,-1.5606674060547012,1,0,1,0,-1.5606674060547012,-1.170500554541026
3105,13,226,1,50,51,1,4275.996,54,2357.777,MORE,-498,2198,1700,3,2,1.0,0.09374084606744876,1.0,-1.3968605915391563,-0.5558699928666215,-1.166474068502265,101,50,51,0,-1.1767566214275886,-1.170500554541026,-1.1314838693896585,0.47017592428538946,-0.6009145837281111,0.6009145837281111,-1.1314838693896585,-1.170500554541026,0,1,0,0,-1.170500554541026,-1.1314838693896585
3106,13,227,23,85,80,1,5795.236,64,2317.3160000000007,MORE,-502,2964,2462,3,2,-5.0,-0.4687042303372438,5.0,-0.6984302957695783,0.09490463292844777,0.6407347639029385,165,85,80,1,0.09972513740911768,0.19508342575683765,0.0,0.47017592428538946,-0.6053448820138221,0.6053448820138221,0.0,0.19508342575683765,1,1,0,1,0.19508342575683765,0.0
3107,13,228,11,50,49,1,6365.7959999999985,54,1851.985,MORE,-1684,3554,1870,3,2,-1.0,-0.09374084606744876,1.0,-1.3968605915391563,-0.5558699928666215,1.3194432440753339,99,50,49,1,-1.2166466763912356,-1.170500554541026,-1.2095172396923934,0.47017592428538946,-1.9144980254413908,1.9144980254413908,-1.2095172396923934,-1.170500554541026,0,1,0,0,-1.170500554541026,-1.2095172396923934
3108,13,229,17,50,43,0,5776.521,54,1963.756,MORE,716,2236,2952,2,2,-7.0,-0.6561859224721414,7.0,-0.34921514788478913,-0.5558699928666215,0.6184723739589773,93,50,43,1,-1.3363168412821769,-1.170500554541026,-1.4436173506005987,-0.9229379254490983,0.7436809459851448,0.7436809459851448,-1.4436173506005987,-1.170500554541026,0,0,1,0,-1.170500554541026,-1.4436173506005987
3109,13,230,21,80,82,1,5259.883000000002,74,3137.558,MORE,584,2966,3550,2,2,2.0,0.18748169213489754,2.0,-1.222253017596762,0.745679258723517,0.003906698518522661,162,80,82,0,0.03989005496364707,0.0,0.07803337030273506,-0.9229379254490983,0.5974811025566853,0.5974811025566853,0.07803337030273506,0.0,1,0,1,1,0.07803337030273506,0.0
3110,13,231,10,50,60,1,4087.283,74,1572.575,MORE,742,2026,2768,3,2,10.0,0.9374084606744876,10.0,0.17460757394239454,0.745679258723517,-1.3909572313927123,110,50,60,0,-0.9972513740911768,-1.170500554541026,-0.7803337030273506,0.47017592428538946,0.7724778848422655,0.7724778848422655,-0.7803337030273506,-1.170500554541026,1,1,1,0,-1.170500554541026,-0.7803337030273506
3111,13,232,3,53,50,0,5729.785,54,2802.5490000000004,MORE,-516,2792,2276,2,1,-3.0,-0.28122253820234633,3.0,-1.0476454436543674,-0.5558699928666215,0.5628776608186641,103,53,50,1,-1.1368665664639415,-1.0534504990869233,-1.170500554541026,-0.9229379254490983,-0.6208509260138102,0.6208509260138102,-1.170500554541026,-1.0534504990869233,0,0,0,0,-1.0534504990869233,-1.170500554541026
3112,13,233,45,122,110,0,5653.554,64,1589.888,MORE,-374,2690,2316,3,2,-12.0,-1.124890152809385,12.0,0.5238227218271837,0.09490463292844777,0.4721972307989959,232,122,110,1,1.4360419786912946,1.6387007763574364,1.170500554541026,0.47017592428538946,-0.46357533687107355,0.46357533687107355,1.170500554541026,1.6387007763574364,1,1,0,2,1.6387007763574364,1.170500554541026
3113,13,234,38,67,80,1,4699.603,44,2194.309,MORE,694,1872,2566,3,2,13.0,1.218630998876834,13.0,0.6984302957695783,-1.2066446186616908,-0.6625732286950778,147,67,80,0,-0.25928535726370594,-0.5072169069677779,0.0,0.47017592428538946,0.7193143054137349,0.7193143054137349,0.0,-0.5072169069677779,0,1,1,1,-0.5072169069677779,0.0
3114,13,235,38,80,67,0,5410.811,64,2013.735,MORE,168,2286,2454,2,2,-13.0,-1.218630998876834,13.0,0.6984302957695783,0.09490463292844777,0.18344279199766292,147,80,67,1,-0.25928535726370594,0.0,-0.5072169069677779,-0.9229379254490983,0.13673008084275243,0.13673008084275243,-0.5072169069677779,0.0,0,0,1,1,0.0,-0.5072169069677779
3115,13,236,36,70,80,1,5424.203,60,2207.366,MORE,1002,2850,3852,3,2,10.0,0.9374084606744876,10.0,0.17460757394239454,-0.16540521738957994,0.1993732181867916,150,70,80,0,-0.19945027481823535,-0.3901668515136753,0.0,0.47017592428538946,1.0604472734134736,1.0604472734134736,0.0,-0.3901668515136753,0,1,1,1,-0.3901668515136753,0.0
3116,13,237,45,110,122,1,4785.365,44,2445.317,MORE,-774,2446,1672,2,2,12.0,1.124890152809385,12.0,0.5238227218271837,-1.2066446186616908,-0.5605552171335506,232,110,122,0,1.4360419786912946,1.170500554541026,1.6387007763574364,-0.9229379254490983,-0.9066051654421627,0.9066051654421627,1.6387007763574364,1.170500554541026,0,0,0,2,1.6387007763574364,1.170500554541026
3117,13,238,42,110,115,0,3572.615,74,2394.636,MORE,320,1986,2306,2,2,5.0,0.4687042303372438,5.0,-0.6984302957695783,0.745679258723517,-2.0031794973653843,225,110,115,0,1.2964267863185297,1.170500554541026,1.3655839802978638,-0.9229379254490983,0.3050814156997663,0.3050814156997663,1.3655839802978638,1.170500554541026,1,0,1,2,1.3655839802978638,1.170500554541026
3118,13,239,41,110,112,1,5652.393,34,1632.441,MORE,-618,2832,2214,3,2,2.0,0.18748169213489754,2.0,-1.222253017596762,-1.85741924445676,0.4708161656253416,222,110,112,0,1.2365917038730592,1.170500554541026,1.248533924843761,0.47017592428538946,-0.733823532299438,0.733823532299438,1.248533924843761,1.170500554541026,0,1,0,2,1.248533924843761,1.170500554541026
3119,13,240,53,110,103,0,4758.971,74,1922.081,MORE,28,2394,2422,2,2,-7.0,-0.6561859224721414,7.0,-0.34921514788478913,0.745679258723517,-0.5919521458100622,213,110,103,1,1.0570864565366473,1.170500554541026,0.8973837584814532,-0.9229379254490983,-0.018330359157128814,0.018330359157128814,0.8973837584814532,1.170500554541026,1,0,1,2,1.170500554541026,0.8973837584814532
3120,14,1,49,110,131,1,2411.837,80,854.618,MORE,10,1150,1160,3,2,21.0,1.9685577674164243,21.0,2.0952908873087353,1.049123911114166,-0.343643206546324,241,110,131,0,1.6155472260277064,1.170500554541026,1.9898509427197442,-0.1905619546346618,0.2384981416787059,0.2384981416787059,1.9898509427197442,1.170500554541026,1,1,1,2,1.9898509427197442,1.170500554541026
3121,14,2,13,47,50,0,2699.638,80,1141.175,MORE,-210,1264,1054,4,1,3.0,0.28122253820234633,3.0,-1.0476454436543674,1.049123911114166,-0.18630124576819174,97,47,50,0,-1.2565367313548828,-1.2875506099951286,-1.170500554541026,0.40339738448636203,-0.011030290941982705,0.011030290941982705,-1.170500554541026,-1.2875506099951286,1,1,1,0,-1.2875506099951286,-1.170500554541026
3122,14,3,16,50,44,0,5223.695,70,1276.617,MORE,-330,2550,2220,6,1,-6.0,-0.5624450764046927,6.0,-0.5238227218271837,0.6423553510699012,1.1936108375663694,94,50,44,1,-1.3163718138003533,-1.170500554541026,-1.4046006654492311,1.5913160627284098,-0.14713670873508558,0.14713670873508558,-1.4046006654492311,-1.170500554541026,1,1,0,0,-1.170500554541026,-1.4046006654492311
3123,14,4,7,57,50,0,4476.188,80,1002.49,MORE,-874,2368,1494,6,1,-7.0,-0.6561859224721414,7.0,-0.34921514788478913,1.049123911114166,0.7849457631733714,107,57,50,1,-1.0570864565366473,-0.8973837584814532,-1.170500554541026,1.5913160627284098,-0.764152469397152,0.764152469397152,-1.170500554541026,-0.8973837584814532,1,1,0,0,-0.8973837584814532,-1.170500554541026
3124,14,5,18,42,50,1,2077.934,60,587.698,MORE,-146,1072,926,4,1,8.0,0.7499267685395902,8.0,-0.17460757394239454,0.2355867910256365,-0.5261893155928549,92,42,50,0,-1.3562618687640005,-1.4826340357519663,-1.170500554541026,0.40339738448636203,0.06155979854767216,0.06155979854767216,-1.170500554541026,-1.4826340357519663,1,1,1,0,-1.4826340357519663,-1.170500554541026
3125,14,6,51,108,110,1,7788.1190000000015,50,1538.083,MORE,-528,3986,3458,9,1,2.0,0.18748169213489754,2.0,-1.222253017596762,-0.17118176901862814,2.5955917216720583,218,108,110,0,1.156811593945765,1.092467184238291,1.170500554541026,3.3731940800914813,-0.3717122980937054,0.3717122980937054,1.170500554541026,1.092467184238291,0,1,0,2,1.170500554541026,1.092467184238291
3126,14,7,31,78,80,0,4302.3,40,1273.833,MORE,-238,2098,1860,6,1,2.0,0.18748169213489754,2.0,-1.222253017596762,-0.5779503290628928,0.6898804962848343,158,78,80,0,-0.03989005496364707,-0.07803337030273506,0.0,1.5913160627284098,-0.04278845509370671,0.04278845509370671,0.0,-0.07803337030273506,0,1,1,1,-0.07803337030273506,0.0
3127,14,8,58,110,92,0,1526.463,80,235.314,MORE,-398,952,554,2,1,-18.0,-1.6873352292140782,18.0,1.571468165481551,1.049123911114166,-0.8276807226841345,202,110,92,1,0.8376911542365885,1.170500554541026,0.4682002218164104,-0.7845212937556856,-0.22426367881784387,0.22426367881784387,0.4682002218164104,1.170500554541026,1,0,0,2,1.170500554541026,0.4682002218164104
3128,14,9,12,50,48,0,3183.118,30,1552.0929999999996,MORE,-364,1596,1232,4,1,-2.0,-0.18748169213489754,2.0,-1.222253017596762,-0.9847188891071574,0.0780192089800939,98,50,48,1,-1.2365917038730592,-1.170500554541026,-1.248533924843761,0.40339738448636203,-0.1857001937764647,0.1857001937764647,-1.248533924843761,-1.170500554541026,0,1,0,0,-1.170500554541026,-1.248533924843761
3129,14,10,54,110,101,0,3205.175,50,951.677,MORE,-446,1714,1268,2,1,-9.0,-0.8436676146070391,9.0,0.0,-0.17118176901862814,0.09007785932836684,211,110,101,1,1.0171964015730004,1.170500554541026,0.8193503881787182,-0.7845212937556856,-0.27870624593508503,0.27870624593508503,0.8193503881787182,1.170500554541026,0,0,0,2,1.170500554541026,0.8193503881787182
3130,14,11,14,46,50,1,1604.214,70,841.297,MORE,708,400,1108,1,2,4.0,0.3749633842697951,4.0,-0.8730378697119728,0.6423553510699012,-0.7851739392036722,96,46,50,0,-1.2764817588367063,-1.3265672951464962,-1.170500554541026,-1.3784806328767094,1.0301838051752543,1.0301838051752543,-1.170500554541026,-1.3265672951464962,1,0,1,0,-1.3265672951464962,-1.170500554541026
3131,14,12,22,80,83,1,6530.474,60,1503.6629999999998,MORE,1262,2286,3548,5,2,3.0,0.28122253820234633,3.0,-1.0476454436543674,0.2355867910256365,1.908032157032552,163,80,83,0,0.05983508244547061,0.0,0.1170500554541026,0.9973567236073858,1.6585417673200793,1.6585417673200793,0.1170500554541026,0.0,1,1,1,1,0.1170500554541026,0.0
3132,14,13,6,50,56,1,1491.1570000000004,100,1636.7620000000004,MORE,1940,428,2368,1,2,6.0,0.5624450764046927,6.0,-0.5238227218271837,1.8626610312026952,-0.8469826544607186,106,50,56,0,-1.077031484018471,-1.170500554541026,-0.9364004436328208,-1.3784806328767094,2.4275430278511103,2.4275430278511103,-0.9364004436328208,-1.170500554541026,1,0,1,0,-1.170500554541026,-0.9364004436328208
3133,14,14,13,50,47,0,1333.8729999999996,80,982.562,MORE,-28,762,734,2,2,-3.0,-0.28122253820234633,3.0,-1.0476454436543674,1.049123911114166,-0.9329704479674398,97,50,47,1,-1.2565367313548828,-1.170500554541026,-1.2875506099951286,-0.7845212937556856,0.19539777604422331,0.19539777604422331,-1.2875506099951286,-1.170500554541026,1,0,1,0,-1.170500554541026,-1.2875506099951286
3134,14,15,46,110,124,0,6532.274,30,1480.169,MORE,-672,3336,2664,8,2,14.0,1.3123718449442827,14.0,0.8730378697119728,-0.9847188891071574,1.9090162242505282,234,110,124,0,1.4759320336549415,1.170500554541026,1.7167341466601715,2.7792347409704576,-0.5350399994454288,0.5350399994454288,1.7167341466601715,1.170500554541026,0,1,0,2,1.7167341466601715,1.170500554541026
3135,14,16,27,91,80,0,4038.85,80,808.0260000000002,MORE,-338,2096,1758,4,2,-11.0,-1.0311493067419364,11.0,0.34921514788478913,1.049123911114166,0.5458513248538839,171,91,80,1,0.21939530230005888,0.4291835366650429,0.0,0.40339738448636203,-0.15621046992129245,0.15621046992129245,0.0,0.4291835366650429,1,1,0,1,0.4291835366650429,0.0
3136,14,17,40,64,80,1,2546.243,80,357.575,MORE,276,1028,1304,3,2,16.0,1.4998535370791803,16.0,1.222253017596762,1.049123911114166,-0.2701629073800749,144,64,80,0,-0.3191204397091766,-0.6242669624218805,0.0,-0.1905619546346618,0.5402007011200839,0.5402007011200839,0.0,-0.6242669624218805,1,0,1,1,-0.6242669624218805,0.0
3137,14,18,22,83,80,0,4194.065,30,1049.154,MORE,-1434,2920,1486,4,1,-3.0,-0.28122253820234633,3.0,-1.0476454436543674,-0.9847188891071574,0.6307079877639423,163,83,80,1,0.05983508244547061,0.1170500554541026,0.0,0.40339738448636203,-1.399315752431632,1.399315752431632,0.0,0.1170500554541026,0,1,0,1,0.1170500554541026,0.0
3138,14,19,54,101,110,0,3940.452,0,1420.001,MORE,-984,2568,1584,4,1,9.0,0.8436676146070391,9.0,0.0,-2.2050245692399515,0.4920567436792298,211,101,110,0,1.0171964015730004,0.8193503881787182,1.170500554541026,0.40339738448636203,-0.8889166857074963,0.8889166857074963,1.170500554541026,0.8193503881787182,0,1,0,2,1.170500554541026,0.8193503881787182
3139,14,20,6,56,50,0,2702.658,30,368.866,MORE,-414,1348,934,4,1,-6.0,-0.5624450764046927,6.0,-0.5238227218271837,-0.9847188891071574,-0.18465019965803248,106,56,50,1,-1.077031484018471,-0.9364004436328208,-1.170500554541026,0.40339738448636203,-0.24241120119025758,0.24241120119025758,-1.170500554541026,-0.9364004436328208,0,1,0,0,-0.9364004436328208,-1.170500554541026
3140,14,21,18,50,42,0,4240.585,60,275.385,MORE,-1736,2766,1030,4,1,-8.0,-0.7499267685395902,8.0,-0.17460757394239454,0.2355867910256365,0.6561406583085158,92,50,42,1,-1.3562618687640005,-1.170500554541026,-1.4826340357519663,0.40339738448636203,-1.7418502372109408,1.7418502372109408,-1.4826340357519663,-1.170500554541026,1,1,0,0,-1.170500554541026,-1.4826340357519663
3141,14,22,43,110,117,0,2314.874,40,1653.171,MORE,-708,1476,768,2,1,7.0,0.6561859224721414,7.0,-0.34921514788478913,-0.5779503290628928,-0.3966532674666476,227,110,117,0,1.3363168412821769,1.170500554541026,1.4436173506005987,-0.7845212937556856,-0.5758719247833597,0.5758719247833597,1.4436173506005987,1.170500554541026,0,0,0,2,1.4436173506005987,1.170500554541026
3142,14,23,32,77,80,0,3636.833,50,1090.861,MORE,-1242,2158,916,2,1,3.0,0.28122253820234633,3.0,-1.0476454436543674,-0.17118176901862814,0.3260670188711307,157,77,80,0,-0.05983508244547061,-0.1170500554541026,0.0,-0.7845212937556856,-1.1815454839626673,1.1815454839626673,0.0,-0.1170500554541026,0,0,0,1,-0.1170500554541026,0.0
3143,14,24,27,80,91,1,1793.3829999999996,70,418.954,MORE,816,436,1252,1,2,11.0,1.0311493067419364,11.0,0.34921514788478913,0.6423553510699012,-0.6817544883385313,171,80,91,0,0.21939530230005888,0.0,0.4291835366650429,-1.3784806328767094,1.152679581189047,1.152679581189047,0.4291835366650429,0.0,1,0,1,1,0.4291835366650429,0.0
3144,14,25,16,44,50,1,4592.348,30,493.3130000000001,MORE,-200,2152,1952,5,2,6.0,0.5624450764046927,6.0,-0.5238227218271837,-0.9847188891071574,0.8484509009734061,94,44,50,0,-1.3163718138003533,-1.4046006654492311,-1.170500554541026,0.9973567236073858,0.0003119105407758672,0.0003119105407758672,-1.170500554541026,-1.4046006654492311,0,1,1,0,-1.4046006654492311,-1.170500554541026
3145,14,26,7,50,57,1,4757.3690000000015,70,2341.3920000000007,MORE,-536,2638,2102,4,1,7.0,0.6561859224721414,7.0,-0.34921514788478913,0.6423553510699012,0.9386685434053936,107,50,57,0,-1.0570864565366473,-1.170500554541026,-0.8973837584814532,0.40339738448636203,-0.3807860592799122,0.3807860592799122,-0.8973837584814532,-1.170500554541026,1,1,0,0,-1.170500554541026,-0.8973837584814532
3146,14,27,14,50,46,0,8235.293,20,2586.734,MORE,-2564,5006,2442,4,1,-4.0,-0.3749633842697951,4.0,-0.8730378697119728,-1.3914874491514222,2.8400635406337718,96,50,46,1,-1.2764817588367063,-1.170500554541026,-1.3265672951464962,0.40339738448636203,-2.6809845199833506,2.6809845199833506,-1.3265672951464962,-1.170500554541026,0,1,0,0,-1.170500554541026,-1.3265672951464962
3147,14,28,51,110,108,1,6841.092,40,1083.22,MORE,954,2304,3258,7,2,-2.0,-0.18748169213489754,2.0,-1.222253017596762,-0.5779503290628928,2.0778482632065467,218,110,108,1,1.156811593945765,1.170500554541026,1.092467184238291,2.1852754018494336,1.3092019616511152,1.3092019616511152,1.092467184238291,1.170500554541026,0,1,1,2,1.170500554541026,1.092467184238291
3148,14,29,50,133,110,0,2101.964,40,1176.744,MORE,-924,1536,612,2,1,-23.0,-2.1560394595513217,23.0,2.444506035193524,-0.5779503290628928,-0.5130520182328788,243,133,110,1,1.6554372809913533,2.0678843130224793,1.170500554541026,-0.7845212937556856,-0.8208634768109448,0.8208634768109448,1.170500554541026,2.0678843130224793,0,0,0,2,2.0678843130224793,1.170500554541026
3149,14,30,49,131,110,0,1568.7910000000004,70,189.699,MORE,-290,762,472,2,1,-21.0,-1.9685577674164243,21.0,2.0952908873087353,0.6423553510699012,-0.8045398353494246,241,131,110,1,1.6155472260277064,1.9898509427197442,1.170500554541026,-0.7845212937556856,-0.10176790280405129,0.10176790280405129,1.170500554541026,1.9898509427197442,1,0,0,2,1.9898509427197442,1.170500554541026
3150,14,31,47,126,110,0,2712.183,60,967.443,MORE,-60,1312,1252,2,1,-16.0,-1.4998535370791803,16.0,1.222253017596762,0.2355867910256365,-0.17944284396291074,236,126,110,1,1.5158220886185887,1.7947675169629065,1.170500554541026,-0.7845212937556856,0.1591027312993959,0.1591027312993959,1.170500554541026,1.7947675169629065,1,0,1,2,1.7947675169629065,1.170500554541026
3151,14,32,50,110,133,1,5973.21,40,1221.0739999999996,MORE,560,2452,3012,4,2,23.0,2.1560394595513217,23.0,2.444506035193524,-0.5779503290628928,1.603373693611421,243,110,133,0,1.6554372809913533,1.170500554541026,2.0678843130224793,0.40339738448636203,0.8623192232304273,0.8623192232304273,2.0678843130224793,1.170500554541026,0,1,1,2,2.0678843130224793,1.170500554541026
3152,14,33,47,110,126,1,3141.054,80,1902.409,MORE,402,1196,1598,5,2,16.0,1.4998535370791803,16.0,1.222253017596762,1.049123911114166,0.05502265150402075,236,110,126,0,1.5158220886185887,1.170500554541026,1.7947675169629065,0.9973567236073858,0.6831124398028419,0.6831124398028419,1.7947675169629065,1.170500554541026,1,1,1,2,1.7947675169629065,1.170500554541026
3153,14,34,12,48,50,1,1848.953,10,2070.248,MORE,-692,1618,926,3,1,2.0,0.18748169213489754,2.0,-1.222253017596762,-1.7982560091956867,-0.6513741465035797,98,48,50,0,-1.2365917038730592,-1.248533924843761,-1.170500554541026,-0.1905619546346618,-0.5577244024109459,0.5577244024109459,-1.170500554541026,-1.248533924843761,0,1,0,0,-1.248533924843761,-1.170500554541026
3154,14,35,32,80,77,0,2688.136,70,843.3910000000002,MORE,-212,1268,1056,4,1,-3.0,-0.28122253820234633,3.0,-1.0476454436543674,0.6423553510699012,-0.1925894352910568,157,80,77,1,-0.05983508244547061,0.0,-0.1170500554541026,0.40339738448636203,-0.01329873123853442,0.01329873123853442,-0.1170500554541026,0.0,1,1,1,1,0.0,-0.1170500554541026
3155,14,36,43,117,110,0,6172.306,30,1392.7120000000002,MORE,-1922,3952,2030,8,1,-7.0,-0.6561859224721414,7.0,-0.34921514788478913,-0.9847188891071574,1.7122202751836981,227,117,110,1,1.3363168412821769,1.4436173506005987,1.170500554541026,2.7792347409704576,-1.9528151847902502,1.9528151847902502,1.170500554541026,1.4436173506005987,0,1,0,2,1.4436173506005987,1.170500554541026
3156,14,37,40,80,64,0,3677.141,80,904.659,MORE,-1306,2256,950,4,1,-16.0,-1.4998535370791803,16.0,1.222253017596762,1.049123911114166,0.3481035641056676,144,80,64,1,-0.3191204397091766,0.0,-0.6242669624218805,0.40339738448636203,-1.254135573452322,1.254135573452322,-0.6242669624218805,0.0,1,1,0,1,0.0,-0.6242669624218805
3157,14,38,31,80,78,0,5200.268,10,1319.979,MORE,328,2562,2890,4,1,-2.0,-0.18748169213489754,2.0,-1.222253017596762,-1.7982560091956867,1.180803202724415,158,80,78,1,-0.03989005496364707,0.0,-0.07803337030273506,0.40339738448636203,0.5991801488304285,0.5991801488304285,-0.07803337030273506,0.0,0,1,1,1,0.0,-0.07803337030273506
3158,14,39,46,124,110,0,2072.589,40,1176.386,MORE,-576,1092,516,2,1,-14.0,-1.3123718449442827,14.0,0.8730378697119728,-0.5779503290628928,-0.529111448526233,234,124,110,1,1.4759320336549415,1.7167341466601715,1.170500554541026,-0.7845212937556856,-0.4261548652109465,0.4261548652109465,1.170500554541026,1.7167341466601715,0,0,0,2,1.7167341466601715,1.170500554541026
3159,14,40,58,92,110,1,4900.0790000000015,50,884.2180000000002,MORE,-468,2418,1950,7,2,18.0,1.6873352292140782,18.0,1.571468165481551,-0.17118176901862814,1.0166886726705706,202,92,110,0,0.8376911542365885,0.4682002218164104,1.170500554541026,2.1852754018494336,-0.3036590891971539,0.3036590891971539,1.170500554541026,0.4682002218164104,0,1,0,2,1.170500554541026,0.4682002218164104
3160,14,41,49,110,131,0,3324.308,20,710.0310000000002,LESS,-976,2104,1128,4,1,21.0,1.9685577674164243,21.0,2.0952908873087353,-1.3914874491514222,0.15520834815009155,241,110,131,1,1.6155472260277064,1.170500554541026,1.9898509427197442,0.40339738448636203,-0.8798429245212894,0.8798429245212894,1.9898509427197442,1.170500554541026,0,1,0,2,1.9898509427197442,1.170500554541026
3161,14,42,13,47,50,1,4480.32,70,1175.852,LESS,846,1584,2430,4,2,3.0,0.28122253820234633,3.0,-1.0476454436543674,0.6423553510699012,0.7872047441426354,97,47,50,1,-1.2565367313548828,-1.2875506099951286,-1.170500554541026,0.40339738448636203,1.1867061856373227,1.1867061856373227,-1.170500554541026,-1.2875506099951286,1,1,1,0,-1.2875506099951286,-1.170500554541026
3162,14,43,16,50,44,1,2523.038,40,1102.599,LESS,472,830,1302,3,2,-6.0,-0.5624450764046927,6.0,-0.5238227218271837,-0.5779503290628928,-0.28284917393181225,94,50,44,0,-1.3163718138003533,-1.170500554541026,-1.4046006654492311,-0.1905619546346618,0.762507850182152,0.762507850182152,-1.4046006654492311,-1.170500554541026,0,0,1,0,-1.170500554541026,-1.4046006654492311
3163,14,44,7,57,50,1,2791.3390000000004,30,401.05800000000005,LESS,582,998,1580,3,2,-7.0,-0.6561859224721414,7.0,-0.34921514788478913,-0.9847188891071574,-0.1361679413484171,107,57,50,0,-1.0570864565366473,-0.8973837584814532,-1.170500554541026,-0.1905619546346618,0.8872720664924962,0.8872720664924962,-1.170500554541026,-0.8973837584814532,0,0,1,0,-0.8973837584814532,-1.170500554541026
3164,14,45,18,42,50,0,6684.934,50,2013.367,LESS,648,2968,3616,8,2,8.0,0.7499267685395902,8.0,-0.17460757394239454,-0.17118176901862814,1.9924760584150711,92,42,50,1,-1.3562618687640005,-1.4826340357519663,-1.170500554541026,2.7792347409704576,0.9621305962787028,0.9621305962787028,-1.170500554541026,-1.4826340357519663,0,1,1,0,-1.4826340357519663,-1.170500554541026
3165,14,46,51,108,110,0,4055.65,20,1971.936,LESS,-436,2266,1830,4,2,2.0,0.18748169213489754,2.0,-1.222253017596762,-1.3914874491514222,0.5550359522216576,218,108,110,1,1.156811593945765,1.092467184238291,1.170500554541026,0.40339738448636203,-0.2673640444523264,0.2673640444523264,1.170500554541026,1.092467184238291,0,1,0,2,1.170500554541026,1.092467184238291
3166,14,47,31,78,80,0,3286.518,20,1907.924,LESS,148,1514,1662,4,2,2.0,0.18748169213489754,2.0,-1.222253017596762,-1.3914874491514222,0.13454840361270076,158,78,80,1,-0.03989005496364707,-0.07803337030273506,0.0,0.40339738448636203,0.39502052214077416,0.39502052214077416,0.0,-0.07803337030273506,0,1,1,1,-0.07803337030273506,0.0
3167,14,48,58,110,92,1,2964.972,30,1269.0,LESS,664,1032,1696,3,2,-18.0,-1.6873352292140782,18.0,1.571468165481551,-0.9847188891071574,-0.04124208398242669,202,110,92,0,0.8376911542365885,1.170500554541026,0.4682002218164104,-0.1905619546346618,0.9802781186511165,0.9802781186511165,0.4682002218164104,1.170500554541026,0,0,1,2,1.170500554541026,0.4682002218164104
3168,14,49,12,50,48,0,5929.486,30,1371.025,LESS,410,2526,2936,4,1,-2.0,-0.18748169213489754,2.0,-1.222253017596762,-0.9847188891071574,1.5794696074787695,98,50,48,0,-1.2365917038730592,-1.170500554541026,-1.248533924843761,0.40339738448636203,0.6921862009890488,0.6921862009890488,-1.248533924843761,-1.170500554541026,0,1,1,0,-1.170500554541026,-1.248533924843761
3169,14,50,54,110,101,1,1761.845,70,1709.9920000000004,LESS,970,364,1334,1,2,-9.0,-0.8436676146070391,9.0,0.0,0.6423553510699012,-0.6989964394054861,211,110,101,0,1.0171964015730004,1.170500554541026,0.8193503881787182,-1.3784806328767094,1.327349484023529,1.327349484023529,0.8193503881787182,1.170500554541026,1,0,1,2,1.170500554541026,0.8193503881787182
3170,14,51,14,46,50,0,1419.557,10,257.402,LESS,-340,788,448,2,1,4.0,0.3749633842697951,4.0,-0.8730378697119728,-1.7982560091956867,-0.886126661575754,96,46,50,1,-1.2764817588367063,-1.3265672951464962,-1.170500554541026,-0.7845212937556856,-0.15847891021784416,0.15847891021784416,-1.170500554541026,-1.3265672951464962,0,0,0,0,-1.3265672951464962,-1.170500554541026
3171,14,52,22,80,83,0,1643.956,10,932.18,LESS,-656,1444,788,4,1,3.0,0.28122253820234633,3.0,-1.0476454436543674,-1.7982560091956867,-0.7634468284387876,163,80,83,1,0.05983508244547061,0.0,0.1170500554541026,0.40339738448636203,-0.5168924770730151,0.5168924770730151,0.1170500554541026,0.0,0,1,0,1,0.1170500554541026,0.0
3172,14,53,6,50,56,0,1249.042,40,164.52,LESS,-264,668,404,2,1,6.0,0.5624450764046927,6.0,-0.5238227218271837,-0.5779503290628928,-0.9793478958386066,106,50,56,1,-1.077031484018471,-1.170500554541026,-0.9364004436328208,-0.7845212937556856,-0.072278178948879,0.072278178948879,-0.9364004436328208,-1.170500554541026,0,0,0,0,-1.170500554541026,-0.9364004436328208
3173,14,54,13,50,47,0,1372.969,90,1010.681,LESS,-46,768,722,2,2,-3.0,-0.28122253820234633,3.0,-1.0476454436543674,1.4558924711584305,-0.9115965079930064,97,50,47,0,-1.2565367313548828,-1.170500554541026,-1.2875506099951286,-0.7845212937556856,0.1749818133752579,0.1749818133752579,-1.2875506099951286,-1.170500554541026,1,0,1,0,-1.170500554541026,-1.2875506099951286
3174,14,55,46,110,124,0,2401.027,20,1514.342,LESS,-556,1468,912,4,1,14.0,1.3123718449442827,14.0,0.8730378697119728,-1.3914874491514222,-0.3495530768942783,234,110,124,1,1.4759320336549415,1.170500554541026,1.7167341466601715,0.40339738448636203,-0.4034704622454294,0.4034704622454294,1.7167341466601715,1.170500554541026,0,1,0,2,1.7167341466601715,1.170500554541026
3175,14,56,27,91,80,0,1245.098,60,1177.377,LESS,-326,720,394,2,1,-11.0,-1.0311493067419364,11.0,0.34921514788478913,0.2355867910256365,-0.9815040964539936,171,91,80,0,0.21939530230005888,0.4291835366650429,0.0,-0.7845212937556856,-0.14259982814198216,0.14259982814198216,0.0,0.4291835366650429,0,0,0,1,0.4291835366650429,0.0
3176,14,57,40,64,80,0,1233.281,70,884.681,LESS,-384,762,378,2,1,16.0,1.4998535370791803,16.0,1.222253017596762,0.6423553510699012,-0.9879644977400044,144,64,80,1,-0.3191204397091766,-0.6242669624218805,0.0,-0.7845212937556856,-0.20838459674198187,0.20838459674198187,0.0,-0.6242669624218805,1,0,0,1,-0.6242669624218805,0.0
3177,14,58,22,83,80,0,1342.216,20,381.341,LESS,-470,884,414,2,1,-3.0,-0.28122253820234633,3.0,-1.0476454436543674,-1.3914874491514222,-0.928409296412122,163,83,80,0,0.05983508244547061,0.1170500554541026,0.0,-0.7845212937556856,-0.3059275294937056,0.3059275294937056,0.0,0.1170500554541026,0,0,0,1,0.1170500554541026,0.0
3178,14,59,54,101,110,0,1259.717,50,935.216,LESS,-326,714,388,2,1,9.0,0.8436676146070391,9.0,0.0,-0.17118176901862814,-0.9735118305320004,211,101,110,1,1.0171964015730004,0.8193503881787182,1.170500554541026,-0.7845212937556856,-0.14259982814198216,0.14259982814198216,1.170500554541026,0.8193503881787182,0,0,0,2,1.170500554541026,0.8193503881787182
3179,14,60,6,56,50,1,2073.05,80,299.835,LESS,442,778,1220,3,2,-6.0,-0.5624450764046927,6.0,-0.5238227218271837,1.049123911114166,-0.5288594179776289,106,56,50,0,-1.077031484018471,-0.9364004436328208,-1.170500554541026,-0.1905619546346618,0.7284812457338762,0.7284812457338762,-1.170500554541026,-0.9364004436328208,1,1,1,0,-0.9364004436328208,-1.170500554541026
3180,14,61,18,50,42,1,3773.646,50,1578.817,LESS,1704,858,2562,3,2,-8.0,-0.7499267685395902,8.0,-0.17460757394239454,-0.17118176901862814,0.40086323458941736,92,50,42,0,-1.3562618687640005,-1.170500554541026,-1.4826340357519663,-0.1905619546346618,2.1598670728580083,2.1598670728580083,-1.4826340357519663,-1.170500554541026,0,1,1,0,-1.170500554541026,-1.4826340357519663
3181,14,62,43,110,117,0,1497.685,80,1411.414,LESS,-440,970,530,2,2,7.0,0.6561859224721414,7.0,-0.34921514788478913,1.049123911114166,-0.8434137706835269,227,110,117,1,1.3363168412821769,1.170500554541026,1.4436173506005987,-0.7845212937556856,-0.2719009250454299,0.2719009250454299,1.4436173506005987,1.170500554541026,1,0,0,2,1.4436173506005987,1.170500554541026
3182,14,63,32,77,80,1,2165.322,20,1446.0739999999996,LESS,-812,1910,1098,4,1,3.0,0.28122253820234633,3.0,-1.0476454436543674,-1.3914874491514222,-0.4784139455681524,157,77,80,1,-0.05983508244547061,-0.1170500554541026,0.0,0.40339738448636203,-0.6938308202040488,0.6938308202040488,0.0,-0.1170500554541026,0,1,0,1,-0.1170500554541026,0.0
3183,14,64,27,80,91,0,1272.365,50,963.232,LESS,-312,686,374,2,1,11.0,1.0311493067419364,11.0,0.34921514788478913,-0.17118176901862814,-0.9665971182136908,171,80,91,1,0.21939530230005888,0.0,0.4291835366650429,-0.7845212937556856,-0.12672074606612016,0.12672074606612016,0.4291835366650429,0.0,0,0,0,1,0.4291835366650429,0.0
3184,14,65,16,44,50,0,1367.841,20,875.872,LESS,-922,1342,420,2,1,6.0,0.5624450764046927,6.0,-0.5238227218271837,-1.3914874491514222,-0.9144000061562172,94,44,50,1,-1.3163718138003533,-1.4046006654492311,-1.170500554541026,-0.7845212937556856,-0.8185950365143931,0.8185950365143931,-1.170500554541026,-1.4046006654492311,0,0,0,0,-1.4046006654492311,-1.170500554541026
3185,14,66,7,50,57,0,2336.13,80,696.7360000000001,LESS,-68,1114,1046,4,2,7.0,0.6561859224721414,7.0,-0.34921514788478913,1.049123911114166,-0.3850325270303738,107,50,57,1,-1.0570864565366473,-1.170500554541026,-0.8973837584814532,0.40339738448636203,0.15002897011318903,0.15002897011318903,-0.8973837584814532,-1.170500554541026,1,1,0,0,-1.170500554541026,-0.8973837584814532
3186,14,67,14,50,46,1,2073.203,50,1167.0839999999996,LESS,388,760,1148,3,2,-4.0,-0.3749633842697951,4.0,-0.8730378697119728,-0.17118176901862814,-0.5287757722641012,96,50,46,0,-1.2764817588367063,-1.170500554541026,-1.3265672951464962,-0.1905619546346618,0.6672333577269799,0.6672333577269799,-1.3265672951464962,-1.170500554541026,0,0,1,0,-1.170500554541026,-1.3265672951464962
3187,14,68,51,110,108,1,2271.048,0,1011.375,LESS,-680,1806,1126,4,1,-2.0,-0.18748169213489754,2.0,-1.222253017596762,-2.2050245692399515,-0.4206131174083171,218,110,108,0,1.156811593945765,1.170500554541026,1.092467184238291,0.40339738448636203,-0.5441137606316356,0.5441137606316356,1.092467184238291,1.170500554541026,0,1,0,2,1.170500554541026,1.092467184238291
3188,14,69,50,133,110,1,1945.156,20,1763.8429999999996,LESS,336,718,1054,3,1,-23.0,-2.1560394595513217,23.0,2.444506035193524,-1.3914874491514222,-0.5987795806308461,243,133,110,0,1.6554372809913533,2.0678843130224793,1.170500554541026,-0.1905619546346618,0.6082539100166353,0.6082539100166353,1.170500554541026,2.0678843130224793,0,1,1,2,2.0678843130224793,1.170500554541026
3189,14,70,49,131,110,1,8341.024,50,1587.0320000000004,LESS,2288,2732,5020,7,2,-21.0,-1.9685577674164243,21.0,2.0952908873087353,-0.17118176901862814,2.8978671023136564,241,131,110,0,1.6155472260277064,1.9898509427197442,1.170500554541026,2.1852754018494336,2.822251639451109,2.822251639451109,1.170500554541026,1.9898509427197442,0,1,1,2,1.9898509427197442,1.170500554541026
3190,14,71,47,126,110,1,1665.83,40,315.821,LESS,862,320,1182,1,2,-16.0,-1.4998535370791803,16.0,1.222253017596762,-0.5779503290628928,-0.7514882249243424,236,126,110,0,1.5158220886185887,1.7947675169629065,1.170500554541026,-1.3784806328767094,1.2048537080097363,1.2048537080097363,1.170500554541026,1.7947675169629065,0,0,1,2,1.7947675169629065,1.170500554541026
3191,14,72,50,110,133,0,1219.089,70,623.507,LESS,-302,668,366,2,1,23.0,2.1560394595513217,23.0,2.444506035193524,0.6423553510699012,-0.9957233210497328,243,110,133,1,1.6554372809913533,1.170500554541026,2.0678843130224793,-0.7845212937556856,-0.11537854458336158,0.11537854458336158,2.0678843130224793,1.170500554541026,1,0,0,2,2.0678843130224793,1.170500554541026
3192,14,73,47,110,126,0,1168.573,70,648.031,LESS,-234,588,354,2,1,16.0,1.4998535370791803,16.0,1.222253017596762,0.6423553510699012,-1.0233406208182123,236,110,126,1,1.5158220886185887,1.170500554541026,1.7947675169629065,-0.7845212937556856,-0.03825157450060328,0.03825157450060328,1.7947675169629065,1.170500554541026,1,0,0,2,1.7947675169629065,1.170500554541026
3193,14,74,12,48,50,0,1321.304,80,1268.104,LESS,-18,728,710,2,2,2.0,0.18748169213489754,2.0,-1.222253017596762,1.049123911114166,-0.9398419706689602,98,48,50,1,-1.2365917038730592,-1.248533924843761,-1.170500554541026,-0.7845212937556856,0.2067399775269819,0.2067399775269819,-1.170500554541026,-1.248533924843761,1,0,1,0,-1.248533924843761,-1.170500554541026
3194,14,75,32,80,77,0,1316.62,10,1253.907,LESS,-682,1056,374,2,1,-3.0,-0.28122253820234633,3.0,-1.0476454436543674,-1.7982560091956867,-0.9424027322517372,157,80,77,0,-0.05983508244547061,0.0,-0.1170500554541026,-0.7845212937556856,-0.5463822009281873,0.5463822009281873,-0.1170500554541026,0.0,0,0,0,1,0.0,-0.1170500554541026
3195,14,76,43,117,110,0,1399.691,70,251.379,LESS,-596,1006,410,2,1,-7.0,-0.6561859224721414,7.0,-0.34921514788478913,0.6423553510699012,-0.8969874834381464,227,117,110,0,1.3363168412821769,1.4436173506005987,1.170500554541026,-0.7845212937556856,-0.44883926817646363,0.44883926817646363,1.170500554541026,1.4436173506005987,1,0,0,2,1.4436173506005987,1.170500554541026
3196,14,77,40,80,64,1,2336.324,60,1328.116,LESS,376,1074,1450,4,1,-16.0,-1.4998535370791803,16.0,1.222253017596762,0.2355867910256365,-0.3849264664524365,144,80,64,0,-0.3191204397091766,0.0,-0.6242669624218805,0.40339738448636203,0.6536227159476696,0.6536227159476696,-0.6242669624218805,0.0,0,1,1,1,0.0,-0.6242669624218805
3197,14,78,31,80,78,0,1289.006,30,1303.604,LESS,-692,1032,340,2,1,-2.0,-0.18748169213489754,2.0,-1.222253017596762,-0.9847188891071574,-0.9574994167835049,158,80,78,0,-0.03989005496364707,0.0,-0.07803337030273506,-0.7845212937556856,-0.5577244024109459,0.5577244024109459,-0.07803337030273506,0.0,0,0,0,1,0.0,-0.07803337030273506
3198,14,79,46,124,110,1,2602.567,40,1234.995,LESS,178,1072,1250,5,2,-14.0,-1.3123718449442827,14.0,0.8730378697119728,-0.5779503290628928,-0.2393703507215938,234,124,110,0,1.4759320336549415,1.7167341466601715,1.170500554541026,0.9973567236073858,0.42904712658904987,0.42904712658904987,1.170500554541026,1.7167341466601715,0,1,1,2,1.7167341466601715,1.170500554541026
3199,14,80,58,92,110,0,1337.46,70,696.5169999999998,LESS,-318,746,428,2,2,18.0,1.6873352292140782,18.0,1.571468165481551,0.6423553510699012,-0.931009420683618,202,92,110,1,0.8376911542365885,0.4682002218164104,1.170500554541026,-0.7845212937556856,-0.1335260669557753,0.1335260669557753,1.170500554541026,0.4682002218164104,1,0,0,2,1.170500554541026,0.4682002218164104
3200,14,81,48,128,110,0,5015.075,30,1107.934,MORE,-1460,3046,1586,6,1,-18.0,-1.6873352292140782,18.0,1.571468165481551,-0.9847188891071574,1.0795574470029805,238,128,110,1,1.5557121435822359,1.8728008872656416,1.170500554541026,1.5913160627284098,-1.428805476286804,1.428805476286804,1.170500554541026,1.8728008872656416,0,1,0,2,1.8728008872656416,1.170500554541026
3201,14,82,8,50,58,1,1367.3629999999996,20,634.3430000000002,MORE,656,310,966,1,2,8.0,0.7499267685395902,8.0,-0.17460757394239454,-1.3914874491514222,-0.9146613306729909,108,50,58,0,-1.0371414290548238,-1.170500554541026,-0.8583670733300858,-1.3784806328767094,0.9712043574649096,0.9712043574649096,-0.8583670733300858,-1.170500554541026,0,0,1,0,-1.170500554541026,-0.8583670733300858
3202,14,83,4,54,50,0,2077.351,70,1452.631,MORE,-98,1336,1238,2,2,-4.0,-0.3749633842697951,4.0,-0.8730378697119728,0.6423553510699012,-0.5265080440306771,104,54,50,1,-1.116921538982118,-1.0144338139355558,-1.170500554541026,-0.7845212937556856,0.11600236566491332,0.11600236566491332,-1.170500554541026,-1.0144338139355558,1,0,1,0,-1.0144338139355558,-1.170500554541026
3203,14,84,37,80,69,0,3691.81,50,1071.171,MORE,208,1468,1676,2,1,-11.0,-1.0311493067419364,11.0,0.34921514788478913,-0.17118176901862814,0.35612316522815984,149,80,69,1,-0.21939530230005888,0.0,-0.4291835366650429,-0.7845212937556856,0.4630737310373256,0.4630737310373256,-0.4291835366650429,0.0,0,0,1,1,0.0,-0.4291835366650429
3204,14,85,52,105,110,0,2172.653,40,1316.531,MORE,-1438,2166,728,2,1,5.0,0.4687042303372438,5.0,-0.6984302957695783,-0.5779503290628928,-0.4744060584709413,215,105,110,0,1.0969765115002945,0.9754171287841883,1.170500554541026,-0.7845212937556856,-1.4038526330247354,1.4038526330247354,1.170500554541026,0.9754171287841883,0,0,0,2,1.170500554541026,0.9754171287841883
3205,14,86,5,55,50,0,3391.115,30,1689.287,MORE,-108,1482,1374,4,1,-5.0,-0.4687042303372438,5.0,-0.6984302957695783,-0.9847188891071574,0.1917320029452613,105,55,50,1,-1.0969765115002945,-0.9754171287841883,-1.170500554541026,0.40339738448636203,0.10466016418215474,0.10466016418215474,-1.170500554541026,-0.9754171287841883,0,1,1,0,-0.9754171287841883,-1.170500554541026
3206,14,87,30,96,80,0,2218.531,100,1542.059,MORE,-258,1578,1320,2,2,-16.0,-1.4998535370791803,16.0,1.222253017596762,1.8626610312026952,-0.4493243719007794,176,96,80,1,0.3191204397091766,0.6242669624218805,0.0,-0.7845212937556856,-0.06547285805922386,0.06547285805922386,0.0,0.6242669624218805,1,0,0,1,0.6242669624218805,0.0
3207,14,88,33,80,75,1,2659.04,30,1375.0410000000004,MORE,460,716,1176,3,2,-5.0,-0.4687042303372438,5.0,-0.6984302957695783,-0.9847188891071574,-0.20849633516562474,155,80,75,1,-0.09972513740911768,0.0,-0.19508342575683765,-0.1905619546346618,0.7488972084028417,0.7488972084028417,-0.19508342575683765,0.0,0,1,1,1,0.0,-0.19508342575683765
3208,14,89,48,110,128,1,2667.889,70,1515.914,MORE,38,1208,1246,4,1,18.0,1.6873352292140782,18.0,1.571468165481551,0.6423553510699012,-0.20365855138125388,238,110,128,0,1.5557121435822359,1.170500554541026,1.8728008872656416,0.40339738448636203,0.2702563058304299,0.2702563058304299,1.8728008872656416,1.170500554541026,1,1,1,2,1.8728008872656416,1.170500554541026
3209,14,90,9,59,50,0,6196.985,20,413.549,MORE,-1460,3560,2100,6,1,-9.0,-0.8436676146070391,9.0,0.0,-1.3914874491514222,1.7257123834461554,109,59,50,1,-1.0171964015730004,-0.8193503881787182,-1.170500554541026,1.5913160627284098,-1.428805476286804,1.428805476286804,-1.170500554541026,-0.8193503881787182,0,1,0,0,-0.8193503881787182,-1.170500554541026
3210,14,91,44,110,119,1,5425.233,10,776.627,MORE,-378,2798,2420,8,1,9.0,0.8436676146070391,9.0,0.0,-1.7982560091956867,1.3037924703310342,229,110,119,0,1.376206896245824,1.170500554541026,1.5216507209033339,2.7792347409704576,-0.20157927585232674,0.20157927585232674,1.5216507209033339,1.170500554541026,0,1,0,2,1.5216507209033339,1.170500554541026
3211,14,92,2,52,50,0,2724.3459999999995,40,1933.971,MORE,-1874,2504,630,2,1,-2.0,-0.18748169213489754,2.0,-1.222253017596762,-0.5779503290628928,-0.1727932830894449,102,52,50,1,-1.156811593945765,-1.092467184238291,-1.170500554541026,-0.7845212937556856,-1.8983726176730091,1.8983726176730091,-1.170500554541026,-1.092467184238291,0,0,0,0,-1.092467184238291,-1.170500554541026
3212,14,93,8,58,50,0,3105.605,60,1115.963,MORE,-468,1910,1442,4,2,-8.0,-0.7499267685395902,8.0,-0.17460757394239454,0.2355867910256365,0.03564254105400834,108,58,50,1,-1.0371414290548238,-0.8583670733300858,-1.170500554541026,0.40339738448636203,-0.3036590891971539,0.3036590891971539,-1.170500554541026,-0.8583670733300858,1,1,0,0,-0.8583670733300858,-1.170500554541026
3213,14,94,44,119,110,0,10200.481,30,955.796,MORE,-4352,6796,2444,3,1,-9.0,-0.8436676146070391,9.0,0.0,-0.9847188891071574,3.914439700611173,229,119,110,1,1.376206896245824,1.5216507209033339,1.170500554541026,-0.1905619546346618,-4.708970145100584,4.708970145100584,1.170500554541026,1.5216507209033339,0,1,0,2,1.5216507209033339,1.170500554541026
3214,14,95,34,74,80,1,1216.532,60,1285.047,MORE,558,292,850,2,1,6.0,0.5624450764046927,6.0,-0.5238227218271837,0.2355867910256365,-0.9971212432032686,154,74,80,0,-0.11967016489094122,-0.2341001109082052,0.0,-0.7845212937556856,0.8600507829338756,0.8600507829338756,0.0,-0.2341001109082052,1,0,1,1,-0.2341001109082052,0.0
3215,14,96,24,86,80,0,2016.147,30,1005.393,MORE,-1292,1854,562,2,1,-6.0,-0.5624450764046927,6.0,-0.5238227218271837,-0.9847188891071574,-0.5599685162578925,166,86,80,1,0.11967016489094122,0.2341001109082052,0.0,-0.7845212937556856,-1.2382564913764602,1.2382564913764602,0.0,0.2341001109082052,0,0,0,1,0.2341001109082052,0.0
3216,14,97,39,66,80,1,1319.821,60,1464.62,MORE,-46,708,662,3,2,14.0,1.3123718449442827,14.0,0.8730378697119728,0.2355867910256365,-0.9406527327157704,146,66,80,0,-0.2792303847455295,-0.5462335921191455,0.0,-0.1905619546346618,0.1749818133752579,0.1749818133752579,0.0,-0.5462335921191455,1,1,1,1,-0.5462335921191455,0.0
3217,14,98,9,50,59,1,2841.325,60,888.738,MORE,332,930,1262,3,2,9.0,0.8436676146070391,9.0,0.0,0.2355867910256365,-0.1088403947052309,109,50,59,0,-1.0171964015730004,-1.170500554541026,-0.8193503881787182,-0.1905619546346618,0.6037170294235319,0.6037170294235319,-0.8193503881787182,-1.170500554541026,1,1,1,0,-1.170500554541026,-0.8193503881787182
3218,14,99,57,94,110,1,3073.9440000000004,50,1631.664,MORE,316,1356,1672,4,1,16.0,1.4998535370791803,16.0,1.222253017596762,-0.17118176901862814,0.018333345393825157,204,94,110,0,0.8775812092002355,0.5462335921191455,1.170500554541026,0.40339738448636203,0.5855695070511182,0.5855695070511182,1.170500554541026,0.5462335921191455,0,1,1,2,1.170500554541026,0.5462335921191455
3219,14,100,60,110,87,0,1385.729,60,981.131,MORE,264,720,984,2,2,-23.0,-2.1560394595513217,23.0,2.444506035193524,0.2355867910256365,-0.9046205648255784,197,110,87,1,0.7379660168274708,1.170500554541026,0.27311679605957273,-0.7845212937556856,0.5265900593407736,0.5265900593407736,0.27311679605957273,1.170500554541026,1,0,1,2,1.170500554541026,0.27311679605957273
3220,14,101,33,75,80,0,3229.698,20,1078.341,MORE,-1586,2630,1044,4,1,5.0,0.4687042303372438,5.0,-0.6984302957695783,-1.3914874491514222,0.10348468176526623,155,75,80,0,-0.09972513740911768,-0.19508342575683765,0.0,0.40339738448636203,-1.5717172149695622,1.5717172149695622,0.0,-0.19508342575683765,0,1,0,1,-0.19508342575683765,0.0
3221,14,102,15,50,45,0,1760.556,30,1171.994,MORE,-1332,1870,538,2,1,-5.0,-0.4687042303372438,5.0,-0.6984302957695783,-0.9847188891071574,-0.6997011408743586,95,50,45,1,-1.2964267863185297,-1.170500554541026,-1.3655839802978638,-0.7845212937556856,-1.2836252973074944,1.2836252973074944,-1.3655839802978638,-1.170500554541026,0,0,0,0,-1.170500554541026,-1.3655839802978638
3222,14,103,59,89,110,1,3067.113,60,1039.627,MORE,460,1174,1634,3,2,21.0,1.9685577674164243,21.0,2.0952908873087353,0.2355867910256365,0.014598810301606872,199,89,110,0,0.7778560717911179,0.3511501663623078,1.170500554541026,-0.1905619546346618,0.7488972084028417,0.7488972084028417,1.170500554541026,0.3511501663623078,1,0,1,2,1.170500554541026,0.3511501663623078
3223,14,104,29,80,94,1,1504.947,60,1325.8629999999996,MORE,566,416,982,1,2,14.0,1.3123718449442827,14.0,0.8730378697119728,0.2355867910256365,-0.8394436061630047,174,80,94,0,0.2792303847455295,0.0,0.5462335921191455,-1.3784806328767094,0.8691245441200826,0.8691245441200826,0.5462335921191455,0.0,1,0,1,1,0.5462335921191455,0.0
3224,14,105,55,110,98,0,4153.062,90,623.856,MORE,-292,2178,1886,6,2,-12.0,-1.124890152809385,12.0,0.5238227218271837,1.4558924711584305,0.608291483242465,208,110,98,1,0.9573613191275298,1.170500554541026,0.7023003327246156,1.5913160627284098,-0.104036343100603,0.104036343100603,0.7023003327246156,1.170500554541026,1,1,0,2,1.170500554541026,0.7023003327246156
3225,14,106,29,94,80,0,1590.977,70,726.71,MORE,-534,996,462,2,1,-14.0,-1.3123718449442827,14.0,0.8730378697119728,0.6423553510699012,-0.7924106601838637,174,94,80,1,0.2792303847455295,0.5462335921191455,0.0,-0.7845212937556856,-0.3785176189833605,0.3785176189833605,0.0,0.5462335921191455,1,0,0,1,0.5462335921191455,0.0
3226,14,107,57,110,94,0,4050.696,80,635.756,MORE,-1834,2870,1036,4,2,-16.0,-1.4998535370791803,16.0,1.222253017596762,1.049123911114166,0.5523275805561842,204,110,94,1,0.8775812092002355,1.170500554541026,0.5462335921191455,0.40339738448636203,-1.8530038117419747,1.8530038117419747,0.5462335921191455,1.170500554541026,1,1,0,2,1.170500554541026,0.5462335921191455
3227,14,108,39,80,66,0,1998.507,30,632.698,MORE,-1076,1416,340,2,1,-14.0,-1.3123718449442827,14.0,0.8730378697119728,-0.9847188891071574,-0.5696123749940547,146,80,66,1,-0.2792303847455295,0.0,-0.5462335921191455,-0.7845212937556856,-0.9932649393488752,0.9932649393488752,-0.5462335921191455,0.0,0,0,0,1,0.0,-0.5462335921191455
3228,14,109,4,50,54,0,1634.169,20,773.178,MORE,-1158,1558,400,2,1,4.0,0.3749633842697951,4.0,-0.8730378697119728,-1.3914874491514222,-0.7687974205845257,104,50,54,0,-1.116921538982118,-1.170500554541026,-1.0144338139355558,-0.7845212937556856,-1.0862709915074955,1.0862709915074955,-1.0144338139355558,-1.170500554541026,0,0,0,0,-1.170500554541026,-1.0144338139355558
3229,14,110,55,98,110,1,2040.699,30,688.595,MORE,224,800,1024,3,2,12.0,1.124890152809385,12.0,0.5238227218271837,-0.9847188891071574,-0.5465458394047032,208,98,110,0,0.9573613191275298,0.7023003327246156,1.170500554541026,-0.1905619546346618,0.4812212534097393,0.4812212534097393,1.170500554541026,0.7023003327246156,0,0,1,2,1.170500554541026,0.7023003327246156
3230,14,111,2,50,52,1,1735.6029999999996,90,1224.678,MORE,544,810,1354,3,2,2.0,0.18748169213489754,2.0,-1.222253017596762,1.4558924711584305,-0.7133430460355527,102,50,52,0,-1.156811593945765,-1.170500554541026,-1.092467184238291,-0.1905619546346618,0.8441717008580136,0.8441717008580136,-1.092467184238291,-1.170500554541026,1,0,1,0,-1.170500554541026,-1.092467184238291
3231,14,112,59,110,89,0,3426.046,50,1296.811,MORE,40,1516,1556,4,1,-21.0,-1.9685577674164243,21.0,2.0952908873087353,-0.17118176901862814,0.21082892071810067,199,110,89,1,0.7778560717911179,1.170500554541026,0.3511501663623078,0.40339738448636203,0.27252474612698163,0.27252474612698163,0.3511501663623078,1.170500554541026,1,1,1,2,1.170500554541026,0.3511501663623078
3232,14,113,60,87,110,1,1302.233,90,957.051,MORE,458,378,836,1,2,23.0,2.1560394595513217,23.0,2.444506035193524,1.4558924711584305,-0.9502681628434132,197,87,110,0,0.7379660168274708,0.27311679605957273,1.170500554541026,-1.3784806328767094,0.7466287681062899,0.7466287681062899,1.170500554541026,0.27311679605957273,1,0,1,2,1.170500554541026,0.27311679605957273
3233,14,114,52,110,105,0,1644.208,40,857.47,MORE,-416,952,536,2,1,-5.0,-0.4687042303372438,5.0,-0.6984302957695783,-0.5779503290628928,-0.763309059028271,215,110,105,1,1.0969765115002945,1.170500554541026,0.9754171287841883,-0.7845212937556856,-0.2446796414868093,0.2446796414868093,0.9754171287841883,1.170500554541026,0,0,0,2,1.170500554541026,0.9754171287841883
3234,14,115,30,80,96,1,2063.859,50,1366.314,MORE,182,832,1014,3,2,16.0,1.4998535370791803,16.0,1.222253017596762,-0.17118176901862814,-0.5338841745334154,176,80,96,0,0.3191204397091766,0.0,0.6242669624218805,-0.1905619546346618,0.4335840071821533,0.4335840071821533,0.6242669624218805,0.0,0,0,1,1,0.6242669624218805,0.0
3235,14,116,24,80,86,1,4972.136,40,743.574,MORE,372,1918,2290,4,2,6.0,0.5624450764046927,6.0,-0.5238227218271837,-0.5779503290628928,1.0560825235181692,166,80,86,0,0.11967016489094122,0.0,0.2341001109082052,0.40339738448636203,0.6490858353545662,0.6490858353545662,0.2341001109082052,0.0,0,1,1,1,0.2341001109082052,0.0
3236,14,117,5,50,55,1,1493.973,10,275.216,MORE,606,362,968,1,2,5.0,0.4687042303372438,5.0,-0.6984302957695783,-1.7982560091956867,-0.8454431359685968,105,50,55,0,-1.0969765115002945,-1.170500554541026,-0.9754171287841883,-1.3784806328767094,0.9144933500511168,0.9144933500511168,-0.9754171287841883,-1.170500554541026,0,0,1,0,-1.170500554541026,-0.9754171287841883
3237,14,118,34,80,74,0,9061.277,40,912.156,MORE,-3278,5534,2256,6,1,-6.0,-0.5624450764046927,6.0,-0.5238227218271837,-0.5779503290628928,3.2916323056184824,154,80,74,1,-0.11967016489094122,0.0,-0.2341001109082052,1.5913160627284098,-3.490817705852313,3.490817705852313,-0.2341001109082052,0.0,0,1,0,1,0.0,-0.2341001109082052
3238,14,119,15,45,50,1,4308.776,40,1197.242,MORE,288,1812,2100,5,2,5.0,0.4687042303372438,5.0,-0.6984302957695783,-0.5779503290628928,0.6934209514535069,95,45,50,0,-1.2964267863185297,-1.3655839802978638,-1.170500554541026,0.9973567236073858,0.5538113428993942,0.5538113428993942,-1.170500554541026,-1.3655839802978638,0,1,1,0,-1.3655839802978638,-1.170500554541026
3239,14,120,37,69,80,1,1492.819,30,237.614,MORE,566,408,974,1,2,11.0,1.0311493067419364,11.0,0.34921514788478913,-0.9847188891071574,-0.8460740323961212,149,69,80,0,-0.21939530230005888,-0.4291835366650429,0.0,-1.3784806328767094,0.8691245441200826,0.8691245441200826,0.0,-0.4291835366650429,0,0,1,1,-0.4291835366650429,0.0
3240,14,121,48,128,110,1,3034.393,80,2119.3520000000008,LESS,632,1152,1784,3,2,-18.0,-1.6873352292140782,18.0,1.571468165481551,1.049123911114166,-0.003289344905152152,238,128,110,0,1.5557121435822359,1.8728008872656416,1.170500554541026,-0.1905619546346618,0.9439830739062891,0.9439830739062891,1.170500554541026,1.8728008872656416,1,1,1,2,1.8728008872656416,1.170500554541026
3241,14,122,8,50,58,0,1726.455,10,1312.313,LESS,-1730,2180,450,2,1,8.0,0.7499267685395902,8.0,-0.17460757394239454,-1.7982560091956867,-0.7183442943189092,108,50,58,1,-1.0371414290548238,-1.170500554541026,-0.8583670733300858,-0.7845212937556856,-1.7350449163212855,1.7350449163212855,-0.8583670733300858,-1.170500554541026,0,0,0,0,-1.170500554541026,-0.8583670733300858
3242,14,123,4,54,50,0,3010.505,90,2494.686,LESS,608,1570,2178,4,2,-4.0,-0.3749633842697951,4.0,-0.8730378697119728,1.4558924711584305,-0.016349010295710245,104,54,50,0,-1.116921538982118,-1.0144338139355558,-1.170500554541026,0.40339738448636203,0.9167617903476685,0.9167617903476685,-1.170500554541026,-1.0144338139355558,1,1,1,0,-1.0144338139355558,-1.170500554541026
3243,14,124,37,80,69,1,3630.022,80,2372.027,LESS,842,986,1828,4,1,-11.0,-1.0311493067419364,11.0,0.34921514788478913,1.049123911114166,0.3223434178591124,149,80,69,0,-0.21939530230005888,0.0,-0.4291835366650429,0.40339738448636203,1.1821693050442192,1.1821693050442192,-0.4291835366650429,0.0,1,1,1,1,0.0,-0.4291835366650429
3244,14,125,52,105,110,0,10180.83,50,1725.924,LESS,-2238,5980,3742,9,1,5.0,0.4687042303372438,5.0,-0.6984302957695783,-0.17118176901862814,3.903696420110928,215,105,110,1,1.0969765115002945,0.9754171287841883,1.170500554541026,3.3731940800914813,-2.3112287516454213,2.3112287516454213,1.170500554541026,0.9754171287841883,0,1,0,2,1.170500554541026,0.9754171287841883
3245,14,126,5,55,50,1,5383.8719999999985,60,1036.423,LESS,-826,3062,2236,6,1,-5.0,-0.4687042303372438,5.0,-0.6984302957695783,0.2355867910256365,1.2811802457739805,105,55,50,0,-1.0969765115002945,-0.9754171287841883,-1.170500554541026,1.5913160627284098,-0.7097099022799108,0.7097099022799108,-1.170500554541026,-0.9754171287841883,0,1,0,0,-0.9754171287841883,-1.170500554541026
3246,14,127,30,96,80,0,4386.3420000000015,30,1991.747,LESS,-1884,3806,1922,4,1,-16.0,-1.4998535370791803,16.0,1.222253017596762,-0.9847188891071574,0.7358265946921226,176,96,80,0,0.3191204397091766,0.6242669624218805,0.0,0.40339738448636203,-1.9097148191557676,1.9097148191557676,0.0,0.6242669624218805,0,1,0,1,0.6242669624218805,0.0
3247,14,128,33,80,75,1,7293.022,40,943.692,LESS,-790,3804,3014,5,2,-5.0,-0.4687042303372438,5.0,-0.6984302957695783,-0.5779503290628928,2.3249202064397583,155,80,75,0,-0.09972513740911768,0.0,-0.19508342575683765,0.9973567236073858,-0.6688779769419799,0.6688779769419799,-0.19508342575683765,0.0,0,1,0,1,0.0,-0.19508342575683765
3248,14,129,48,110,128,0,2719.974,70,1090.121,LESS,-426,1432,1006,4,1,18.0,1.6873352292140782,18.0,1.571468165481551,0.6423553510699012,-0.17518347302110565,238,110,128,1,1.5557121435822359,1.170500554541026,1.8728008872656416,0.40339738448636203,-0.25602184296956787,0.25602184296956787,1.8728008872656416,1.170500554541026,1,1,0,2,1.8728008872656416,1.170500554541026
3249,14,130,9,59,50,1,5170.8290000000015,80,1493.81,LESS,-914,2006,1092,3,1,-9.0,-0.8436676146070391,9.0,0.0,1.049123911114166,1.1647087833744227,109,59,50,0,-1.0171964015730004,-0.8193503881787182,-1.170500554541026,-0.1905619546346618,-0.8095212753281863,0.8095212753281863,-1.170500554541026,-0.8193503881787182,1,1,0,0,-0.8193503881787182,-1.170500554541026
3250,14,131,44,110,119,0,8635.108,60,1591.065,LESS,1386,3058,4444,7,2,9.0,0.8436676146070391,9.0,0.0,0.2355867910256365,3.0586440043865344,229,110,119,1,1.376206896245824,1.170500554541026,1.5216507209033339,2.1852754018494336,1.7991850657062856,1.7991850657062856,1.5216507209033339,1.170500554541026,0,1,1,2,1.5216507209033339,1.170500554541026
3251,14,132,2,52,50,1,5570.065,30,1182.306,LESS,154,2500,2654,5,2,-2.0,-0.18748169213489754,2.0,-1.222253017596762,-0.9847188891071574,1.3829727055054024,102,52,50,0,-1.156811593945765,-1.092467184238291,-1.170500554541026,0.9973567236073858,0.4018258430304293,0.4018258430304293,-1.170500554541026,-1.092467184238291,0,1,1,0,-1.092467184238291,-1.170500554541026
3252,14,133,8,58,50,0,3089.8390000000004,70,764.533,LESS,-1150,2092,942,3,2,-8.0,-0.7499267685395902,8.0,-0.17460757394239454,0.6423553510699012,0.027023205632560974,108,58,50,0,-1.0371414290548238,-0.8583670733300858,-1.170500554541026,-0.1905619546346618,-1.0771972303212887,1.0771972303212887,-1.170500554541026,-0.8583670733300858,1,1,0,0,-0.8583670733300858,-1.170500554541026
3253,14,134,44,119,110,1,2183.526,50,1093.075,LESS,342,782,1124,3,2,-9.0,-0.8436676146070391,9.0,0.0,-0.17118176901862814,-0.4684617457703578,229,119,110,0,1.376206896245824,1.5216507209033339,1.170500554541026,-0.1905619546346618,0.6150592309062904,0.6150592309062904,1.170500554541026,1.5216507209033339,0,1,1,2,1.5216507209033339,1.170500554541026
3254,14,135,34,74,80,0,2594.473,60,1299.751,LESS,32,1310,1342,2,1,6.0,0.5624450764046927,6.0,-0.5238227218271837,0.2355867910256365,-0.2437953729784248,154,74,80,1,-0.11967016489094122,-0.2341001109082052,0.0,-0.7845212937556856,0.26345098494077474,0.26345098494077474,0.0,-0.2341001109082052,1,0,1,1,-0.2341001109082052,0.0
3255,14,136,24,86,80,1,3695.539,70,2358.74,LESS,-280,2192,1912,6,1,-6.0,-0.5624450764046927,6.0,-0.5238227218271837,0.6423553510699012,0.35816182448139977,166,86,80,0,0.11967016489094122,0.2341001109082052,0.0,1.5913160627284098,-0.09042570132129271,0.09042570132129271,0.0,0.2341001109082052,1,1,0,1,0.2341001109082052,0.0
3256,14,137,39,66,80,0,3132.579,80,1146.349,LESS,-1482,2350,868,2,2,14.0,1.3123718449442827,14.0,0.8730378697119728,1.049123911114166,0.05038933501938499,146,66,80,1,-0.2792303847455295,-0.5462335921191455,0.0,-0.7845212937556856,-1.453758319548873,1.453758319548873,0.0,-0.5462335921191455,1,0,0,1,-0.5462335921191455,0.0
3257,14,138,9,50,59,0,1289.7910000000004,90,929.998,LESS,210,652,862,2,2,9.0,0.8436676146070391,9.0,0.0,1.4558924711584305,-0.9570702541356654,109,50,59,1,-1.0171964015730004,-1.170500554541026,-0.8193503881787182,-0.7845212937556856,0.46534217133387734,0.46534217133387734,-0.8193503881787182,-1.170500554541026,1,0,1,0,-1.170500554541026,-0.8193503881787182
3258,14,139,57,94,110,0,5681.576999999998,70,1051.014,LESS,-1716,3236,1520,4,1,16.0,1.4998535370791803,16.0,1.222253017596762,0.6423553510699012,1.4439367630670192,204,94,110,1,0.8775812092002355,0.5462335921191455,1.170500554541026,0.40339738448636203,-1.7191658342454237,1.7191658342454237,1.170500554541026,0.5462335921191455,1,1,0,2,1.170500554541026,0.5462335921191455
3259,14,140,60,110,87,1,3496.864,70,945.837,LESS,370,1452,1822,4,2,-23.0,-2.1560394595513217,23.0,2.444506035193524,0.6423553510699012,0.24954540529732655,197,110,87,0,0.7379660168274708,1.170500554541026,0.27311679605957273,0.40339738448636203,0.6468173950580145,0.6468173950580145,0.27311679605957273,1.170500554541026,1,1,1,2,1.170500554541026,0.27311679605957273
3260,14,141,33,75,80,0,1519.027,70,1188.873,LESS,-402,890,488,2,1,5.0,0.4687042303372438,5.0,-0.6984302957695783,0.6423553510699012,-0.8317460137023943,155,75,80,1,-0.09972513740911768,-0.19508342575683765,0.0,-0.7845212937556856,-0.2288005594109473,0.2288005594109473,0.0,-0.19508342575683765,1,0,0,1,-0.19508342575683765,0.0
3261,14,142,15,50,45,1,4598.014,30,1540.826,LESS,1330,1414,2744,6,1,-5.0,-0.4687042303372438,5.0,-0.6984302957695783,-0.9847188891071574,0.8515485258939899,95,50,45,0,-1.2964267863185297,-1.170500554541026,-1.3655839802978638,1.5913160627284098,1.7356687374028377,1.7356687374028377,-1.3655839802978638,-1.170500554541026,0,1,1,0,-1.170500554541026,-1.3655839802978638
3262,14,143,59,89,110,0,2953.836,40,729.1080000000002,LESS,-774,1696,922,4,1,21.0,1.9685577674164243,21.0,2.0952908873087353,-0.5779503290628928,-0.04733017983763687,199,89,110,1,0.7778560717911179,0.3511501663623078,1.170500554541026,0.40339738448636203,-0.6507304545695662,0.6507304545695662,1.170500554541026,0.3511501663623078,0,1,0,2,1.170500554541026,0.3511501663623078
3263,14,144,29,80,94,0,3660.782,100,697.503,LESS,1306,1358,2664,2,2,14.0,1.3123718449442827,14.0,0.8730378697119728,1.8626610312026952,0.3391600332062981,174,80,94,1,0.2792303847455295,0.0,0.5462335921191455,-0.7845212937556856,1.708447453844217,1.708447453844217,0.5462335921191455,0.0,1,0,1,1,0.5462335921191455,0.0
3264,14,145,55,110,98,1,6895.45,80,1461.822,LESS,688,2502,3190,5,2,-12.0,-1.124890152809385,12.0,0.5238227218271837,1.049123911114166,2.1075659997813943,208,110,98,0,0.9573613191275298,1.170500554541026,0.7023003327246156,0.9973567236073858,1.007499402209737,1.007499402209737,0.7023003327246156,1.170500554541026,1,1,1,2,1.170500554541026,0.7023003327246156
3265,14,146,29,94,80,1,2595.649,40,1792.379,LESS,-232,1716,1484,4,1,-14.0,-1.3123718449442827,14.0,0.8730378697119728,-0.5779503290628928,-0.24315244906268066,174,94,80,0,0.2792303847455295,0.5462335921191455,0.0,0.40339738448636203,-0.03598313420405157,0.03598313420405157,0.0,0.5462335921191455,0,1,0,1,0.5462335921191455,0.0
3266,14,147,57,110,94,1,2868.746,80,1701.704,LESS,620,1428,2048,5,2,-16.0,-1.4998535370791803,16.0,1.222253017596762,1.049123911114166,-0.0938492240473902,204,110,94,0,0.8775812092002355,1.170500554541026,0.5462335921191455,0.9973567236073858,0.9303724321269788,0.9303724321269788,0.5462335921191455,1.170500554541026,1,1,1,2,1.170500554541026,0.5462335921191455
3267,14,148,39,80,66,1,3832.444,50,1009.092,LESS,-32,1808,1776,6,1,-14.0,-1.3123718449442827,14.0,0.8730378697119728,-0.17118176901862814,0.43300833696860497,146,80,66,0,-0.2792303847455295,0.0,-0.5462335921191455,1.5913160627284098,0.1908608954511199,0.1908608954511199,-0.5462335921191455,0.0,0,1,1,1,0.0,-0.5462335921191455
3268,14,149,4,50,54,0,2633.974,50,1280.672,LESS,-1624,2248,624,2,1,4.0,0.3749633842697951,4.0,-0.8730378697119728,-0.17118176901862814,-0.2222000178799469,104,50,54,1,-1.116921538982118,-1.170500554541026,-1.0144338139355558,-0.7845212937556856,-1.6148175806040448,1.6148175806040448,-1.0144338139355558,-1.170500554541026,0,0,0,0,-1.170500554541026,-1.0144338139355558
3269,14,150,55,98,110,0,5024.522,40,1111.933,LESS,-768,2784,2016,6,1,12.0,1.124890152809385,12.0,0.5238227218271837,-0.5779503290628928,1.0847221597853232,208,98,110,1,0.9573613191275298,0.7023003327246156,1.170500554541026,1.5913160627284098,-0.6439251336799111,0.6439251336799111,1.170500554541026,0.7023003327246156,0,1,0,2,1.170500554541026,0.7023003327246156
3270,14,151,2,50,52,0,1779.915,80,732.659,LESS,-392,1170,778,2,2,2.0,0.18748169213489754,2.0,-1.222253017596762,1.049123911114166,-0.6891174979450295,102,50,52,1,-1.156811593945765,-1.170500554541026,-1.092467184238291,-0.7845212937556856,-0.21745835792818874,0.21745835792818874,-1.092467184238291,-1.170500554541026,1,0,0,0,-1.170500554541026,-1.092467184238291
3271,14,152,59,110,89,1,4224.099,70,1360.895,LESS,1304,1366,2670,3,1,-21.0,-1.9685577674164243,21.0,2.0952908873087353,0.6423553510699012,0.6471276959998778,199,110,89,0,0.7778560717911179,1.170500554541026,0.3511501663623078,-0.1905619546346618,1.7061790135476653,1.7061790135476653,0.3511501663623078,1.170500554541026,1,0,1,2,1.170500554541026,0.3511501663623078
3272,14,153,60,87,110,0,1386.497,70,2527.199,LESS,-482,930,448,2,1,23.0,2.1560394595513217,23.0,2.444506035193524,0.6423553510699012,-0.9042006961459086,197,87,110,1,0.7379660168274708,0.27311679605957273,1.170500554541026,-0.7845212937556856,-0.3195381712730159,0.3195381712730159,1.170500554541026,0.27311679605957273,1,0,0,2,1.170500554541026,0.27311679605957273
3273,14,154,52,110,105,0,4284.96,70,2761.369,LESS,-294,2202,1908,8,1,-5.0,-0.4687042303372438,5.0,-0.6984302957695783,0.6423553510699012,0.6804006487516678,215,110,105,0,1.0969765115002945,1.170500554541026,0.9754171287841883,2.7792347409704576,-0.10630478339715471,0.10630478339715471,0.9754171287841883,1.170500554541026,1,1,0,2,1.170500554541026,0.9754171287841883
3274,14,155,30,80,96,0,4919.425,50,1536.806,LESS,-2286,3484,1198,4,2,16.0,1.4998535370791803,16.0,1.222253017596762,-0.17118176901862814,1.0272652084477694,176,80,96,1,0.3191204397091766,0.0,0.6242669624218805,0.40339738448636203,-2.3656713187626623,2.3656713187626623,0.6242669624218805,0.0,0,1,0,1,0.6242669624218805,0.0
3275,14,156,24,80,86,0,4094.346,100,2419.833,LESS,868,1836,2704,4,2,6.0,0.5624450764046927,6.0,-0.5238227218271837,1.8626610312026952,0.5761912105920962,166,80,86,1,0.11967016489094122,0.0,0.2341001109082052,0.40339738448636203,1.2116590288993916,1.2116590288993916,0.2341001109082052,0.0,1,1,1,1,0.2341001109082052,0.0
3276,14,157,5,50,55,0,8258.419,70,2336.388,LESS,86,3700,3786,10,1,5.0,0.4687042303372438,5.0,-0.6984302957695783,0.6423553510699012,2.85270661756872,105,50,55,1,-1.0969765115002945,-1.170500554541026,-0.9754171287841883,3.9671534192125053,0.324698872947671,0.324698872947671,-0.9754171287841883,-1.170500554541026,1,1,1,0,-1.170500554541026,-0.9754171287841883
3277,14,158,34,80,74,0,6018.196999999999,40,1730.244,LESS,604,2374,2978,3,1,-6.0,-0.5624450764046927,6.0,-0.5238227218271837,-0.5779503290628928,1.627968266908684,154,80,74,0,-0.11967016489094122,0.0,-0.2341001109082052,-0.1905619546346618,0.912224909754565,0.912224909754565,-0.2341001109082052,0.0,0,0,1,1,0.0,-0.2341001109082052
3278,14,159,15,45,50,0,4584.38,80,1051.047,LESS,544,1868,2412,4,2,5.0,0.4687042303372438,5.0,-0.6984302957695783,1.049123911114166,0.8440947634218335,95,45,50,1,-1.2964267863185297,-1.3655839802978638,-1.170500554541026,0.40339738448636203,0.8441717008580136,0.8441717008580136,-1.170500554541026,-1.3655839802978638,1,1,1,0,-1.3655839802978638,-1.170500554541026
3279,14,160,37,69,80,0,5677.403,80,1734.052,LESS,-2308,4032,1724,2,1,11.0,1.0311493067419364,11.0,0.34921514788478913,1.049123911114166,1.4416548205293365,149,69,80,1,-0.21939530230005888,-0.4291835366650429,0.0,-0.7845212937556856,-2.3906241620247313,2.3906241620247313,0.0,-0.4291835366650429,1,0,0,1,-0.4291835366650429,0.0
3280,14,161,3,50,53,0,7810.219,20,1733.68,MORE,-1378,4450,3072,4,1,3.0,0.28122253820234633,3.0,-1.0476454436543674,-1.3914874491514222,2.6076738802927597,103,50,53,0,-1.1368665664639415,-1.170500554541026,-1.0534504990869233,0.40339738448636203,-1.3357994241281839,1.3357994241281839,-1.0534504990869233,-1.170500554541026,0,1,0,0,-1.170500554541026,-1.0534504990869233
3281,14,162,20,50,40,0,4358.031,50,1909.785,MORE,-708,2504,1796,2,1,-10.0,-0.9374084606744876,10.0,0.17460757394239454,-0.17118176901862814,0.7203488574653933,90,50,40,1,-1.3961519237276474,-1.170500554541026,-1.5606674060547012,-0.7845212937556856,-0.5758719247833597,0.5758719247833597,-1.5606674060547012,-1.170500554541026,0,0,0,0,-1.170500554541026,-1.5606674060547012
3282,14,163,25,80,88,0,2082.529,0,1788.029,MORE,-1468,2022,554,2,1,8.0,0.7499267685395902,8.0,-0.17460757394239454,-2.2050245692399515,-0.5236772106669669,168,80,88,0,0.1595602198545883,0.0,0.31213348121094026,-0.7845212937556856,-1.4378792374730112,1.4378792374730112,0.31213348121094026,0.0,0,0,0,1,0.31213348121094026,0.0
3283,14,164,42,115,110,0,4631.005,100,2153.569,MORE,1894,1480,3374,2,2,-5.0,-0.4687042303372438,5.0,-0.6984302957695783,1.8626610312026952,0.8695848378874553,225,115,110,1,1.2964267863185297,1.3655839802978638,1.170500554541026,-0.7845212937556856,2.375368901030421,2.375368901030421,1.170500554541026,1.3655839802978638,1,0,1,2,1.3655839802978638,1.170500554541026
3284,14,165,53,103,110,0,3551.473,50,1191.662,MORE,1400,1056,2456,2,1,7.0,0.6561859224721414,7.0,-0.34921514788478913,-0.17118176901862814,0.2794003645786807,213,103,110,0,1.0570864565366473,0.8973837584814532,1.170500554541026,-0.7845212937556856,1.8150641477821476,1.8150641477821476,1.170500554541026,0.8973837584814532,1,0,1,2,1.170500554541026,0.8973837584814532
3285,14,166,26,90,80,0,5933.998000000001,30,446.536,MORE,-1162,3328,2166,2,1,-10.0,-0.9374084606744876,10.0,0.17460757394239454,-0.9847188891071574,1.5819363359718297,170,90,80,1,0.19945027481823535,0.3901668515136753,0.0,-0.7845212937556856,-1.090807872100599,1.090807872100599,0.0,0.3901668515136753,0,0,0,1,0.3901668515136753,0.0
3286,14,167,35,80,72,0,3048.616,70,1827.0,MORE,240,1304,1544,2,1,-8.0,-0.7499267685395902,8.0,-0.17460757394239454,0.6423553510699012,0.004486426228886185,152,80,72,1,-0.1595602198545883,0.0,-0.31213348121094026,-0.7845212937556856,0.49936877578215305,0.49936877578215305,-0.31213348121094026,0.0,1,0,1,1,0.0,-0.31213348121094026
3287,14,168,28,93,80,0,2389.491,50,1547.364,MORE,-842,1312,470,2,1,-13.0,-1.218630998876834,13.0,0.6984302957695783,-0.17118176901862814,-0.35585985435348283,173,93,80,1,0.25928535726370594,0.5072169069677779,0.0,-0.7845212937556856,-0.7278574246523245,0.7278574246523245,0.0,0.5072169069677779,1,0,0,1,0.5072169069677779,0.0
3288,14,169,26,80,90,1,4955.968,70,1899.677,MORE,-1298,2904,1606,3,2,10.0,0.9374084606744876,10.0,0.17460757394239454,0.6423553510699012,1.0472434130847068,170,80,90,0,0.19945027481823535,0.0,0.3901668515136753,-0.1905619546346618,-1.2450618122661152,1.2450618122661152,0.3901668515136753,0.0,1,0,0,1,0.3901668515136753,0.0
3289,14,170,25,88,80,1,2224.953,60,1297.925,MORE,260,810,1070,3,2,-8.0,-0.7499267685395902,8.0,-0.17460757394239454,0.2355867910256365,-0.4458134387486459,168,88,80,1,0.1595602198545883,0.31213348121094026,0.0,-0.1905619546346618,0.5220531787476702,0.5220531787476702,0.0,0.31213348121094026,1,0,1,1,0.31213348121094026,0.0
3290,14,171,36,80,70,0,6152.036999999998,30,1072.674,MORE,-658,3166,2508,4,1,-10.0,-0.9374084606744876,10.0,0.17460757394239454,-0.9847188891071574,1.7011391316052802,150,80,70,1,-0.19945027481823535,0.0,-0.3901668515136753,0.40339738448636203,-0.5191609173695668,0.5191609173695668,-0.3901668515136753,0.0,0,1,0,1,0.0,-0.3901668515136753
3291,14,172,28,80,93,1,1813.711,60,1368.489,MORE,332,668,1000,3,2,13.0,1.218630998876834,13.0,0.6984302957695783,0.2355867910256365,-0.6706410892235248,173,80,93,0,0.25928535726370594,0.0,0.5072169069677779,-0.1905619546346618,0.6037170294235319,0.6037170294235319,0.5072169069677779,0.0,1,1,1,1,0.5072169069677779,0.0
3292,14,173,21,82,80,0,3622.56,60,1386.6660000000004,MORE,-644,2208,1564,6,1,-2.0,-0.18748169213489754,2.0,-1.222253017596762,0.2355867910256365,0.3182639125365929,162,82,80,1,0.03989005496364707,0.07803337030273506,0.0,1.5913160627284098,-0.5032818352937047,0.5032818352937047,0.0,0.07803337030273506,1,1,0,1,0.07803337030273506,0.0
3293,14,174,19,50,41,0,2720.344,90,913.1,MORE,-52,1446,1394,4,2,-9.0,-0.8436676146070391,9.0,0.0,1.4558924711584305,-0.17498119253741068,91,50,41,1,-1.376206896245824,-1.170500554541026,-1.5216507209033339,0.40339738448636203,0.16817649248560274,0.16817649248560274,-1.5216507209033339,-1.170500554541026,1,1,1,0,-1.170500554541026,-1.5216507209033339
3294,14,175,56,96,110,1,2245.708,10,1310.193,MORE,-802,1898,1096,4,1,14.0,1.3123718449442827,14.0,0.8730378697119728,-1.7982560091956867,-0.43446659702137547,206,96,110,0,0.9174712641638826,0.6242669624218805,1.170500554541026,0.40339738448636203,-0.6824886187212902,0.6824886187212902,1.170500554541026,0.6242669624218805,0,1,0,2,1.170500554541026,0.6242669624218805
3295,14,176,23,80,85,1,3785.487,100,832.188,MORE,1872,1004,2876,3,2,5.0,0.4687042303372438,5.0,-0.6984302957695783,1.8626610312026952,0.40733675677166775,165,80,85,0,0.09972513740911768,0.0,0.19508342575683765,-0.1905619546346618,2.3504160577683524,2.3504160577683524,0.19508342575683765,0.0,1,0,1,1,0.19508342575683765,0.0
3296,14,177,10,60,50,1,3213.752,80,1219.299,MORE,572,1150,1722,3,2,-10.0,-0.9374084606744876,10.0,0.17460757394239454,1.049123911114166,0.09476693962202117,110,60,50,1,-0.9972513740911768,-0.7803337030273506,-1.170500554541026,-0.1905619546346618,0.8759298650097377,0.8759298650097377,-1.170500554541026,-0.7803337030273506,1,0,1,0,-0.7803337030273506,-1.170500554541026
3297,14,178,19,41,50,1,1167.823,50,356.559,MORE,504,294,798,1,2,9.0,0.8436676146070391,9.0,0.0,-0.17118176901862814,-1.0237506488257022,91,41,50,0,-1.376206896245824,-1.5216507209033339,-1.170500554541026,-1.3784806328767094,0.7988028949269793,0.7988028949269793,-1.170500554541026,-1.5216507209033339,0,0,1,0,-1.5216507209033339,-1.170500554541026
3298,14,179,56,110,96,0,1525.374,90,828.164,MORE,-18,836,818,2,2,-14.0,-1.3123718449442827,14.0,0.8730378697119728,1.4558924711584305,-0.8282760833510099,206,110,96,1,0.9174712641638826,1.170500554541026,0.6242669624218805,-0.7845212937556856,0.2067399775269819,0.2067399775269819,0.6242669624218805,1.170500554541026,1,0,1,2,1.170500554541026,0.6242669624218805
3299,14,180,35,72,80,1,3431.149000000001,50,460.387,MORE,446,1316,1762,5,2,8.0,0.7499267685395902,8.0,-0.17460757394239454,-0.17118176901862814,0.2136187512810624,152,72,80,0,-0.1595602198545883,-0.31213348121094026,0.0,0.9973567236073858,0.7330181263269796,0.7330181263269796,0.0,-0.31213348121094026,0,1,1,1,-0.31213348121094026,0.0
3300,14,181,11,49,50,0,2443.1910000000007,20,1987.299,MORE,-202,1316,1114,2,1,1.0,0.09374084606744876,1.0,-1.3968605915391563,-1.3914874491514222,-0.32650184901720597,99,49,50,0,-1.2166466763912356,-1.2095172396923934,-1.170500554541026,-0.7845212937556856,-0.0019565297557758475,0.0019565297557758475,-1.170500554541026,-1.2095172396923934,0,0,1,0,-1.2095172396923934,-1.170500554541026
3301,14,182,17,43,50,1,2221.091,50,1066.841,MORE,48,1074,1122,4,1,7.0,0.6561859224721414,7.0,-0.34921514788478913,-0.17118176901862814,-0.4479248096352139,93,43,50,0,-1.3363168412821769,-1.4436173506005987,-1.170500554541026,0.40339738448636203,0.2815985073131885,0.2815985073131885,-1.170500554541026,-1.4436173506005987,1,1,1,0,-1.4436173506005987,-1.170500554541026
3302,14,183,1,51,50,0,2935.902,60,1144.497,MORE,-346,1544,1198,2,1,-1.0,-0.09374084606744876,1.0,-1.3968605915391563,0.2355867910256365,-0.05713476955273509,101,51,50,1,-1.1767566214275886,-1.1314838693896585,-1.170500554541026,-0.7845212937556856,-0.1652842311074993,0.1652842311074993,-1.170500554541026,-1.1314838693896585,1,0,0,0,-1.1314838693896585,-1.170500554541026
3303,14,184,41,112,110,0,1651.364,50,1739.1989999999996,MORE,-346,1070,724,2,1,-2.0,-0.18748169213489754,2.0,-1.222253017596762,-0.17118176901862814,-0.7593968451328074,222,112,110,1,1.2365917038730592,1.248533924843761,1.170500554541026,-0.7845212937556856,-0.1652842311074993,0.1652842311074993,1.170500554541026,1.248533924843761,1,0,0,2,1.248533924843761,1.170500554541026
3304,14,185,20,40,50,1,1982.287,70,1103.292,MORE,894,654,1548,3,2,10.0,0.9374084606744876,10.0,0.17460757394239454,0.6423553510699012,-0.5784799140360363,90,40,50,0,-1.3961519237276474,-1.5606674060547012,-1.170500554541026,-0.1905619546346618,1.2411487527545637,1.2411487527545637,-1.170500554541026,-1.5606674060547012,1,0,1,0,-1.5606674060547012,-1.170500554541026
3305,14,186,1,50,51,0,2313.609,30,1784.65,MORE,-624,1222,598,1,1,1.0,0.09374084606744876,1.0,-1.3968605915391563,-0.9847188891071574,-0.3973448480392805,101,50,51,0,-1.1767566214275886,-1.170500554541026,-1.1314838693896585,-1.3784806328767094,-0.48059743232818763,0.48059743232818763,-1.1314838693896585,-1.170500554541026,0,0,0,0,-1.170500554541026,-1.1314838693896585
3306,14,187,23,85,80,0,1456.456,90,1026.878,MORE,-682,1152,470,2,2,-5.0,-0.4687042303372438,5.0,-0.6984302957695783,1.4558924711584305,-0.8659538303112613,165,85,80,1,0.09972513740911768,0.19508342575683765,0.0,-0.7845212937556856,-0.5463822009281873,0.5463822009281873,0.0,0.19508342575683765,1,0,0,1,0.19508342575683765,0.0
3307,14,188,11,50,49,0,1619.36,20,1358.471,MORE,-1386,1806,420,2,1,-1.0,-0.09374084606744876,1.0,-1.3968605915391563,-1.3914874491514222,-0.7768935602684163,99,50,49,1,-1.2166466763912356,-1.170500554541026,-1.2095172396923934,-0.7845212937556856,-1.3448731853143907,1.3448731853143907,-1.2095172396923934,-1.170500554541026,0,0,0,0,-1.170500554541026,-1.2095172396923934
3308,14,189,17,50,43,0,1573.1629999999998,70,1495.241,MORE,-612,1116,504,2,1,-7.0,-0.6561859224721414,7.0,-0.34921514788478913,0.6423553510699012,-0.8021496454177639,93,50,43,1,-1.3363168412821769,-1.170500554541026,-1.4436173506005987,-0.7845212937556856,-0.4669867905488774,0.4669867905488774,-1.4436173506005987,-1.170500554541026,1,0,0,0,-1.170500554541026,-1.4436173506005987
3309,14,190,21,80,82,1,1486.638,20,783.722,MORE,-248,1018,770,4,1,2.0,0.18748169213489754,2.0,-1.222253017596762,-1.3914874491514222,-0.8494532098818481,162,80,82,0,0.03989005496364707,0.0,0.07803337030273506,0.40339738448636203,-0.054130656576465284,0.054130656576465284,0.07803337030273506,0.0,0,1,1,1,0.07803337030273506,0.0
3310,14,191,10,50,60,1,1062.845,80,1729.784,MORE,814,424,1238,2,2,10.0,0.9374084606744876,10.0,0.17460757394239454,1.049123911114166,-1.081142542386068,110,50,60,0,-0.9972513740911768,-1.170500554541026,-0.7803337030273506,-0.7845212937556856,1.150411140892495,1.150411140892495,-0.7803337030273506,-1.170500554541026,1,0,1,0,-1.170500554541026,-0.7803337030273506
3311,14,192,3,53,50,0,3646.101,50,1133.322,MORE,-646,1946,1300,6,1,-3.0,-0.28122253820234633,3.0,-1.0476454436543674,-0.17118176901862814,0.3311338716356858,103,53,50,1,-1.1368665664639415,-1.0534504990869233,-1.170500554541026,1.5913160627284098,-0.5055502755902566,0.5055502755902566,-1.170500554541026,-1.0534504990869233,1,1,0,0,-1.0534504990869233,-1.170500554541026
3312,14,193,45,122,110,0,1232.637,90,1102.624,MORE,-126,832,706,2,2,-12.0,-1.124890152809385,12.0,0.5238227218271837,1.4558924711584305,-0.9883165751224356,232,122,110,1,1.4360419786912946,1.6387007763574364,1.170500554541026,-0.7845212937556856,0.0842442015131893,0.0842442015131893,1.170500554541026,1.6387007763574364,1,0,1,2,1.6387007763574364,1.170500554541026
3313,14,194,38,67,80,1,2411.8,40,178.847,MORE,202,1124,1326,5,2,13.0,1.218630998876834,13.0,0.6984302957695783,-0.5779503290628928,-0.3436634345946933,147,67,80,0,-0.25928535726370594,-0.5072169069677779,0.0,0.9973567236073858,0.45626841014767044,0.45626841014767044,0.0,-0.5072169069677779,0,1,1,1,-0.5072169069677779,0.0
3314,14,195,38,80,67,0,4659.356,90,989.437,MORE,-744,2822,2078,4,2,-13.0,-1.218630998876834,13.0,0.6984302957695783,1.4558924711584305,0.8850844432745831,147,80,67,1,-0.25928535726370594,0.0,-0.5072169069677779,0.40339738448636203,-0.6167038501212905,0.6167038501212905,-0.5072169069677779,0.0,1,1,0,1,0.0,-0.5072169069677779
3315,14,196,36,70,80,1,1656.365,60,1172.111,MORE,158,696,854,3,2,10.0,0.9374084606744876,10.0,0.17460757394239454,0.2355867910256365,-0.7566627783788648,150,70,80,0,-0.19945027481823535,-0.3901668515136753,0.0,-0.1905619546346618,0.40636272362353276,0.40636272362353276,0.0,-0.3901668515136753,1,0,1,1,-0.3901668515136753,0.0
3316,14,197,45,110,122,0,2788.233,40,1239.218,MORE,-1074,2026,952,4,1,12.0,1.124890152809385,12.0,0.5238227218271837,-0.5779503290628928,-0.13786600400343535,232,110,122,0,1.4360419786912946,1.170500554541026,1.6387007763574364,0.40339738448636203,-0.9909964990523235,0.9909964990523235,1.6387007763574364,1.170500554541026,0,1,0,2,1.6387007763574364,1.170500554541026
3317,14,198,42,110,115,1,3271.608,50,911.298,MORE,152,1518,1670,3,2,5.0,0.4687042303372438,5.0,-0.6984302957695783,-0.17118176901862814,0.12639704682380173,225,110,115,0,1.2964267863185297,1.170500554541026,1.3655839802978638,-0.1905619546346618,0.3995574027338776,0.3995574027338776,1.3655839802978638,1.170500554541026,0,1,1,2,1.3655839802978638,1.170500554541026
3318,14,199,41,110,112,1,2808.27,70,1714.144,MORE,624,1332,1956,4,1,2.0,0.18748169213489754,2.0,-1.222253017596762,0.6423553510699012,-0.12691169575533542,222,110,112,0,1.2365917038730592,1.170500554541026,1.248533924843761,0.40339738448636203,0.9349093127200823,0.9349093127200823,1.248533924843761,1.170500554541026,1,1,1,2,1.248533924843761,1.170500554541026
3319,14,200,53,110,103,0,1766.714,20,1512.7579999999996,MORE,-670,1906,1236,2,2,-7.0,-0.6561859224721414,7.0,-0.34921514788478913,-1.3914874491514222,-0.6963345375808617,213,110,103,1,1.0570864565366473,1.170500554541026,0.8973837584814532,-0.7845212937556856,-0.5327715591488771,0.5327715591488771,0.8973837584814532,1.170500554541026,0,0,0,2,1.170500554541026,0.8973837584814532
3320,14,201,3,50,53,1,4022.289,30,1526.406,LESS,172,1344,1516,3,2,3.0,0.28122253820234633,3.0,-1.0476454436543674,-0.9847188891071574,0.5367973597444972,103,50,53,1,-1.1368665664639415,-1.170500554541026,-1.0534504990869233,-0.1905619546346618,0.42224180569939473,0.42224180569939473,-1.0534504990869233,-1.170500554541026,0,1,1,0,-1.170500554541026,-1.0534504990869233
3321,14,202,20,50,40,1,3577.684,70,913.426,LESS,598,1342,1940,5,2,-10.0,-0.9374084606744876,10.0,0.17460757394239454,0.6423553510699012,0.2937300233844377,90,50,40,0,-1.3961519237276474,-1.170500554541026,-1.5606674060547012,0.9973567236073858,0.9054195888649099,0.9054195888649099,-1.5606674060547012,-1.170500554541026,1,1,1,0,-1.170500554541026,-1.5606674060547012
3322,14,203,25,80,88,1,2419.418,70,1156.697,LESS,674,980,1654,4,2,8.0,0.7499267685395902,8.0,-0.17460757394239454,0.6423553510699012,-0.339498643446616,168,80,88,1,0.1595602198545883,0.0,0.31213348121094026,0.40339738448636203,0.9916203201338751,0.9916203201338751,0.31213348121094026,0.0,1,1,1,1,0.31213348121094026,0.0
3323,14,204,42,115,110,1,2636.488,50,1103.276,LESS,1054,644,1698,3,2,-5.0,-0.4687042303372438,5.0,-0.6984302957695783,-0.17118176901862814,-0.22082560399884094,225,115,110,0,1.2964267863185297,1.3655839802978638,1.170500554541026,-0.1905619546346618,1.422623976478701,1.422623976478701,1.170500554541026,1.3655839802978638,0,0,1,2,1.3655839802978638,1.170500554541026
3324,14,205,53,103,110,0,1578.246,50,751.5830000000002,LESS,-300,802,502,2,1,7.0,0.6561859224721414,7.0,-0.34921514788478913,-0.17118176901862814,-0.7993707489350022,213,103,110,1,1.0570864565366473,0.8973837584814532,1.170500554541026,-0.7845212937556856,-0.11311010428680986,0.11311010428680986,1.170500554541026,0.8973837584814532,0,0,0,2,1.170500554541026,0.8973837584814532
3325,14,206,26,90,80,1,1717.583,50,1854.464,LESS,506,498,1004,3,2,-10.0,-0.9374084606744876,10.0,0.17460757394239454,-0.17118176901862814,-0.7231946522955096,170,90,80,0,0.19945027481823535,0.3901668515136753,0.0,-0.1905619546346618,0.801071335223531,0.801071335223531,0.0,0.3901668515136753,0,0,1,1,0.3901668515136753,0.0
3326,14,207,35,80,72,1,1695.674,50,569.991,LESS,-38,880,842,4,1,-8.0,-0.7499267685395902,8.0,-0.17460757394239454,-0.17118176901862814,-0.7351723904503045,152,80,72,0,-0.1595602198545883,0.0,-0.31213348121094026,0.40339738448636203,0.18405557456146474,0.18405557456146474,-0.31213348121094026,0.0,0,1,1,1,0.0,-0.31213348121094026
3327,14,208,28,93,80,1,1706.779,50,791.015,LESS,10,830,840,4,1,-13.0,-1.218630998876834,13.0,0.6984302957695783,-0.17118176901862814,-0.7291012424194041,173,93,80,0,0.25928535726370594,0.5072169069677779,0.0,0.40339738448636203,0.2384981416787059,0.2384981416787059,0.0,0.5072169069677779,0,1,1,1,0.5072169069677779,0.0
3328,14,209,26,80,90,0,2530.383,80,821.617,LESS,-668,1558,890,2,2,10.0,0.9374084606744876,10.0,0.17460757394239454,1.049123911114166,-0.2788336329784613,170,80,90,1,0.19945027481823535,0.0,0.3901668515136753,-0.7845212937556856,-0.5305031188523254,0.5305031188523254,0.3901668515136753,0.0,1,0,0,1,0.3901668515136753,0.0
3329,14,210,25,88,80,1,1934.216,30,904.701,LESS,132,954,1086,3,1,-8.0,-0.7499267685395902,8.0,-0.17460757394239454,-0.9847188891071574,-0.6047605225000986,168,88,80,0,0.1595602198545883,0.31213348121094026,0.0,-0.1905619546346618,0.3768729997683605,0.3768729997683605,0.0,0.31213348121094026,0,0,1,1,0.31213348121094026,0.0
3330,14,211,36,80,70,0,1507.17,20,1165.772,LESS,-46,778,732,3,2,-10.0,-0.9374084606744876,10.0,0.17460757394239454,-1.3914874491514222,-0.8382282831488045,150,80,70,0,-0.19945027481823535,0.0,-0.3901668515136753,-0.1905619546346618,0.1749818133752579,0.1749818133752579,-0.3901668515136753,0.0,0,0,1,1,0.0,-0.3901668515136753
3331,14,212,28,80,93,0,1112.674,90,1388.0220000000004,LESS,146,826,972,2,2,13.0,1.218630998876834,13.0,0.6984302957695783,1.4558924711584305,-1.0539008282724491,173,80,93,1,0.25928535726370594,0.0,0.5072169069677779,-0.7845212937556856,0.39275208184422244,0.39275208184422244,0.5072169069677779,0.0,1,0,1,1,0.5072169069677779,0.0
3332,14,213,21,82,80,0,1033.302,70,630.781,LESS,-318,680,362,2,1,-2.0,-0.18748169213489754,2.0,-1.222253017596762,0.6423553510699012,-1.0972938189531,162,82,80,0,0.03989005496364707,0.07803337030273506,0.0,-0.7845212937556856,-0.1335260669557753,0.1335260669557753,0.0,0.07803337030273506,1,0,0,1,0.07803337030273506,0.0
3333,14,214,19,50,41,1,1911.303,80,685.487,LESS,954,700,1654,3,2,-9.0,-0.8436676146070391,9.0,0.0,1.049123911114166,-0.6172871514809197,91,50,41,0,-1.376206896245824,-1.170500554541026,-1.5216507209033339,-0.1905619546346618,1.3092019616511152,1.3092019616511152,-1.5216507209033339,-1.170500554541026,1,1,1,0,-1.170500554541026,-1.5216507209033339
3334,14,215,56,96,110,0,2970.806,80,828.698,LESS,198,1496,1694,4,2,14.0,1.3123718449442827,14.0,0.8730378697119728,1.049123911114166,-0.03805261278816539,206,96,110,1,0.9174712641638826,0.6242669624218805,1.170500554541026,0.40339738448636203,0.451731529554567,0.451731529554567,1.170500554541026,0.6242669624218805,1,1,1,2,1.170500554541026,0.6242669624218805
3335,14,216,23,80,85,0,3411.277,70,857.166,LESS,-854,1972,1118,4,1,5.0,0.4687042303372438,5.0,-0.6984302957695783,0.6423553510699012,0.20275464919460975,165,80,85,1,0.09972513740911768,0.0,0.19508342575683765,0.40339738448636203,-0.7414680664316348,0.7414680664316348,0.19508342575683765,0.0,1,1,0,1,0.19508342575683765,0.0
3336,14,217,10,60,50,1,2324.178,60,1438.591,LESS,458,780,1238,4,1,-10.0,-0.9374084606744876,10.0,0.17460757394239454,0.2355867910256365,-0.3915667333577329,110,60,50,0,-0.9972513740911768,-0.7803337030273506,-1.170500554541026,0.40339738448636203,0.7466287681062899,0.7466287681062899,-1.170500554541026,-0.7803337030273506,0,1,1,0,-0.7803337030273506,-1.170500554541026
3337,14,218,19,41,50,0,1555.319,80,1284.249,LESS,-118,954,836,3,2,9.0,0.8436676146070391,9.0,0.0,1.049123911114166,-0.8119050317719634,91,41,50,1,-1.376206896245824,-1.5216507209033339,-1.170500554541026,-0.1905619546346618,0.09331796269939616,0.09331796269939616,-1.170500554541026,-1.5216507209033339,1,1,0,0,-1.5216507209033339,-1.170500554541026
3338,14,219,56,110,96,1,1295.527,70,730.52,LESS,1264,294,1558,1,2,-14.0,-1.3123718449442827,14.0,0.8730378697119728,0.6423553510699012,-0.9539343599343828,206,110,96,0,0.9174712641638826,1.170500554541026,0.6242669624218805,-1.3784806328767094,1.660810207616631,1.660810207616631,0.6242669624218805,1.170500554541026,1,0,1,2,1.170500554541026,0.6242669624218805
3339,14,220,35,72,80,0,1378.195,80,643.91,LESS,-390,958,568,1,1,8.0,0.7499267685395902,8.0,-0.17460757394239454,1.049123911114166,-0.9087394328368168,152,72,80,1,-0.1595602198545883,-0.31213348121094026,0.0,-1.3784806328767094,-0.215189917631637,0.215189917631637,0.0,-0.31213348121094026,1,0,0,1,-0.31213348121094026,0.0
3340,14,221,11,49,50,1,3603.538,70,1060.642,LESS,34,1282,1316,3,2,1.0,0.09374084606744876,1.0,-1.3968605915391563,0.6423553510699012,0.3078645088586293,99,49,50,1,-1.2166466763912356,-1.2095172396923934,-1.170500554541026,-0.1905619546346618,0.26571942523732645,0.26571942523732645,-1.170500554541026,-1.2095172396923934,1,1,1,0,-1.2095172396923934,-1.170500554541026
3341,14,222,17,43,50,0,1417.078,90,1265.831,LESS,204,752,956,2,2,7.0,0.6561859224721414,7.0,-0.34921514788478913,1.4558924711584305,-0.8874819408165107,93,43,50,1,-1.3363168412821769,-1.4436173506005987,-1.170500554541026,-0.7845212937556856,0.45853685044422215,0.45853685044422215,-1.170500554541026,-1.4436173506005987,1,0,1,0,-1.4436173506005987,-1.170500554541026
3342,14,223,1,51,50,0,1493.379,80,561.548,LESS,-418,1094,676,2,2,-1.0,-0.09374084606744876,1.0,-1.3968605915391563,1.049123911114166,-0.8457678781505288,101,51,50,0,-1.1767566214275886,-1.1314838693896585,-1.170500554541026,-0.7845212937556856,-0.24694808178336103,0.24694808178336103,-1.170500554541026,-1.1314838693896585,1,0,0,0,-1.1314838693896585,-1.170500554541026
3343,14,224,41,112,110,0,1204.389,10,821.69,LESS,-692,1068,376,2,1,-2.0,-0.18748169213489754,2.0,-1.222253017596762,-1.7982560091956867,-1.003759869996535,222,112,110,0,1.2365917038730592,1.248533924843761,1.170500554541026,-0.7845212937556856,-0.5577244024109459,0.5577244024109459,1.170500554541026,1.248533924843761,0,0,0,2,1.248533924843761,1.170500554541026
3344,14,225,20,40,50,0,1120.662,80,191.071,LESS,-562,904,342,2,1,10.0,0.9374084606744876,10.0,0.17460757394239454,1.049123911114166,-1.0495337566406768,90,40,50,1,-1.3961519237276474,-1.5606674060547012,-1.170500554541026,-0.7845212937556856,-0.4102757831350845,0.4102757831350845,-1.170500554541026,-1.5606674060547012,1,0,0,0,-1.5606674060547012,-1.170500554541026
3345,14,226,1,50,51,1,1066.639,40,535.245,LESS,664,292,956,1,2,1.0,0.09374084606744876,1.0,-1.3968605915391563,-0.5779503290628928,-1.079068347372179,101,50,51,1,-1.1767566214275886,-1.170500554541026,-1.1314838693896585,-1.3784806328767094,0.9802781186511165,0.9802781186511165,-1.1314838693896585,-1.170500554541026,0,0,1,0,-1.170500554541026,-1.1314838693896585
3346,14,227,23,85,80,0,1047.298,20,692.788,LESS,-316,720,404,2,1,-5.0,-0.4687042303372438,5.0,-0.6984302957695783,-1.3914874491514222,-1.0896421496293285,165,85,80,0,0.09972513740911768,0.19508342575683765,0.0,-0.7845212937556856,-0.13125762665922358,0.13125762665922358,0.0,0.19508342575683765,0,0,0,1,0.19508342575683765,0.0
3347,14,228,11,50,49,0,1080.82,100,640.144,LESS,-50,826,776,2,2,-1.0,-0.09374084606744876,1.0,-1.3968605915391563,1.8626610312026952,-1.0713155378065602,99,50,49,0,-1.2166466763912356,-1.170500554541026,-1.2095172396923934,-0.7845212937556856,0.17044493278215445,0.17044493278215445,-1.2095172396923934,-1.170500554541026,1,0,0,0,-1.170500554541026,-1.2095172396923934
3348,14,229,17,50,43,0,2406.61,40,665.669,LESS,-1062,1424,362,2,1,-7.0,-0.6561859224721414,7.0,-0.34921514788478913,-0.5779503290628928,-0.34650082840652346,93,50,43,0,-1.3363168412821769,-1.170500554541026,-1.4436173506005987,-0.7845212937556856,-0.9773858572730131,0.9773858572730131,-1.4436173506005987,-1.170500554541026,0,0,0,0,-1.170500554541026,-1.4436173506005987
3349,14,230,21,80,82,0,1064.427,90,619.7769999999998,LESS,82,724,806,2,2,2.0,0.18748169213489754,2.0,-1.222253017596762,1.4558924711584305,-1.0802776566422692,162,80,82,1,0.03989005496364707,0.0,0.07803337030273506,-0.7845212937556856,0.3201619923545676,0.3201619923545676,0.07803337030273506,0.0,1,0,1,1,0.07803337030273506,0.0
3350,14,231,10,50,60,0,1104.734,100,689.04,LESS,182,584,766,2,2,10.0,0.9374084606744876,10.0,0.17460757394239454,1.8626610312026952,-1.0582416581117422,110,50,60,1,-0.9972513740911768,-1.170500554541026,-0.7803337030273506,-0.7845212937556856,0.4335840071821533,0.4335840071821533,-0.7803337030273506,-1.170500554541026,1,0,1,0,-1.170500554541026,-0.7803337030273506
3351,14,232,3,53,50,0,1927.102,70,1532.467,LESS,-690,1236,546,2,1,-3.0,-0.28122253820234633,3.0,-1.0476454436543674,0.6423553510699012,-0.6086497748271427,103,53,50,0,-1.1368665664639415,-1.0534504990869233,-1.170500554541026,-0.7845212937556856,-0.5554559621143942,0.5554559621143942,-1.170500554541026,-1.0534504990869233,1,0,0,0,-1.0534504990869233,-1.170500554541026
3352,14,233,45,122,110,1,4370.941,70,1026.58,LESS,1190,1498,2688,7,2,-12.0,-1.124890152809385,12.0,0.5238227218271837,0.6423553510699012,0.7274068062343193,232,122,110,0,1.4360419786912946,1.6387007763574364,1.170500554541026,2.1852754018494336,1.5768779166442175,1.5768779166442175,1.170500554541026,1.6387007763574364,1,1,1,2,1.6387007763574364,1.170500554541026
3353,14,234,38,67,80,0,1375.695,30,871.617,LESS,-478,874,396,2,1,13.0,1.218630998876834,13.0,0.6984302957695783,-0.9847188891071574,-0.9101061928617832,147,67,80,1,-0.25928535726370594,-0.5072169069677779,0.0,-0.7845212937556856,-0.3150012906799125,0.3150012906799125,0.0,-0.5072169069677779,0,0,0,1,-0.5072169069677779,0.0
3354,14,235,38,80,67,0,1286.488,20,814.804,LESS,-126,728,602,4,1,-13.0,-1.218630998876834,13.0,0.6984302957695783,-1.3914874491514222,-0.9588760174806512,147,80,67,0,-0.25928535726370594,0.0,-0.5072169069677779,0.40339738448636203,0.0842442015131893,0.0842442015131893,-0.5072169069677779,0.0,0,1,0,1,0.0,-0.5072169069677779
3355,14,236,36,70,80,0,2458.285,70,780.3960000000002,LESS,-690,1348,658,2,1,10.0,0.9374084606744876,10.0,0.17460757394239454,0.6423553510699012,-0.3182498986904698,150,70,80,1,-0.19945027481823535,-0.3901668515136753,0.0,-0.7845212937556856,-0.5554559621143942,0.5554559621143942,0.0,-0.3901668515136753,1,0,0,1,-0.3901668515136753,0.0
3356,14,237,45,110,122,0,3166.419000000001,70,1960.481,LESS,-1276,2338,1062,4,1,12.0,1.124890152809385,12.0,0.5238227218271837,0.6423553510699012,0.06888979871732935,232,110,122,1,1.4360419786912946,1.170500554541026,1.6387007763574364,0.40339738448636203,-1.2201089690040465,1.2201089690040465,1.6387007763574364,1.170500554541026,1,1,0,2,1.6387007763574364,1.170500554541026
3357,14,238,42,110,115,0,1586.569,80,586.256,LESS,74,858,932,2,2,5.0,0.4687042303372438,5.0,-0.6984302957695783,1.049123911114166,-0.7948205314598844,225,110,115,1,1.2964267863185297,1.170500554541026,1.3655839802978638,-0.7845212937556856,0.3110882311683607,0.3110882311683607,1.3655839802978638,1.170500554541026,1,0,1,2,1.3655839802978638,1.170500554541026
3358,14,239,41,110,112,1,2434.474,20,627.9259999999998,LESS,476,844,1320,3,2,2.0,0.18748169213489754,2.0,-1.222253017596762,-1.3914874491514222,-0.3312674678722589,222,110,112,1,1.2365917038730592,1.170500554541026,1.248533924843761,-0.1905619546346618,0.7670447307752554,0.7670447307752554,1.248533924843761,1.170500554541026,0,1,1,2,1.248533924843761,1.170500554541026
3359,14,240,53,110,103,0,1479.644,90,605.244,LESS,108,754,862,2,2,-7.0,-0.6561859224721414,7.0,-0.34921514788478913,1.4558924711584305,-0.8532768577276937,213,110,103,0,1.0570864565366473,1.170500554541026,0.8973837584814532,-0.7845212937556856,0.3496517162097399,0.3496517162097399,0.8973837584814532,1.170500554541026,1,0,1,2,1.170500554541026,0.8973837584814532
3360,15,1,49,110,131,1,2542.2470000000008,50,1525.443,MORE,154,1062,1216,3,2,21.0,1.9685577674164243,21.0,2.0952908873087353,0.6428829363192977,-0.5371445022092147,241,110,131,0,1.6155472260277064,1.170500554541026,1.9898509427197442,0.12528343789428434,0.957378221713594,0.957378221713594,1.9898509427197442,1.170500554541026,1,1,1,2,1.9898509427197442,1.170500554541026
3361,15,2,13,47,50,1,8627.313,40,1848.251,MORE,528,3726,4254,6,1,3.0,0.28122253820234633,3.0,-1.0476454436543674,0.1823100864189054,1.972469588862294,97,47,50,0,-1.2565367313548828,-1.2875506099951286,-1.170500554541026,2.175376057982576,1.3354835613931562,1.3354835613931562,-1.170500554541026,-1.2875506099951286,0,1,1,0,-1.2875506099951286,-1.170500554541026
3362,15,3,16,50,44,0,6442.393,30,1888.01,MORE,234,2794,3028,5,1,-6.0,-0.5624450764046927,6.0,-0.5238227218271837,-0.2782627634814869,1.0713608712470766,94,50,44,1,-1.3163718138003533,-1.170500554541026,-1.4046006654492311,1.4920118512864788,1.038256369238634,1.038256369238634,-1.4046006654492311,-1.170500554541026,0,1,1,0,-1.170500554541026,-1.4046006654492311
3363,15,4,7,57,50,0,2761.3140000000008,70,3198.033,MORE,-84,1348,1264,1,1,-7.0,-0.6561859224721414,7.0,-0.34921514788478913,1.564028636120082,-0.4467964878920713,107,57,50,1,-1.0570864565366473,-0.8973837584814532,-1.170500554541026,-1.24144497549791,0.7167657328265998,0.7167657328265998,-1.170500554541026,-0.8973837584814532,1,0,1,0,-0.8973837584814532,-1.170500554541026
3364,15,5,18,42,50,0,8024.03,20,2275.13,MORE,2866,2842,5708,3,1,8.0,0.7499267685395902,8.0,-0.17460757394239454,-0.7388356133818792,1.7236625064569608,92,42,50,0,-1.3562618687640005,-1.4826340357519663,-1.170500554541026,0.12528343789428434,3.699147422812452,3.699147422812452,-1.170500554541026,-1.4826340357519663,0,1,1,0,-1.4826340357519663,-1.170500554541026
3365,15,6,51,108,110,0,9336.779,30,1535.384,MORE,-434,4458,4024,5,1,2.0,0.18748169213489754,2.0,-1.222253017596762,-0.2782627634814869,2.2650688590651384,218,108,110,0,1.156811593945765,1.092467184238291,1.170500554541026,1.4920118512864788,0.3629238374045496,0.3629238374045496,1.170500554541026,1.092467184238291,0,1,1,2,1.170500554541026,1.092467184238291
3366,15,7,31,78,80,0,9932.804,30,1489.525,MORE,-10,4416,4406,7,1,2.0,0.18748169213489754,2.0,-1.222253017596762,-0.2782627634814869,2.510882583785773,158,78,80,0,-0.03989005496364707,-0.07803337030273506,0.0,2.8587402646786737,0.7915780192872619,0.7915780192872619,0.0,-0.07803337030273506,0,1,1,1,-0.07803337030273506,0.0
3367,15,8,58,110,92,0,5285.785,40,2767.736,MORE,-1246,2948,1702,4,1,-18.0,-1.6873352292140782,18.0,1.571468165481551,0.1823100864189054,0.594350476512486,202,110,92,1,0.8376911542365885,1.170500554541026,0.4682002218164104,0.8086476445903815,-0.45798935997460705,0.45798935997460705,0.4682002218164104,1.170500554541026,0,1,0,2,1.170500554541026,0.4682002218164104
3368,15,9,12,50,48,0,7635.335,60,2366.269,MORE,-1614,4078,2464,5,1,-2.0,-0.18748169213489754,2.0,-1.222253017596762,1.10345578621969,1.5633562009659372,98,50,48,1,-1.2365917038730592,-1.170500554541026,-1.248533924843761,1.4920118512864788,-0.8300288385897913,0.8300288385897913,-1.248533924843761,-1.170500554541026,1,1,0,0,-1.170500554541026,-1.248533924843761
3369,15,10,54,110,101,0,9593.819,40,1902.163,MORE,-3134,6026,2892,4,1,-9.0,-0.8436676146070391,9.0,0.0,0.1823100864189054,2.371077767755532,211,110,101,1,1.0171964015730004,1.170500554541026,0.8193503881787182,0.8086476445903815,-2.366713641565552,2.366713641565552,0.8193503881787182,1.170500554541026,0,1,0,2,1.170500554541026,0.8193503881787182
3370,15,11,14,46,50,1,4161.977,80,1148.823,MORE,-450,2168,1718,3,2,4.0,0.3749633842697951,4.0,-0.8730378697119728,2.024601486020474,0.13086751799422325,96,46,50,0,-1.2764817588367063,-1.3265672951464962,-1.170500554541026,0.12528343789428434,0.3467482078995415,0.3467482078995415,-1.170500554541026,-1.3265672951464962,1,1,1,0,-1.3265672951464962,-1.170500554541026
3371,15,12,22,80,83,1,14553.385,20,1363.056,MORE,-844,7216,6372,6,1,3.0,0.28122253820234633,3.0,-1.0476454436543674,-0.7388356133818792,4.416511082562497,163,80,83,0,0.05983508244547061,0.0,0.1170500554541026,2.175376057982576,-0.05157666866128074,0.05157666866128074,0.1170500554541026,0.0,0,1,0,1,0.1170500554541026,0.0
3372,15,13,6,50,56,0,5162.8420000000015,30,1169.515,MORE,-114,2410,2296,3,1,6.0,0.5624450764046927,6.0,-0.5238227218271837,-0.2782627634814869,0.5436460987459012,106,50,56,0,-1.077031484018471,-1.170500554541026,-0.9364004436328208,0.12528343789428434,0.6864364275047098,0.6864364275047098,-0.9364004436328208,-1.170500554541026,0,1,1,0,-1.170500554541026,-0.9364004436328208
3373,15,14,13,50,47,1,8179.39,60,2638.831,MORE,-890,4496,3606,5,1,-3.0,-0.28122253820234633,3.0,-1.0476454436543674,1.10345578621969,1.7877363628767384,97,50,47,1,-1.2565367313548828,-1.170500554541026,-1.2875506099951286,1.4920118512864788,-0.09808160348817878,0.09808160348817878,-1.2875506099951286,-1.170500554541026,1,1,0,0,-1.170500554541026,-1.2875506099951286
3374,15,15,46,110,124,1,3542.087,70,1688.966,MORE,-504,1672,1168,1,2,14.0,1.3123718449442827,14.0,0.8730378697119728,1.564028636120082,-0.12478865383929795,234,110,124,0,1.4759320336549415,1.170500554541026,1.7167341466601715,-1.24144497549791,0.2921554583201395,0.2921554583201395,1.7167341466601715,1.170500554541026,1,0,1,2,1.7167341466601715,1.170500554541026
3375,15,16,27,91,80,0,13076.186000000003,40,1220.639,MORE,-1624,6840,5216,6,1,-11.0,-1.0311493067419364,11.0,0.34921514788478913,0.1823100864189054,3.807281959046543,171,91,80,1,0.21939530230005888,0.4291835366650429,0.0,2.175376057982576,-0.8401386070304213,0.8401386070304213,0.0,0.4291835366650429,1,1,0,1,0.4291835366650429,0.0
3376,15,17,40,64,80,1,8313.158000000001,20,1041.43,MORE,-2758,5178,2420,3,2,16.0,1.4998535370791803,16.0,1.222253017596762,-0.7388356133818792,1.8429052070165481,144,64,80,0,-0.3191204397091766,-0.6242669624218805,0.0,0.12528343789428434,-1.986586348197864,1.986586348197864,0.0,-0.6242669624218805,0,1,0,1,-0.6242669624218805,0.0
3377,15,18,22,83,80,1,8153.101,40,1757.368,MORE,-1698,4802,3104,5,1,-3.0,-0.28122253820234633,3.0,-1.0476454436543674,0.1823100864189054,1.7768942052337189,163,83,80,1,0.05983508244547061,0.1170500554541026,0.0,1.4920118512864788,-0.9149508934910834,0.9149508934910834,0.0,0.1170500554541026,0,1,0,1,0.1170500554541026,0.0
3378,15,19,54,101,110,1,3705.626,50,1354.987,MORE,-1174,2344,1170,1,1,9.0,0.8436676146070391,9.0,0.0,0.6428829363192977,-0.05734159922399156,211,101,110,0,1.0171964015730004,0.8193503881787182,1.170500554541026,-1.24144497549791,-0.385199027202071,0.385199027202071,1.170500554541026,0.8193503881787182,1,0,0,2,1.170500554541026,0.8193503881787182
3379,15,20,6,56,50,0,8992.614,60,1714.6529999999998,MORE,-4126,6222,2096,4,1,-6.0,-0.5624450764046927,6.0,-0.5238227218271837,1.10345578621969,2.123127697925123,106,56,50,1,-1.077031484018471,-0.9364004436328208,-1.170500554541026,0.8086476445903815,-3.369602670876049,3.369602670876049,-1.170500554541026,-0.9364004436328208,1,1,0,0,-0.9364004436328208,-1.170500554541026
3380,15,21,18,50,42,0,9472.059,20,1133.545,MORE,-604,5030,4426,4,1,-8.0,-0.7499267685395902,8.0,-0.17460757394239454,-0.7388356133818792,2.3208612850207726,92,50,42,1,-1.3562618687640005,-1.170500554541026,-1.4826340357519663,0.8086476445903815,0.19105777391383943,0.19105777391383943,-1.4826340357519663,-1.170500554541026,0,1,0,0,-1.170500554541026,-1.4826340357519663
3381,15,22,43,110,117,1,8236.17,30,1255.539,MORE,-2828,5516,2688,3,1,7.0,0.6561859224721414,7.0,-0.34921514788478913,-0.2782627634814869,1.8111536747170764,227,110,117,0,1.3363168412821769,1.170500554541026,1.4436173506005987,0.12528343789428434,-2.057354727282274,2.057354727282274,1.4436173506005987,1.170500554541026,0,1,0,2,1.4436173506005987,1.170500554541026
3382,15,23,32,77,80,0,15938.463,30,1313.052,MORE,-5850,10718,4868,4,1,3.0,0.28122253820234633,3.0,-1.0476454436543674,-0.2782627634814869,4.9877474941368565,157,77,80,0,-0.05983508244547061,-0.1170500554541026,0.0,0.8086476445903815,-5.112526750040662,5.112526750040662,0.0,-0.1170500554541026,0,1,0,1,-0.1170500554541026,0.0
3383,15,24,27,80,91,1,4239.218,70,2087.778,MORE,-1818,2984,1166,1,2,11.0,1.0311493067419364,11.0,0.34921514788478913,1.564028636120082,0.16272339301816782,171,80,91,0,0.21939530230005888,0.0,0.4291835366650429,-1.24144497549791,-1.0362681147786434,1.0362681147786434,0.4291835366650429,0.0,1,0,0,1,0.4291835366650429,0.0
3384,15,25,16,44,50,1,5746.953,20,1211.642,MORE,-570,2996,2426,3,1,6.0,0.5624450764046927,6.0,-0.5238227218271837,-0.7388356133818792,0.7845462297140563,94,44,50,0,-1.3163718138003533,-1.4046006654492311,-1.170500554541026,0.12528343789428434,0.22543098661198147,0.22543098661198147,-1.170500554541026,-1.4046006654492311,0,1,1,0,-1.4046006654492311,-1.170500554541026
3385,15,26,7,50,57,1,9532.568,30,965.135,MORE,-2670,5822,3152,5,2,7.0,0.6561859224721414,7.0,-0.34921514788478913,-0.2782627634814869,2.345816517887047,107,50,57,0,-1.0570864565366473,-1.170500554541026,-0.8973837584814532,1.4920118512864788,-1.89762038592032,1.89762038592032,-0.8973837584814532,-1.170500554541026,0,1,0,0,-1.170500554541026,-0.8973837584814532
3386,15,27,14,50,46,1,4722.124,10,2298.998,MORE,-3702,4978,1276,2,1,-4.0,-0.3749633842697951,4.0,-0.8730378697119728,-1.1994084632822717,0.3618843720877421,96,50,46,1,-1.2764817588367063,-1.170500554541026,-1.3265672951464962,-0.5580807688018129,-2.9409484889933366,2.9409484889933366,-1.3265672951464962,-1.170500554541026,0,0,0,0,-1.170500554541026,-1.3265672951464962
3387,15,28,51,110,108,1,15369.211,30,966.335,MORE,-1346,7984,6638,5,2,-2.0,-0.18748169213489754,2.0,-1.222253017596762,-0.2782627634814869,4.7529755392278,218,110,108,1,1.156811593945765,1.170500554541026,1.092467184238291,1.4920118512864788,-0.5590870443809071,0.5590870443809071,1.092467184238291,1.170500554541026,0,1,0,2,1.170500554541026,1.092467184238291
3388,15,29,50,133,110,0,7385.411,60,1128.231,MORE,-322,3694,3372,2,1,-23.0,-2.1560394595513217,23.0,2.444506035193524,1.10345578621969,1.4602820860595491,243,133,110,1,1.6554372809913533,2.0678843130224793,1.170500554541026,-0.5580807688018129,0.4761532439396056,0.4761532439396056,1.170500554541026,2.0678843130224793,1,0,1,2,2.0678843130224793,1.170500554541026
3389,15,30,49,131,110,0,9895.334,40,3463.062,MORE,-3884,5854,1970,3,1,-21.0,-1.9685577674164243,21.0,2.0952908873087353,0.1823100864189054,2.4954291375959623,241,131,110,1,1.6155472260277064,1.9898509427197442,1.170500554541026,0.12528343789428434,-3.1249462746128027,3.1249462746128027,1.170500554541026,1.9898509427197442,1,1,0,2,1.9898509427197442,1.170500554541026
3390,15,31,47,126,110,1,6098.063,10,1692.057,MORE,-3354,5072,1718,2,1,-16.0,-1.4998535370791803,16.0,1.222253017596762,-1.1994084632822717,0.9293516605041442,236,126,110,1,1.5158220886185887,1.7947675169629065,1.170500554541026,-0.5580807688018129,-2.5891285472594125,2.5891285472594125,1.170500554541026,1.7947675169629065,0,0,0,2,1.7947675169629065,1.170500554541026
3391,15,32,50,110,133,1,4835.46,40,982.44,MORE,-512,2444,1932,3,2,23.0,2.1560394595513217,23.0,2.444506035193524,0.1823100864189054,0.4086266132771855,243,110,133,0,1.6554372809913533,1.170500554541026,2.0678843130224793,0.12528343789428434,0.28406764356763553,0.28406764356763553,2.0678843130224793,1.170500554541026,1,1,1,2,2.0678843130224793,1.170500554541026
3392,15,33,47,110,126,1,6008.151999999999,30,1508.818,MORE,-1990,3722,1732,3,2,16.0,1.4998535370791803,16.0,1.222253017596762,-0.2782627634814869,0.8922704008198067,236,110,126,0,1.5158220886185887,1.170500554541026,1.7947675169629065,0.12528343789428434,-1.2101561319574796,1.2101561319574796,1.7947675169629065,1.170500554541026,0,1,0,2,1.7947675169629065,1.170500554541026
3393,15,34,12,48,50,1,6182.891,50,1105.731,MORE,-216,2826,2610,5,2,2.0,0.18748169213489754,2.0,-1.222253017596762,0.6428829363192977,0.964336579996786,98,48,50,0,-1.2365917038730592,-1.248533924843761,-1.170500554541026,1.4920118512864788,0.5833167894102838,0.5833167894102838,-1.170500554541026,-1.248533924843761,1,1,1,0,-1.248533924843761,-1.170500554541026
3394,15,35,32,80,77,0,7349.7959999999985,70,990.448,MORE,-1632,4266,2634,4,1,-3.0,-0.28122253820234633,3.0,-1.0476454436543674,1.564028636120082,1.4455936823752642,157,80,77,1,-0.05983508244547061,0.0,-0.1170500554541026,0.8086476445903815,-0.8482264217829253,0.8482264217829253,-0.1170500554541026,0.0,1,1,0,1,0.0,-0.1170500554541026
3395,15,36,43,117,110,1,10474.995,50,973.248,MORE,-1698,5750,4052,5,1,-7.0,-0.6561859224721414,7.0,-0.34921514788478913,0.6428829363192977,2.7344939913945248,227,117,110,1,1.3363168412821769,1.4436173506005987,1.170500554541026,1.4920118512864788,-0.9149508934910834,0.9149508934910834,1.170500554541026,1.4436173506005987,1,1,0,2,1.4436173506005987,1.170500554541026
3396,15,37,40,80,64,0,5421.495,20,1078.382,MORE,-1094,3320,2226,4,1,-16.0,-1.4998535370791803,16.0,1.222253017596762,-0.7388356133818792,0.6503202438575426,144,80,64,1,-0.3191204397091766,0.0,-0.6242669624218805,0.8086476445903815,-0.3043208796770309,0.3043208796770309,-0.6242669624218805,0.0,0,1,0,1,0.0,-0.6242669624218805
3397,15,38,31,80,78,1,3153.256,30,1689.38,MORE,-1478,2796,1318,1,1,-2.0,-0.18748169213489754,2.0,-1.222253017596762,-0.2782627634814869,-0.28515104869999897,158,80,78,1,-0.03989005496364707,0.0,-0.07803337030273506,-1.24144497549791,-0.6925359877972233,0.6925359877972233,-0.07803337030273506,0.0,0,0,0,1,0.0,-0.07803337030273506
3398,15,39,46,124,110,0,6262.733,60,2074.022,MORE,-1000,3394,2394,4,1,-14.0,-1.3123718449442827,14.0,0.8730378697119728,1.10345578621969,0.9972651642158123,234,124,110,1,1.4759320336549415,1.7167341466601715,1.170500554541026,0.8086476445903815,-0.20928905633510886,0.20928905633510886,1.170500554541026,1.7167341466601715,1,1,0,2,1.7167341466601715,1.170500554541026
3399,15,40,58,92,110,1,4944.41,30,1597.639,MORE,1828,1356,3184,2,1,18.0,1.6873352292140782,18.0,1.571468165481551,-0.2782627634814869,0.4535599722945306,202,92,110,0,0.8376911542365885,0.4682002218164104,1.170500554541026,-0.5580807688018129,2.6497534586750575,2.6497534586750575,1.170500554541026,0.4682002218164104,0,0,1,2,1.170500554541026,0.4682002218164104
3400,15,41,49,110,131,0,3213.057,20,1650.136,LESS,-2066,3054,988,4,1,21.0,1.9685577674164243,21.0,2.0952908873087353,-0.7388356133818792,-0.2604878104935165,241,110,131,1,1.6155472260277064,1.170500554541026,1.9898509427197442,0.8086476445903815,-1.2869903721062677,1.2869903721062677,1.9898509427197442,1.170500554541026,0,1,0,2,1.9898509427197442,1.170500554541026
3401,15,42,13,47,50,0,1911.881,50,1214.537,LESS,-334,990,656,2,1,3.0,0.28122253820234633,3.0,-1.0476454436543674,0.6428829363192977,-0.7971212051952439,97,47,50,1,-1.2565367313548828,-1.2875506099951286,-1.170500554541026,-0.5580807688018129,0.46402152181084966,0.46402152181084966,-1.170500554541026,-1.2875506099951286,1,0,1,0,-1.2875506099951286,-1.170500554541026
3402,15,43,16,50,44,1,3329.31,20,1248.964,LESS,104,1790,1894,3,2,-6.0,-0.5624450764046927,6.0,-0.5238227218271837,-0.7388356133818792,-0.21254253480885896,94,50,44,0,-1.3163718138003533,-1.170500554541026,-1.4046006654492311,0.12528343789428434,0.906829379510444,0.906829379510444,-1.4046006654492311,-1.170500554541026,0,1,1,0,-1.170500554541026,-1.4046006654492311
3403,15,44,7,57,50,0,3117.9040000000005,10,1027.6989999999996,LESS,-1982,2754,772,2,1,-7.0,-0.6561859224721414,7.0,-0.34921514788478913,-1.1994084632822717,-0.29973098544145066,107,57,50,0,-1.0570864565366473,-0.8973837584814532,-1.170500554541026,-0.5580807688018129,-1.2020683172049755,1.2020683172049755,-1.170500554541026,-0.8973837584814532,0,0,0,0,-0.8973837584814532,-1.170500554541026
3404,15,45,18,42,50,0,2299.119,20,1504.491,LESS,-1360,1964,604,2,1,8.0,0.7499267685395902,8.0,-0.17460757394239454,-0.7388356133818792,-0.6374157983190737,92,42,50,1,-1.3562618687640005,-1.4826340357519663,-1.170500554541026,-0.5580807688018129,-0.5732407201977892,0.5732407201977892,-1.170500554541026,-1.4826340357519663,0,0,0,0,-1.4826340357519663,-1.170500554541026
3405,15,46,51,108,110,0,2421.203,40,1476.402,LESS,-1016,1830,814,2,1,2.0,0.18748169213489754,2.0,-1.222253017596762,0.1823100864189054,-0.5870656909094953,218,108,110,1,1.156811593945765,1.092467184238291,1.170500554541026,-0.5580807688018129,-0.22546468584011686,0.22546468584011686,1.170500554541026,1.092467184238291,1,0,0,2,1.170500554541026,1.092467184238291
3406,15,47,31,78,80,1,4847.147,30,1576.106,LESS,-1060,2772,1712,5,1,2.0,0.18748169213489754,2.0,-1.222253017596762,-0.2782627634814869,0.413446587272924,158,78,80,1,-0.03989005496364707,-0.07803337030273506,0.0,1.4920118512864788,-0.2699476669788889,0.2699476669788889,0.0,-0.07803337030273506,1,1,0,1,-0.07803337030273506,0.0
3407,15,48,58,110,92,1,5263.507,10,861.372,LESS,668,2204,2872,5,1,-18.0,-1.6873352292140782,18.0,1.571468165481551,-1.1994084632822717,0.5851625428531153,202,110,92,0,0.8376911542365885,1.170500554541026,0.4682002218164104,1.4920118512864788,1.4770203195619764,1.4770203195619764,0.4682002218164104,1.170500554541026,0,1,1,2,1.170500554541026,0.4682002218164104
3408,15,49,12,50,48,0,2595.804,0,1128.247,LESS,-1766,2432,666,2,1,-2.0,-0.18748169213489754,2.0,-1.222253017596762,-1.6599813131826635,-0.5150564259458652,98,50,48,0,-1.2365917038730592,-1.170500554541026,-1.248533924843761,-0.5580807688018129,-0.9836973188873674,0.9836973188873674,-1.248533924843761,-1.170500554541026,0,0,0,0,-1.170500554541026,-1.248533924843761
3409,15,50,54,110,101,1,2951.027,20,1820.664,LESS,132,1524,1656,3,1,-9.0,-0.8436676146070391,9.0,0.0,-0.7388356133818792,-0.36855470414486996,211,110,101,0,1.0171964015730004,1.170500554541026,0.8193503881787182,0.12528343789428434,0.9351367311442079,0.9351367311442079,0.8193503881787182,1.170500554541026,0,1,1,2,1.170500554541026,0.8193503881787182
3410,15,51,14,46,50,0,1781.246,10,957.064,LESS,-1318,1848,530,2,1,4.0,0.3749633842697951,4.0,-0.8730378697119728,-1.1994084632822717,-0.8509979317232925,96,46,50,1,-1.2764817588367063,-1.3265672951464962,-1.170500554541026,-0.5580807688018129,-0.5307796927471431,0.5307796927471431,-1.170500554541026,-1.3265672951464962,0,0,0,0,-1.3265672951464962,-1.170500554541026
3411,15,52,22,80,83,0,2734.038,40,961.186,LESS,-1328,1948,620,2,1,3.0,0.28122253820234633,3.0,-1.0476454436543674,0.1823100864189054,-0.4580457058870887,163,80,83,1,0.05983508244547061,0.0,0.1170500554541026,-0.5580807688018129,-0.5408894611877731,0.5408894611877731,0.1170500554541026,0.0,1,0,0,1,0.1170500554541026,0.0
3412,15,53,6,50,56,0,2200.877,60,1208.63,LESS,-1114,1622,508,2,1,6.0,0.5624450764046927,6.0,-0.5238227218271837,1.10345578621969,-0.677932944317991,106,50,56,1,-1.077031484018471,-1.170500554541026,-0.9364004436328208,-0.5580807688018129,-0.3245404165582909,0.3245404165582909,-0.9364004436328208,-1.170500554541026,1,0,0,0,-1.170500554541026,-0.9364004436328208
3413,15,54,13,50,47,1,2352.41,10,1449.0320000000004,LESS,-942,1960,1018,3,1,-3.0,-0.28122253820234633,3.0,-1.0476454436543674,-1.1994084632822717,-0.6154374262640638,97,50,47,0,-1.2565367313548828,-1.170500554541026,-1.2875506099951286,0.12528343789428434,-0.15065239937945482,0.15065239937945482,-1.2875506099951286,-1.170500554541026,0,1,0,0,-1.170500554541026,-1.2875506099951286
3414,15,55,46,110,124,0,3729.995,20,998.566,LESS,-1192,2508,1316,4,1,14.0,1.3123718449442827,14.0,0.8730378697119728,-0.7388356133818792,-0.047291291505830266,234,110,124,1,1.4759320336549415,1.170500554541026,1.7167341466601715,0.8086476445903815,-0.40339661039520497,0.40339661039520497,1.7167341466601715,1.170500554541026,0,1,0,2,1.7167341466601715,1.170500554541026
3415,15,56,27,91,80,1,5162.3,10,2388.883,LESS,-2358,4240,1882,5,1,-11.0,-1.0311493067419364,11.0,0.34921514788478913,-1.1994084632822717,0.5434225661108626,171,91,80,0,0.21939530230005888,0.4291835366650429,0.0,1.4920118512864788,-1.5821956105726638,1.5821956105726638,0.0,0.4291835366650429,0,1,0,1,0.4291835366650429,0.0
3416,15,57,40,64,80,0,1931.223,10,724.405,LESS,-1282,1792,510,2,1,16.0,1.4998535370791803,16.0,1.222253017596762,-1.1994084632822717,-0.7891441420459692,144,64,80,1,-0.3191204397091766,-0.6242669624218805,0.0,-0.5580807688018129,-0.49438452636087504,0.49438452636087504,0.0,-0.6242669624218805,0,0,0,1,-0.6242669624218805,0.0
3417,15,58,22,83,80,1,6761.232,10,1719.0410000000004,LESS,-1528,4138,2610,7,1,-3.0,-0.28122253820234633,3.0,-1.0476454436543674,-1.1994084632822717,1.2028570369720086,163,83,80,0,0.05983508244547061,0.1170500554541026,0.0,2.8587402646786737,-0.7430848300003733,0.7430848300003733,0.0,0.1170500554541026,0,1,0,1,0.1170500554541026,0.0
3418,15,59,54,101,110,0,2898.953,20,1467.836,LESS,-1976,2538,562,2,1,9.0,0.8436676146070391,9.0,0.0,-0.7388356133818792,-0.390031158825634,211,101,110,1,1.0171964015730004,0.8193503881787182,1.170500554541026,-0.5580807688018129,-1.1960024561405975,1.1960024561405975,1.170500554541026,0.8193503881787182,0,0,0,2,1.170500554541026,0.8193503881787182
3419,15,60,6,56,50,0,7102.359,20,1503.537,LESS,-214,3282,3068,9,1,-6.0,-0.5624450764046927,6.0,-0.5238227218271837,-0.7388356133818792,1.3435452605746698,106,56,50,0,-1.077031484018471,-0.9364004436328208,-1.170500554541026,4.225468678070868,0.5853387430984097,0.5853387430984097,-1.170500554541026,-0.9364004436328208,0,1,1,0,-0.9364004436328208,-1.170500554541026
3420,15,61,18,50,42,1,3027.068,30,1536.6729999999998,LESS,600,960,1560,3,2,-8.0,-0.7499267685395902,8.0,-0.17460757394239454,-0.2782627634814869,-0.3371937353239617,92,50,42,0,-1.3562618687640005,-1.170500554541026,-1.4826340357519663,0.12528343789428434,1.4082738941656923,1.4082738941656923,-1.4826340357519663,-1.170500554541026,1,1,1,0,-1.170500554541026,-1.4826340357519663
3421,15,62,43,110,117,0,3191.786,40,1183.071,LESS,-820,1806,986,4,1,7.0,0.6561859224721414,7.0,-0.34921514788478913,0.1823100864189054,-0.2692604353641722,227,110,117,1,1.3363168412821769,1.170500554541026,1.4436173506005987,0.8086476445903815,-0.02731322440376872,0.02731322440376872,1.4436173506005987,1.170500554541026,1,1,1,2,1.4436173506005987,1.170500554541026
3422,15,63,32,77,80,0,2312.661,10,1310.652,LESS,-1728,2242,514,2,1,3.0,0.28122253820234633,3.0,-1.0476454436543674,-1.1994084632822717,-0.6318307818178082,157,77,80,1,-0.05983508244547061,-0.1170500554541026,0.0,-0.5580807688018129,-0.9452801988129734,0.9452801988129734,0.0,-0.1170500554541026,0,0,0,1,-0.1170500554541026,0.0
3423,15,64,27,80,91,0,1751.829,60,833.7510000000002,LESS,-582,1068,486,2,1,11.0,1.0311493067419364,11.0,0.34921514788478913,1.10345578621969,-0.8631301448688936,171,80,91,1,0.21939530230005888,0.0,0.4291835366650429,-0.5580807688018129,0.21329926448322545,0.21329926448322545,0.4291835366650429,0.0,1,0,1,1,0.4291835366650429,0.0
3424,15,65,16,44,50,0,1885.989,70,904.589,LESS,-474,1016,542,2,1,6.0,0.5624450764046927,6.0,-0.5238227218271837,1.564028636120082,-0.8077996313694257,94,44,50,1,-1.3163718138003533,-1.4046006654492311,-1.170500554541026,-0.5580807688018129,0.32248476364202955,0.32248476364202955,-1.170500554541026,-1.4046006654492311,1,1,1,0,-1.4046006654492311,-1.170500554541026
3425,15,66,7,50,57,0,1841.842,70,1436.942,LESS,-606,1088,482,2,1,7.0,0.6561859224721414,7.0,-0.34921514788478913,1.564028636120082,-0.8260068181572985,107,50,57,1,-1.0570864565366473,-1.170500554541026,-0.8973837584814532,-0.5580807688018129,0.18903582022571344,0.18903582022571344,-0.8973837584814532,-1.170500554541026,1,0,1,0,-1.170500554541026,-0.8973837584814532
3426,15,67,14,50,46,1,3151.2990000000004,30,1388.675,LESS,476,1132,1608,3,2,-4.0,-0.3749633842697951,4.0,-0.8730378697119728,-0.2782627634814869,-0.2859581582327839,96,50,46,0,-1.2764817588367063,-1.170500554541026,-1.3265672951464962,0.12528343789428434,1.2829127655018802,1.2829127655018802,-1.3265672951464962,-1.170500554541026,1,1,1,0,-1.170500554541026,-1.3265672951464962
3427,15,68,51,110,108,1,2884.3459999999995,20,999.755,LESS,-222,1582,1360,3,1,-2.0,-0.18748169213489754,2.0,-1.222253017596762,-0.7388356133818792,-0.3960554045820946,218,110,108,0,1.156811593945765,1.170500554541026,1.092467184238291,0.12528343789428434,0.5772509283459057,0.5772509283459057,1.092467184238291,1.170500554541026,0,1,1,2,1.170500554541026,1.092467184238291
3428,15,69,50,133,110,1,2756.411,50,1737.808,LESS,-206,1460,1254,3,1,-23.0,-2.1560394595513217,23.0,2.444506035193524,0.6428829363192977,-0.4488185921533112,243,133,110,0,1.6554372809913533,2.0678843130224793,1.170500554541026,0.12528343789428434,0.5934265578509137,0.5934265578509137,1.170500554541026,2.0678843130224793,1,1,1,2,2.0678843130224793,1.170500554541026
3429,15,70,49,131,110,1,2296.337,20,1158.503,LESS,-856,1736,880,1,1,-21.0,-1.9685577674164243,21.0,2.0952908873087353,-0.7388356133818792,-0.6385631558664465,241,131,110,0,1.6155472260277064,1.9898509427197442,1.170500554541026,-1.24144497549791,-0.06370839079003675,0.06370839079003675,1.170500554541026,1.9898509427197442,0,0,0,2,1.9898509427197442,1.170500554541026
3430,15,71,47,126,110,0,2620.081,10,1979.122,LESS,-1990,2548,558,2,1,-16.0,-1.4998535370791803,16.0,1.222253017596762,-1.1994084632822717,-0.5050440610366033,236,126,110,0,1.5158220886185887,1.7947675169629065,1.170500554541026,-0.5580807688018129,-1.2101561319574796,1.2101561319574796,1.170500554541026,1.7947675169629065,0,0,0,2,1.7947675169629065,1.170500554541026
3431,15,72,50,110,133,0,3754.063,10,1110.116,LESS,-1690,2840,1150,4,1,23.0,2.1560394595513217,23.0,2.444506035193524,-1.1994084632822717,-0.037365122760263735,243,110,133,1,1.6554372809913533,1.170500554541026,2.0678843130224793,0.8086476445903815,-0.9068630787385794,0.9068630787385794,2.0678843130224793,1.170500554541026,0,1,0,2,2.0678843130224793,1.170500554541026
3432,15,73,47,110,126,0,2232.07,30,1465.745,LESS,-296,1090,794,3,1,16.0,1.4998535370791803,16.0,1.222253017596762,-0.2782627634814869,-0.6650682699918959,236,110,126,1,1.5158220886185887,1.170500554541026,1.7947675169629065,0.12528343789428434,0.5024386418852437,0.5024386418852437,1.7947675169629065,1.170500554541026,1,1,1,2,1.7947675169629065,1.170500554541026
3433,15,74,12,48,50,0,4715.899,20,958.123,LESS,-2634,3888,1254,4,1,2.0,0.18748169213489754,2.0,-1.222253017596762,-0.7388356133818792,0.3593170461594911,98,48,50,1,-1.2365917038730592,-1.248533924843761,-1.170500554541026,0.8086476445903815,-1.861225219534052,1.861225219534052,-1.170500554541026,-1.248533924843761,0,1,0,0,-1.248533924843761,-1.170500554541026
3434,15,75,32,80,77,0,4339.1,20,1549.136,LESS,-1632,3052,1420,4,1,-3.0,-0.28122253820234633,3.0,-1.0476454436543674,-0.7388356133818792,0.20391691082790167,157,80,77,0,-0.05983508244547061,0.0,-0.1170500554541026,0.8086476445903815,-0.8482264217829253,0.8482264217829253,-0.1170500554541026,0.0,0,1,0,1,0.0,-0.1170500554541026
3435,15,76,43,117,110,1,4913.117,0,1906.458,LESS,-1096,3500,2404,3,1,-7.0,-0.6561859224721414,7.0,-0.34921514788478913,-1.6599813131826635,0.4406540557848494,227,117,110,0,1.3363168412821769,1.4436173506005987,1.170500554541026,0.12528343789428434,-0.30634283336515694,0.30634283336515694,1.170500554541026,1.4436173506005987,0,1,0,2,1.4436173506005987,1.170500554541026
3436,15,77,40,80,64,1,3676.601,30,1003.426,LESS,-468,1796,1328,3,2,-16.0,-1.4998535370791803,16.0,1.222253017596762,-0.2782627634814869,-0.06931214300993419,144,80,64,0,-0.3191204397091766,0.0,-0.6242669624218805,0.12528343789428434,0.32855062470640756,0.32855062470640756,-0.6242669624218805,0.0,1,1,1,1,0.0,-0.6242669624218805
3437,15,78,31,80,78,0,5630.674,20,1109.927,LESS,-1182,3268,2086,6,1,-2.0,-0.18748169213489754,2.0,-1.222253017596762,-0.7388356133818792,0.7365902310616662,158,80,78,0,-0.03989005496364707,0.0,-0.07803337030273506,2.175376057982576,-0.393286841954575,0.393286841954575,-0.07803337030273506,0.0,1,1,0,1,0.0,-0.07803337030273506
3438,15,79,46,124,110,1,3010.181,50,1538.89,LESS,402,1128,1530,3,2,-14.0,-1.3123718449442827,14.0,0.8730378697119728,0.6428829363192977,-0.34415830286619137,234,124,110,0,1.4759320336549415,1.7167341466601715,1.170500554541026,0.12528343789428434,1.2081004790412182,1.2081004790412182,1.170500554541026,1.7167341466601715,1,1,1,2,1.7167341466601715,1.170500554541026
3439,15,80,58,92,110,0,2233.943,70,1482.025,LESS,-870,1428,558,2,1,18.0,1.6873352292140782,18.0,1.571468165481551,1.564028636120082,-0.6642958038933233,202,92,110,1,0.8376911542365885,0.4682002218164104,1.170500554541026,-0.5580807688018129,-0.07786206660691876,0.07786206660691876,1.170500554541026,0.4682002218164104,1,0,0,2,1.170500554541026,0.4682002218164104
3440,15,81,48,128,110,0,2979.25,30,1045.3239999999996,MORE,-522,1576,1054,4,1,-18.0,-1.6873352292140782,18.0,1.571468165481551,-0.2782627634814869,-0.3569149226712901,238,128,110,1,1.5557121435822359,1.8728008872656416,1.170500554541026,0.8086476445903815,0.2739578751270055,0.2739578751270055,1.170500554541026,1.8728008872656416,0,1,1,2,1.8728008872656416,1.170500554541026
3441,15,82,8,50,58,1,3156.916,10,1866.769,MORE,-342,1974,1632,3,1,8.0,0.7499267685395902,8.0,-0.17460757394239454,-1.1994084632822717,-0.2836415847807379,108,50,58,0,-1.0371414290548238,-1.170500554541026,-0.8583670733300858,0.12528343789428434,0.4559337070583456,0.4559337070583456,-0.8583670733300858,-1.170500554541026,0,1,1,0,-1.170500554541026,-0.8583670733300858
3442,15,83,4,54,50,1,3595.586,30,1396.024,MORE,968,1154,2122,3,2,-4.0,-0.3749633842697951,4.0,-0.8730378697119728,-0.2782627634814869,-0.10272449804242836,104,54,50,1,-1.116921538982118,-1.0144338139355558,-1.170500554541026,0.12528343789428434,1.7803133727808766,1.7803133727808766,-1.170500554541026,-1.0144338139355558,0,1,1,0,-1.0144338139355558,-1.170500554541026
3443,15,84,37,80,69,0,3120.278,80,1598.935,MORE,-856,2102,1246,2,2,-11.0,-1.0311493067419364,11.0,0.34921514788478913,2.024601486020474,-0.2987518960031106,149,80,69,1,-0.21939530230005888,0.0,-0.4291835366650429,-0.5580807688018129,-0.06370839079003675,0.06370839079003675,-0.4291835366650429,0.0,1,0,0,1,0.0,-0.4291835366650429
3444,15,85,52,105,110,1,2814.763,70,1173.585,MORE,-752,1638,886,1,2,5.0,0.4687042303372438,5.0,-0.6984302957695783,1.564028636120082,-0.4247529531869952,215,105,110,0,1.0969765115002945,0.9754171287841883,1.170500554541026,-1.24144497549791,0.04143320099251533,0.04143320099251533,1.170500554541026,0.9754171287841883,1,0,0,2,1.170500554541026,0.9754171287841883
3445,15,86,5,55,50,0,2994.377,30,1317.9029999999998,MORE,-1868,2564,696,2,1,-5.0,-0.4687042303372438,5.0,-0.6984302957695783,-0.2782627634814869,-0.3506762175601806,105,55,50,1,-1.0969765115002945,-0.9754171287841883,-1.170500554541026,-0.5580807688018129,-1.0868169569817936,1.0868169569817936,-1.170500554541026,-0.9754171287841883,0,0,0,0,-0.9754171287841883,-1.170500554541026
3446,15,87,30,96,80,0,3986.693,30,1294.904,MORE,-890,2332,1442,4,1,-16.0,-1.4998535370791803,16.0,1.222253017596762,-0.2782627634814869,0.058576568916698435,176,96,80,1,0.3191204397091766,0.6242669624218805,0.0,0.8086476445903815,-0.09808160348817878,0.09808160348817878,0.0,0.6242669624218805,0,1,0,1,0.6242669624218805,0.0
3447,15,88,33,80,75,0,3316.936,40,584.17,MORE,-1252,2222,970,2,1,-5.0,-0.4687042303372438,5.0,-0.6984302957695783,0.1823100864189054,-0.21764584260583572,155,80,75,1,-0.09972513740911768,0.0,-0.19508342575683765,-0.5580807688018129,-0.46405522103898506,0.46405522103898506,-0.19508342575683765,0.0,1,0,0,1,0.0,-0.19508342575683765
3448,15,89,48,110,128,1,3882.113,20,1263.87,MORE,16,1838,1854,3,1,18.0,1.6873352292140782,18.0,1.571468165481551,-0.7388356133818792,0.015445493322077218,238,110,128,0,1.5557121435822359,1.170500554541026,1.8728008872656416,0.12528343789428434,0.8178634172328999,0.8178634172328999,1.8728008872656416,1.170500554541026,0,0,1,2,1.8728008872656416,1.170500554541026
3449,15,90,9,59,50,0,6059.312,10,1415.92,MORE,-1310,3950,2640,4,1,-9.0,-0.8436676146070391,9.0,0.0,-1.1994084632822717,0.9133699019425916,109,59,50,1,-1.0171964015730004,-0.8193503881787182,-1.170500554541026,0.8086476445903815,-0.5226918779946391,0.5226918779946391,-1.170500554541026,-0.8193503881787182,0,1,0,0,-0.8193503881787182,-1.170500554541026
3450,15,91,44,110,119,1,2162.938,90,1619.1470000000004,MORE,814,880,1694,1,2,9.0,0.8436676146070391,9.0,0.0,2.485174335920867,-0.6935798163488222,229,110,119,0,1.376206896245824,1.170500554541026,1.5216507209033339,-1.24144497549791,1.6246229387951745,1.6246229387951745,1.5216507209033339,1.170500554541026,1,0,1,2,1.5216507209033339,1.170500554541026
3451,15,92,2,52,50,1,2865.913,70,1225.415,MORE,-438,1386,948,1,2,-2.0,-0.18748169213489754,2.0,-1.222253017596762,1.564028636120082,-0.4036575762825692,102,52,50,1,-1.156811593945765,-1.092467184238291,-1.170500554541026,-1.24144497549791,0.35887993002829754,0.35887993002829754,-1.170500554541026,-1.092467184238291,1,0,1,0,-1.092467184238291,-1.170500554541026
3452,15,93,8,58,50,1,5206.444,30,1149.823,MORE,-546,2612,2066,3,2,-8.0,-0.7499267685395902,8.0,-0.17460757394239454,-0.2782627634814869,0.5616285156332279,108,58,50,1,-1.0371414290548238,-0.8583670733300858,-1.170500554541026,0.12528343789428434,0.24969443086949347,0.24969443086949347,-1.170500554541026,-0.8583670733300858,0,1,1,0,-0.8583670733300858,-1.170500554541026
3453,15,94,44,119,110,0,2973.926,80,1790.9979999999996,MORE,-1100,1896,796,2,1,-9.0,-0.8436676146070391,9.0,0.0,2.024601486020474,-0.35911065652542823,229,119,110,1,1.376206896245824,1.5216507209033339,1.170500554541026,-0.5580807688018129,-0.31038674074140893,0.31038674074140893,1.170500554541026,1.5216507209033339,1,0,0,2,1.5216507209033339,1.170500554541026
3454,15,95,34,74,80,1,2883.09,20,1300.527,MORE,-718,1766,1048,1,1,6.0,0.5624450764046927,6.0,-0.5238227218271837,-0.7388356133818792,-0.3965734064079391,154,74,80,0,-0.11967016489094122,-0.2341001109082052,0.0,-1.24144497549791,0.07580641369065735,0.07580641369065735,0.0,-0.2341001109082052,0,0,0,1,-0.2341001109082052,0.0
3455,15,96,24,86,80,1,4685.692,20,1421.919,MORE,-490,2894,2404,3,1,-6.0,-0.5624450764046927,6.0,-0.5238227218271837,-0.7388356133818792,0.34685901976355754,166,86,80,1,0.11967016489094122,0.2341001109082052,0.0,0.12528343789428434,0.30630913413702154,0.30630913413702154,0.0,0.2341001109082052,0,1,1,1,0.2341001109082052,0.0
3456,15,97,39,66,80,1,3041.92,50,1913.987,MORE,-566,1600,1034,1,2,14.0,1.3123718449442827,14.0,0.8730378697119728,0.6428829363192977,-0.3310684462177148,146,66,80,0,-0.2792303847455295,-0.5462335921191455,0.0,-1.24144497549791,0.22947489398823345,0.22947489398823345,0.0,-0.5462335921191455,1,0,1,1,-0.5462335921191455,0.0
3457,15,98,9,50,59,1,1800.668,60,1446.9879999999996,MORE,110,710,820,1,2,9.0,0.8436676146070391,9.0,0.0,1.10345578621969,-0.8429878748271487,109,50,59,0,-1.0171964015730004,-1.170500554541026,-0.8193503881787182,-1.24144497549791,0.912895240574822,0.912895240574822,-0.8193503881787182,-1.170500554541026,1,0,1,0,-1.170500554541026,-0.8193503881787182
3458,15,99,57,94,110,1,1763.589,80,1528.8239999999996,MORE,42,710,752,1,2,16.0,1.4998535370791803,16.0,1.222253017596762,2.024601486020474,-0.8582800640791372,204,94,110,0,0.8775812092002355,0.5462335921191455,1.170500554541026,-1.24144497549791,0.8441488151785379,0.8441488151785379,1.170500554541026,0.5462335921191455,1,0,1,2,1.170500554541026,0.5462335921191455
3459,15,100,60,110,87,0,2315.861,30,1025.151,MORE,-580,1418,838,2,1,-23.0,-2.1560394595513217,23.0,2.444506035193524,-0.2782627634814869,-0.6305110319430446,197,110,87,1,0.7379660168274708,1.170500554541026,0.27311679605957273,-0.5580807688018129,0.21532121817135144,0.21532121817135144,0.27311679605957273,1.170500554541026,0,0,1,2,1.170500554541026,0.27311679605957273
3460,15,101,33,75,80,0,2945.51,60,1461.3429999999996,MORE,-1126,1924,798,2,1,5.0,0.4687042303372438,5.0,-0.6984302957695783,1.10345578621969,-0.3708300354133297,155,75,80,0,-0.09972513740911768,-0.19508342575683765,0.0,-0.5580807688018129,-0.33667213868704693,0.33667213868704693,0.0,-0.19508342575683765,1,0,0,1,-0.19508342575683765,0.0
3461,15,102,15,50,45,0,2771.265,40,3979.682,MORE,-1676,2360,684,2,1,-5.0,-0.4687042303372438,5.0,-0.6984302957695783,0.1823100864189054,-0.4426924782033925,95,50,45,1,-1.2964267863185297,-1.170500554541026,-1.3655839802978638,-0.5580807688018129,-0.8927094029216973,0.8927094029216973,-1.3655839802978638,-1.170500554541026,0,0,0,0,-1.170500554541026,-1.3655839802978638
3462,15,103,59,89,110,1,4139.096,70,3268.832000000001,MORE,184,1694,1878,2,1,21.0,1.9685577674164243,21.0,2.0952908873087353,1.564028636120082,0.12143089396782683,199,89,110,0,0.7778560717911179,0.3511501663623078,1.170500554541026,-0.5580807688018129,0.987707527035484,0.987707527035484,1.170500554541026,0.3511501663623078,1,0,1,2,1.170500554541026,0.3511501663623078
3463,15,104,29,80,94,0,2622.048,50,1083.836,MORE,-960,1666,706,2,1,14.0,1.3123718449442827,14.0,0.8730378697119728,0.6428829363192977,-0.5042328272854596,174,80,94,0,0.2792303847455295,0.0,0.5462335921191455,-0.5580807688018129,-0.16884998257258882,0.16884998257258882,0.5462335921191455,0.0,1,0,0,1,0.5462335921191455,0.0
3464,15,105,55,110,98,0,3390.561,50,1417.146,MORE,-1470,2356,886,2,1,-12.0,-1.124890152809385,12.0,0.5238227218271837,0.6428829363192977,-0.1872812849403741,208,110,98,1,0.9573613191275298,1.170500554541026,0.7023003327246156,-0.5580807688018129,-0.6844481730447192,0.6844481730447192,0.7023003327246156,1.170500554541026,1,0,0,2,1.170500554541026,0.7023003327246156
3465,15,106,29,94,80,0,2481.136,10,975.505,MORE,-1492,2198,706,2,1,-14.0,-1.3123718449442827,14.0,0.8730378697119728,-1.1994084632822717,-0.5623480130206788,174,94,80,1,0.2792303847455295,0.5462335921191455,0.0,-0.5580807688018129,-0.7066896636141052,0.7066896636141052,0.0,0.5462335921191455,0,0,0,1,0.5462335921191455,0.0
3466,15,107,57,110,94,1,6369.557,30,1488.0320000000004,MORE,-1192,3536,2344,5,2,-16.0,-1.4998535370791803,16.0,1.222253017596762,-0.2782627634814869,1.0413217144101112,204,110,94,1,0.8775812092002355,1.170500554541026,0.5462335921191455,1.4920118512864788,-0.40339661039520497,0.40339661039520497,0.5462335921191455,1.170500554541026,0,1,0,2,1.170500554541026,0.5462335921191455
3467,15,108,39,80,66,1,2528.916,10,1406.164,MORE,-1466,2400,934,1,1,-14.0,-1.3123718449442827,14.0,0.8730378697119728,-1.1994084632822717,-0.5426424977031133,146,80,66,1,-0.2792303847455295,0.0,-0.5462335921191455,-1.24144497549791,-0.6804042656684672,0.6804042656684672,-0.5462335921191455,0.0,0,0,0,1,0.0,-0.5462335921191455
3468,15,109,4,50,54,1,3756.866,10,1061.472,MORE,-912,2362,1450,2,1,4.0,0.3749633842697951,4.0,-0.8730378697119728,-1.1994084632822717,-0.03620910435433795,104,50,54,0,-1.116921538982118,-1.170500554541026,-1.0144338139355558,-0.5580807688018129,-0.12032309405756479,0.12032309405756479,-1.0144338139355558,-1.170500554541026,0,0,0,0,-1.170500554541026,-1.0144338139355558
3469,15,110,55,98,110,0,4616.184,40,1001.294,MORE,-2068,3206,1138,2,1,12.0,1.124890152809385,12.0,0.5238227218271837,0.1823100864189054,0.31819240279634664,208,98,110,0,0.9573613191275298,0.7023003327246156,1.170500554541026,-0.5580807688018129,-1.2890123257943937,1.2890123257943937,1.170500554541026,0.7023003327246156,0,0,0,2,1.170500554541026,0.7023003327246156
3470,15,111,2,50,52,1,1577.296,20,1392.226,MORE,-810,1696,886,1,1,2.0,0.18748169213489754,2.0,-1.222253017596762,-0.7388356133818792,-0.9351113651476852,102,50,52,0,-1.156811593945765,-1.170500554541026,-1.092467184238291,-1.24144497549791,-0.017203455963138714,0.017203455963138714,-1.092467184238291,-1.170500554541026,0,0,0,0,-1.170500554541026,-1.092467184238291
3471,15,112,59,110,89,1,1761.881,80,1000.045,MORE,300,632,932,1,2,-21.0,-1.9685577674164243,21.0,2.0952908873087353,2.024601486020474,-0.8589844805747923,199,110,89,1,0.7778560717911179,1.170500554541026,0.3511501663623078,-1.24144497549791,1.104980840946792,1.104980840946792,0.3511501663623078,1.170500554541026,1,0,1,2,1.170500554541026,0.3511501663623078
3472,15,113,60,87,110,1,3794.42,30,1840.005,MORE,-216,1980,1764,3,2,23.0,2.1560394595513217,23.0,2.444506035193524,-0.2782627634814869,-0.0207210147303142,197,87,110,0,0.7379660168274708,0.27311679605957273,1.170500554541026,0.12528343789428434,0.5833167894102838,0.5833167894102838,1.170500554541026,0.27311679605957273,0,1,1,2,1.170500554541026,0.27311679605957273
3473,15,114,52,110,105,1,2456.939,30,1577.961,MORE,126,1020,1146,1,2,-5.0,-0.4687042303372438,5.0,-0.6984302957695783,-0.2782627634814869,-0.5723273841830718,215,110,105,1,1.0969765115002945,1.170500554541026,0.9754171287841883,-1.24144497549791,0.92907087007983,0.92907087007983,0.9754171287841883,1.170500554541026,0,0,1,2,1.170500554541026,0.9754171287841883
3474,15,115,30,80,96,1,3026.1240000000007,20,858.459,MORE,-128,1514,1386,3,2,16.0,1.4998535370791803,16.0,1.222253017596762,-0.7388356133818792,-0.33758306153701684,176,80,96,0,0.3191204397091766,0.0,0.6242669624218805,0.12528343789428434,0.6722827516878278,0.6722827516878278,0.6242669624218805,0.0,0,1,1,1,0.6242669624218805,0.0
3475,15,116,24,80,86,1,2286.223,80,1147.499,MORE,224,816,1040,1,2,6.0,0.5624450764046927,6.0,-0.5238227218271837,2.024601486020474,-0.6427343903143715,166,80,86,0,0.11967016489094122,0.0,0.2341001109082052,-1.24144497549791,1.028146600798004,1.028146600798004,0.2341001109082052,0.0,1,0,1,1,0.2341001109082052,0.0
3476,15,117,5,50,55,1,7993.306,20,2178.183,MORE,2512,2176,4688,4,1,5.0,0.4687042303372438,5.0,-0.6984302957695783,-0.7388356133818792,1.7109912579718858,105,50,55,0,-1.0969765115002945,-1.170500554541026,-0.9754171287841883,0.8086476445903815,3.34126162001415,3.34126162001415,-0.9754171287841883,-1.170500554541026,0,1,1,0,-1.170500554541026,-0.9754171287841883
3477,15,118,34,80,74,1,5194.652,20,1771.9129999999998,MORE,-188,2636,2448,3,1,-6.0,-0.5624450764046927,6.0,-0.5238227218271837,-0.7388356133818792,0.5567652373447235,154,80,74,1,-0.11967016489094122,0.0,-0.2341001109082052,0.12528343789428434,0.6116241410440477,0.6116241410440477,-0.2341001109082052,0.0,0,1,1,1,0.0,-0.2341001109082052
3478,15,119,15,45,50,1,2514.565,70,1196.401,MORE,136,1010,1146,3,2,5.0,0.4687042303372438,5.0,-0.6984302957695783,1.564028636120082,-0.5485611634695927,95,45,50,0,-1.2964267863185297,-1.3655839802978638,-1.170500554541026,0.12528343789428434,0.93918063852046,0.93918063852046,-1.170500554541026,-1.3655839802978638,1,0,1,0,-1.3655839802978638,-1.170500554541026
3479,15,120,37,69,80,1,2769.315,50,1418.169,MORE,-956,1774,818,3,2,11.0,1.0311493067419364,11.0,0.34921514788478913,0.6428829363192977,-0.44349670078332654,149,69,80,0,-0.21939530230005888,-0.4291835366650429,0.0,0.12528343789428434,-0.16480607519633683,0.16480607519633683,0.0,-0.4291835366650429,1,0,0,1,-0.4291835366650429,0.0
3480,15,121,48,128,110,1,2718.708,10,970.494,LESS,-130,1686,1556,3,1,-18.0,-1.6873352292140782,18.0,1.571468165481551,-1.1994084632822717,-0.4643681326308785,238,128,110,0,1.5557121435822359,1.8728008872656416,1.170500554541026,0.12528343789428434,0.6702607979997017,0.6702607979997017,1.170500554541026,1.8728008872656416,0,1,1,2,1.8728008872656416,1.170500554541026
3481,15,122,8,50,58,0,1756.919,70,1854.072,LESS,-330,952,622,2,1,8.0,0.7499267685395902,8.0,-0.17460757394239454,1.564028636120082,-0.8610309177243476,108,50,58,1,-1.0371414290548238,-1.170500554541026,-0.8583670733300858,-0.5580807688018129,0.46806542918710164,0.46806542918710164,-0.8583670733300858,-1.170500554541026,1,0,1,0,-1.170500554541026,-0.8583670733300858
3482,15,123,4,54,50,0,1910.429,30,2294.681,LESS,-1426,1990,564,2,1,-4.0,-0.3749633842697951,4.0,-0.8730378697119728,-0.2782627634814869,-0.7977200417009179,104,54,50,0,-1.116921538982118,-1.0144338139355558,-1.170500554541026,-0.5580807688018129,-0.6399651919059471,0.6399651919059471,-1.170500554541026,-1.0144338139355558,1,0,0,0,-1.0144338139355558,-1.170500554541026
3483,15,124,37,80,69,0,1606.328,0,1568.33,LESS,-1600,2046,446,2,1,-11.0,-1.0311493067419364,11.0,0.34921514788478913,-1.6599813131826635,-0.9231379344088914,149,80,69,0,-0.21939530230005888,0.0,-0.4291835366650429,-0.5580807688018129,-0.8158751627729093,0.8158751627729093,-0.4291835366650429,0.0,0,0,0,1,0.0,-0.4291835366650429
3484,15,125,52,105,110,1,4621.395,10,1619.626,LESS,-1048,3080,2032,5,1,5.0,0.4687042303372438,5.0,-0.6984302957695783,-1.1994084632822717,0.32034153298303225,215,105,110,1,1.0969765115002945,0.9754171287841883,1.170500554541026,1.4920118512864788,-0.25781594485013287,0.25781594485013287,1.170500554541026,0.9754171287841883,0,1,0,2,1.170500554541026,0.9754171287841883
3485,15,126,5,55,50,1,6781.861,10,1948.877,LESS,-810,3884,3074,5,1,-5.0,-0.4687042303372438,5.0,-0.6984302957695783,-1.1994084632822717,1.21136488702404,105,55,50,0,-1.0969765115002945,-0.9754171287841883,-1.170500554541026,1.4920118512864788,-0.017203455963138714,0.017203455963138714,-1.170500554541026,-0.9754171287841883,0,1,1,0,-0.9754171287841883,-1.170500554541026
3486,15,127,30,96,80,0,4229.285,10,1864.734,LESS,-1244,3052,1808,4,1,-16.0,-1.4998535370791803,16.0,1.222253017596762,-1.1994084632822717,0.15862680692253414,176,96,80,0,0.3191204397091766,0.6242669624218805,0.0,0.8086476445903815,-0.455967406286481,0.455967406286481,0.0,0.6242669624218805,0,1,0,1,0.6242669624218805,0.0
3487,15,128,33,80,75,1,3837.949,20,1306.814,LESS,88,1816,1904,3,1,-5.0,-0.4687042303372438,5.0,-0.6984302957695783,-0.7388356133818792,-0.002768704637005153,155,80,75,0,-0.09972513740911768,0.0,-0.19508342575683765,0.12528343789428434,0.8906537500054359,0.8906537500054359,-0.19508342575683765,0.0,0,1,1,1,0.0,-0.19508342575683765
3488,15,129,48,110,128,0,1884.373,60,1359.03,LESS,-622,1146,524,2,1,18.0,1.6873352292140782,18.0,1.571468165481551,1.10345578621969,-0.8084661050561813,238,110,128,1,1.5557121435822359,1.170500554541026,1.8728008872656416,-0.5580807688018129,0.17286019072070544,0.17286019072070544,1.8728008872656416,1.170500554541026,1,0,1,2,1.8728008872656416,1.170500554541026
3489,15,130,9,59,50,1,3025.3720000000008,10,843.8639999999998,LESS,42,1520,1562,3,1,-9.0,-0.8436676146070391,9.0,0.0,-1.1994084632822717,-0.3378932027575863,109,59,50,0,-1.0171964015730004,-0.8193503881787182,-1.170500554541026,0.12528343789428434,0.8441488151785379,0.8441488151785379,-1.170500554541026,-0.8193503881787182,0,1,1,0,-0.8193503881787182,-1.170500554541026
3490,15,131,44,110,119,0,1598.082,40,987.718,LESS,-660,1078,418,2,1,9.0,0.8436676146070391,9.0,0.0,0.1823100864189054,-0.9265387648674231,229,110,119,1,1.376206896245824,1.170500554541026,1.5216507209033339,-0.5580807688018129,0.1344430706463114,0.1344430706463114,1.5216507209033339,1.170500554541026,1,0,1,2,1.5216507209033339,1.170500554541026
3491,15,132,2,52,50,1,4371.913,20,1458.082,LESS,68,1888,1956,5,2,-2.0,-0.18748169213489754,2.0,-1.222253017596762,-0.7388356133818792,0.21744970852809545,102,52,50,0,-1.156811593945765,-1.092467184238291,-1.170500554541026,1.4920118512864788,0.8704342131241759,0.8704342131241759,-1.170500554541026,-1.092467184238291,0,1,1,0,-1.092467184238291,-1.170500554541026
3492,15,133,8,58,50,1,2226.644,20,2023.209,LESS,-760,1884,1124,1,1,-8.0,-0.7499267685395902,8.0,-0.17460757394239454,-0.7388356133818792,-0.6673060708732923,108,58,50,0,-1.0371414290548238,-0.8583670733300858,-1.170500554541026,-1.24144497549791,0.03334538624001132,0.03334538624001132,-1.170500554541026,-0.8583670733300858,0,0,1,0,-0.8583670733300858,-1.170500554541026
3493,15,134,44,119,110,1,2362.153,10,1622.187,LESS,-450,1652,1202,3,1,-9.0,-0.8436676146070391,9.0,0.0,-1.1994084632822717,-0.6114192003172443,229,119,110,0,1.376206896245824,1.5216507209033339,1.170500554541026,0.12528343789428434,0.3467482078995415,0.3467482078995415,1.170500554541026,1.5216507209033339,0,1,1,2,1.5216507209033339,1.170500554541026
3494,15,135,34,74,80,0,3672.313,10,2710.7290000000007,LESS,-752,2228,1476,4,1,6.0,0.5624450764046927,6.0,-0.5238227218271837,-1.1994084632822717,-0.07108060784211755,154,74,80,1,-0.11967016489094122,-0.2341001109082052,0.0,0.8086476445903815,0.04143320099251533,0.04143320099251533,0.0,-0.2341001109082052,0,1,1,1,-0.2341001109082052,0.0
3495,15,136,24,86,80,0,3397.7140000000004,40,1373.921,LESS,-900,2094,1194,4,1,-6.0,-0.5624450764046927,6.0,-0.5238227218271837,0.1823100864189054,-0.18433123154844128,166,86,80,0,0.11967016489094122,0.2341001109082052,0.0,0.8086476445903815,-0.10819137192880877,0.10819137192880877,0.0,0.2341001109082052,1,1,0,1,0.2341001109082052,0.0
3496,15,137,39,66,80,0,2572.407,10,747.6460000000002,LESS,-1804,2390,586,2,1,14.0,1.3123718449442827,14.0,0.8730378697119728,-1.1994084632822717,-0.5247058596395671,146,66,80,1,-0.2792303847455295,-0.5462335921191455,0.0,-0.5580807688018129,-1.0221144389617614,1.0221144389617614,0.0,-0.5462335921191455,0,0,0,1,-0.5462335921191455,0.0
3497,15,138,9,50,59,0,1822.967,80,1336.5120000000004,LESS,-336,1036,700,2,2,9.0,0.8436676146070391,9.0,0.0,2.024601486020474,-0.8337912803092249,109,50,59,1,-1.0171964015730004,-1.170500554541026,-0.8193503881787182,-0.5580807688018129,0.46199956812272364,0.46199956812272364,-0.8193503881787182,-1.170500554541026,1,0,1,0,-1.170500554541026,-0.8193503881787182
3498,15,139,57,94,110,0,2926.668,20,1902.098,LESS,-1886,2422,536,2,1,16.0,1.4998535370791803,16.0,1.222253017596762,-0.7388356133818792,-0.3786008876446728,204,94,110,1,0.8775812092002355,0.5462335921191455,1.170500554541026,-0.5580807688018129,-1.1050145401749274,1.1050145401749274,1.170500554541026,0.5462335921191455,0,0,0,2,1.170500554541026,0.5462335921191455
3499,15,140,60,110,87,1,3288.899000000001,20,1123.347,LESS,218,1372,1590,3,1,-23.0,-2.1560394595513217,23.0,2.444506035193524,-0.7388356133818792,-0.2292089136179448,197,110,87,0,0.7379660168274708,1.170500554541026,0.27311679605957273,0.12528343789428434,1.022080739733626,1.022080739733626,0.27311679605957273,1.170500554541026,0,1,1,2,1.170500554541026,0.27311679605957273
3500,15,141,33,75,80,0,1954.916,80,1535.434,LESS,-608,1192,584,2,1,5.0,0.4687042303372438,5.0,-0.6984302957695783,2.024601486020474,-0.7793726314888515,155,75,80,1,-0.09972513740911768,-0.19508342575683765,0.0,-0.5580807688018129,0.18701386653758742,0.18701386653758742,0.0,-0.19508342575683765,1,0,1,1,-0.19508342575683765,0.0
3501,15,142,15,50,45,1,3543.855,30,910.905,LESS,372,1228,1600,3,2,-5.0,-0.4687042303372438,5.0,-0.6984302957695783,-0.2782627634814869,-0.124059492033491,95,50,45,0,-1.2964267863185297,-1.170500554541026,-1.3655839802978638,0.12528343789428434,1.1777711737193282,1.1777711737193282,-1.3655839802978638,-1.170500554541026,1,1,1,0,-1.170500554541026,-1.3655839802978638
3502,15,143,59,89,110,0,2000.4,30,1164.033,LESS,-812,1354,542,2,1,21.0,1.9685577674164243,21.0,2.0952908873087353,-0.2782627634814869,-0.7606140367064291,199,89,110,1,0.7778560717911179,0.3511501663623078,1.170500554541026,-0.5580807688018129,-0.019225409651264715,0.019225409651264715,1.170500554541026,0.3511501663623078,1,0,1,2,1.170500554541026,0.3511501663623078
3503,15,144,29,80,94,0,1725.1470000000004,30,1687.694,LESS,-478,964,486,2,1,14.0,1.3123718449442827,14.0,0.8730378697119728,-0.2782627634814869,-0.8741343842934076,174,80,94,1,0.2792303847455295,0.0,0.5462335921191455,-0.5580807688018129,0.3184408562657775,0.3184408562657775,0.5462335921191455,0.0,1,0,1,1,0.5462335921191455,0.0
3504,15,145,55,110,98,1,2511.125,50,1266.927,LESS,178,1000,1178,3,2,-12.0,-1.124890152809385,12.0,0.5238227218271837,0.6428829363192977,-0.5499798945849637,208,110,98,0,0.9573613191275298,1.170500554541026,0.7023003327246156,0.12528343789428434,0.981641665971106,0.981641665971106,0.7023003327246156,1.170500554541026,1,1,1,2,1.170500554541026,0.7023003327246156
3505,15,146,29,94,80,1,2649.541,50,1243.713,LESS,-32,1160,1128,3,2,-14.0,-1.3123718449442827,14.0,0.8730378697119728,0.6428829363192977,-0.49289411375206,174,94,80,0,0.2792303847455295,0.5462335921191455,0.0,0.12528343789428434,0.7693365287178758,0.7693365287178758,0.0,0.5462335921191455,1,1,1,1,0.5462335921191455,0.0
3506,15,147,57,110,94,1,2566.174,0,940.815,LESS,-854,1904,1050,3,1,-16.0,-1.4998535370791803,16.0,1.222253017596762,-1.6599813131826635,-0.5272764849425053,204,110,94,0,0.8775812092002355,1.170500554541026,0.5462335921191455,0.12528343789428434,-0.06168643710191075,0.06168643710191075,0.5462335921191455,1.170500554541026,0,1,1,2,1.170500554541026,0.5462335921191455
3507,15,148,39,80,66,1,4575.964,30,976.431,LESS,-304,2176,1872,5,2,-14.0,-1.3123718449442827,14.0,0.8730378697119728,-0.2782627634814869,0.30160479655791034,146,80,66,0,-0.2792303847455295,0.0,-0.5462335921191455,1.4920118512864788,0.49435082713273965,0.49435082713273965,-0.5462335921191455,0.0,1,1,1,1,0.0,-0.5462335921191455
3508,15,149,4,50,54,0,5647.967,20,2019.155,LESS,-1374,3232,1858,4,1,4.0,0.3749633842697951,4.0,-0.8730378697119728,-0.7388356133818792,0.7437222418692562,104,50,54,1,-1.116921538982118,-1.170500554541026,-1.0144338139355558,0.8086476445903815,-0.5873943960146711,0.5873943960146711,-1.0144338139355558,-1.170500554541026,0,1,0,0,-1.170500554541026,-1.0144338139355558
3509,15,150,55,98,110,0,3817.8,30,813.954,LESS,-2186,2796,610,2,1,12.0,1.124890152809385,12.0,0.5238227218271837,-0.2782627634814869,-0.011078592207821895,208,98,110,1,0.9573613191275298,0.7023003327246156,1.170500554541026,-0.5580807688018129,-1.4083075933938278,1.4083075933938278,1.170500554541026,0.7023003327246156,1,0,0,2,1.170500554541026,0.7023003327246156
3510,15,151,2,50,52,0,1913.333,40,1198.711,LESS,-374,1004,630,2,1,2.0,0.18748169213489754,2.0,-1.222253017596762,0.1823100864189054,-0.7965223686895698,102,50,52,1,-1.156811593945765,-1.170500554541026,-1.092467184238291,-0.5580807688018129,0.4235824480483296,0.4235824480483296,-1.092467184238291,-1.170500554541026,1,0,1,0,-1.170500554541026,-1.092467184238291
3511,15,152,59,110,89,1,2582.84,20,1205.908,LESS,-40,1332,1292,3,1,-21.0,-1.9685577674164243,21.0,2.0952908873087353,-0.7388356133818792,-0.5204030626260016,199,110,89,0,0.7778560717911179,1.170500554541026,0.3511501663623078,0.12528343789428434,0.7612487139653719,0.7612487139653719,0.3511501663623078,1.170500554541026,0,1,1,2,1.170500554541026,0.3511501663623078
3512,15,153,60,87,110,0,2610.201,30,2349.741,LESS,-1100,1916,816,2,1,23.0,2.1560394595513217,23.0,2.444506035193524,-0.2782627634814869,-0.5091187887749362,197,87,110,1,0.7379660168274708,0.27311679605957273,1.170500554541026,-0.5580807688018129,-0.31038674074140893,0.31038674074140893,1.170500554541026,0.27311679605957273,1,0,0,2,1.170500554541026,0.27311679605957273
3513,15,154,52,110,105,1,1888.47,30,878.89,LESS,500,554,1054,1,2,-5.0,-0.4687042303372438,5.0,-0.6984302957695783,-0.2782627634814869,-0.806776412794648,215,110,105,0,1.0969765115002945,1.170500554541026,0.9754171287841883,-1.24144497549791,1.3071762097593922,1.3071762097593922,0.9754171287841883,1.170500554541026,1,0,1,2,1.170500554541026,0.9754171287841883
3514,15,155,30,80,96,0,1708.715,30,1101.262,LESS,-1184,1656,472,2,1,16.0,1.4998535370791803,16.0,1.222253017596762,-0.2782627634814869,-0.8809112999003195,176,80,96,1,0.3191204397091766,0.0,0.6242669624218805,-0.5580807688018129,-0.395308795642701,0.395308795642701,0.6242669624218805,0.0,1,0,0,1,0.6242669624218805,0.0
3515,15,156,24,80,86,0,2612.92,30,1092.713,LESS,-1516,2162,646,2,1,6.0,0.5624450764046927,6.0,-0.5238227218271837,-0.2782627634814869,-0.5079974138032228,166,80,86,1,0.11967016489094122,0.0,0.2341001109082052,-0.5580807688018129,-0.7309531078716173,0.7309531078716173,0.2341001109082052,0.0,1,0,0,1,0.2341001109082052,0.0
3516,15,157,5,50,55,1,2526.137,40,1126.655,LESS,-106,1154,1048,3,2,5.0,0.4687042303372438,5.0,-0.6984302957695783,0.1823100864189054,-0.5437886179849785,105,50,55,1,-1.0969765115002945,-1.170500554541026,-0.9754171287841883,0.12528343789428434,0.6945242422572138,0.6945242422572138,-0.9754171287841883,-1.170500554541026,1,1,1,0,-1.170500554541026,-0.9754171287841883
3517,15,158,34,80,74,1,2436.881,30,1097.605,LESS,-238,1246,1008,1,2,-6.0,-0.5624450764046927,6.0,-0.5238227218271837,-0.2782627634814869,-0.5805997413668249,154,80,74,0,-0.11967016489094122,0.0,-0.2341001109082052,-1.24144497549791,0.5610752988408977,0.5610752988408977,-0.2341001109082052,0.0,1,0,1,1,0.0,-0.2341001109082052
3518,15,159,15,45,50,0,2371.353,60,1171.803,LESS,-754,1376,622,2,1,5.0,0.4687042303372438,5.0,-0.6984302957695783,1.10345578621969,-0.6076249194272985,95,45,50,1,-1.2964267863185297,-1.3655839802978638,-1.170500554541026,-0.5580807688018129,0.03941124730438933,0.03941124730438933,-1.170500554541026,-1.3655839802978638,1,0,1,0,-1.3655839802978638,-1.170500554541026
3519,15,160,37,69,80,0,1880.462,40,1193.452,LESS,-870,1326,456,2,1,11.0,1.0311493067419364,11.0,0.34921514788478913,0.1823100864189054,-0.8100790868562441,149,69,80,1,-0.21939530230005888,-0.4291835366650429,0.0,-0.5580807688018129,-0.07786206660691876,0.07786206660691876,0.0,-0.4291835366650429,1,0,0,1,-0.4291835366650429,0.0
3520,15,161,3,50,53,0,2780.69,10,643.1659999999998,MORE,-1118,1970,852,4,1,3.0,0.28122253820234633,3.0,-1.0476454436543674,-1.1994084632822717,-0.4388054024003775,103,50,53,0,-1.1368665664639415,-1.170500554541026,-1.0534504990869233,0.8086476445903815,-0.32858432393454295,0.32858432393454295,-1.0534504990869233,-1.170500554541026,0,1,0,0,-1.170500554541026,-1.0534504990869233
3521,15,162,20,50,40,0,1750.4589999999996,60,1901.483,MORE,-362,1300,938,2,1,-10.0,-0.9374084606744876,10.0,0.17460757394239454,1.10345578621969,-0.8636951627840271,90,50,40,1,-1.3961519237276474,-1.170500554541026,-1.5606674060547012,-0.5580807688018129,0.43571417017708564,0.43571417017708564,-1.5606674060547012,-1.170500554541026,1,0,1,0,-1.170500554541026,-1.5606674060547012
3522,15,163,25,80,88,1,1840.353,90,1946.307,MORE,1826,636,2462,1,2,8.0,0.7499267685395902,8.0,-0.17460757394239454,2.485174335920867,-0.8266209142708995,168,80,88,0,0.1595602198545883,0.0,0.31213348121094026,-1.24144497549791,2.6477315049869317,2.6477315049869317,0.31213348121094026,0.0,1,0,1,1,0.31213348121094026,0.0
3523,15,164,42,115,110,0,3000.427,70,1977.12,MORE,-1206,2018,812,2,1,-5.0,-0.4687042303372438,5.0,-0.6984302957695783,1.564028636120082,-0.34818106545320543,225,115,110,1,1.2964267863185297,1.3655839802978638,1.170500554541026,-0.5580807688018129,-0.417550286212087,0.417550286212087,1.170500554541026,1.3655839802978638,1,0,0,2,1.3655839802978638,1.170500554541026
3524,15,165,53,103,110,1,4711.282,30,843.7769999999998,MORE,-820,2548,1728,3,2,7.0,0.6561859224721414,7.0,-0.34921514788478913,-0.2782627634814869,0.3574128945433085,213,103,110,0,1.0570864565366473,0.8973837584814532,1.170500554541026,0.12528343789428434,-0.02731322440376872,0.02731322440376872,1.170500554541026,0.8973837584814532,0,1,0,2,1.170500554541026,0.8973837584814532
3525,15,166,26,90,80,0,6119.472,40,1156.499,MORE,-916,3166,2250,6,1,-10.0,-0.9374084606744876,10.0,0.17460757394239454,0.1823100864189054,0.938181199588149,170,90,80,1,0.19945027481823535,0.3901668515136753,0.0,2.175376057982576,-0.12436700143381679,0.12436700143381679,0.0,0.3901668515136753,1,1,0,1,0.3901668515136753,0.0
3526,15,167,35,80,72,1,6086.816999999999,40,1196.823,MORE,602,1670,2272,3,2,-8.0,-0.7499267685395902,8.0,-0.17460757394239454,0.1823100864189054,0.9247135645380212,152,80,72,1,-0.1595602198545883,0.0,-0.31213348121094026,0.12528343789428434,1.4102958478538183,1.4102958478538183,-0.31213348121094026,0.0,1,1,1,1,0.0,-0.31213348121094026
3527,15,168,28,93,80,0,2073.7,60,1188.879,MORE,-574,1258,684,2,1,-13.0,-1.218630998876834,13.0,0.6984302957695783,1.10345578621969,-0.7303835161376232,173,93,80,1,0.25928535726370594,0.5072169069677779,0.0,-0.5580807688018129,0.22138707923572945,0.22138707923572945,0.0,0.5072169069677779,1,0,1,1,0.5072169069677779,0.0
3528,15,169,26,80,90,1,1919.815,90,1106.355,MORE,444,976,1420,1,2,10.0,0.9374084606744876,10.0,0.17460757394239454,2.485174335920867,-0.7938490503495017,170,80,90,0,0.19945027481823535,0.0,0.3901668515136753,-1.24144497549791,1.2505615064918643,1.2505615064918643,0.3901668515136753,0.0,1,0,1,1,0.3901668515136753,0.0
3529,15,170,25,88,80,0,1859.665,40,1074.775,MORE,-740,1220,480,2,1,-8.0,-0.7499267685395902,8.0,-0.17460757394239454,0.1823100864189054,-0.8186562237767006,168,88,80,1,0.1595602198545883,0.31213348121094026,0.0,-0.5580807688018129,0.05356492312127134,0.05356492312127134,0.0,0.31213348121094026,1,0,0,1,0.31213348121094026,0.0
3530,15,171,36,80,70,1,3829.803,20,1845.452,MORE,-632,2232,1600,3,1,-10.0,-0.9374084606744876,10.0,0.17460757394239454,-0.7388356133818792,-0.006128292911950565,150,80,70,1,-0.19945027481823535,0.0,-0.3901668515136753,0.12528343789428434,0.1627504222800754,0.1627504222800754,-0.3901668515136753,0.0,0,1,0,1,0.0,-0.3901668515136753
3531,15,172,28,80,93,1,2262.893,70,1016.848,MORE,442,744,1186,3,2,13.0,1.218630998876834,13.0,0.6984302957695783,1.564028636120082,-0.6523561917450705,173,80,93,0,0.25928535726370594,0.0,0.5072169069677779,0.12528343789428434,1.2485395528037382,1.2485395528037382,0.5072169069677779,0.0,1,1,1,1,0.5072169069677779,0.0
3532,15,173,21,82,80,0,2561.397,80,879.95,MORE,-722,1498,776,2,1,-2.0,-0.18748169213489754,2.0,-1.222253017596762,2.024601486020474,-0.5292466240524261,162,82,80,1,0.03989005496364707,0.07803337030273506,0.0,-0.5580807688018129,0.07176250631440535,0.07176250631440535,0.0,0.07803337030273506,1,0,0,1,0.07803337030273506,0.0
3533,15,174,19,50,41,0,2966.97,20,1612.9129999999998,MORE,-488,1716,1228,4,1,-9.0,-0.8436676146070391,9.0,0.0,-0.7388356133818792,-0.3619794628156959,91,50,41,1,-1.376206896245824,-1.170500554541026,-1.5216507209033339,0.8086476445903815,0.3083310878251475,0.3083310878251475,-1.5216507209033339,-1.170500554541026,0,1,1,0,-1.170500554541026,-1.5216507209033339
3534,15,175,56,96,110,1,1997.931,60,1218.879,MORE,-82,912,830,1,2,14.0,1.3123718449442827,14.0,0.8730378697119728,1.10345578621969,-0.7616323062191763,206,96,110,0,0.9174712641638826,0.6242669624218805,1.170500554541026,-1.24144497549791,0.7187876865147258,0.7187876865147258,1.170500554541026,0.6242669624218805,1,0,1,2,1.170500554541026,0.6242669624218805
3535,15,176,23,80,85,1,2338.831,70,1062.985,MORE,-542,1352,810,1,2,5.0,0.4687042303372438,5.0,-0.6984302957695783,1.564028636120082,-0.6210377023732563,165,80,85,0,0.09972513740911768,0.0,0.19508342575683765,-1.24144497549791,0.2537383382457455,0.2537383382457455,0.19508342575683765,0.0,1,0,1,1,0.19508342575683765,0.0
3536,15,177,10,60,50,0,5661.196,60,1594.703,MORE,-1836,3620,1784,4,1,-10.0,-0.9374084606744876,10.0,0.17460757394239454,1.10345578621969,0.7491781703358966,110,60,50,1,-0.9972513740911768,-0.7803337030273506,-1.170500554541026,0.8086476445903815,-1.0544656979717775,1.0544656979717775,-1.170500554541026,-0.7803337030273506,1,1,0,0,-0.7803337030273506,-1.170500554541026
3537,15,178,19,41,50,1,2959.739,30,705.434,MORE,-100,1344,1244,2,2,9.0,0.8436676146070391,9.0,0.0,-0.2782627634814869,-0.3649616851108258,91,41,50,0,-1.376206896245824,-1.5216507209033339,-1.170500554541026,-0.5580807688018129,0.7005901033215918,0.7005901033215918,-1.170500554541026,-1.5216507209033339,0,0,1,0,-1.5216507209033339,-1.170500554541026
3538,15,179,56,110,96,0,2422.732,70,1460.987,MORE,-914,1596,682,2,1,-14.0,-1.3123718449442827,14.0,0.8730378697119728,1.564028636120082,-0.5864350979224598,206,110,96,1,0.9174712641638826,1.170500554541026,0.6242669624218805,-0.5580807688018129,-0.12234504774569079,0.12234504774569079,0.6242669624218805,1.170500554541026,1,0,0,2,1.170500554541026,0.6242669624218805
3539,15,180,35,72,80,1,3826.993,50,1292.109,MORE,-770,2130,1360,3,2,8.0,0.7499267685395902,8.0,-0.17460757394239454,0.6428829363192977,-0.007287198270727413,152,72,80,0,-0.1595602198545883,-0.31213348121094026,0.0,0.12528343789428434,0.023235617799381315,0.023235617799381315,0.0,-0.31213348121094026,1,1,0,1,-0.31213348121094026,0.0
3540,15,181,11,49,50,1,1758.854,60,728.36,MORE,308,674,982,1,2,1.0,0.09374084606744876,1.0,-1.3968605915391563,1.10345578621969,-0.8602328814719515,99,49,50,0,-1.2166466763912356,-1.2095172396923934,-1.170500554541026,-1.24144497549791,1.1130686556992961,1.1130686556992961,-1.170500554541026,-1.2095172396923934,1,0,1,0,-1.2095172396923934,-1.170500554541026
3541,15,182,17,43,50,1,3028.583,30,971.556,MORE,-340,1522,1182,3,2,7.0,0.6561859224721414,7.0,-0.34921514788478913,-0.2782627634814869,-0.3365689162426284,93,43,50,0,-1.3363168412821769,-1.4436173506005987,-1.170500554541026,0.12528343789428434,0.45795566074647165,0.45795566074647165,-1.170500554541026,-1.4436173506005987,0,1,1,0,-1.4436173506005987,-1.170500554541026
3542,15,183,1,51,50,1,2697.3740000000007,50,991.139,MORE,-462,1414,952,1,2,-1.0,-0.09374084606744876,1.0,-1.3968605915391563,0.6428829363192977,-0.4731667400771935,101,51,50,1,-1.1767566214275886,-1.1314838693896585,-1.170500554541026,-1.24144497549791,0.33461648577078557,0.33461648577078557,-1.170500554541026,-1.1314838693896585,1,0,1,0,-1.1314838693896585,-1.170500554541026
3543,15,184,41,112,110,1,4102.764,30,1237.243,MORE,108,2052,2160,3,1,-2.0,-0.18748169213489754,2.0,-1.222253017596762,-0.2782627634814869,0.10644678382722872,222,112,110,1,1.2365917038730592,1.248533924843761,1.170500554541026,0.12528343789428434,0.910873286886696,0.910873286886696,1.170500554541026,1.248533924843761,0,1,1,2,1.248533924843761,1.170500554541026
3544,15,185,20,40,50,1,1756.352,40,925.087,MORE,-126,960,834,1,1,10.0,0.9374084606744876,10.0,0.17460757394239454,0.1823100864189054,-0.8612647609052823,90,40,50,0,-1.3961519237276474,-1.5606674060547012,-1.170500554541026,-1.24144497549791,0.6743047053759538,0.6743047053759538,-1.170500554541026,-1.5606674060547012,1,0,1,0,-1.5606674060547012,-1.170500554541026
3545,15,186,1,50,51,1,2397.228,40,1185.806,MORE,-492,1364,872,1,2,1.0,0.09374084606744876,1.0,-1.3968605915391563,0.1823100864189054,-0.5969535044243264,101,50,51,0,-1.1767566214275886,-1.170500554541026,-1.1314838693896585,-1.24144497549791,0.3042871804488955,0.3042871804488955,-1.1314838693896585,-1.170500554541026,1,0,1,0,-1.170500554541026,-1.1314838693896585
3546,15,187,23,85,80,0,2173.729,60,1624.302,MORE,-998,1610,612,2,1,-5.0,-0.4687042303372438,5.0,-0.6984302957695783,1.10345578621969,-0.6891293723180176,165,85,80,1,0.09972513740911768,0.19508342575683765,0.0,-0.5580807688018129,-0.20726710264698286,0.20726710264698286,0.0,0.19508342575683765,1,0,0,1,0.19508342575683765,0.0
3547,15,188,11,50,49,0,3967.911,10,2268.212,MORE,-1936,3436,1500,4,1,-1.0,-0.09374084606744876,1.0,-1.3968605915391563,-1.1994084632822717,0.050830461995507205,99,50,49,1,-1.2166466763912356,-1.170500554541026,-1.2095172396923934,0.8086476445903815,-1.1555633823780775,1.1555633823780775,-1.2095172396923934,-1.170500554541026,0,1,0,0,-1.170500554541026,-1.2095172396923934
3548,15,189,17,50,43,0,3741.914,30,1515.162,MORE,-626,1954,1328,4,1,-7.0,-0.6561859224721414,7.0,-0.34921514788478913,-0.2782627634814869,-0.042375635644171225,93,50,43,1,-1.3363168412821769,-1.170500554541026,-1.4436173506005987,0.8086476445903815,0.16881628334445342,0.16881628334445342,-1.4436173506005987,-1.170500554541026,0,1,0,0,-1.170500554541026,-1.4436173506005987
3549,15,190,21,80,82,1,3889.217,10,1881.65,MORE,-1336,2746,1410,3,1,2.0,0.18748169213489754,2.0,-1.222253017596762,-1.1994084632822717,0.01837533804405273,162,80,82,0,0.03989005496364707,0.0,0.07803337030273506,0.12528343789428434,-0.5489772759402771,0.5489772759402771,0.07803337030273506,0.0,0,1,0,1,0.07803337030273506,0.0
3550,15,191,10,50,60,1,1520.499,60,1256.078,MORE,180,608,788,1,2,10.0,0.9374084606744876,10.0,0.17460757394239454,1.10345578621969,-0.9585356881592328,110,50,60,0,-0.9972513740911768,-1.170500554541026,-0.7803337030273506,-1.24144497549791,0.983663619659232,0.983663619659232,-0.7803337030273506,-1.170500554541026,1,0,1,0,-1.170500554541026,-0.7803337030273506
3551,15,192,3,53,50,1,1762.876,60,1810.368,MORE,306,804,1110,1,2,-3.0,-0.28122253820234633,3.0,-1.0476454436543674,1.10345578621969,-0.8585741208481079,103,53,50,1,-1.1368665664639415,-1.0534504990869233,-1.170500554541026,-1.24144497549791,1.11104670201117,1.11104670201117,-1.170500554541026,-1.0534504990869233,1,0,1,0,-1.0534504990869233,-1.170500554541026
3552,15,193,45,122,110,0,1924.224,70,717.16,MORE,-882,1486,604,2,1,-12.0,-1.124890152809385,12.0,0.5238227218271837,1.564028636120082,-0.7920306824751788,232,122,110,1,1.4360419786912946,1.6387007763574364,1.170500554541026,-0.5580807688018129,-0.08999378873567476,0.08999378873567476,1.170500554541026,1.6387007763574364,1,0,0,2,1.6387007763574364,1.170500554541026
3553,15,194,38,67,80,1,3361.83,50,1561.0079999999996,MORE,-896,1968,1072,1,2,13.0,1.218630998876834,13.0,0.6984302957695783,0.6428829363192977,-0.1991305767065729,147,67,80,0,-0.25928535726370594,-0.5072169069677779,0.0,-1.24144497549791,-0.10414746455255677,0.10414746455255677,0.0,-0.5072169069677779,1,0,0,1,-0.5072169069677779,0.0
3554,15,195,38,80,67,0,3701.003,30,1426.845,MORE,-480,1894,1414,4,1,-13.0,-1.218630998876834,13.0,0.6984302957695783,-0.2782627634814869,-0.05924822537118925,147,80,67,1,-0.25928535726370594,0.0,-0.5072169069677779,0.8086476445903815,0.31641890257765154,0.31641890257765154,-0.5072169069677779,0.0,0,1,1,1,0.0,-0.5072169069677779
3555,15,196,36,70,80,1,1737.534,40,1607.866,MORE,158,728,886,1,2,10.0,0.9374084606744876,10.0,0.17460757394239454,0.1823100864189054,-0.8690257150125645,150,70,80,0,-0.19945027481823535,-0.3901668515136753,0.0,-1.24144497549791,0.961422129089846,0.961422129089846,0.0,-0.3901668515136753,0,0,1,1,-0.3901668515136753,0.0
3556,15,197,45,110,122,1,1580.1470000000004,80,1506.909,MORE,154,642,796,1,2,12.0,1.124890152809385,12.0,0.5238227218271837,2.024601486020474,-0.9339355504936376,232,110,122,0,1.4360419786912946,1.170500554541026,1.6387007763574364,-1.24144497549791,0.957378221713594,0.957378221713594,1.6387007763574364,1.170500554541026,1,0,1,2,1.6387007763574364,1.170500554541026
3557,15,198,42,110,115,1,3868.655,20,715.023,MORE,-432,1952,1520,3,1,5.0,0.4687042303372438,5.0,-0.6984302957695783,-0.7388356133818792,0.0098951202550243,225,110,115,0,1.2964267863185297,1.170500554541026,1.3655839802978638,0.12528343789428434,0.36494579109267555,0.36494579109267555,1.3655839802978638,1.170500554541026,0,1,1,2,1.3655839802978638,1.170500554541026
3558,15,199,41,110,112,1,4961.902,20,1886.832,MORE,408,2118,2526,5,1,2.0,0.18748169213489754,2.0,-1.222253017596762,-0.7388356133818792,0.4607740550474578,222,110,112,0,1.2365917038730592,1.170500554541026,1.248533924843761,1.4920118512864788,1.2141663401055962,1.2141663401055962,1.248533924843761,1.170500554541026,0,1,1,2,1.248533924843761,1.170500554541026
3559,15,200,53,110,103,1,1960.82,50,2266.383,MORE,92,840,932,1,2,-7.0,-0.6561859224721414,7.0,-0.34921514788478913,0.6428829363192977,-0.7769376929699126,213,110,103,1,1.0570864565366473,1.170500554541026,0.8973837584814532,-1.24144497549791,0.8946976573816879,0.8946976573816879,0.8973837584814532,1.170500554541026,1,0,1,2,1.170500554541026,0.8973837584814532
3560,15,201,3,50,53,1,4807.99,10,2145.589,LESS,-1462,3594,2132,7,1,3.0,0.28122253820234633,3.0,-1.0476454436543674,-1.1994084632822717,0.3972973854460107,103,50,53,1,-1.1368665664639415,-1.170500554541026,-1.0534504990869233,2.8587402646786737,-0.6763603582922152,0.6763603582922152,-1.0534504990869233,-1.170500554541026,0,1,0,0,-1.170500554541026,-1.0534504990869233
3561,15,202,20,50,40,1,1529.044,50,1622.089,LESS,408,528,936,1,2,-10.0,-0.9374084606744876,10.0,0.17460757394239454,0.6428829363192977,-0.955011543571778,90,50,40,0,-1.3961519237276474,-1.170500554541026,-1.5606674060547012,-1.24144497549791,1.2141663401055962,1.2141663401055962,-1.5606674060547012,-1.170500554541026,1,0,1,0,-1.170500554541026,-1.5606674060547012
3562,15,203,25,80,88,0,1627.6660000000004,20,1923.786,LESS,-2016,2482,466,2,1,8.0,0.7499267685395902,8.0,-0.17460757394239454,-0.7388356133818792,-0.9143376772752324,168,80,88,1,0.1595602198545883,0.0,0.31213348121094026,-0.5580807688018129,-1.2364415299031175,1.2364415299031175,0.31213348121094026,0.0,0,0,0,1,0.31213348121094026,0.0
3563,15,204,42,115,110,1,2454.485,30,1236.747,LESS,-26,1164,1138,3,1,-5.0,-0.4687042303372438,5.0,-0.6984302957695783,-0.2782627634814869,-0.5733394673682811,225,115,110,0,1.2964267863185297,1.3655839802978638,1.170500554541026,0.12528343789428434,0.7754023897822538,0.7754023897822538,1.170500554541026,1.3655839802978638,1,1,1,2,1.3655839802978638,1.170500554541026
3564,15,205,53,103,110,0,1884.516,20,1775.404,LESS,-1472,1924,452,2,1,7.0,0.6561859224721414,7.0,-0.34921514788478913,-0.7388356133818792,-0.8084071287336528,213,103,110,1,1.0570864565366473,0.8973837584814532,1.170500554541026,-0.5580807688018129,-0.6864701267328452,0.6864701267328452,1.170500554541026,0.8973837584814532,0,0,0,2,1.170500554541026,0.8973837584814532
3565,15,206,26,90,80,1,3335.151,40,983.234,LESS,-936,1930,994,1,2,-10.0,-0.9374084606744876,10.0,0.17460757394239454,0.1823100864189054,-0.21013357886557935,170,90,80,0,0.19945027481823535,0.3901668515136753,0.0,-1.24144497549791,-0.1445865383150768,0.1445865383150768,0.0,0.3901668515136753,1,0,0,1,0.3901668515136753,0.0
3566,15,207,35,80,72,0,3638.464,10,1272.518,LESS,-1044,2384,1340,4,1,-8.0,-0.7499267685395902,8.0,-0.17460757394239454,-1.1994084632822717,-0.08504067456426648,152,80,72,0,-0.1595602198545883,0.0,-0.31213348121094026,0.8086476445903815,-0.2537720374738809,0.2537720374738809,-0.31213348121094026,0.0,0,1,0,1,0.0,-0.31213348121094026
3567,15,208,28,93,80,1,4355.9,30,1819.126,LESS,-542,2400,1858,3,1,-13.0,-1.218630998876834,13.0,0.6984302957695783,-0.2782627634814869,0.2108455976704108,173,93,80,0,0.25928535726370594,0.5072169069677779,0.0,0.12528343789428434,0.2537383382457455,0.2537383382457455,0.0,0.5072169069677779,1,1,1,1,0.5072169069677779,0.0
3568,15,209,26,80,90,0,3821.367,60,788.314,LESS,-958,2232,1274,4,1,10.0,0.9374084606744876,10.0,0.17460757394239454,1.10345578621969,-0.009607483519296234,170,80,90,1,0.19945027481823535,0.0,0.3901668515136753,0.8086476445903815,-0.16682802888446283,0.16682802888446283,0.3901668515136753,0.0,1,1,0,1,0.3901668515136753,0.0
3569,15,210,25,88,80,1,1757.382,30,860.0889999999998,LESS,246,894,1140,1,1,-8.0,-0.7499267685395902,8.0,-0.17460757394239454,-0.2782627634814869,-0.8608399664143428,168,88,80,0,0.1595602198545883,0.31213348121094026,0.0,-1.24144497549791,1.05038809136739,1.05038809136739,0.0,0.31213348121094026,1,0,1,1,0.31213348121094026,0.0
3570,15,211,36,80,70,1,2452.173,20,1613.0970000000002,LESS,-192,1540,1348,1,1,-10.0,-0.9374084606744876,10.0,0.17460757394239454,-0.7388356133818792,-0.5742929866527979,150,80,70,0,-0.19945027481823535,0.0,-0.3901668515136753,-1.24144497549791,0.6075802336677958,0.6075802336677958,-0.3901668515136753,0.0,0,0,1,1,0.0,-0.3901668515136753
3571,15,212,28,80,93,0,2488.712,70,706.8919999999998,LESS,-786,1462,676,2,1,13.0,1.218630998876834,13.0,0.6984302957695783,1.564028636120082,-0.5592235051921758,173,80,93,1,0.25928535726370594,0.0,0.5072169069677779,-0.5580807688018129,0.007059988294373304,0.007059988294373304,0.5072169069677779,0.0,1,0,1,1,0.5072169069677779,0.0
3572,15,213,21,82,80,0,3737.865,50,866.837,LESS,-1342,2490,1148,4,1,-2.0,-0.18748169213489754,2.0,-1.222253017596762,0.6428829363192977,-0.04404553165758334,162,82,80,0,0.03989005496364707,0.07803337030273506,0.0,0.8086476445903815,-0.5550431370046551,0.5550431370046551,0.0,0.07803337030273506,1,1,0,1,0.07803337030273506,0.0
3573,15,214,19,50,41,0,1937.901,20,2005.139,LESS,-1478,2086,608,2,1,-9.0,-0.8436676146070391,9.0,0.0,-0.7388356133818792,-0.7863899890260716,91,50,41,0,-1.376206896245824,-1.170500554541026,-1.5216507209033339,-0.5580807688018129,-0.6925359877972233,0.6925359877972233,-1.5216507209033339,-1.170500554541026,0,1,0,0,-1.170500554541026,-1.5216507209033339
3574,15,215,56,96,110,1,1545.585,30,1456.406,LESS,268,610,878,1,2,14.0,1.3123718449442827,14.0,0.8730378697119728,-0.2782627634814869,-0.9481896739847574,206,96,110,1,0.9174712641638826,0.6242669624218805,1.170500554541026,-1.24144497549791,1.0726295819367762,1.0726295819367762,1.170500554541026,0.6242669624218805,1,0,1,2,1.170500554541026,0.6242669624218805
3575,15,216,23,80,85,0,1850.509,10,1535.388,LESS,-1264,1764,500,2,1,5.0,0.4687042303372438,5.0,-0.6984302957695783,-1.1994084632822717,-0.8224323581058681,165,80,85,1,0.09972513740911768,0.0,0.19508342575683765,-0.5580807688018129,-0.4761869431677411,0.4761869431677411,0.19508342575683765,0.0,0,0,0,1,0.19508342575683765,0.0
3576,15,217,10,60,50,1,2344.205,10,1818.262,LESS,-1554,2602,1048,3,1,-10.0,-0.9374084606744876,10.0,0.17460757394239454,-1.1994084632822717,-0.6188213474273251,110,60,50,0,-0.9972513740911768,-0.7803337030273506,-1.170500554541026,0.12528343789428434,-0.7693702279460113,0.7693702279460113,-1.170500554541026,-0.7803337030273506,0,1,0,0,-0.7803337030273506,-1.170500554541026
3577,15,218,19,41,50,0,1751.0279999999998,60,1163.268,LESS,-544,1026,482,2,1,9.0,0.8436676146070391,9.0,0.0,1.10345578621969,-0.8634604947594205,91,41,50,1,-1.376206896245824,-1.5216507209033339,-1.170500554541026,-0.5580807688018129,0.25171638455761947,0.25171638455761947,-1.170500554541026,-1.5216507209033339,1,0,1,0,-1.5216507209033339,-1.170500554541026
3578,15,219,56,110,96,0,5484.384,10,1445.111,LESS,-1446,3548,2102,6,1,-14.0,-1.3123718449442827,14.0,0.8730378697119728,-1.1994084632822717,0.676257040693172,206,110,96,0,0.9174712641638826,1.170500554541026,0.6242669624218805,2.175376057982576,-0.6601847287872071,0.6601847287872071,0.6242669624218805,1.170500554541026,0,1,0,2,1.170500554541026,0.6242669624218805
3579,15,220,35,72,80,0,5401.733,10,1641.2120000000002,LESS,-2594,4204,1610,4,1,8.0,0.7499267685395902,8.0,-0.17460757394239454,-1.1994084632822717,0.6421699635372051,152,72,80,1,-0.1595602198545883,-0.31213348121094026,0.0,0.8086476445903815,-1.820786145771532,1.820786145771532,0.0,-0.31213348121094026,0,1,0,1,-0.31213348121094026,0.0
3580,15,221,11,49,50,0,2323.862,20,1433.8829999999996,LESS,-1438,2094,656,2,1,1.0,0.09374084606744876,1.0,-1.3968605915391563,-0.7388356133818792,-0.6272112448342994,99,49,50,1,-1.2166466763912356,-1.2095172396923934,-1.170500554541026,-0.5580807688018129,-0.6520969140347032,0.6520969140347032,-1.170500554541026,-1.2095172396923934,0,0,0,0,-1.2095172396923934,-1.170500554541026
3581,15,222,17,43,50,0,1736.275,50,956.566,LESS,-676,1122,446,2,1,7.0,0.6561859224721414,7.0,-0.34921514788478913,0.6428829363192977,-0.8695449541039171,93,43,50,1,-1.3363168412821769,-1.4436173506005987,-1.170500554541026,-0.5580807688018129,0.11826744114130339,0.11826744114130339,-1.170500554541026,-1.4436173506005987,1,0,1,0,-1.4436173506005987,-1.170500554541026
3582,15,223,1,51,50,0,2496.636,20,1700.355,LESS,-1712,2246,534,2,1,-1.0,-0.09374084606744876,1.0,-1.3968605915391563,-0.7388356133818792,-0.5559554745647922,101,51,50,0,-1.1767566214275886,-1.1314838693896585,-1.170500554541026,-0.5580807688018129,-0.9291045693079654,0.9291045693079654,-1.170500554541026,-1.1314838693896585,0,0,0,0,-1.1314838693896585,-1.170500554541026
3583,15,224,41,112,110,0,2643.958,10,1477.149,LESS,-1312,2414,1102,2,1,-2.0,-0.18748169213489754,2.0,-1.222253017596762,-1.1994084632822717,-0.4951966648616867,222,112,110,0,1.2365917038730592,1.248533924843761,1.170500554541026,-0.5580807688018129,-0.5247138316827651,0.5247138316827651,1.170500554541026,1.248533924843761,0,0,0,2,1.248533924843761,1.170500554541026
3584,15,225,20,40,50,0,1751.451,60,1594.741,LESS,-1010,1532,522,2,1,10.0,0.9374084606744876,10.0,0.17460757394239454,1.10345578621969,-0.8632860403228502,90,40,50,1,-1.3961519237276474,-1.5606674060547012,-1.170500554541026,-0.5580807688018129,-0.21939882477573885,0.21939882477573885,-1.170500554541026,-1.5606674060547012,1,0,0,0,-1.5606674060547012,-1.170500554541026
3585,15,226,1,50,51,1,5616.222,30,1148.764,LESS,-1026,3312,2286,5,1,1.0,0.09374084606744876,1.0,-1.3968605915391563,-0.2782627634814869,0.7306299106897646,101,50,51,1,-1.1767566214275886,-1.170500554541026,-1.1314838693896585,1.4920118512864788,-0.23557445428074686,0.23557445428074686,-1.1314838693896585,-1.170500554541026,1,1,0,0,-1.170500554541026,-1.1314838693896585
3586,15,227,23,85,80,1,6900.5059999999985,40,1275.932,LESS,-984,3722,2738,6,1,-5.0,-0.4687042303372438,5.0,-0.6984302957695783,0.1823100864189054,1.2602966757400826,165,85,80,0,0.09972513740911768,0.19508342575683765,0.0,2.175376057982576,-0.19311342683010085,0.19311342683010085,0.0,0.19508342575683765,1,1,0,1,0.19508342575683765,0.0
3587,15,228,11,50,49,0,6086.955,30,543.304,LESS,-1126,3378,2252,6,1,-1.0,-0.09374084606744876,1.0,-1.3968605915391563,-0.2782627634814869,0.9247704787513706,99,50,49,0,-1.2166466763912356,-1.170500554541026,-1.2095172396923934,2.175376057982576,-0.33667213868704693,0.33667213868704693,-1.2095172396923934,-1.170500554541026,1,1,0,0,-1.170500554541026,-1.2095172396923934
3588,15,229,17,50,43,1,5994.553000000001,20,912.474,LESS,-440,2840,2400,5,2,-7.0,-0.6561859224721414,7.0,-0.34921514788478913,-0.7388356133818792,0.8866618762738975,93,50,43,0,-1.3363168412821769,-1.170500554541026,-1.4436173506005987,1.4920118512864788,0.3568579763401716,0.3568579763401716,-1.4436173506005987,-1.170500554541026,0,1,1,0,-1.170500554541026,-1.4436173506005987
3589,15,230,21,80,82,1,3866.99,10,668.659,LESS,124,1796,1920,3,1,2.0,0.18748169213489754,2.0,-1.222253017596762,-1.1994084632822717,0.00920843789831114,162,80,82,1,0.03989005496364707,0.0,0.07803337030273506,0.12528343789428434,0.927048916391704,0.927048916391704,0.07803337030273506,0.0,0,1,1,1,0.07803337030273506,0.0
3590,15,231,10,50,60,0,2893.133,50,725.7130000000002,LESS,-452,1362,910,2,1,10.0,0.9374084606744876,10.0,0.17460757394239454,0.6428829363192977,-0.39243145391036055,110,50,60,1,-0.9972513740911768,-1.170500554541026,-0.7803337030273506,-0.5580807688018129,0.34472625421141556,0.34472625421141556,-0.7803337030273506,-1.170500554541026,1,0,1,0,-1.170500554541026,-0.7803337030273506
3591,15,232,3,53,50,0,1795.4260000000004,10,1209.687,LESS,-1562,2112,550,2,1,-3.0,-0.28122253820234633,3.0,-1.0476454436543674,-1.1994084632822717,-0.8451497900907458,103,53,50,0,-1.1368665664639415,-1.0534504990869233,-1.170500554541026,-0.5580807688018129,-0.7774580426985153,0.7774580426985153,-1.170500554541026,-1.0534504990869233,0,0,0,0,-1.0534504990869233,-1.170500554541026
3592,15,233,45,122,110,0,5605.866,10,1313.82,LESS,-810,3154,2344,6,1,-12.0,-1.124890152809385,12.0,0.5238227218271837,-1.1994084632822717,0.7263588701575606,232,122,110,0,1.4360419786912946,1.6387007763574364,1.170500554541026,2.175376057982576,-0.017203455963138714,0.017203455963138714,1.170500554541026,1.6387007763574364,0,1,1,2,1.6387007763574364,1.170500554541026
3593,15,234,38,67,80,0,1843.322,70,1562.9129999999998,LESS,-684,1158,474,2,1,13.0,1.218630998876834,13.0,0.6984302957695783,1.564028636120082,-0.8253964338402203,147,67,80,1,-0.25928535726370594,-0.5072169069677779,0.0,-0.5580807688018129,0.11017962638879938,0.11017962638879938,0.0,-0.5072169069677779,1,0,1,1,-0.5072169069677779,0.0
3594,15,235,38,80,67,1,2435.599,30,1046.725,LESS,6,1098,1104,1,2,-13.0,-1.218630998876834,13.0,0.6984302957695783,-0.2782627634814869,-0.581128466160402,147,80,67,0,-0.25928535726370594,0.0,-0.5072169069677779,-1.24144497549791,0.8077536487922699,0.8077536487922699,-0.5072169069677779,0.0,1,0,1,1,0.0,-0.5072169069677779
3595,15,236,36,70,80,0,2240.474,60,1292.919,LESS,-824,1310,486,2,1,10.0,0.9374084606744876,10.0,0.17460757394239454,1.10345578621969,-0.6616022768832978,150,70,80,1,-0.19945027481823535,-0.3901668515136753,0.0,-0.5580807688018129,-0.031357131780020725,0.031357131780020725,0.0,-0.3901668515136753,1,0,1,1,-0.3901668515136753,0.0
3596,15,237,45,110,122,0,2563.388,10,1958.226,LESS,-2340,2978,638,2,1,12.0,1.124890152809385,12.0,0.5238227218271837,-1.1994084632822717,-0.5284254921772216,232,110,122,1,1.4360419786912946,1.170500554541026,1.6387007763574364,-0.5580807688018129,-1.5639980273795298,1.5639980273795298,1.6387007763574364,1.170500554541026,0,0,0,2,1.6387007763574364,1.170500554541026
3597,15,238,42,110,115,0,1991.946,10,845.607,LESS,-1318,1788,470,2,1,5.0,0.4687042303372438,5.0,-0.6984302957695783,-1.1994084632822717,-0.7641006509068204,225,110,115,1,1.2964267863185297,1.170500554541026,1.3655839802978638,-0.5580807688018129,-0.5307796927471431,0.5307796927471431,1.3655839802978638,1.170500554541026,0,0,0,2,1.3655839802978638,1.170500554541026
3598,15,239,41,110,112,1,4074.443,20,1174.587,LESS,-1268,2874,1606,3,1,2.0,0.18748169213489754,2.0,-1.222253017596762,-0.7388356133818792,0.0947665850137342,222,110,112,1,1.2365917038730592,1.170500554541026,1.248533924843761,0.12528343789428434,-0.48023085054399306,0.48023085054399306,1.248533924843761,1.170500554541026,0,1,0,2,1.248533924843761,1.170500554541026
3599,15,240,53,110,103,1,1927.761,30,1053.328,LESS,118,864,982,1,2,-7.0,-0.6561859224721414,7.0,-0.34921514788478913,-0.2782627634814869,-0.7905719464417291,213,110,103,0,1.0570864565366473,1.170500554541026,0.8973837584814532,-1.24144497549791,0.9209830553273259,0.9209830553273259,0.8973837584814532,1.170500554541026,1,0,1,2,1.170500554541026,0.8973837584814532
3600,16,1,49,110,131,1,5036.814,14,1646.553,LESS,-1422,3096,1674,3,1,21.0,1.9685577674164243,21.0,2.0952908873087353,-2.046783534275825,1.5933414235288232,241,110,131,1,1.6155472260277064,1.170500554541026,1.9898509427197442,0.2602634814552885,-1.5748121643546342,1.5748121643546342,1.9898509427197442,1.170500554541026,0,1,0,2,1.9898509427197442,1.170500554541026
3601,16,2,13,47,50,0,6666.279,34,1100.221,LESS,-492,3444,2952,8,1,3.0,0.28122253820234633,3.0,-1.0476454436543674,-0.9290860411559204,2.735854751837508,97,47,50,1,-1.2565367313548828,-1.2875506099951286,-1.170500554541026,3.7304432341924683,-0.29708338936715945,0.29708338936715945,-1.170500554541026,-1.2875506099951286,0,1,0,0,-1.2875506099951286,-1.170500554541026
3602,16,3,16,50,44,0,2896.882,44,724.44,LESS,-824,1694,870,4,1,-6.0,-0.5624450764046927,6.0,-0.5238227218271837,-0.3702372945959683,0.09290979003300684,94,50,44,0,-1.3163718138003533,-1.170500554541026,-1.4046006654492311,0.9542994320027245,-0.7532188230186021,0.7532188230186021,-1.4046006654492311,-1.170500554541026,0,1,0,0,-1.170500554541026,-1.4046006654492311
3603,16,4,7,57,50,1,4941.589,24,1393.966,LESS,48,2698,2746,5,2,-7.0,-0.6561859224721414,7.0,-0.34921514788478913,-1.4879347877158726,1.526573599925251,107,57,50,0,-1.0570864565366473,-0.8973837584814532,-1.170500554541026,1.6483353825501603,0.4448236412707291,0.4448236412707291,-1.170500554541026,-0.8973837584814532,0,1,1,0,-0.8973837584814532,-1.170500554541026
3604,16,5,18,42,50,1,3747.957,34,1569.109,LESS,960,1206,2166,3,2,8.0,0.7499267685395902,8.0,-0.17460757394239454,-0.9290860411559204,0.6896483090501773,92,42,50,1,-1.3562618687640005,-1.4826340357519663,-1.170500554541026,0.2602634814552885,1.6978221819036075,1.6978221819036075,-1.170500554541026,-1.4826340357519663,0,1,1,0,-1.4826340357519663,-1.170500554541026
3605,16,6,51,108,110,1,7078.549,24,1090.017,LESS,390,3116,3506,8,1,2.0,0.18748169213489754,2.0,-1.222253017596762,-1.4879347877158726,3.0249213901892498,218,108,110,1,1.156811593945765,1.092467184238291,1.170500554541026,3.7304432341924683,0.9146980940080585,0.9146980940080585,1.170500554541026,1.092467184238291,0,1,1,2,1.170500554541026,1.092467184238291
3606,16,7,31,78,80,1,8817.116,34,1262.065,LESS,1546,3212,4758,7,1,2.0,0.18748169213489754,2.0,-1.222253017596762,-0.9290860411559204,4.243932519398927,158,78,80,1,-0.03989005496364707,-0.07803337030273506,0.0,3.0364072836450324,2.5029287003365757,2.5029287003365757,0.0,-0.07803337030273506,0,1,1,1,-0.07803337030273506,0.0
3607,16,8,58,110,92,1,1844.604,54,1313.365,LESS,846,452,1298,1,2,-18.0,-1.6873352292140782,18.0,1.571468165481551,0.18861145196398388,-0.6449039341562247,202,110,92,0,0.8376911542365885,1.170500554541026,0.4682002218164104,-1.1278084196395834,1.5411973643244976,1.5411973643244976,0.4682002218164104,1.170500554541026,1,0,1,2,1.170500554541026,0.4682002218164104
3608,16,9,12,50,48,1,6962.203,34,1623.368,LESS,1458,1906,3364,6,1,-2.0,-0.18748169213489754,2.0,-1.222253017596762,-0.9290860411559204,2.9433443967003434,98,50,48,0,-1.2365917038730592,-1.170500554541026,-1.248533924843761,2.3423713330975966,2.3820253323807714,2.3820253323807714,-1.248533924843761,-1.170500554541026,0,1,1,0,-1.170500554541026,-1.248533924843761
3609,16,10,54,110,101,1,2189.002,44,1225.72,LESS,386,792,1178,3,2,-9.0,-0.8436676146070391,9.0,0.0,-0.3702372945959683,-0.4034263293946285,211,110,101,0,1.0171964015730004,1.170500554541026,0.8193503881787182,0.2602634814552885,0.9092024863737037,0.9092024863737037,0.8193503881787182,1.170500554541026,0,1,1,2,1.170500554541026,0.8193503881787182
3610,16,11,14,46,50,0,1864.762,44,1066.813,LESS,-568,1106,538,2,1,4.0,0.3749633842697951,4.0,-0.8730378697119728,-0.3702372945959683,-0.6307699799614145,96,46,50,1,-1.2764817588367063,-1.3265672951464962,-1.170500554541026,-0.4337724690921475,-0.40149993441989934,0.40149993441989934,-1.170500554541026,-1.3265672951464962,0,0,0,0,-1.3265672951464962,-1.170500554541026
3611,16,12,22,80,83,1,5642.773,34,1133.101,LESS,-342,2582,2240,5,2,3.0,0.28122253820234633,3.0,-1.0476454436543674,-0.9290860411559204,2.0182147616542827,163,80,83,1,0.05983508244547061,0.0,0.1170500554541026,1.6483353825501603,-0.09099810307885708,0.09099810307885708,0.1170500554541026,0.0,0,1,1,1,0.1170500554541026,0.0
3612,16,13,6,50,56,0,7938.654,54,1651.733,LESS,-692,3524,2832,7,1,6.0,0.5624450764046927,6.0,-0.5238227218271837,0.18861145196398388,3.6279913709773863,106,50,56,1,-1.077031484018471,-1.170500554541026,-0.9364004436328208,3.0364072836450324,-0.5718637710848959,0.5718637710848959,-0.9364004436328208,-1.170500554541026,1,1,0,0,-1.170500554541026,-0.9364004436328208
3613,16,14,13,50,47,0,1773.503,54,1119.358,LESS,-536,1022,486,2,1,-3.0,-0.28122253820234633,3.0,-1.0476454436543674,0.18861145196398388,-0.6947570087273728,97,50,47,0,-1.2565367313548828,-1.170500554541026,-1.2875506099951286,-0.4337724690921475,-0.3575350733450615,0.3575350733450615,-1.2875506099951286,-1.170500554541026,1,0,0,0,-1.170500554541026,-1.2875506099951286
3614,16,15,46,110,124,0,8362.72,34,941.766,LESS,-848,3918,3070,5,1,14.0,1.3123718449442827,14.0,0.8730378697119728,-0.9290860411559204,3.9253288756691407,234,110,124,1,1.4759320336549415,1.170500554541026,1.7167341466601715,1.6483353825501603,-0.7861924688247305,0.7861924688247305,1.7167341466601715,1.170500554541026,0,1,0,2,1.7167341466601715,1.170500554541026
3615,16,16,27,91,80,1,4171.918,44,1154.943,LESS,614,1700,2314,6,1,-11.0,-1.0311493067419364,11.0,0.34921514788478913,-0.3702372945959683,0.9869121920934326,171,91,80,0,0.21939530230005888,0.4291835366650429,0.0,2.3423713330975966,1.2224521215319233,1.2224521215319233,0.0,0.4291835366650429,0,1,1,1,0.4291835366650429,0.0
3616,16,17,40,64,80,0,6348.423000000002,34,1126.422,LESS,-88,2928,2840,6,1,16.0,1.4998535370791803,16.0,1.222253017596762,-0.9290860411559204,2.512987297499499,144,64,80,1,-0.3191204397091766,-0.6242669624218805,0.0,2.3423713330975966,0.25797298170266825,0.25797298170266825,0.0,-0.6242669624218805,0,1,1,1,-0.6242669624218805,0.0
3617,16,18,22,83,80,0,4260.96,44,1258.434,LESS,-234,2000,1766,4,1,-3.0,-0.28122253820234633,3.0,-1.0476454436543674,-0.3702372945959683,1.0493447523382138,163,83,80,0,0.05983508244547061,0.1170500554541026,0.0,0.9542994320027245,0.05738330304872062,0.05738330304872062,0.0,0.1170500554541026,0,1,1,1,0.1170500554541026,0.0
3618,16,19,54,101,110,0,3135.347,54,1462.3570000000002,LESS,-746,1822,1076,4,1,9.0,0.8436676146070391,9.0,0.0,0.18861145196398388,0.2601115653611855,211,101,110,1,1.0171964015730004,0.8193503881787182,1.170500554541026,0.9542994320027245,-0.6460544741486848,0.6460544741486848,1.170500554541026,0.8193503881787182,1,1,0,2,1.170500554541026,0.8193503881787182
3619,16,20,6,56,50,1,6903.403,44,1241.103,LESS,-238,3146,2908,7,2,-6.0,-0.5624450764046927,6.0,-0.5238227218271837,-0.3702372945959683,2.902116273540563,106,56,50,0,-1.077031484018471,-0.9364004436328208,-1.170500554541026,3.0364072836450324,0.051887695414365886,0.051887695414365886,-1.170500554541026,-0.9364004436328208,0,1,1,0,-0.9364004436328208,-1.170500554541026
3620,16,21,18,50,42,0,4110.928,54,1234.954,LESS,-470,1760,1290,4,1,-8.0,-0.7499267685395902,8.0,-0.17460757394239454,0.18861145196398388,0.9441485316935182,92,50,42,0,-1.3562618687640005,-1.170500554541026,-1.4826340357519663,0.9542994320027245,-0.26685754737820844,0.26685754737820844,-1.4826340357519663,-1.170500554541026,1,1,0,0,-1.170500554541026,-1.4826340357519663
3621,16,22,43,110,117,0,4106.266,50,1983.088,LESS,176,1928,2104,4,2,7.0,0.6561859224721414,7.0,-0.34921514788478913,-0.03492804665999701,0.9408797305001356,227,110,117,1,1.3363168412821769,1.170500554541026,1.4436173506005987,0.9542994320027245,0.6206830855700805,0.6206830855700805,1.4436173506005987,1.170500554541026,0,1,1,2,1.4436173506005987,1.170500554541026
3622,16,23,32,77,80,1,8227.724,14,1822.837,LESS,-1296,4728,3432,7,1,3.0,0.28122253820234633,3.0,-1.0476454436543674,-2.046783534275825,3.83067527508959,157,77,80,1,-0.05983508244547061,-0.1170500554541026,0.0,3.0364072836450324,-1.4017005238724602,1.4017005238724602,0.0,-0.1170500554541026,0,1,0,1,-0.1170500554541026,0.0
3623,16,24,27,80,91,0,4491.226,54,1561.811,LESS,-730,2382,1652,4,1,11.0,1.0311493067419364,11.0,0.34921514788478913,0.18861145196398388,1.2107977286564084,171,80,91,1,0.21939530230005888,0.0,0.4291835366650429,0.9542994320027245,-0.6240720436112659,0.6240720436112659,0.4291835366650429,0.0,1,1,0,1,0.4291835366650429,0.0
3624,16,25,16,44,50,0,2868.9770000000008,54,2084.783,LESS,-188,1490,1302,4,1,6.0,0.5624450764046927,6.0,-0.5238227218271837,0.18861145196398388,0.07334396049604039,94,44,50,1,-1.3163718138003533,-1.4046006654492311,-1.170500554541026,0.9542994320027245,0.12058279084380001,0.12058279084380001,-1.170500554541026,-1.4046006654492311,1,1,1,0,-1.4046006654492311,-1.170500554541026
3625,16,26,7,50,57,0,3290.348,44,430.80300000000005,LESS,-276,1556,1280,4,1,7.0,0.6561859224721414,7.0,-0.34921514788478913,-0.3702372945959683,0.36879184287630495,107,50,57,1,-1.0570864565366473,-1.170500554541026,-0.8973837584814532,0.9542994320027245,-0.0003205771120040467,0.0003205771120040467,-0.8973837584814532,-1.170500554541026,0,1,1,0,-1.170500554541026,-0.8973837584814532
3626,16,27,14,50,46,0,3626.132,44,1001.018,LESS,-810,1868,1058,2,1,-4.0,-0.3749633842697951,4.0,-0.8730378697119728,-0.3702372945959683,0.604229667826705,96,50,46,0,-1.2764817588367063,-1.170500554541026,-1.3265672951464962,-0.4337724690921475,-0.7339841962983605,0.7339841962983605,-1.3265672951464962,-1.170500554541026,0,0,0,0,-1.170500554541026,-1.3265672951464962
3627,16,28,51,110,108,1,6855.8690000000015,54,791.051,LESS,118,2062,2180,4,2,-2.0,-0.18748169213489754,2.0,-1.222253017596762,0.18861145196398388,2.8687874026855127,218,110,108,0,1.156811593945765,1.170500554541026,1.092467184238291,0.9542994320027245,0.5409967748719369,0.5409967748719369,1.092467184238291,1.170500554541026,1,1,1,2,1.170500554541026,1.092467184238291
3628,16,29,50,133,110,1,1653.6470000000004,64,965.699,LESS,766,500,1266,1,2,-23.0,-2.1560394595513217,23.0,2.444506035193524,0.7474601985239361,-0.778795068751838,243,133,110,0,1.6554372809913533,2.0678843130224793,1.170500554541026,-1.1278084196395834,1.431285211637403,1.431285211637403,1.170500554541026,2.0678843130224793,1,0,1,2,2.0678843130224793,1.170500554541026
3629,16,30,49,131,110,1,2228.77,44,856.4069999999998,LESS,418,828,1246,1,2,-21.0,-1.9685577674164243,21.0,2.0952908873087353,-0.3702372945959683,-0.3755426558943202,241,131,110,0,1.6155472260277064,1.9898509427197442,1.170500554541026,-1.1278084196395834,0.9531673474485416,0.9531673474485416,1.170500554541026,1.9898509427197442,0,0,1,2,1.9898509427197442,1.170500554541026
3630,16,31,47,126,110,1,5596.932,64,916.762,LESS,536,2256,2792,3,2,-16.0,-1.4998535370791803,16.0,1.222253017596762,0.7474601985239361,1.9860729522364688,236,126,110,0,1.5158220886185887,1.7947675169629065,1.170500554541026,0.2602634814552885,1.115287772662006,1.115287772662006,1.170500554541026,1.7947675169629065,1,1,1,2,1.7947675169629065,1.170500554541026
3631,16,32,50,110,133,0,3126.533,54,1201.835,LESS,-406,1874,1468,2,2,23.0,2.1560394595513217,23.0,2.444506035193524,0.18861145196398388,0.25393155383856114,243,110,133,1,1.6554372809913533,1.170500554541026,2.0678843130224793,-0.4337724690921475,-0.17892782522853276,0.17892782522853276,2.0678843130224793,1.170500554541026,1,0,1,2,2.0678843130224793,1.170500554541026
3632,16,33,47,110,126,0,2338.83,64,1198.427,LESS,-700,1362,662,2,1,16.0,1.4998535370791803,16.0,1.222253017596762,0.7474601985239361,-0.2983731450955895,236,110,126,1,1.5158220886185887,1.170500554541026,1.7947675169629065,-0.4337724690921475,-0.5828549863536054,0.5828549863536054,1.7947675169629065,1.170500554541026,1,0,0,2,1.7947675169629065,1.170500554541026
3633,16,34,12,48,50,0,5193.959,54,1199.714,LESS,442,1522,1964,3,1,2.0,0.18748169213489754,2.0,-1.222253017596762,0.18861145196398388,1.7035249849904488,98,48,50,1,-1.2365917038730592,-1.248533924843761,-1.170500554541026,0.2602634814552885,0.98614099325467,0.98614099325467,-1.170500554541026,-1.248533924843761,1,1,1,0,-1.248533924843761,-1.170500554541026
3634,16,35,32,80,77,1,1584.104,54,1217.72,LESS,344,504,848,1,2,-3.0,-0.28122253820234633,3.0,-1.0476454436543674,0.18861145196398388,-0.8275557382909636,157,80,77,0,-0.05983508244547061,0.0,-0.1170500554541026,-1.1278084196395834,0.8514986062129791,0.8514986062129791,-0.1170500554541026,0.0,1,0,1,1,0.0,-0.1170500554541026
3635,16,36,43,117,110,0,1990.986,44,1492.007,LESS,-412,968,556,2,1,-7.0,-0.6561859224721414,7.0,-0.34921514788478913,-0.3702372945959683,-0.542266942245087,227,117,110,0,1.3363168412821769,1.4436173506005987,1.170500554541026,-0.4337724690921475,-0.18717123668006486,0.18717123668006486,1.170500554541026,1.4436173506005987,0,0,0,2,1.4436173506005987,1.170500554541026
3636,16,37,40,80,64,0,5000.792,34,906.248,LESS,-680,2502,1822,2,1,-16.0,-1.4998535370791803,16.0,1.222253017596762,-0.9290860411559204,1.568084289983558,144,80,64,0,-0.3191204397091766,0.0,-0.6242669624218805,-0.4337724690921475,-0.5553769481818318,0.5553769481818318,-0.6242669624218805,0.0,0,0,0,1,0.0,-0.6242669624218805
3637,16,38,31,80,78,0,6590.522,54,1512.063,LESS,150,2460,2610,2,2,-2.0,-0.18748169213489754,2.0,-1.222253017596762,0.18861145196398388,2.68273708302432,158,80,78,0,-0.03989005496364707,0.0,-0.07803337030273506,-0.4337724690921475,0.5849616359467747,0.5849616359467747,-0.07803337030273506,0.0,1,0,1,1,0.0,-0.07803337030273506
3638,16,39,46,124,110,1,4521.86,44,2062.364,LESS,1134,1648,2782,3,1,-14.0,-1.3123718449442827,14.0,0.8730378697119728,-0.3702372945959683,1.2322770198958077,234,124,110,0,1.4759320336549415,1.7167341466601715,1.170500554541026,0.2602634814552885,1.9368811139980382,1.9368811139980382,1.170500554541026,1.7167341466601715,0,1,1,2,1.7167341466601715,1.170500554541026
3639,16,40,58,92,110,0,4227.98,54,1661.654,LESS,-1720,2882,1162,4,1,18.0,1.6873352292140782,18.0,1.571468165481551,0.18861145196398388,1.0262205431237654,202,92,110,1,0.8376911542365885,0.4682002218164104,1.170500554541026,0.9542994320027245,-1.9842349331140616,1.9842349331140616,1.170500554541026,0.4682002218164104,1,1,0,2,1.170500554541026,0.4682002218164104
3640,16,41,49,110,131,1,2008.781,54,1570.344,MORE,-246,1294,1048,1,1,21.0,1.9685577674164243,21.0,2.0952908873087353,0.18861145196398388,-0.5297898257207966,241,110,131,0,1.6155472260277064,1.170500554541026,1.9898509427197442,-1.1278084196395834,0.04089648014565643,0.04089648014565643,1.9898509427197442,1.170500554541026,0,0,0,2,1.9898509427197442,1.170500554541026
3641,16,42,13,47,50,0,2586.882,54,1154.285,MORE,-522,1408,886,2,1,3.0,0.28122253820234633,3.0,-1.0476454436543674,0.18861145196398388,-0.12444936268011818,97,47,50,0,-1.2565367313548828,-1.2875506099951286,-1.170500554541026,-0.4337724690921475,-0.33830044662481995,0.33830044662481995,-1.170500554541026,-1.2875506099951286,1,0,0,0,-1.2875506099951286,-1.170500554541026
3642,16,43,16,50,44,1,3858.222,64,993.097,MORE,-1136,2154,1018,3,2,-6.0,-0.5624450764046927,6.0,-0.5238227218271837,0.7474601985239361,0.7669615573531218,94,50,44,1,-1.3163718138003533,-1.170500554541026,-1.4046006654492311,0.2602634814552885,-1.181876218498271,1.181876218498271,-1.4046006654492311,-1.170500554541026,1,1,0,0,-1.170500554541026,-1.4046006654492311
3643,16,44,7,57,50,0,2024.535,64,2929.4590000000007,MORE,-588,1162,574,2,1,-7.0,-0.6561859224721414,7.0,-0.34921514788478913,0.7474601985239361,-0.5187437738116271,107,57,50,1,-1.0570864565366473,-0.8973837584814532,-1.170500554541026,-0.4337724690921475,-0.428977972591673,0.428977972591673,-1.170500554541026,-0.8973837584814532,1,0,0,0,-0.8973837584814532,-1.170500554541026
3644,16,45,18,42,50,1,2895.813,54,1411.194,MORE,172,1062,1234,3,2,8.0,0.7499267685395902,8.0,-0.17460757394239454,0.18861145196398388,0.09216025153542516,92,42,50,0,-1.3562618687640005,-1.4826340357519663,-1.170500554541026,0.2602634814552885,0.6151874779357257,0.6151874779357257,-1.170500554541026,-1.4826340357519663,1,1,1,0,-1.4826340357519663,-1.170500554541026
3645,16,46,51,108,110,0,2284.07,64,1695.065,MORE,-338,1056,718,2,1,2.0,0.18748169213489754,2.0,-1.222253017596762,0.7474601985239361,-0.3367685876845272,218,108,110,0,1.156811593945765,1.092467184238291,1.170500554541026,-0.4337724690921475,-0.08550249544450236,0.08550249544450236,1.170500554541026,1.092467184238291,1,0,0,2,1.170500554541026,1.092467184238291
3646,16,47,31,78,80,1,1841.979,64,1556.9029999999998,MORE,832,428,1260,1,2,2.0,0.18748169213489754,2.0,-1.222253017596762,0.7474601985239361,-0.6467444753687148,158,78,80,0,-0.03989005496364707,-0.07803337030273506,0.0,-1.1278084196395834,1.5219627376042562,1.5219627376042562,0.0,-0.07803337030273506,1,0,1,1,-0.07803337030273506,0.0
3647,16,48,58,110,92,0,2076.77,64,2730.553,MORE,-834,1384,550,2,1,-18.0,-1.6873352292140782,18.0,1.571468165481551,0.7474601985239361,-0.4821187565794654,202,110,92,1,0.8376911542365885,1.170500554541026,0.4682002218164104,-0.4337724690921475,-0.7669578421044889,0.7669578421044889,0.4682002218164104,1.170500554541026,1,0,0,2,1.170500554541026,0.4682002218164104
3648,16,49,12,50,48,0,3061.948,64,1116.562,MORE,-392,1526,1134,4,1,-2.0,-0.18748169213489754,2.0,-1.222253017596762,0.7474601985239361,0.20864722842573152,98,50,48,1,-1.2365917038730592,-1.170500554541026,-1.248533924843761,0.9542994320027245,-0.15969319850829122,0.15969319850829122,-1.248533924843761,-1.170500554541026,1,1,0,0,-1.170500554541026,-1.248533924843761
3649,16,50,54,110,101,0,2374.73,44,1133.268,MORE,-730,1292,562,2,1,-9.0,-0.8436676146070391,9.0,0.0,-0.3702372945959683,-0.2732015528942953,211,110,101,1,1.0171964015730004,1.170500554541026,0.8193503881787182,-0.4337724690921475,-0.6240720436112659,0.6240720436112659,0.8193503881787182,1.170500554541026,0,0,0,2,1.170500554541026,0.8193503881787182
3650,16,51,14,46,50,1,3362.285,24,826.643,MORE,444,1122,1566,2,1,4.0,0.3749633842697951,4.0,-0.8730378697119728,-1.4879347877158726,0.4192310860012213,96,46,50,0,-1.2764817588367063,-1.3265672951464962,-1.170500554541026,-0.4337724690921475,0.9888887970718473,0.9888887970718473,-1.170500554541026,-1.3265672951464962,0,0,1,0,-1.3265672951464962,-1.170500554541026
3651,16,52,22,80,83,0,2935.1940000000004,54,1297.523,MORE,-278,1368,1090,4,1,3.0,0.28122253820234633,3.0,-1.0476454436543674,0.18861145196398388,0.11977257667412078,163,80,83,0,0.05983508244547061,0.0,0.1170500554541026,0.9542994320027245,-0.003068380929181412,0.003068380929181412,0.1170500554541026,0.0,1,1,0,1,0.1170500554541026,0.0
3652,16,53,6,50,56,1,1436.7420000000004,44,705.9839999999998,MORE,272,496,768,1,2,6.0,0.5624450764046927,6.0,-0.5238227218271837,-0.3702372945959683,-0.9308798655880972,106,50,56,0,-1.077031484018471,-1.170500554541026,-0.9364004436328208,-1.1278084196395834,0.752577668794594,0.752577668794594,-0.9364004436328208,-1.170500554541026,0,0,1,0,-1.170500554541026,-0.9364004436328208
3653,16,54,13,50,47,0,3460.248,30,1365.81,MORE,-2092,2642,550,2,1,-3.0,-0.28122253820234633,3.0,-1.0476454436543674,-1.1526255397799017,0.4879186817342404,97,50,47,1,-1.2565367313548828,-1.170500554541026,-1.2875506099951286,-0.4337724690921475,-2.4953264431090516,2.4953264431090516,-1.2875506099951286,-1.170500554541026,0,0,0,0,-1.170500554541026,-1.2875506099951286
3654,16,55,46,110,124,1,2347.5460000000007,24,1986.477,MORE,-134,1220,1086,3,1,14.0,1.3123718449442827,14.0,0.8730378697119728,-1.4879347877158726,-0.29226184711156444,234,110,124,0,1.4759320336549415,1.170500554541026,1.7167341466601715,0.2602634814552885,0.19477349390758886,0.19477349390758886,1.7167341466601715,1.170500554541026,0,1,1,2,1.7167341466601715,1.170500554541026
3655,16,56,27,91,80,1,4932.093,24,1708.037,MORE,876,1698,2574,4,1,-11.0,-1.0311493067419364,11.0,0.34921514788478913,-1.4879347877158726,1.5199153982666578,171,91,80,1,0.21939530230005888,0.4291835366650429,0.0,0.9542994320027245,1.5824144215821583,1.5824144215821583,0.0,0.4291835366650429,0,1,1,1,0.4291835366650429,0.0
3656,16,57,40,64,80,1,3935.056,14,1237.635,MORE,-146,1874,1728,5,1,16.0,1.4998535370791803,16.0,1.222253017596762,-2.046783534275825,0.8208343739323483,144,64,80,0,-0.3191204397091766,-0.6242669624218805,0.0,1.6483353825501603,0.17828667100452467,0.17828667100452467,0.0,-0.6242669624218805,0,1,1,1,-0.6242669624218805,0.0
3657,16,58,22,83,80,1,2121.737,64,1128.934,MORE,-190,998,808,1,2,-3.0,-0.28122253820234633,3.0,-1.0476454436543674,0.7474601985239361,-0.4505897597405909,163,83,80,1,0.05983508244547061,0.1170500554541026,0.0,-1.1278084196395834,0.11783498702662265,0.11783498702662265,0.0,0.1170500554541026,1,0,1,1,0.1170500554541026,0.0
3658,16,59,54,101,110,1,1531.599,84,1230.267,MORE,408,466,874,1,2,9.0,0.8436676146070391,9.0,0.0,1.8651576916438404,-0.8643700683335528,211,101,110,0,1.0171964015730004,0.8193503881787182,1.170500554541026,-1.1278084196395834,0.9394283283626548,0.9394283283626548,1.170500554541026,0.8193503881787182,1,0,1,2,1.170500554541026,0.8193503881787182
3659,16,60,6,56,50,0,2478.458,44,1563.26,MORE,-986,1598,612,2,1,-6.0,-0.5624450764046927,6.0,-0.5238227218271837,-0.3702372945959683,-0.20047177807936933,106,56,50,1,-1.077031484018471,-0.9364004436328208,-1.170500554541026,-0.4337724690921475,-0.9757909322099686,0.9757909322099686,-1.170500554541026,-0.9364004436328208,0,0,0,0,-0.9364004436328208,-1.170500554541026
3660,16,61,18,50,42,0,3828.946,54,2090.023,MORE,-1322,2356,1034,4,1,-8.0,-0.7499267685395902,8.0,-0.17460757394239454,0.18861145196398388,0.7464344394343169,92,50,42,1,-1.3562618687640005,-1.170500554541026,-1.4826340357519663,0.9542994320027245,-1.4374219734957658,1.4374219734957658,-1.4826340357519663,-1.170500554541026,1,1,0,0,-1.170500554541026,-1.4826340357519663
3661,16,62,43,110,117,1,4461.252,24,790.7130000000002,MORE,432,1746,2178,5,2,7.0,0.6561859224721414,7.0,-0.34921514788478913,-1.4879347877158726,1.1897812020647212,227,110,117,0,1.3363168412821769,1.170500554541026,1.4436173506005987,1.6483353825501603,0.9724019741687832,0.9724019741687832,1.4436173506005987,1.170500554541026,0,1,1,2,1.4436173506005987,1.170500554541026
3662,16,63,32,77,80,0,2795.627,34,1097.404,MORE,-748,1504,756,2,1,3.0,0.28122253820234633,3.0,-1.0476454436543674,-0.9290860411559204,0.021913980329885882,157,77,80,0,-0.05983508244547061,-0.1170500554541026,0.0,-0.4337724690921475,-0.6488022779658622,0.6488022779658622,0.0,-0.1170500554541026,0,0,0,1,-0.1170500554541026,0.0
3663,16,64,27,80,91,0,3155.075,44,1333.104,MORE,-158,1418,1260,4,1,11.0,1.0311493067419364,11.0,0.34921514788478913,-0.3702372945959683,0.27394402137642565,171,80,91,0,0.21939530230005888,0.0,0.4291835366650429,0.9542994320027245,0.16179984810146048,0.16179984810146048,0.4291835366650429,0.0,0,1,1,1,0.4291835366650429,0.0
3664,16,65,16,44,50,1,1472.473,74,2048.362,MORE,54,556,610,1,1,6.0,0.5624450764046927,6.0,-0.5238227218271837,1.3063089450838885,-0.9058267691829599,94,44,50,0,-1.3163718138003533,-1.4046006654492311,-1.170500554541026,-1.1278084196395834,0.45306705272226117,0.45306705272226117,-1.170500554541026,-1.4046006654492311,1,0,1,0,-1.4046006654492311,-1.170500554541026
3665,16,66,7,50,57,1,1866.506,74,1398.101,MORE,788,212,1000,1,2,7.0,0.6561859224721414,7.0,-0.34921514788478913,1.3063089450838885,-0.6295471594377637,107,50,57,0,-1.0570864565366473,-1.170500554541026,-0.8973837584814532,-1.1278084196395834,1.461511053626354,1.461511053626354,-0.8973837584814532,-1.170500554541026,1,0,1,0,-1.170500554541026,-0.8973837584814532
3666,16,67,14,50,46,0,1862.875,74,955.688,MORE,-580,1070,490,1,2,-4.0,-0.3749633842697951,4.0,-0.8730378697119728,1.3063089450838885,-0.632093066158736,96,50,46,1,-1.2764817588367063,-1.170500554541026,-1.3265672951464962,-1.1278084196395834,-0.41798675732296353,0.41798675732296353,-1.3265672951464962,-1.170500554541026,1,0,0,0,-1.170500554541026,-1.3265672951464962
3667,16,68,51,110,108,0,1877.529,24,802.7439999999998,MORE,-462,1016,554,2,1,-2.0,-0.18748169213489754,2.0,-1.222253017596762,-1.4879347877158726,-0.6218182886624194,218,110,108,1,1.156811593945765,1.170500554541026,1.092467184238291,-0.4337724690921475,-0.255866332109499,0.255866332109499,1.092467184238291,1.170500554541026,0,1,0,2,1.170500554541026,1.092467184238291
3668,16,69,50,133,110,0,1935.355,54,1006.368,MORE,-454,1058,604,2,1,-23.0,-2.1560394595513217,23.0,2.444506035193524,0.18861145196398388,-0.5812730939372931,243,133,110,1,1.6554372809913533,2.0678843130224793,1.170500554541026,-0.4337724690921475,-0.24487511684078953,0.24487511684078953,1.170500554541026,2.0678843130224793,1,1,0,2,2.0678843130224793,1.170500554541026
3669,16,70,49,131,110,1,4587.041,34,1661.309,MORE,80,1982,2062,5,2,-21.0,-1.9685577674164243,21.0,2.0952908873087353,-0.9290860411559204,1.2779792358086928,241,131,110,1,1.6155472260277064,1.9898509427197442,1.170500554541026,1.6483353825501603,0.4887885023455669,0.4887885023455669,1.170500554541026,1.9898509427197442,0,1,1,2,1.9898509427197442,1.170500554541026
3670,16,71,47,126,110,0,2047.813,4,1954.489,MORE,-1562,2114,552,2,1,-16.0,-1.4998535370791803,16.0,1.222253017596762,-2.605632280835777,-0.5024222049185426,236,126,110,1,1.5158220886185887,1.7947675169629065,1.170500554541026,-0.4337724690921475,-1.7671584315570497,1.7671584315570497,1.170500554541026,1.7947675169629065,0,0,0,2,1.7947675169629065,1.170500554541026
3671,16,72,50,110,133,1,1788.521,64,1914.64,MORE,290,776,1066,2,1,23.0,2.1560394595513217,23.0,2.444506035193524,0.7474601985239361,-0.6842270095162576,243,110,133,0,1.6554372809913533,1.170500554541026,2.0678843130224793,-0.4337724690921475,0.7773079031491903,0.7773079031491903,2.0678843130224793,1.170500554541026,1,1,1,2,2.0678843130224793,1.170500554541026
3672,16,73,47,110,126,1,2422.426,94,1909.529,MORE,770,952,1722,3,2,16.0,1.4998535370791803,16.0,1.222253017596762,2.4240064382037927,-0.23975909435298826,236,110,126,0,1.5158220886185887,1.170500554541026,1.7947675169629065,0.2602634814552885,1.436780819271758,1.436780819271758,1.7947675169629065,1.170500554541026,1,1,1,2,1.7947675169629065,1.170500554541026
3673,16,74,12,48,50,1,2130.592,34,879.732,MORE,202,822,1024,3,2,2.0,0.18748169213489754,2.0,-1.222253017596762,-0.9290860411559204,-0.444381000717124,98,48,50,0,-1.2365917038730592,-1.248533924843761,-1.170500554541026,0.2602634814552885,0.6564045351933862,0.6564045351933862,-1.170500554541026,-1.248533924843761,0,1,1,0,-1.248533924843761,-1.170500554541026
3674,16,75,32,80,77,1,2285.173,54,1788.464,MORE,554,970,1524,5,2,-3.0,-0.28122253820234633,3.0,-1.0476454436543674,0.18861145196398388,-0.33599520979600295,157,80,77,1,-0.05983508244547061,0.0,-0.1170500554541026,1.6483353825501603,1.1400180070166024,1.1400180070166024,-0.1170500554541026,0.0,1,1,1,1,0.0,-0.1170500554541026
3675,16,76,43,117,110,0,4221.68,54,1298.565,MORE,-2938,3496,558,2,1,-7.0,-0.6561859224721414,7.0,-0.34921514788478913,0.18861145196398388,1.0218032442137897,227,117,110,1,1.3363168412821769,1.4436173506005987,1.170500554541026,-0.4337724690921475,-3.6576474577750773,3.6576474577750773,1.170500554541026,1.4436173506005987,1,1,0,2,1.4436173506005987,1.170500554541026
3676,16,77,40,80,64,0,1724.138,4,1235.35,MORE,-1022,1540,518,2,1,-16.0,-1.4998535370791803,16.0,1.222253017596762,-2.605632280835777,-0.7293697009005451,144,80,64,1,-0.3191204397091766,0.0,-0.6242669624218805,-0.4337724690921475,-1.0252514009191611,1.0252514009191611,-0.6242669624218805,0.0,0,1,0,1,0.0,-0.6242669624218805
3677,16,78,31,80,78,0,2763.993,44,1174.27,MORE,-424,1450,1026,4,1,-2.0,-0.18748169213489754,2.0,-1.222253017596762,-0.3702372945959683,-0.00026646946665282616,158,80,78,1,-0.03989005496364707,0.0,-0.07803337030273506,0.9542994320027245,-0.20365805958312905,0.20365805958312905,-0.07803337030273506,0.0,0,1,0,1,0.0,-0.07803337030273506
3678,16,79,46,124,110,0,1961.624,54,1099.932,MORE,-664,1180,516,2,1,-14.0,-1.3123718449442827,14.0,0.8730378697119728,0.18861145196398388,-0.5628543597998057,234,124,110,1,1.4759320336549415,1.7167341466601715,1.170500554541026,-0.4337724690921475,-0.5333945176444128,0.5333945176444128,1.170500554541026,1.7167341466601715,1,1,0,2,1.7167341466601715,1.170500554541026
3679,16,80,58,92,110,1,3086.572,24,1331.845,MORE,212,1212,1424,3,2,18.0,1.6873352292140782,18.0,1.571468165481551,-1.4879347877158726,0.2259125567367252,202,92,110,0,0.8376911542365885,0.4682002218164104,1.170500554541026,0.2602634814552885,0.670143554279273,0.670143554279273,1.170500554541026,0.4682002218164104,0,1,1,2,1.170500554541026,0.4682002218164104
3680,16,81,48,128,110,1,2803.514,44,1405.844,LESS,-372,1726,1354,3,1,-18.0,-1.6873352292140782,18.0,1.571468165481551,-0.3702372945959683,0.027444017870042185,238,128,110,0,1.5557121435822359,1.8728008872656416,1.170500554541026,0.2602634814552885,-0.13221516033651756,0.13221516033651756,1.170500554541026,1.8728008872656416,0,1,1,2,1.8728008872656416,1.170500554541026
3681,16,82,8,50,58,0,2544.863,24,846.9860000000001,LESS,-942,1464,522,2,1,8.0,0.7499267685395902,8.0,-0.17460757394239454,-1.4879347877158726,-0.15391134409254673,108,50,58,1,-1.0371414290548238,-1.170500554541026,-0.8583670733300858,-0.4337724690921475,-0.9153392482320666,0.9153392482320666,-0.8583670733300858,-1.170500554541026,0,0,0,0,-1.170500554541026,-0.8583670733300858
3682,16,83,4,54,50,1,1861.787,54,1332.7520000000004,LESS,688,518,1206,1,2,-4.0,-0.3749633842697951,4.0,-0.8730378697119728,0.18861145196398388,-0.6328559266689033,104,54,50,0,-1.116921538982118,-1.0144338139355558,-1.170500554541026,-1.1278084196395834,1.3241208627674859,1.3241208627674859,-1.170500554541026,-1.0144338139355558,1,0,1,0,-1.0144338139355558,-1.170500554541026
3683,16,84,37,80,69,1,1488.12,54,1303.728,LESS,462,610,1072,2,1,-11.0,-1.0311493067419364,11.0,0.34921514788478913,0.18861145196398388,-0.8948557412394043,149,80,69,0,-0.21939530230005888,0.0,-0.4291835366650429,-0.4337724690921475,1.0136190314264437,1.0136190314264437,-0.4291835366650429,0.0,1,0,1,1,0.0,-0.4291835366650429
3684,16,85,52,105,110,1,2691.067,14,2116.576,LESS,204,1100,1304,3,2,5.0,0.4687042303372438,5.0,-0.6984302957695783,-2.046783534275825,-0.05139915840457973,215,105,110,1,1.0969765115002945,0.9754171287841883,1.170500554541026,0.2602634814552885,0.6591523390105636,0.6591523390105636,1.170500554541026,0.9754171287841883,0,1,1,2,1.170500554541026,0.9754171287841883
3685,16,86,5,55,50,1,2097.914,54,1109.751,LESS,302,776,1078,3,2,-5.0,-0.4687042303372438,5.0,-0.6984302957695783,0.18861145196398388,-0.4672934600473159,105,55,50,0,-1.0969765115002945,-0.9754171287841883,-1.170500554541026,0.2602634814552885,0.7937947260522544,0.7937947260522544,-1.170500554541026,-0.9754171287841883,1,1,1,0,-0.9754171287841883,-1.170500554541026
3686,16,87,30,96,80,1,1489.775,74,1481.145,LESS,684,338,1022,1,2,-16.0,-1.4998535370791803,16.0,1.222253017596762,1.3063089450838885,-0.8936953238273391,176,96,80,0,0.3191204397091766,0.6242669624218805,0.0,-1.1278084196395834,1.3186252551331312,1.3186252551331312,0.0,0.6242669624218805,1,0,1,1,0.6242669624218805,0.0
3687,16,88,33,80,75,0,3101.53,34,2096.806,LESS,-912,1802,890,1,1,-5.0,-0.4687042303372438,5.0,-0.6984302957695783,-0.9290860411559204,0.2364004864344121,155,80,75,0,-0.09972513740911768,0.0,-0.19508342575683765,-1.1278084196395834,-0.8741221909744061,0.8741221909744061,-0.19508342575683765,0.0,0,0,0,1,0.0,-0.19508342575683765
3688,16,89,48,110,128,0,1626.11,44,1294.924,LESS,-576,1008,432,2,1,18.0,1.6873352292140782,18.0,1.571468165481551,-0.3702372945959683,-0.7981028719397781,238,110,128,1,1.5557121435822359,1.170500554541026,1.8728008872656416,-0.4337724690921475,-0.4124911496886088,0.4124911496886088,1.8728008872656416,1.170500554541026,0,0,0,2,1.8728008872656416,1.170500554541026
3689,16,90,9,59,50,1,2510.29,74,1692.951,LESS,536,960,1496,3,2,-9.0,-0.8436676146070391,9.0,0.0,1.3063089450838885,-0.17815249888851714,109,59,50,0,-1.0171964015730004,-0.8193503881787182,-1.170500554541026,0.2602634814552885,1.115287772662006,1.115287772662006,-1.170500554541026,-0.8193503881787182,1,1,1,0,-0.8193503881787182,-1.170500554541026
3690,16,91,44,110,119,0,1714.624,54,1999.882,LESS,-788,1196,408,2,1,9.0,0.8436676146070391,9.0,0.0,0.18861145196398388,-0.7360405234131666,229,110,119,1,1.376206896245824,1.170500554541026,1.5216507209033339,-0.4337724690921475,-0.7037583543094095,0.7037583543094095,1.5216507209033339,1.170500554541026,1,0,0,2,1.5216507209033339,1.170500554541026
3691,16,92,2,52,50,0,3615.13,54,1589.484,LESS,-856,1770,914,3,1,-2.0,-0.18748169213489754,2.0,-1.222253017596762,0.18861145196398388,0.5965155213810605,102,52,50,0,-1.156811593945765,-1.092467184238291,-1.170500554541026,0.2602634814552885,-0.7971836840934399,0.7971836840934399,-1.170500554541026,-1.092467184238291,1,1,0,0,-1.092467184238291,-1.170500554541026
3692,16,93,8,58,50,1,1902.783,54,872.553,LESS,404,654,1058,1,2,-8.0,-0.7499267685395902,8.0,-0.17460757394239454,0.18861145196398388,-0.6041112304604284,108,58,50,0,-1.0371414290548238,-0.8583670733300858,-1.170500554541026,-1.1278084196395834,0.9339327207283,0.9339327207283,-1.170500554541026,-0.8583670733300858,1,0,1,0,-0.8583670733300858,-1.170500554541026
3693,16,94,44,119,110,1,2407.591,44,1204.848,LESS,390,986,1376,4,1,-9.0,-0.8436676146070391,9.0,0.0,-0.3702372945959683,-0.25016078154814697,229,119,110,0,1.376206896245824,1.5216507209033339,1.170500554541026,0.9542994320027245,0.9146980940080585,0.9146980940080585,1.170500554541026,1.5216507209033339,0,1,1,2,1.5216507209033339,1.170500554541026
3694,16,95,34,74,80,0,1659.011,44,813.938,LESS,-494,1006,512,2,1,6.0,0.5624450764046927,6.0,-0.5238227218271837,-0.3702372945959683,-0.7750340542513441,154,74,80,1,-0.11967016489094122,-0.2341001109082052,0.0,-0.4337724690921475,-0.2998311931843368,0.2998311931843368,0.0,-0.2341001109082052,0,0,0,1,-0.2341001109082052,0.0
3695,16,96,24,86,80,0,1623.4779999999996,24,1394.325,LESS,-742,1170,428,2,1,-6.0,-0.5624450764046927,6.0,-0.5238227218271837,-1.4879347877158726,-0.7999483212621684,166,86,80,0,0.11967016489094122,0.2341001109082052,0.0,-0.4337724690921475,-0.6405588665143301,0.6405588665143301,0.0,0.2341001109082052,0,0,0,1,0.2341001109082052,0.0
3696,16,97,39,66,80,0,1791.695,54,1105.062,LESS,-360,902,542,2,1,14.0,1.3123718449442827,14.0,0.8730378697119728,0.18861145196398388,-0.6820015322558981,146,66,80,1,-0.2792303847455295,-0.5462335921191455,0.0,-0.4337724690921475,-0.11572833743345337,0.11572833743345337,0.0,-0.5462335921191455,1,0,1,1,-0.5462335921191455,0.0
3697,16,98,9,50,59,0,1734.8570000000002,54,966.912,LESS,-506,1032,526,2,1,9.0,0.8436676146070391,9.0,0.0,0.18861145196398388,-0.7218539823265708,109,50,59,1,-1.0171964015730004,-1.170500554541026,-0.8193503881787182,-0.4337724690921475,-0.316318016087401,0.316318016087401,-0.8193503881787182,-1.170500554541026,1,0,0,0,-1.170500554541026,-0.8193503881787182
3698,16,99,57,94,110,0,1758.39,44,1435.231,LESS,-706,1222,516,2,1,16.0,1.4998535370791803,16.0,1.222253017596762,-0.3702372945959683,-0.7053536180014162,204,94,110,1,0.8775812092002355,0.5462335921191455,1.170500554541026,-0.4337724690921475,-0.5910983978051375,0.5910983978051375,1.170500554541026,0.5462335921191455,0,0,0,2,1.170500554541026,0.5462335921191455
3699,16,100,60,110,87,1,2344.225,54,1853.898,LESS,524,794,1318,3,2,-23.0,-2.1560394595513217,23.0,2.444506035193524,0.18861145196398388,-0.29459039467982395,197,110,87,0,0.7379660168274708,1.170500554541026,0.27311679605957273,0.2602634814552885,1.098800949758942,1.098800949758942,0.27311679605957273,1.170500554541026,1,1,1,2,1.170500554541026,0.27311679605957273
3700,16,101,33,75,80,0,2101.854,54,812.684,LESS,-830,1384,554,2,1,5.0,0.4687042303372438,5.0,-0.6984302957695783,0.18861145196398388,-0.464530895332188,155,75,80,1,-0.09972513740911768,-0.19508342575683765,0.0,-0.4337724690921475,-0.7614622344701342,0.7614622344701342,0.0,-0.19508342575683765,1,0,0,1,-0.19508342575683765,0.0
3701,16,102,15,50,45,1,3114.9040000000005,54,1596.082,LESS,312,1420,1732,3,1,-5.0,-0.4687042303372438,5.0,-0.6984302957695783,0.18861145196398388,0.2457777809775908,95,50,45,0,-1.2964267863185297,-1.170500554541026,-1.3655839802978638,0.2602634814552885,0.8075337451381412,0.8075337451381412,-1.3655839802978638,-1.170500554541026,1,1,1,0,-1.170500554541026,-1.3655839802978638
3702,16,103,59,89,110,0,1732.851,54,1876.152,LESS,-1408,1792,384,2,1,21.0,1.9685577674164243,21.0,2.0952908873087353,0.18861145196398388,-0.7232605063921919,199,89,110,1,0.7778560717911179,0.3511501663623078,1.170500554541026,-0.4337724690921475,-1.5555775376343925,1.5555775376343925,1.170500554541026,0.3511501663623078,1,0,0,2,1.170500554541026,0.3511501663623078
3703,16,104,29,80,94,0,2078.607,44,1673.861,LESS,-1008,1560,552,2,1,14.0,1.3123718449442827,14.0,0.8730378697119728,-0.3702372945959683,-0.4808307283100008,174,80,94,1,0.2792303847455295,0.0,0.5462335921191455,-0.4337724690921475,-1.0060167741989197,1.0060167741989197,0.5462335921191455,0.0,0,0,0,1,0.5462335921191455,0.0
3704,16,105,55,110,98,0,1734.678,54,1843.91,LESS,-424,1094,670,2,2,-12.0,-1.124890152809385,12.0,0.5238227218271837,0.18861145196398388,-0.7219794897082987,208,110,98,0,0.9573613191275298,1.170500554541026,0.7023003327246156,-0.4337724690921475,-0.20365805958312905,0.20365805958312905,0.7023003327246156,1.170500554541026,0,0,0,2,1.170500554541026,0.7023003327246156
3705,16,106,29,94,80,1,2516.607,54,1602.598,LESS,970,1004,1974,3,2,-14.0,-1.3123718449442827,14.0,0.8730378697119728,0.18861145196398388,-0.1737232802830694,174,94,80,0,0.2792303847455295,0.5462335921191455,0.0,0.2602634814552885,1.7115612009894943,1.7115612009894943,0.0,0.5462335921191455,0,1,1,1,0.5462335921191455,0.0
3706,16,107,57,110,94,1,2332.303,54,1475.042,LESS,-48,1266,1218,3,1,-16.0,-1.4998535370791803,16.0,1.222253017596762,0.18861145196398388,-0.3029496069980365,204,110,94,0,0.8775812092002355,1.170500554541026,0.5462335921191455,0.2602634814552885,0.31292905804621557,0.31292905804621557,0.5462335921191455,1.170500554541026,0,1,1,2,1.170500554541026,0.5462335921191455
3707,16,108,39,80,66,1,3024.633,54,1323.289,LESS,504,1254,1758,4,1,-14.0,-1.3123718449442827,14.0,0.8730378697119728,0.18861145196398388,0.18248349686608548,146,80,66,0,-0.2792303847455295,0.0,-0.5462335921191455,0.9542994320027245,1.0713229115871683,1.0713229115871683,-0.5462335921191455,0.0,0,1,1,1,0.0,-0.5462335921191455
3708,16,109,4,50,54,0,4090.687,64,2790.031,LESS,-2320,3070,750,2,1,4.0,0.3749633842697951,4.0,-0.8730378697119728,0.7474601985239361,0.9299563813384656,104,50,54,1,-1.116921538982118,-1.170500554541026,-1.0144338139355558,-0.4337724690921475,-2.808576078267271,2.808576078267271,-1.0144338139355558,-1.170500554541026,1,0,0,0,-1.170500554541026,-1.0144338139355558
3709,16,110,55,98,110,0,3128.631,64,1306.901,LESS,-840,1918,1078,4,1,12.0,1.124890152809385,12.0,0.5238227218271837,0.7474601985239361,0.255402584491439,208,98,110,1,0.9573613191275298,0.7023003327246156,1.170500554541026,0.9542994320027245,-0.775201253556021,0.775201253556021,1.170500554541026,0.7023003327246156,1,1,0,2,1.170500554541026,0.7023003327246156
3710,16,111,2,50,52,0,2587.4210000000007,74,2137.141,LESS,-1428,1986,558,2,1,2.0,0.18748169213489754,2.0,-1.222253017596762,1.3063089450838885,-0.12407143821781973,102,50,52,1,-1.156811593945765,-1.170500554541026,-1.092467184238291,-0.4337724690921475,-1.5830555758061662,1.5830555758061662,-1.092467184238291,-1.170500554541026,1,0,0,0,-1.170500554541026,-1.092467184238291
3711,16,112,59,110,89,1,2383.534,74,2175.145,LESS,470,936,1406,3,2,-21.0,-1.9685577674164243,21.0,2.0952908873087353,1.3063089450838885,-0.2670285529572425,199,110,89,0,0.7778560717911179,1.170500554541026,0.3511501663623078,0.2602634814552885,1.024610246695153,1.024610246695153,0.3511501663623078,1.170500554541026,1,1,1,2,1.170500554541026,0.3511501663623078
3712,16,113,60,87,110,0,3422.254000000001,64,1509.588,LESS,-690,1760,1070,4,1,23.0,2.1560394595513217,23.0,2.444506035193524,0.7474601985239361,0.4612788635142974,197,87,110,1,0.7379660168274708,0.27311679605957273,1.170500554541026,0.9542994320027245,-0.5691159672677186,0.5691159672677186,1.170500554541026,0.27311679605957273,1,1,0,2,1.170500554541026,0.27311679605957273
3713,16,114,52,110,105,0,3160.078,54,1795.345,LESS,-984,1772,788,4,1,-5.0,-0.4687042303372438,5.0,-0.6984302957695783,0.18861145196398388,0.2774519176377928,215,110,105,0,1.0969765115002945,1.170500554541026,0.9754171287841883,0.9542994320027245,-0.9730431283927913,0.9730431283927913,0.9754171287841883,1.170500554541026,0,1,0,2,1.170500554541026,0.9754171287841883
3714,16,115,30,80,96,0,1962.005,64,1601.351,LESS,-1072,1488,416,2,1,16.0,1.4998535370791803,16.0,1.222253017596762,0.7474601985239361,-0.5625872183895356,176,80,96,1,0.3191204397091766,0.0,0.6242669624218805,-0.4337724690921475,-1.0939464963485954,1.0939464963485954,0.6242669624218805,0.0,1,0,0,1,0.6242669624218805,0.0
3715,16,116,24,80,86,0,1680.483,64,986.194,LESS,-710,1122,412,2,1,6.0,0.5624450764046927,6.0,-0.5238227218271837,0.7474601985239361,-0.759978777712453,166,80,86,1,0.11967016489094122,0.0,0.2341001109082052,-0.4337724690921475,-0.5965940054394923,0.5965940054394923,0.2341001109082052,0.0,1,0,0,1,0.2341001109082052,0.0
3716,16,117,5,50,55,0,1656.122,64,1365.624,LESS,-734,1126,392,2,1,5.0,0.4687042303372438,5.0,-0.6984302957695783,0.7474601985239361,-0.7770597013229189,105,50,55,1,-1.0969765115002945,-1.170500554541026,-0.9754171287841883,-0.4337724690921475,-0.6295676512456206,0.6295676512456206,-0.9754171287841883,-1.170500554541026,1,0,0,0,-1.170500554541026,-0.9754171287841883
3717,16,118,34,80,74,0,2741.023,14,1730.023,LESS,-568,1576,1008,4,1,-6.0,-0.5624450764046927,6.0,-0.5238227218271837,-2.046783534275825,-0.016372081524138108,154,80,74,0,-0.11967016489094122,0.0,-0.2341001109082052,0.9542994320027245,-0.40149993441989934,0.40149993441989934,-0.2341001109082052,0.0,0,1,0,1,0.0,-0.2341001109082052
3718,16,119,15,45,50,0,2959.108,64,1039.52,LESS,-64,1252,1188,3,1,5.0,0.4687042303372438,5.0,-0.6984302957695783,0.7474601985239361,0.13654008240954535,95,45,50,1,-1.2964267863185297,-1.3655839802978638,-1.170500554541026,0.2602634814552885,0.29094662750879663,0.29094662750879663,-1.170500554541026,-1.3655839802978638,1,0,1,0,-1.3655839802978638,-1.170500554541026
3719,16,120,37,69,80,0,1697.1429999999998,84,1744.624,LESS,-252,972,720,2,1,11.0,1.0311493067419364,11.0,0.34921514788478913,1.8651576916438404,-0.7482974761505156,149,69,80,1,-0.21939530230005888,-0.4291835366650429,0.0,-0.4337724690921475,0.032653068694124335,0.032653068694124335,0.0,-0.4291835366650429,1,0,1,1,-0.4291835366650429,0.0
3720,16,121,48,128,110,1,2297.314,54,1738.244,MORE,154,1236,1390,4,1,-18.0,-1.6873352292140782,18.0,1.571468165481551,0.18861145196398388,-0.32748244375377694,238,128,110,1,1.5557121435822359,1.8728008872656416,1.170500554541026,0.9542994320027245,0.5904572435811294,0.5904572435811294,1.170500554541026,1.8728008872656416,1,1,1,2,1.8728008872656416,1.170500554541026
3721,16,122,8,50,58,1,1450.68,54,1471.1429999999998,MORE,198,638,836,1,1,8.0,0.7499267685395902,8.0,-0.17460757394239454,0.18861145196398388,-0.9211071176186926,108,50,58,0,-1.0371414290548238,-1.170500554541026,-0.8583670733300858,-1.1278084196395834,0.6509089275590314,0.6509089275590314,-0.8583670733300858,-1.170500554541026,1,0,1,0,-1.170500554541026,-0.8583670733300858
3722,16,123,4,54,50,0,1785.609,74,1356.09,MORE,-524,1250,726,3,2,-4.0,-0.3749633842697951,4.0,-0.8730378697119728,1.3063089450838885,-0.6862687832346467,104,54,50,1,-1.116921538982118,-1.0144338139355558,-1.170500554541026,0.2602634814552885,-0.3410482504419973,0.3410482504419973,-1.170500554541026,-1.0144338139355558,1,1,0,0,-1.0144338139355558,-1.170500554541026
3723,16,124,37,80,69,0,3070.115,54,2037.406,MORE,-1548,2356,808,2,1,-11.0,-1.0311493067419364,11.0,0.34921514788478913,0.18861145196398388,0.2143735903618866,149,80,69,1,-0.21939530230005888,0.0,-0.4291835366650429,-0.4337724690921475,-1.7479238048368082,1.7479238048368082,-0.4291835366650429,0.0,1,1,0,1,0.0,-0.4291835366650429
3724,16,125,52,105,110,0,2001.393,64,1384.372,MORE,-1064,1544,480,2,1,5.0,0.4687042303372438,5.0,-0.6984302957695783,0.7474601985239361,-0.5349699851409403,215,105,110,0,1.0969765115002945,0.9754171287841883,1.170500554541026,-0.4337724690921475,-1.082955281079886,1.082955281079886,1.170500554541026,0.9754171287841883,1,1,0,2,1.170500554541026,0.9754171287841883
3725,16,126,5,55,50,1,3542.867,54,1436.544,MORE,-134,1608,1474,4,2,-5.0,-0.4687042303372438,5.0,-0.6984302957695783,0.18861145196398388,0.5458477005665168,105,55,50,1,-1.0969765115002945,-0.9754171287841883,-1.170500554541026,0.9542994320027245,0.19477349390758886,0.19477349390758886,-1.170500554541026,-0.9754171287841883,1,1,1,0,-0.9754171287841883,-1.170500554541026
3726,16,127,30,96,80,0,1684.057,84,1900.555,MORE,-894,1392,498,2,1,-16.0,-1.4998535370791803,16.0,1.222253017596762,1.8651576916438404,-0.7574728370292378,176,96,80,1,0.3191204397091766,0.6242669624218805,0.0,-0.4337724690921475,-0.8493919566198098,0.8493919566198098,0.0,0.6242669624218805,1,1,0,1,0.6242669624218805,0.0
3727,16,128,33,80,75,0,3277.203,54,1411.7420000000004,MORE,-566,1600,1034,4,1,-5.0,-0.4687042303372438,5.0,-0.6984302957695783,0.18861145196398388,0.3595751136427113,155,80,75,1,-0.09972513740911768,0.0,-0.19508342575683765,0.9542994320027245,-0.39875213060272197,0.39875213060272197,-0.19508342575683765,0.0,1,1,0,1,0.0,-0.19508342575683765
3728,16,129,48,110,128,1,2804.936,64,1975.425,MORE,148,1106,1254,4,1,18.0,1.6873352292140782,18.0,1.571468165481551,0.7474601985239361,0.028441065338294026,238,110,128,0,1.5557121435822359,1.170500554541026,1.8728008872656416,0.9542994320027245,0.5822138321295973,0.5822138321295973,1.8728008872656416,1.170500554541026,1,1,1,2,1.8728008872656416,1.170500554541026
3729,16,130,9,59,50,0,2607.568,44,1261.758,MORE,-284,1422,1138,4,1,-9.0,-0.8436676146070391,9.0,0.0,-0.3702372945959683,-0.10994519676713838,109,59,50,1,-1.0171964015730004,-0.8193503881787182,-1.170500554541026,0.9542994320027245,-0.011311792380713507,0.011311792380713507,-1.170500554541026,-0.8193503881787182,0,1,0,0,-0.8193503881787182,-1.170500554541026
3730,16,131,44,110,119,1,4602.334,24,1066.111,MORE,196,1924,2120,5,1,9.0,0.8436676146070391,9.0,0.0,-1.4879347877158726,1.2887020536230211,229,110,119,0,1.376206896245824,1.170500554541026,1.5216507209033339,1.6483353825501603,0.6481611237418541,0.6481611237418541,1.5216507209033339,1.170500554541026,0,1,1,2,1.5216507209033339,1.170500554541026
3731,16,132,2,52,50,1,2088.893,24,2252.214,MORE,382,792,1174,4,1,-2.0,-0.18748169213489754,2.0,-1.222253017596762,-1.4879347877158726,-0.4736186113912679,102,52,50,1,-1.156811593945765,-1.092467184238291,-1.170500554541026,0.9542994320027245,0.9037068787393491,0.9037068787393491,-1.170500554541026,-1.092467184238291,0,1,1,0,-1.092467184238291,-1.170500554541026
3732,16,133,8,58,50,0,2599.006,44,686.068,MORE,-1534,2130,596,2,1,-8.0,-0.7499267685395902,8.0,-0.17460757394239454,-0.3702372945959683,-0.11594851633336373,108,58,50,1,-1.0371414290548238,-0.8583670733300858,-1.170500554541026,-0.4337724690921475,-1.7286891781165665,1.7286891781165665,-1.170500554541026,-0.8583670733300858,0,1,0,0,-0.8583670733300858,-1.170500554541026
3733,16,134,44,119,110,0,2728.257,34,1766.0739999999996,MORE,-152,1328,1176,2,1,-9.0,-0.8436676146070391,9.0,0.0,-0.9290860411559204,-0.02532307166457608,229,119,110,1,1.376206896245824,1.5216507209033339,1.170500554541026,-0.4337724690921475,0.17004325955299257,0.17004325955299257,1.170500554541026,1.5216507209033339,0,1,1,2,1.5216507209033339,1.170500554541026
3734,16,135,34,74,80,1,1424.432,64,1262.171,MORE,472,394,866,1,2,6.0,0.5624450764046927,6.0,-0.5238227218271837,0.7474601985239361,-0.93951112742648,154,74,80,0,-0.11967016489094122,-0.2341001109082052,0.0,-1.1278084196395834,1.0273580505123305,1.0273580505123305,0.0,-0.2341001109082052,1,0,1,1,-0.2341001109082052,0.0
3735,16,136,24,86,80,0,4003.233,54,952.968,MORE,460,1616,2076,4,1,-6.0,-0.5624450764046927,6.0,-0.5238227218271837,0.18861145196398388,0.8686372608824217,166,86,80,1,0.11967016489094122,0.2341001109082052,0.0,0.9542994320027245,1.0108712276092662,1.0108712276092662,0.0,0.2341001109082052,1,1,1,1,0.2341001109082052,0.0
3736,16,137,39,66,80,1,2458.65,54,1980.77,MORE,152,1014,1166,3,2,14.0,1.3123718449442827,14.0,0.8730378697119728,0.18861145196398388,-0.21436032677918088,146,66,80,0,-0.2792303847455295,-0.5462335921191455,0.0,0.2602634814552885,0.5877094397639521,0.5877094397639521,0.0,-0.5462335921191455,1,1,1,1,-0.5462335921191455,0.0
3737,16,138,9,50,59,1,1380.082,64,1928.36,MORE,292,484,776,1,2,9.0,0.8436676146070391,9.0,0.0,0.7474601985239361,-0.9706075094355996,109,50,59,0,-1.0171964015730004,-1.170500554541026,-0.8193503881787182,-1.1278084196395834,0.7800557069663676,0.7800557069663676,-0.8193503881787182,-1.170500554541026,1,0,1,0,-1.170500554541026,-0.8193503881787182
3738,16,139,57,94,110,1,2036.945,64,2782.967,MORE,234,772,1006,3,2,16.0,1.4998535370791803,16.0,1.222253017596762,0.7474601985239361,-0.5100423961175307,204,94,110,0,0.8775812092002355,0.5462335921191455,1.170500554541026,0.2602634814552885,0.700369396268224,0.700369396268224,1.170500554541026,0.5462335921191455,1,1,1,2,1.170500554541026,0.5462335921191455
3739,16,140,60,110,87,0,2979.857,54,1034.516,MORE,-988,1852,864,2,1,-23.0,-2.1560394595513217,23.0,2.444506035193524,0.18861145196398388,0.15108842131162467,197,110,87,1,0.7379660168274708,1.170500554541026,0.27311679605957273,-0.4337724690921475,-0.978538736027146,0.978538736027146,0.27311679605957273,1.170500554541026,1,1,0,2,1.170500554541026,0.27311679605957273
3740,16,141,33,75,80,1,1563.707,64,1431.844,MORE,790,422,1212,1,2,5.0,0.4687042303372438,5.0,-0.6984302957695783,0.7474601985239361,-0.8418572693809301,155,75,80,0,-0.09972513740911768,-0.19508342575683765,0.0,-1.1278084196395834,1.4642588574435316,1.4642588574435316,0.0,-0.19508342575683765,1,0,1,1,-0.19508342575683765,0.0
3741,16,142,15,50,45,0,1949.932,24,1118.245,MORE,-872,1350,478,2,1,-5.0,-0.4687042303372438,5.0,-0.6984302957695783,-1.4879347877158726,-0.5710523056498762,95,50,45,1,-1.2964267863185297,-1.170500554541026,-1.3655839802978638,-0.4337724690921475,-0.8191661146308589,0.8191661146308589,-1.3655839802978638,-1.170500554541026,0,1,0,0,-1.170500554541026,-1.3655839802978638
3742,16,143,59,89,110,1,1564.188,74,1426.149,MORE,480,460,940,1,2,21.0,1.9685577674164243,21.0,2.0952908873087353,1.3063089450838885,-0.8415200121149461,199,89,110,0,0.7778560717911179,0.3511501663623078,1.170500554541026,-1.1278084196395834,1.0383492657810398,1.0383492657810398,1.170500554541026,0.3511501663623078,1,0,1,2,1.170500554541026,0.3511501663623078
3743,16,144,29,80,94,1,1570.775,84,1621.487,MORE,526,328,854,0,2,14.0,1.3123718449442827,14.0,0.8730378697119728,1.8651576916438404,-0.8369014806990708,174,80,94,0,0.2792303847455295,0.0,0.5462335921191455,-1.8218443701870195,1.1015487535761193,1.1015487535761193,0.5462335921191455,0.0,1,0,1,1,0.5462335921191455,0.0
3744,16,145,55,110,98,0,2046.326,54,575.155,MORE,-634,1204,570,2,1,-12.0,-1.124890152809385,12.0,0.5238227218271837,0.18861145196398388,-0.5034648276930085,208,110,98,1,0.9573613191275298,1.170500554541026,0.7023003327246156,-0.4337724690921475,-0.49217746038675236,0.49217746038675236,0.7023003327246156,1.170500554541026,0,0,0,2,1.170500554541026,0.7023003327246156
3745,16,146,29,94,80,1,1989.609,44,1492.9029999999998,MORE,1032,402,1434,1,2,-14.0,-1.3123718449442827,14.0,0.8730378697119728,-0.3702372945959683,-0.5432324375782677,174,94,80,1,0.2792303847455295,0.5462335921191455,0.0,-1.1278084196395834,1.7967431193219927,1.7967431193219927,0.0,0.5462335921191455,0,0,1,1,0.5462335921191455,0.0
3746,16,147,57,110,94,0,4922.105,34,1417.241,MORE,-2006,3248,1242,2,1,-16.0,-1.4998535370791803,16.0,1.222253017596762,-0.9290860411559204,1.5129122265979522,204,110,94,1,0.8775812092002355,1.170500554541026,0.5462335921191455,-0.4337724690921475,-2.377170878970425,2.377170878970425,0.5462335921191455,1.170500554541026,0,0,0,2,1.170500554541026,0.5462335921191455
3747,16,148,39,80,66,0,2979.601,34,1566.369,MORE,-1336,1838,502,2,1,-14.0,-1.3123718449442827,14.0,0.8730378697119728,-0.9290860411559204,0.15090892472099715,146,80,66,1,-0.2792303847455295,0.0,-0.5462335921191455,-0.4337724690921475,-1.4566566002160075,1.4566566002160075,-0.5462335921191455,0.0,0,0,0,1,0.0,-0.5462335921191455
3748,16,149,4,50,54,0,1501.083,44,1157.842,MORE,-676,1166,490,2,1,4.0,0.3749633842697951,4.0,-0.8730378697119728,-0.3702372945959683,-0.8857666228632098,104,50,54,0,-1.116921538982118,-1.170500554541026,-1.0144338139355558,-0.4337724690921475,-0.5498813405474771,0.5498813405474771,-1.0144338139355558,-1.170500554541026,0,0,0,0,-1.170500554541026,-1.0144338139355558
3749,16,150,55,98,110,1,4729.0,54,766.07,MORE,-1274,2808,1534,3,2,12.0,1.124890152809385,12.0,0.5238227218271837,0.18861145196398388,1.3775150034216042,208,98,110,0,0.9573613191275298,0.7023003327246156,1.170500554541026,0.2602634814552885,-1.371474681883509,1.371474681883509,1.170500554541026,0.7023003327246156,0,1,0,2,1.170500554541026,0.7023003327246156
3750,16,151,2,50,52,1,1268.247,44,1510.251,MORE,200,456,656,1,2,2.0,0.18748169213489754,2.0,-1.222253017596762,-0.3702372945959683,-1.0490215766732525,102,50,52,0,-1.156811593945765,-1.170500554541026,-1.092467184238291,-1.1278084196395834,0.6536567313762088,0.6536567313762088,-1.092467184238291,-1.170500554541026,0,0,1,0,-1.170500554541026,-1.092467184238291
3751,16,152,59,110,89,0,1773.473,54,1965.71,MORE,-1216,1722,506,2,1,-21.0,-1.9685577674164243,21.0,2.0952908873087353,0.18861145196398388,-0.694778043484087,199,110,89,1,0.7778560717911179,1.170500554541026,0.3511501663623078,-0.4337724690921475,-1.2917883711853655,1.2917883711853655,0.3511501663623078,1.170500554541026,0,0,0,2,1.170500554541026,0.3511501663623078
3752,16,153,60,87,110,1,3472.1,74,6672.377,MORE,734,1560,2294,3,2,23.0,2.1560394595513217,23.0,2.444506035193524,1.3063089450838885,0.4962288129534529,197,87,110,0,0.7379660168274708,0.27311679605957273,1.170500554541026,0.2602634814552885,1.3873203505625653,1.3873203505625653,1.170500554541026,0.27311679605957273,1,1,1,2,1.170500554541026,0.27311679605957273
3753,16,154,52,110,105,1,3527.954,54,1865.46,MORE,-508,1838,1330,4,1,-5.0,-0.4687042303372438,5.0,-0.6984302957695783,0.18861145196398388,0.5353913230039012,215,110,105,1,1.0969765115002945,1.170500554541026,0.9754171287841883,0.9542994320027245,-0.3190658199045784,0.3190658199045784,0.9754171287841883,1.170500554541026,0,1,0,2,1.170500554541026,0.9754171287841883
3754,16,155,30,80,96,1,1474.216,54,1145.385,MORE,710,420,1130,1,2,16.0,1.4998535370791803,16.0,1.222253017596762,0.18861145196398388,-0.9046046498178664,176,80,96,0,0.3191204397091766,0.0,0.6242669624218805,-1.1278084196395834,1.3543467047564368,1.3543467047564368,0.6242669624218805,0.0,0,0,1,1,0.6242669624218805,0.0
3755,16,156,24,80,86,1,2694.1890000000008,64,1933.838,MORE,-496,1766,1270,0,2,6.0,0.5624450764046927,6.0,-0.5238227218271837,0.7474601985239361,-0.04921014138919089,166,80,86,0,0.11967016489094122,0.0,0.2341001109082052,-1.8218443701870195,-0.3025789970015142,0.3025789970015142,0.2341001109082052,0.0,1,0,0,1,0.2341001109082052,0.0
3756,16,157,5,50,55,1,1369.8,64,928.387,MORE,356,406,762,1,2,5.0,0.4687042303372438,5.0,-0.6984302957695783,0.7474601985239361,-0.977816821720104,105,50,55,0,-1.0969765115002945,-1.170500554541026,-0.9754171287841883,-1.1278084196395834,0.8679854291160433,0.8679854291160433,-0.9754171287841883,-1.170500554541026,1,0,1,0,-1.170500554541026,-0.9754171287841883
3757,16,158,34,80,74,0,2337.132,54,962.254,MORE,-1284,1816,532,1,1,-6.0,-0.5624450764046927,6.0,-0.5238227218271837,0.18861145196398388,-0.29956371232561163,154,80,74,1,-0.11967016489094122,0.0,-0.2341001109082052,-1.1278084196395834,-1.385213700969396,1.385213700969396,-0.2341001109082052,0.0,0,0,0,1,0.0,-0.2341001109082052
3758,16,159,15,45,50,1,1163.444,54,1063.001,MORE,226,382,608,1,2,5.0,0.4687042303372438,5.0,-0.6984302957695783,0.18861145196398388,-1.1225050969371029,95,45,50,0,-1.2964267863185297,-1.3655839802978638,-1.170500554541026,-1.1278084196395834,0.6893781809995145,0.6893781809995145,-1.170500554541026,-1.3655839802978638,0,0,1,0,-1.3655839802978638,-1.170500554541026
3759,16,160,37,69,80,1,2544.723,64,1346.78,MORE,-500,828,328,1,1,11.0,1.0311493067419364,11.0,0.34921514788478913,0.7474601985239361,-0.1540095062905461,149,69,80,0,-0.21939530230005888,-0.4291835366650429,0.0,-1.1278084196395834,-0.30807460463586894,0.30807460463586894,0.0,-0.4291835366650429,1,0,0,1,-0.4291835366650429,0.0
3760,16,161,3,50,53,0,3733.765,14,1145.701,LESS,-1166,2058,892,3,1,3.0,0.28122253820234633,3.0,-1.0476454436543674,-2.046783534275825,0.6796974668072591,103,50,53,1,-1.1368665664639415,-1.170500554541026,-1.0534504990869233,0.2602634814552885,-1.2230932757559314,1.2230932757559314,-1.0534504990869233,-1.170500554541026,0,1,0,0,-1.170500554541026,-1.0534504990869233
3761,16,162,20,50,40,1,1372.3570000000002,34,1250.605,LESS,720,366,1086,1,2,-10.0,-0.9374084606744876,10.0,0.17460757394239454,-0.9290860411559204,-0.9760239592894993,90,50,40,0,-1.3961519237276474,-1.170500554541026,-1.5606674060547012,-1.1278084196395834,1.3680857238423236,1.3680857238423236,-1.5606674060547012,-1.170500554541026,0,0,1,0,-1.170500554541026,-1.5606674060547012
3762,16,163,25,80,88,0,1660.7910000000004,64,1387.411,LESS,-332,956,624,2,2,8.0,0.7499267685395902,8.0,-0.17460757394239454,0.7474601985239361,-0.7737859920196362,168,80,88,1,0.1595602198545883,0.0,0.31213348121094026,-0.4337724690921475,-0.07725908399297027,0.07725908399297027,0.31213348121094026,0.0,1,0,1,1,0.31213348121094026,0.0
3763,16,164,42,115,110,1,2780.666,34,759.3439999999998,LESS,572,976,1548,3,2,-5.0,-0.4687042303372438,5.0,-0.6984302957695783,-0.9290860411559204,0.011423947156527763,225,115,110,0,1.2964267863185297,1.3655839802978638,1.170500554541026,0.2602634814552885,1.1647482413711987,1.1647482413711987,1.170500554541026,1.3655839802978638,0,1,1,2,1.3655839802978638,1.170500554541026
3764,16,165,53,103,110,0,1638.734,54,1488.59,LESS,-858,1274,416,2,1,7.0,0.6561859224721414,7.0,-0.34921514788478913,0.18861145196398388,-0.7892514463144539,213,103,110,1,1.0570864565366473,0.8973837584814532,1.170500554541026,-0.4337724690921475,-0.7999314879106173,0.7999314879106173,1.170500554541026,0.8973837584814532,0,0,0,2,1.170500554541026,0.8973837584814532
3765,16,166,26,90,80,1,2529.656,24,1882.865,LESS,530,912,1442,3,2,-10.0,-0.9374084606744876,10.0,0.17460757394239454,-1.4879347877158726,-0.16457386227096113,170,90,80,0,0.19945027481823535,0.3901668515136753,0.0,0.2602634814552885,1.1070443612104741,1.1070443612104741,0.0,0.3901668515136753,0,1,1,1,0.3901668515136753,0.0
3766,16,167,35,80,72,1,3319.275,44,1068.634,LESS,712,1252,1964,3,2,-8.0,-0.7499267685395902,8.0,-0.17460757394239454,-0.3702372945959683,0.3890742564586682,152,80,72,0,-0.1595602198545883,0.0,-0.31213348121094026,0.2602634814552885,1.3570945085736144,1.3570945085736144,-0.31213348121094026,0.0,0,1,1,1,0.0,-0.31213348121094026
3767,16,168,28,93,80,1,1600.094,34,1478.0320000000004,LESS,528,608,1136,1,1,-13.0,-1.218630998876834,13.0,0.6984302957695783,-0.9290860411559204,-0.8163442129623092,173,93,80,0,0.25928535726370594,0.5072169069677779,0.0,-1.1278084196395834,1.1042965573932966,1.1042965573932966,0.0,0.5072169069677779,0,0,1,1,0.5072169069677779,0.0
3768,16,169,26,80,90,0,2007.16,80,1417.122,LESS,-734,1234,500,2,1,10.0,0.9374084606744876,10.0,0.17460757394239454,1.6416181930198597,-0.530926403741919,170,80,90,1,0.19945027481823535,0.0,0.3901668515136753,-0.4337724690921475,-0.6295676512456206,0.6295676512456206,0.3901668515136753,0.0,1,0,0,1,0.3901668515136753,0.0
3769,16,170,25,88,80,0,2217.586,44,1788.505,LESS,-1120,1606,486,2,1,-8.0,-0.7499267685395902,8.0,-0.17460757394239454,-0.3702372945959683,-0.3833844131973642,168,88,80,0,0.1595602198545883,0.31213348121094026,0.0,-0.4337724690921475,-1.159893787960852,1.159893787960852,0.0,0.31213348121094026,0,0,0,1,0.31213348121094026,0.0
3770,16,171,36,80,70,1,2922.13,24,1634.033,LESS,266,1186,1452,3,2,-10.0,-0.9374084606744876,10.0,0.17460757394239454,-1.4879347877158726,0.1106126412836552,150,80,70,0,-0.19945027481823535,0.0,-0.3901668515136753,0.2602634814552885,0.7443342573430619,0.7443342573430619,-0.3901668515136753,0.0,0,1,1,1,0.0,-0.3901668515136753
3771,16,172,28,80,93,0,2608.895,84,1264.786,LESS,-344,884,540,1,2,13.0,1.218630998876834,13.0,0.6984302957695783,1.8651576916438404,-0.10901475936181494,173,80,93,1,0.25928535726370594,0.0,0.5072169069677779,-1.1278084196395834,-0.09374590689603446,0.09374590689603446,0.5072169069677779,0.0,1,0,1,1,0.5072169069677779,0.0
3772,16,173,21,82,80,1,2210.489,4,1455.871,LESS,-200,1218,1018,3,1,-2.0,-0.18748169213489754,2.0,-1.222253017596762,-2.605632280835777,-0.3883605354773803,162,82,80,0,0.03989005496364707,0.07803337030273506,0.0,0.2602634814552885,0.10409596794073582,0.10409596794073582,0.0,0.07803337030273506,0,0,1,1,0.07803337030273506,0.0
3773,16,174,19,50,41,1,3039.761,44,1956.775,LESS,462,1164,1626,3,2,-9.0,-0.8436676146070391,9.0,0.0,-0.3702372945959683,0.1930906235184861,91,50,41,0,-1.376206896245824,-1.170500554541026,-1.5216507209033339,0.2602634814552885,1.0136190314264437,1.0136190314264437,-1.5216507209033339,-1.170500554541026,0,1,1,0,-1.170500554541026,-1.5216507209033339
3774,16,175,56,96,110,0,1541.849,74,2200.985,LESS,-448,900,452,2,1,14.0,1.3123718449442827,14.0,0.8730378697119728,1.3063089450838885,-0.8571831931228768,206,96,110,1,0.9174712641638826,0.6242669624218805,1.170500554541026,-0.4337724690921475,-0.23663170538925743,0.23663170538925743,1.170500554541026,0.6242669624218805,1,0,0,2,1.170500554541026,0.6242669624218805
3775,16,176,23,80,85,0,2464.052,64,1395.894,LESS,-878,1362,484,2,1,5.0,0.4687042303372438,5.0,-0.6984302957695783,0.7474601985239361,-0.21057266825351534,165,80,85,1,0.09972513740911768,0.0,0.19508342575683765,-0.4337724690921475,-0.8274095260823909,0.8274095260823909,0.19508342575683765,0.0,1,0,0,1,0.19508342575683765,0.0
3776,16,177,10,60,50,1,2385.439,64,1713.784,LESS,226,894,1120,3,2,-10.0,-0.9374084606744876,10.0,0.17460757394239454,0.7474601985239361,-0.26569284590589265,110,60,50,0,-0.9972513740911768,-0.7803337030273506,-1.170500554541026,0.2602634814552885,0.6893781809995145,0.6893781809995145,-1.170500554541026,-0.7803337030273506,1,0,1,0,-0.7803337030273506,-1.170500554541026
3777,16,178,19,41,50,0,1751.336,94,1892.466,LESS,-408,894,486,2,2,9.0,0.8436676146070391,9.0,0.0,2.4240064382037927,-0.7102995904634755,91,41,50,1,-1.376206896245824,-1.5216507209033339,-1.170500554541026,-0.4337724690921475,-0.18167562904571014,0.18167562904571014,-1.170500554541026,-1.5216507209033339,1,0,1,0,-1.5216507209033339,-1.170500554541026
3778,16,179,56,110,96,0,3381.522,34,1625.101,LESS,-926,2064,1138,4,1,-14.0,-1.3123718449442827,14.0,0.8730378697119728,-0.9290860411559204,0.4327192731649064,206,110,96,0,0.9174712641638826,1.170500554541026,0.6242669624218805,0.9542994320027245,-0.8933568176946477,0.8933568176946477,0.6242669624218805,1.170500554541026,0,1,0,2,1.170500554541026,0.6242669624218805
3779,16,180,35,72,80,0,4947.916,34,1861.562,LESS,-236,1698,1462,3,2,8.0,0.7499267685395902,8.0,-0.17460757394239454,-0.9290860411559204,1.5310098301162702,152,72,80,1,-0.1595602198545883,-0.31213348121094026,0.0,0.2602634814552885,0.054635499231543254,0.054635499231543254,0.0,-0.31213348121094026,0,0,1,1,-0.31213348121094026,0.0
3780,16,181,11,49,50,0,3439.893,64,1120.5739999999996,LESS,-512,1504,992,4,1,1.0,0.09374084606744876,1.0,-1.3968605915391563,0.7474601985239361,0.4736465993036737,99,49,50,1,-1.2166466763912356,-1.2095172396923934,-1.170500554541026,0.9542994320027245,-0.32456142753893313,0.32456142753893313,-1.170500554541026,-1.2095172396923934,1,1,0,0,-1.2095172396923934,-1.170500554541026
3781,16,182,17,43,50,0,1827.288,54,858.738,LESS,-922,1302,380,2,1,7.0,0.6561859224721414,7.0,-0.34921514788478913,0.18861145196398388,-0.6570451957316455,93,43,50,1,-1.3363168412821769,-1.4436173506005987,-1.170500554541026,-0.4337724690921475,-0.887861210060293,0.887861210060293,-1.170500554541026,-1.4436173506005987,1,0,0,0,-1.4436173506005987,-1.170500554541026
3782,16,183,1,51,50,0,4233.239000000001,64,1427.4979999999996,LESS,-372,2180,1808,6,1,-1.0,-0.09374084606744876,1.0,-1.3968605915391563,0.7474601985239361,1.0299079359757612,101,51,50,0,-1.1767566214275886,-1.1314838693896585,-1.170500554541026,2.3423713330975966,-0.13221516033651756,0.13221516033651756,-1.170500554541026,-1.1314838693896585,1,1,1,0,-1.1314838693896585,-1.170500554541026
3783,16,184,41,112,110,0,3197.341,64,1272.22,LESS,-662,1852,1190,4,1,-2.0,-0.18748169213489754,2.0,-1.222253017596762,0.7474601985239361,0.30357918895246744,222,112,110,0,1.2365917038730592,1.248533924843761,1.170500554541026,0.9542994320027245,-0.5306467138272355,0.5306467138272355,1.170500554541026,1.248533924843761,1,1,0,2,1.248533924843761,1.170500554541026
3784,16,185,20,40,50,0,1839.566,44,2928.3190000000004,LESS,-2148,2544,396,2,1,10.0,0.9374084606744876,10.0,0.17460757394239454,-0.3702372945959683,-0.6484363709670915,90,40,50,1,-1.3961519237276474,-1.5606674060547012,-1.170500554541026,-0.4337724690921475,-2.572264949990018,2.572264949990018,-1.170500554541026,-1.5606674060547012,0,0,0,0,-1.5606674060547012,-1.170500554541026
3785,16,186,1,50,51,0,1646.644,64,1561.5179999999998,LESS,-696,1076,380,2,1,1.0,0.09374084606744876,1.0,-1.3968605915391563,0.7474601985239361,-0.7837052821274835,101,50,51,1,-1.1767566214275886,-1.170500554541026,-1.1314838693896585,-0.4337724690921475,-0.5773593787192507,0.5773593787192507,-1.1314838693896585,-1.170500554541026,1,0,0,0,-1.170500554541026,-1.1314838693896585
3786,16,187,23,85,80,0,1821.897,64,780.6030000000002,LESS,-588,1136,548,2,1,-5.0,-0.4687042303372438,5.0,-0.6984302957695783,0.7474601985239361,-0.6608251415131826,165,85,80,0,0.09972513740911768,0.19508342575683765,0.0,-0.4337724690921475,-0.428977972591673,0.428977972591673,0.0,0.19508342575683765,1,0,0,1,0.19508342575683765,0.0
3787,16,188,11,50,49,1,3053.78,54,1644.7520000000004,LESS,364,1266,1630,3,1,-1.0,-0.09374084606744876,1.0,-1.3968605915391563,0.18861145196398388,0.20292016533101948,99,50,49,0,-1.2166466763912356,-1.170500554541026,-1.2095172396923934,0.2602634814552885,0.8789766443847528,0.8789766443847528,-1.2095172396923934,-1.170500554541026,0,1,1,0,-1.170500554541026,-1.2095172396923934
3788,16,189,17,50,43,1,2725.795,20,1461.83,LESS,-602,1452,850,1,1,-7.0,-0.6561859224721414,7.0,-0.34921514788478913,-1.7114742863398535,-0.027049324032252568,93,50,43,0,-1.3363168412821769,-1.170500554541026,-1.4436173506005987,-1.1278084196395834,-0.44821259931191454,0.44821259931191454,-1.4436173506005987,-1.170500554541026,0,0,0,0,-1.170500554541026,-1.4436173506005987
3789,16,190,21,80,82,0,1549.39,64,1183.902,LESS,-544,896,352,1,1,2.0,0.18748169213489754,2.0,-1.222253017596762,0.7474601985239361,-0.8518957564434907,162,80,82,1,0.03989005496364707,0.0,0.07803337030273506,-1.1278084196395834,-0.36852628861377096,0.36852628861377096,0.07803337030273506,0.0,1,0,0,1,0.07803337030273506,0.0
3790,16,191,10,50,60,0,1413.255,54,771.2139999999998,LESS,-520,862,342,2,1,10.0,0.9374084606744876,10.0,0.17460757394239454,0.18861145196398388,-0.947347976619624,110,50,60,1,-0.9972513740911768,-1.170500554541026,-0.7803337030273506,-0.4337724690921475,-0.3355526428076426,0.3355526428076426,-0.7803337030273506,-1.170500554541026,0,0,0,0,-1.170500554541026,-0.7803337030273506
3791,16,192,3,53,50,0,2962.129000000001,64,1183.161,LESS,-552,1574,1022,4,1,-3.0,-0.28122253820234633,3.0,-1.0476454436543674,0.7474601985239361,0.13865828241066308,103,53,50,0,-1.1368665664639415,-1.0534504990869233,-1.170500554541026,0.9542994320027245,-0.3795175038824804,0.3795175038824804,-1.170500554541026,-1.0534504990869233,1,1,0,0,-1.0534504990869233,-1.170500554541026
3792,16,193,45,122,110,1,3921.2790000000014,14,680.3560000000001,LESS,344,1726,2070,5,1,-12.0,-1.124890152809385,12.0,0.5238227218271837,-2.046783534275825,0.8111745124906437,232,122,110,0,1.4360419786912946,1.6387007763574364,1.170500554541026,1.6483353825501603,0.8514986062129791,0.8514986062129791,1.170500554541026,1.6387007763574364,0,1,1,2,1.6387007763574364,1.170500554541026
3793,16,194,38,67,80,0,2808.397,54,1231.891,LESS,-590,1534,944,3,1,13.0,1.218630998876834,13.0,0.6984302957695783,0.18861145196398388,0.030867775104552343,147,67,80,1,-0.25928535726370594,-0.5072169069677779,0.0,0.2602634814552885,-0.43172577640885035,0.43172577640885035,0.0,-0.5072169069677779,0,1,0,1,-0.5072169069677779,0.0
3794,16,195,38,80,67,0,2444.954,54,1108.493,LESS,-962,1676,714,2,1,-13.0,-1.218630998876834,13.0,0.6984302957695783,0.18861145196398388,-0.2239633943777581,147,80,67,0,-0.25928535726370594,0.0,-0.5072169069677779,-0.4337724690921475,-0.9428172864038402,0.9428172864038402,-0.5072169069677779,0.0,1,0,0,1,0.0,-0.5072169069677779
3795,16,196,36,70,80,1,1661.744,44,1144.938,LESS,722,410,1132,1,2,10.0,0.9374084606744876,10.0,0.17460757394239454,-0.3702372945959683,-0.7731177879146829,150,70,80,1,-0.19945027481823535,-0.3901668515136753,0.0,-1.1278084196395834,1.3708335276595012,1.3708335276595012,0.0,-0.3901668515136753,0,0,1,1,-0.3901668515136753,0.0
3796,16,197,45,110,122,0,1944.174,64,1340.881,LESS,-802,1318,516,2,1,12.0,1.124890152809385,12.0,0.5238227218271837,0.7474601985239361,-0.5750895766218832,232,110,122,1,1.4360419786912946,1.170500554541026,1.6387007763574364,-0.4337724690921475,-0.722992981029651,0.722992981029651,1.6387007763574364,1.170500554541026,1,0,0,2,1.6387007763574364,1.170500554541026
3797,16,198,42,110,115,0,4598.125,64,1102.229,LESS,-1372,2742,1370,4,1,5.0,0.4687042303372438,5.0,-0.6984302957695783,0.7474601985239361,1.2857508772560229,225,110,115,1,1.2964267863185297,1.170500554541026,1.3655839802978638,0.9542994320027245,-1.5061170689252001,1.5061170689252001,1.3655839802978638,1.170500554541026,1,1,0,2,1.3655839802978638,1.170500554541026
3798,16,199,41,110,112,0,2324.459,54,819.664,LESS,126,1072,1198,3,2,2.0,0.18748169213489754,2.0,-1.222253017596762,0.18861145196398388,-0.3084494947202357,222,110,112,1,1.2365917038730592,1.170500554541026,1.248533924843761,0.2602634814552885,0.5519879901406464,0.5519879901406464,1.248533924843761,1.170500554541026,1,1,1,2,1.248533924843761,1.170500554541026
3799,16,200,53,110,103,0,2029.368,74,1238.017,LESS,-1040,1554,514,2,1,-7.0,-0.6561859224721414,7.0,-0.34921514788478913,1.3063089450838885,-0.5153550745049736,213,110,103,0,1.0570864565366473,1.170500554541026,0.8973837584814532,-0.4337724690921475,-1.0499816352737574,1.0499816352737574,0.8973837584814532,1.170500554541026,1,0,0,2,1.170500554541026,0.8973837584814532
3800,16,201,3,50,53,0,3447.013,34,1662.247,MORE,-436,1838,1402,4,2,3.0,0.28122253820234633,3.0,-1.0476454436543674,-0.9290860411559204,0.4786388482305041,103,50,53,0,-1.1368665664639415,-1.170500554541026,-1.0534504990869233,0.9542994320027245,-0.22014488248619324,0.22014488248619324,-1.0534504990869233,-1.170500554541026,0,1,0,0,-1.170500554541026,-1.0534504990869233
3801,16,202,20,50,40,0,2861.298,54,1401.24,MORE,-378,1408,1030,4,1,-10.0,-0.9374084606744876,10.0,0.17460757394239454,0.18861145196398388,0.06795976393576844,90,50,40,1,-1.3961519237276474,-1.170500554541026,-1.5606674060547012,0.9542994320027245,-0.14045857178804966,0.14045857178804966,-1.5606674060547012,-1.170500554541026,0,1,0,0,-1.170500554541026,-1.5606674060547012
3802,16,203,25,80,88,1,1581.868,74,1480.129,MORE,-224,908,684,0,1,8.0,0.7499267685395902,8.0,-0.17460757394239454,1.3063089450838885,-0.8291235288247267,168,80,88,0,0.1595602198545883,0.0,0.31213348121094026,-1.8218443701870195,0.07112232213460744,0.07112232213460744,0.31213348121094026,0.0,1,0,0,1,0.31213348121094026,0.0
3803,16,204,42,115,110,1,3253.2790000000005,14,662.804,MORE,348,1346,1694,3,1,-5.0,-0.4687042303372438,5.0,-0.6984302957695783,-2.046783534275825,0.3428005963217156,225,115,110,1,1.2964267863185297,1.3655839802978638,1.170500554541026,0.2602634814552885,0.8569942138473339,0.8569942138473339,1.170500554541026,1.3655839802978638,0,1,1,2,1.3655839802978638,1.170500554541026
3804,16,205,53,103,110,1,1378.583,64,1360.634,MORE,246,452,698,1,2,7.0,0.6561859224721414,7.0,-0.34921514788478913,0.7474601985239361,-0.9716585461127512,213,103,110,0,1.0570864565366473,0.8973837584814532,1.170500554541026,-1.1278084196395834,0.7168562191712882,0.7168562191712882,1.170500554541026,0.8973837584814532,1,0,1,2,1.170500554541026,0.8973837584814532
3805,16,206,26,90,80,1,1118.566,54,1105.891,MORE,338,372,710,1,2,-10.0,-0.9374084606744876,10.0,0.17460757394239454,0.18861145196398388,-1.1539716906643922,170,90,80,1,0.19945027481823535,0.3901668515136753,0.0,-1.1278084196395834,0.8432551947614471,0.8432551947614471,0.0,0.3901668515136753,0,0,1,1,0.3901668515136753,0.0
3806,16,207,35,80,72,0,4386.187,44,1779.802,MORE,-564,2272,1708,4,1,-8.0,-0.7499267685395902,8.0,-0.17460757394239454,-0.3702372945959683,1.1371487349730731,152,80,72,1,-0.1595602198545883,0.0,-0.31213348121094026,0.9542994320027245,-0.3960043267855446,0.3960043267855446,-0.31213348121094026,0.0,0,1,0,1,0.0,-0.31213348121094026
3807,16,208,28,93,80,0,4784.368,20,1225.529,MORE,-2122,3116,994,4,1,-13.0,-1.218630998876834,13.0,0.6984302957695783,-1.7114742863398535,1.4163367504132829,173,93,80,1,0.25928535726370594,0.5072169069677779,0.0,0.9542994320027245,-2.536543500366712,2.536543500366712,0.0,0.5072169069677779,0,1,0,1,0.5072169069677779,0.0
3808,16,209,26,80,90,0,4116.16,34,1207.044,MORE,-1298,2624,1326,4,1,10.0,0.9374084606744876,10.0,0.17460757394239454,-0.9290860411559204,0.94781699326447,170,80,90,0,0.19945027481823535,0.0,0.3901668515136753,0.9542994320027245,-1.4044483276896376,1.4044483276896376,0.3901668515136753,0.0,0,1,0,1,0.3901668515136753,0.0
3809,16,210,25,88,80,0,2423.192,24,772.322,MORE,-1330,1794,464,2,1,-8.0,-0.7499267685395902,8.0,-0.17460757394239454,-1.4879347877158726,-0.2392220068982196,168,88,80,1,0.1595602198545883,0.31213348121094026,0.0,-0.4337724690921475,-1.4484131887644753,1.4484131887644753,0.0,0.31213348121094026,0,0,0,1,0.31213348121094026,0.0
3810,16,211,36,80,70,0,1776.985,54,840.423,MORE,-694,1140,446,2,1,-10.0,-0.9374084606744876,10.0,0.17460757394239454,0.18861145196398388,-0.6923155746314145,150,80,70,1,-0.19945027481823535,0.0,-0.3901668515136753,-0.4337724690921475,-0.5746115749020734,0.5746115749020734,-0.3901668515136753,0.0,0,0,0,1,0.0,-0.3901668515136753
3811,16,212,28,80,93,1,1505.001,84,1816.382,MORE,464,502,966,1,2,13.0,1.218630998876834,13.0,0.6984302957695783,1.8651576916438404,-0.8830194836363389,173,80,93,0,0.25928535726370594,0.0,0.5072169069677779,-1.1278084196395834,1.016366835243621,1.016366835243621,0.5072169069677779,0.0,1,0,1,1,0.5072169069677779,0.0
3812,16,213,21,82,80,1,1452.55,94,681.164,MORE,400,474,874,1,2,-2.0,-0.18748169213489754,2.0,-1.222253017596762,2.4240064382037927,-0.9197959511168424,162,82,80,1,0.03989005496364707,0.07803337030273506,0.0,-1.1278084196395834,0.9284371130939453,0.9284371130939453,0.0,0.07803337030273506,1,0,1,1,0.07803337030273506,0.0
3813,16,214,19,50,41,0,1761.95,54,1409.457,MORE,-506,1012,506,2,1,-9.0,-0.8436676146070391,9.0,0.0,0.18861145196398388,-0.7028574935380009,91,50,41,1,-1.376206896245824,-1.170500554541026,-1.5216507209033339,-0.4337724690921475,-0.316318016087401,0.316318016087401,-1.5216507209033339,-1.170500554541026,0,0,0,0,-1.170500554541026,-1.5216507209033339
3814,16,215,56,96,110,1,1458.171,54,1024.91,MORE,708,430,1138,2,1,14.0,1.3123718449442827,14.0,0.8730378697119728,0.18861145196398388,-0.9158547388671636,206,96,110,0,0.9174712641638826,0.6242669624218805,1.170500554541026,-0.4337724690921475,1.3515989009392595,1.3515989009392595,1.170500554541026,0.6242669624218805,0,0,1,2,1.170500554541026,0.6242669624218805
3815,16,216,23,80,85,1,2013.089,74,917.115,MORE,84,870,954,3,2,5.0,0.4687042303372438,5.0,-0.6984302957695783,1.3063089450838885,-0.5267692346566413,165,80,85,0,0.09972513740911768,0.0,0.19508342575683765,0.2602634814552885,0.49428410997992167,0.49428410997992167,0.19508342575683765,0.0,1,1,1,1,0.19508342575683765,0.0
3816,16,217,10,60,50,1,1090.55,64,1329.506,MORE,152,382,534,1,2,-10.0,-0.9374084606744876,10.0,0.17460757394239454,0.7474601985239361,-1.173615348801201,110,60,50,1,-0.9972513740911768,-0.7803337030273506,-1.170500554541026,-1.1278084196395834,0.5877094397639521,0.5877094397639521,-1.170500554541026,-0.7803337030273506,1,0,1,0,-0.7803337030273506,-1.170500554541026
3817,16,218,19,41,50,1,1368.803,74,1226.284,MORE,530,390,920,1,2,9.0,0.8436676146070391,9.0,0.0,1.3063089450838885,-0.9785158768015716,91,41,50,0,-1.376206896245824,-1.5216507209033339,-1.170500554541026,-1.1278084196395834,1.1070443612104741,1.1070443612104741,-1.170500554541026,-1.5216507209033339,1,0,1,0,-1.5216507209033339,-1.170500554541026
3818,16,219,56,110,96,0,3310.863,74,1164.647,MORE,-942,1964,1022,4,1,-14.0,-1.3123718449442827,14.0,0.8730378697119728,1.3063089450838885,0.3831761106760138,206,110,96,1,0.9174712641638826,1.170500554541026,0.6242669624218805,0.9542994320027245,-0.9153392482320666,0.9153392482320666,0.6242669624218805,1.170500554541026,1,1,0,2,1.170500554541026,0.6242669624218805
3819,16,220,35,72,80,1,1333.375,74,1281.919,MORE,134,522,656,1,2,8.0,0.7499267685395902,8.0,-0.17460757394239454,1.3063089450838885,-1.0033565221638965,152,72,80,0,-0.1595602198545883,-0.31213348121094026,0.0,-1.1278084196395834,0.5629792054093558,0.5629792054093558,0.0,-0.31213348121094026,1,0,1,1,-0.31213348121094026,0.0
3820,16,221,11,49,50,1,1099.681,64,1724.947,MORE,-48,716,668,1,1,1.0,0.09374084606744876,1.0,-1.3968605915391563,0.7474601985239361,-1.1672130700159642,99,49,50,0,-1.2166466763912356,-1.2095172396923934,-1.170500554541026,-1.1278084196395834,0.31292905804621557,0.31292905804621557,-1.170500554541026,-1.2095172396923934,1,0,1,0,-1.2095172396923934,-1.170500554541026
3821,16,222,17,43,50,1,1094.369,54,720.309,MORE,308,348,656,1,2,7.0,0.6561859224721414,7.0,-0.34921514788478913,0.18861145196398388,-1.170937624271487,93,43,50,0,-1.3363168412821769,-1.4436173506005987,-1.170500554541026,-1.1278084196395834,0.8020381375037865,0.8020381375037865,-1.170500554541026,-1.4436173506005987,0,0,1,0,-1.4436173506005987,-1.170500554541026
3822,16,223,1,51,50,1,1480.236,44,1647.814,MORE,-922,1370,448,2,1,-1.0,-0.09374084606744876,1.0,-1.3968605915391563,-0.3702372945959683,-0.9003836753038891,101,51,50,1,-1.1767566214275886,-1.1314838693896585,-1.170500554541026,-0.4337724690921475,-0.887861210060293,0.887861210060293,-1.170500554541026,-1.1314838693896585,0,1,0,0,-1.1314838693896585,-1.170500554541026
3823,16,224,41,112,110,1,2309.8160000000007,54,1567.151,MORE,314,914,1228,2,2,-2.0,-0.18748169213489754,2.0,-1.222253017596762,0.18861145196398388,-0.3187165594724232,222,112,110,1,1.2365917038730592,1.248533924843761,1.170500554541026,-0.4337724690921475,0.8102815489553187,0.8102815489553187,1.170500554541026,1.248533924843761,0,1,1,2,1.248533924843761,1.170500554541026
3824,16,225,20,40,50,1,1215.538,64,1015.409,MORE,360,344,704,1,2,10.0,0.9374084606744876,10.0,0.17460757394239454,0.7474601985239361,-1.085978943061498,90,40,50,0,-1.3961519237276474,-1.5606674060547012,-1.170500554541026,-1.1278084196395834,0.873481036750398,0.873481036750398,-1.170500554541026,-1.5606674060547012,1,0,1,0,-1.5606674060547012,-1.170500554541026
3825,16,226,1,50,51,0,2433.235,44,1644.443,MORE,-356,1212,856,3,2,1.0,0.09374084606744876,1.0,-1.3968605915391563,-0.3702372945959683,-0.2321802715088714,101,50,51,0,-1.1767566214275886,-1.170500554541026,-1.1314838693896585,0.2602634814552885,-0.11023272979909865,0.11023272979909865,-1.1314838693896585,-1.170500554541026,0,1,0,0,-1.170500554541026,-1.1314838693896585
3826,16,227,23,85,80,1,2634.328,64,1744.245,MORE,898,832,1730,3,2,-5.0,-0.4687042303372438,5.0,-0.6984302957695783,0.7474601985239361,-0.09118219377809587,165,85,80,1,0.09972513740911768,0.19508342575683765,0.0,0.2602634814552885,1.6126402635711092,1.6126402635711092,0.0,0.19508342575683765,1,1,1,1,0.19508342575683765,0.0
3827,16,228,11,50,49,0,3138.7090000000007,14,400.265,MORE,-946,1868,922,4,1,-1.0,-0.09374084606744876,1.0,-1.3968605915391563,-2.046783534275825,0.2624688604302876,99,50,49,1,-1.2166466763912356,-1.170500554541026,-1.2095172396923934,0.9542994320027245,-0.9208348558664213,0.9208348558664213,-1.2095172396923934,-1.170500554541026,0,1,0,0,-1.170500554541026,-1.2095172396923934
3828,16,229,17,50,43,0,2271.006,74,715.63,MORE,-944,1528,584,2,1,-7.0,-0.6561859224721414,7.0,-0.34921514788478913,1.3063089450838885,-0.3459285230749928,93,50,43,1,-1.3363168412821769,-1.170500554541026,-1.4436173506005987,-0.4337724690921475,-0.9180870520492439,0.9180870520492439,-1.4436173506005987,-1.170500554541026,1,1,0,0,-1.170500554541026,-1.4436173506005987
3829,16,230,21,80,82,1,1691.994,74,1692.3239999999996,MORE,718,412,1130,1,2,2.0,0.18748169213489754,2.0,-1.222253017596762,1.3063089450838885,-0.7519077415612248,162,80,82,0,0.03989005496364707,0.0,0.07803337030273506,-1.1278084196395834,1.3653379200251463,1.3653379200251463,0.07803337030273506,0.0,1,0,1,1,0.07803337030273506,0.0
3830,16,231,10,50,60,1,1163.123,74,697.446,MORE,292,494,786,1,2,10.0,0.9374084606744876,10.0,0.17460757394239454,1.3063089450838885,-1.1227301688339444,110,50,60,0,-0.9972513740911768,-1.170500554541026,-0.7803337030273506,-1.1278084196395834,0.7800557069663676,0.7800557069663676,-0.7803337030273506,-1.170500554541026,1,0,1,0,-1.170500554541026,-0.7803337030273506
3831,16,232,3,53,50,1,2011.25,54,1716.523,MORE,208,788,996,3,2,-3.0,-0.28122253820234633,3.0,-1.0476454436543674,0.18861145196398388,-0.5280586652432201,103,53,50,1,-1.1368665664639415,-1.0534504990869233,-1.170500554541026,0.2602634814552885,0.6646479466449183,0.6646479466449183,-1.170500554541026,-1.0534504990869233,0,1,1,0,-1.0534504990869233,-1.170500554541026
3832,16,233,45,122,110,0,1789.399,74,1538.996,MORE,-488,1054,566,2,1,-12.0,-1.124890152809385,12.0,0.5238227218271837,1.3063089450838885,-0.6836113923030895,232,122,110,1,1.4360419786912946,1.6387007763574364,1.170500554541026,-0.4337724690921475,-0.29158778173280475,0.29158778173280475,1.170500554541026,1.6387007763574364,1,0,0,2,1.6387007763574364,1.170500554541026
3833,16,234,38,67,80,1,1387.178,64,1581.6989999999996,MORE,-268,896,628,1,1,13.0,1.218630998876834,13.0,0.6984302957695783,0.7474601985239361,-0.9656320883141404,147,67,80,0,-0.25928535726370594,-0.5072169069677779,0.0,-1.1278084196395834,0.010670638156705414,0.010670638156705414,0.0,-0.5072169069677779,1,0,0,1,-0.5072169069677779,0.0
3834,16,235,38,80,67,0,1788.973,24,1520.412,MORE,-1388,1918,530,2,1,-13.0,-1.218630998876834,13.0,0.6984302957695783,-1.4879347877158726,-0.6839100858484307,147,80,67,1,-0.25928535726370594,0.0,-0.5072169069677779,-0.4337724690921475,-1.528099499462619,1.528099499462619,-0.5072169069677779,0.0,0,0,0,1,0.0,-0.5072169069677779
3835,16,236,36,70,80,1,1354.686,44,1069.545,MORE,256,464,720,1,2,10.0,0.9374084606744876,10.0,0.17460757394239454,-0.3702372945959683,-0.9884141321527048,150,70,80,0,-0.19945027481823535,-0.3901668515136753,0.0,-1.1278084196395834,0.730595238257175,0.730595238257175,0.0,-0.3901668515136753,0,0,1,1,-0.3901668515136753,0.0
3836,16,237,45,110,122,0,1574.639,14,1738.9070000000004,MORE,-788,1250,462,2,1,12.0,1.124890152809385,12.0,0.5238227218271837,-2.046783534275825,-0.8341922040342854,232,110,122,0,1.4360419786912946,1.170500554541026,1.6387007763574364,-0.4337724690921475,-0.7037583543094095,0.7037583543094095,1.6387007763574364,1.170500554541026,0,0,0,2,1.6387007763574364,1.170500554541026
3837,16,238,42,110,115,0,3036.3340000000007,54,1409.283,MORE,-440,1584,1144,3,2,5.0,0.4687042303372438,5.0,-0.6984302957695783,0.18861145196398388,0.1906877531431709,225,110,115,0,1.2964267863185297,1.170500554541026,1.3655839802978638,0.2602634814552885,-0.225640490120548,0.225640490120548,1.3655839802978638,1.170500554541026,0,1,0,2,1.3655839802978638,1.170500554541026
3838,16,239,41,110,112,0,2535.757,14,692.268,MORE,-1300,1870,570,2,1,2.0,0.18748169213489754,2.0,-1.222253017596762,-2.046783534275825,-0.16029609391385533,222,110,112,0,1.2365917038730592,1.170500554541026,1.248533924843761,-0.4337724690921475,-1.4071961315068149,1.4071961315068149,1.248533924843761,1.170500554541026,0,1,0,2,1.248533924843761,1.170500554541026
3839,16,240,53,110,103,1,1278.781,44,1034.305,MORE,280,408,688,1,2,-7.0,-0.6561859224721414,7.0,-0.34921514788478913,-0.3702372945959683,-1.0416355724323492,213,110,103,1,1.0570864565366473,1.170500554541026,0.8973837584814532,-1.1278084196395834,0.7635688840633034,0.7635688840633034,0.8973837584814532,1.170500554541026,0,0,1,2,1.170500554541026,0.8973837584814532
3840,17,1,49,110,131,1,5160.755,80,1884.758,MORE,82,2318,2400,5,2,21.0,1.9685577674164243,21.0,2.0952908873087353,0.7755022797829446,-0.3996992936629853,241,110,131,0,1.6155472260277064,1.170500554541026,1.9898509427197442,-0.14608895903122907,-0.07366553351381891,0.07366553351381891,1.9898509427197442,1.170500554541026,1,1,0,2,1.9898509427197442,1.170500554541026
3841,17,2,13,47,50,1,5476.752,40,1548.726,MORE,-136,2394,2258,6,2,3.0,0.28122253820234633,3.0,-1.0476454436543674,-0.9518345846987879,-0.3114644206674399,97,47,50,0,-1.2565367313548828,-1.2875506099951286,-1.170500554541026,0.20452454264372044,-0.25457901048729825,0.25457901048729825,-1.170500554541026,-1.2875506099951286,0,1,0,0,-1.2875506099951286,-1.170500554541026
3842,17,3,16,50,44,0,8795.442,30,1616.957,MORE,-2158,3992,1834,4,2,-6.0,-0.5624450764046927,6.0,-0.5238227218271837,-1.3836688008192208,0.6152032080175991,94,50,44,1,-1.3163718138003533,-1.170500554541026,-1.4046006654492311,-0.4967024607061786,-1.9325930033330567,1.9325930033330567,-1.4046006654492311,-1.170500554541026,0,0,0,0,-1.170500554541026,-1.4046006654492311
3843,17,4,7,57,50,0,2722.045,80,1625.376,MORE,266,1298,1564,3,2,-7.0,-0.6561859224721414,7.0,-0.34921514788478913,0.7755022797829446,-1.0806528062690113,107,57,50,1,-1.0570864565366473,-0.8973837584814532,-1.170500554541026,-0.847315962381128,0.07903208007847562,0.07903208007847562,-1.170500554541026,-0.8973837584814532,1,0,0,0,-0.8973837584814532,-1.170500554541026
3844,17,5,18,42,50,1,2295.407,80,2449.336,MORE,1046,558,1604,2,2,8.0,0.7499267685395902,8.0,-0.17460757394239454,0.7755022797829446,-1.19978162630551,92,42,50,0,-1.3562618687640005,-1.4826340357519663,-1.170500554541026,-1.1979294640560776,0.7263371811762459,0.7263371811762459,-1.170500554541026,-1.4826340357519663,1,0,1,0,-1.4826340357519663,-1.170500554541026
3845,17,6,51,108,110,1,8504.661,80,1307.47,MORE,632,3302,3934,9,2,2.0,0.18748169213489754,2.0,-1.222253017596762,0.7755022797829446,0.5340093213524801,218,108,110,0,1.156811593945765,1.092467184238291,1.170500554541026,1.2563650476685688,0.38276755059358325,0.38276755059358325,1.170500554541026,1.092467184238291,1,1,1,2,1.170500554541026,1.092467184238291
3846,17,7,31,78,80,1,8819.823,80,1345.461,MORE,1678,2690,4368,9,2,2.0,0.18748169213489754,2.0,-1.222253017596762,0.7755022797829446,0.6220110398593713,158,78,80,0,-0.03989005496364707,-0.07803337030273506,0.0,1.2563650476685688,1.250820288732388,1.250820288732388,0.0,-0.07803337030273506,1,1,1,1,-0.07803337030273506,0.0
3847,17,8,58,110,92,0,5062.996,80,2850.815,MORE,-846,2698,1852,6,2,-18.0,-1.6873352292140782,18.0,1.571468165481551,0.7755022797829446,-0.4269962393592151,202,110,92,1,0.8376911542365885,1.170500554541026,0.4682002218164104,0.20452454264372044,-0.8437926281532174,0.8437926281532174,0.4682002218164104,1.170500554541026,1,1,0,2,1.170500554541026,0.4682002218164104
3848,17,9,12,50,48,1,5747.1280000000015,80,1136.544,MORE,-154,2824,2670,6,2,-2.0,-0.18748169213489754,2.0,-1.222253017596762,0.7755022797829446,-0.23596815956039244,98,50,48,1,-1.2365917038730592,-1.170500554541026,-1.248533924843761,0.20452454264372044,-0.2695168205126314,0.2695168205126314,-1.248533924843761,-1.170500554541026,1,1,0,0,-1.170500554541026,-1.248533924843761
3849,17,10,54,110,101,1,9253.138,20,1267.716,MORE,174,3948,4122,5,1,-9.0,-0.8436676146070391,9.0,0.0,-1.8155030169396544,0.7430042581243067,211,110,101,1,1.0171964015730004,1.170500554541026,0.8193503881787182,-0.14608895903122907,0.002683273282328353,0.002683273282328353,0.8193503881787182,1.170500554541026,0,1,0,2,1.170500554541026,0.8193503881787182
3850,17,11,14,46,50,1,4601.858,20,1119.638,MORE,1068,1642,2710,4,1,4.0,0.3749633842697951,4.0,-0.8730378697119728,-1.8155030169396544,-0.5557583885676562,96,46,50,0,-1.2764817588367063,-1.3265672951464962,-1.170500554541026,-0.4967024607061786,0.744594504540542,0.744594504540542,-1.170500554541026,-1.3265672951464962,0,0,1,0,-1.3265672951464962,-1.170500554541026
3851,17,12,22,80,83,0,5596.897,20,2564.168,MORE,-1114,2706,1592,5,1,3.0,0.28122253820234633,3.0,-1.0476454436543674,-1.8155030169396544,-0.2779167008598159,163,80,83,0,0.05983508244547061,0.0,0.1170500554541026,-0.14608895903122907,-1.0662000218637333,1.0662000218637333,0.1170500554541026,0.0,0,1,0,1,0.1170500554541026,0.0
3852,17,13,6,50,56,1,4091.185,70,1050.535,MORE,-106,1486,1380,3,2,6.0,0.5624450764046927,6.0,-0.5238227218271837,0.3436680636625115,-0.6983520438784793,106,50,56,0,-1.077031484018471,-1.170500554541026,-0.9364004436328208,-0.847315962381128,-0.22968266044507635,0.22968266044507635,-0.9364004436328208,-1.170500554541026,0,0,0,0,-1.170500554541026,-0.9364004436328208
3853,17,14,13,50,47,0,6796.208000000001,70,1497.38,MORE,-534,3028,2494,7,1,-3.0,-0.28122253820234633,3.0,-1.0476454436543674,0.3436680636625115,0.05696323080776518,97,50,47,1,-1.2565367313548828,-1.170500554541026,-1.2875506099951286,0.55513804431867,-0.5848705877141093,0.5848705877141093,-1.2875506099951286,-1.170500554541026,0,1,0,0,-1.170500554541026,-1.2875506099951286
3854,17,15,46,110,124,1,2675.7490000000007,90,988.718,MORE,696,946,1642,4,2,14.0,1.3123718449442827,14.0,0.8730378697119728,1.207336495903378,-1.0935798963369605,234,110,124,0,1.4759320336549415,1.170500554541026,1.7167341466601715,-0.4967024607061786,0.43587976401699,0.43587976401699,1.7167341466601715,1.170500554541026,1,0,1,2,1.7167341466601715,1.170500554541026
3855,17,16,27,91,80,0,5472.234,80,1868.926,MORE,1876,1790,3666,2,2,-11.0,-1.0311493067419364,11.0,0.34921514788478913,0.7755022797829446,-0.31272596794856555,171,91,80,1,0.21939530230005888,0.4291835366650429,0.0,-1.1979294640560776,1.4151361990110527,1.4151361990110527,0.0,0.4291835366650429,1,0,1,1,0.4291835366650429,0.0
3856,17,17,40,64,80,1,8278.929,70,2005.083,MORE,-346,3628,3282,11,2,16.0,1.4998535370791803,16.0,1.222253017596762,0.3436680636625115,0.4709788674208592,144,64,80,0,-0.3191204397091766,-0.6242669624218805,0.0,1.957592051018468,-0.4288534607828518,0.4288534607828518,0.0,-0.6242669624218805,0,1,0,1,-0.6242669624218805,0.0
3857,17,18,22,83,80,1,11238.256,70,1323.144,MORE,228,4596,4824,8,2,-3.0,-0.28122253820234633,3.0,-1.0476454436543674,0.3436680636625115,1.2973026679546875,163,83,80,1,0.05983508244547061,0.1170500554541026,0.0,0.9057515459936194,0.047496703358327834,0.047496703358327834,0.0,0.1170500554541026,0,1,0,1,0.1170500554541026,0.0
3858,17,19,54,101,110,1,14285.494,70,1643.864,MORE,206,6354,6560,14,2,9.0,0.8436676146070391,9.0,0.0,0.3436680636625115,2.148173587353289,211,101,110,0,1.0171964015730004,0.8193503881787182,1.170500554541026,3.009432556043316,0.02923937999403175,0.02923937999403175,1.170500554541026,0.8193503881787182,1,1,0,2,1.170500554541026,0.8193503881787182
3859,17,20,6,56,50,1,7703.028,30,782.2589999999999,MORE,-1750,4350,2600,6,2,-6.0,-0.5624450764046927,6.0,-0.5238227218271837,-1.3836688008192208,0.31017179775561704,106,56,50,1,-1.077031484018471,-0.9364004436328208,-1.170500554541026,0.20452454264372044,-1.5940026427588383,1.5940026427588383,-1.170500554541026,-0.9364004436328208,0,1,0,0,-0.9364004436328208,-1.170500554541026
3860,17,21,18,50,42,0,10331.197,30,1680.224,MORE,-932,4560,3628,8,1,-8.0,-0.7499267685395902,8.0,-0.17460757394239454,-1.3836688008192208,1.0440273657699632,92,50,42,1,-1.3562618687640005,-1.170500554541026,-1.4826340357519663,0.9057515459936194,-0.9151621649409203,0.9151621649409203,-1.4826340357519663,-1.170500554541026,0,1,0,0,-1.170500554541026,-1.4826340357519663
3861,17,22,43,110,117,0,18416.96,20,1521.7879999999998,MORE,1282,6606,7888,8,1,7.0,0.6561859224721414,7.0,-0.34921514788478913,-1.8155030169396544,3.3017901653442614,227,110,117,0,1.3363168412821769,1.170500554541026,1.4436173506005987,0.9057515459936194,0.9221884681750585,0.9221884681750585,1.4436173506005987,1.170500554541026,0,1,1,2,1.4436173506005987,1.170500554541026
3862,17,23,32,77,80,0,2657.793,20,2684.021,MORE,524,1602,2126,1,1,3.0,0.28122253820234633,3.0,-1.0476454436543674,-1.8155030169396544,-1.098593695137291,157,77,80,0,-0.05983508244547061,-0.1170500554541026,0.0,-1.548542965731027,0.29314069044158425,0.29314069044158425,0.0,-0.1170500554541026,0,0,1,1,-0.1170500554541026,0.0
3863,17,24,27,80,91,1,8402.476,80,1094.052,MORE,662,3522,4184,4,2,11.0,1.0311493067419364,11.0,0.34921514788478913,0.7755022797829446,0.5054765172529168,171,80,91,0,0.21939530230005888,0.0,0.4291835366650429,-0.4967024607061786,0.40766390063580515,0.40766390063580515,0.4291835366650429,0.0,1,0,1,1,0.4291835366650429,0.0
3864,17,25,16,44,50,1,3144.345,80,1614.294,MORE,1316,1174,2490,4,2,6.0,0.5624450764046927,6.0,-0.5238227218271837,0.7755022797829446,-0.9627352726657848,94,44,50,0,-1.3163718138003533,-1.4046006654492311,-1.170500554541026,-0.4967024607061786,0.9504043315562434,0.9504043315562434,-1.170500554541026,-1.4046006654492311,1,0,1,0,-1.4046006654492311,-1.170500554541026
3865,17,26,7,50,57,1,3045.078,80,1771.57,MORE,1748,1078,2826,4,2,7.0,0.6561859224721414,7.0,-0.34921514788478913,0.7755022797829446,-0.9904532925762548,107,50,57,0,-1.0570864565366473,-1.170500554541026,-0.8973837584814532,-0.4967024607061786,1.3089117721642392,1.3089117721642392,-0.8973837584814532,-1.170500554541026,1,0,1,0,-1.170500554541026,-0.8973837584814532
3866,17,27,14,50,46,1,10122.536,30,1838.598,MORE,-580,4790,4210,8,2,-4.0,-0.3749633842697951,4.0,-0.8730378697119728,-1.3836688008192208,0.9857635948033924,96,50,46,1,-1.2764817588367063,-1.170500554541026,-1.3265672951464962,0.9057515459936194,-0.6230449911121829,0.6230449911121829,-1.3265672951464962,-1.170500554541026,0,1,0,0,-1.170500554541026,-1.3265672951464962
3867,17,28,51,110,108,0,5818.096,70,983.345,MORE,1228,2066,3294,4,2,-2.0,-0.18748169213489754,2.0,-1.222253017596762,0.3436680636625115,-0.2161519826133085,218,110,108,1,1.156811593945765,1.170500554541026,1.092467184238291,-0.4967024607061786,0.877375038099059,0.877375038099059,1.092467184238291,1.170500554541026,0,0,1,2,1.170500554541026,1.092467184238291
3868,17,29,50,133,110,0,5373.225,90,2144.134,MORE,3134,1670,4804,3,2,-23.0,-2.1560394595513217,23.0,2.444506035193524,1.207336495903378,-0.34037194731044546,243,133,110,1,1.6554372809913533,2.0678843130224793,1.170500554541026,-0.847315962381128,2.4591231441148924,2.4591231441148924,1.170500554541026,2.0678843130224793,1,0,1,2,2.0678843130224793,1.170500554541026
3869,17,30,49,131,110,0,6580.386,90,1268.242,MORE,372,3086,3458,4,2,-21.0,-1.9685577674164243,21.0,2.0952908873087353,1.207336495903378,-0.0033000842225822,241,131,110,1,1.6155472260277064,1.9898509427197442,1.170500554541026,-0.4967024607061786,0.1669991835609931,0.1669991835609931,1.170500554541026,1.9898509427197442,1,0,1,2,1.9898509427197442,1.170500554541026
3870,17,31,47,126,110,0,5049.907,30,1670.858,MORE,808,2014,2822,3,1,-16.0,-1.4998535370791803,16.0,1.222253017596762,-1.3836688008192208,-0.4306510406789703,236,126,110,1,1.5158220886185887,1.7947675169629065,1.170500554541026,-0.847315962381128,0.5288261375079519,0.5288261375079519,1.170500554541026,1.7947675169629065,0,0,1,2,1.7947675169629065,1.170500554541026
3871,17,32,50,110,133,1,10371.513,60,1128.029,MORE,-42,3592,3550,4,2,23.0,2.1560394595513217,23.0,2.444506035193524,-0.08816615245792167,1.0552846787814427,243,110,133,0,1.6554372809913533,1.170500554541026,2.0678843130224793,-0.4967024607061786,-0.17657044702166957,0.17657044702166957,2.0678843130224793,1.170500554541026,0,0,0,2,2.0678843130224793,1.170500554541026
3872,17,33,47,110,126,1,4922.645,80,2176.956,MORE,-178,2510,2332,3,2,16.0,1.4998535370791803,16.0,1.222253017596762,0.7755022797829446,-0.4661860185653397,236,110,126,0,1.5158220886185887,1.170500554541026,1.7947675169629065,-0.847315962381128,-0.289433900546409,0.289433900546409,1.7947675169629065,1.170500554541026,1,0,0,2,1.7947675169629065,1.170500554541026
3873,17,34,12,48,50,0,4311.127,80,1147.108,MORE,-248,1890,1642,4,2,2.0,0.18748169213489754,2.0,-1.222253017596762,0.7755022797829446,-0.6369383138861494,98,48,50,0,-1.2365917038730592,-1.248533924843761,-1.170500554541026,-0.4967024607061786,-0.34752538397826016,0.34752538397826016,-1.170500554541026,-1.248533924843761,1,0,0,0,-1.248533924843761,-1.170500554541026
3874,17,35,32,80,77,0,10980.744,20,1370.905,MORE,976,3070,4046,4,1,-3.0,-0.28122253820234633,3.0,-1.0476454436543674,-1.8155030169396544,1.2253983821075791,157,80,77,1,-0.05983508244547061,0.0,-0.1170500554541026,-0.4967024607061786,0.6682456977443948,0.6682456977443948,-0.1170500554541026,0.0,0,0,1,1,0.0,-0.1170500554541026
3875,17,36,43,117,110,0,6566.471,20,1974.558,MORE,576,2600,3176,4,1,-7.0,-0.6561859224721414,7.0,-0.34921514788478913,-1.8155030169396544,-0.007185526988599251,227,117,110,1,1.3363168412821769,1.4436173506005987,1.170500554541026,-0.4967024607061786,0.3362943638481023,0.3362943638481023,1.170500554541026,1.4436173506005987,0,0,1,2,1.4436173506005987,1.170500554541026
3876,17,37,40,80,64,0,3874.463,70,2369.292,MORE,184,1826,2010,5,2,-16.0,-1.4998535370791803,16.0,1.222253017596762,0.3436680636625115,-0.7588666631480944,144,80,64,1,-0.3191204397091766,0.0,-0.6242669624218805,-0.14608895903122907,0.010982056629735665,0.010982056629735665,-0.6242669624218805,0.0,1,1,0,1,0.0,-0.6242669624218805
3877,17,38,31,80,78,1,13264.296,70,1536.309,MORE,1392,4306,5698,9,2,-2.0,-0.18748169213489754,2.0,-1.222253017596762,0.3436680636625115,1.8630276023176555,158,80,78,1,-0.03989005496364707,0.0,-0.07803337030273506,1.2563650476685688,1.0134750849965388,1.0134750849965388,-0.07803337030273506,0.0,1,1,1,1,0.0,-0.07803337030273506
3878,17,39,46,124,110,0,7431.411,20,1374.023,MORE,110,3128,3238,7,1,-14.0,-1.3123718449442827,14.0,0.8730378697119728,-1.8155030169396544,0.2343290160253124,234,124,110,1,1.4759320336549415,1.7167341466601715,1.170500554541026,0.55513804431867,-0.05042894014107844,0.05042894014107844,1.170500554541026,1.7167341466601715,0,1,0,2,1.7167341466601715,1.170500554541026
3879,17,40,58,92,110,1,8552.089,70,927.765,MORE,554,2674,3228,4,1,18.0,1.6873352292140782,18.0,1.571468165481551,0.3436680636625115,0.5472524963080422,202,92,110,0,0.8376911542365885,0.4682002218164104,1.170500554541026,-0.4967024607061786,0.3180370404838062,0.3180370404838062,1.170500554541026,0.4682002218164104,1,0,1,2,1.170500554541026,0.4682002218164104
3880,17,41,49,110,131,0,2444.521,80,1244.207,LESS,-104,1272,1168,3,2,21.0,1.9685577674164243,21.0,2.0952908873087353,0.7755022797829446,-1.1581449814897118,241,110,131,1,1.6155472260277064,1.170500554541026,1.9898509427197442,-0.847315962381128,-0.2280229037755949,0.2280229037755949,1.9898509427197442,1.170500554541026,1,0,0,2,1.9898509427197442,1.170500554541026
3881,17,42,13,47,50,1,4629.874,60,1351.708,LESS,552,1914,2466,6,2,3.0,0.28122253820234633,3.0,-1.0476454436543674,-0.08816615245792167,-0.5479355668261741,97,47,50,1,-1.2565367313548828,-1.2875506099951286,-1.170500554541026,0.20452454264372044,0.31637728381432473,0.31637728381432473,-1.170500554541026,-1.2875506099951286,0,1,1,0,-1.2875506099951286,-1.170500554541026
3882,17,43,16,50,44,0,6612.573,20,3609.292,LESS,-3020,4828,1808,5,1,-6.0,-0.5624450764046927,6.0,-0.5238227218271837,-1.8155030169396544,0.005687393054441345,94,50,44,0,-1.3163718138003533,-1.170500554541026,-1.4046006654492311,-0.14608895903122907,-2.647948127879567,2.647948127879567,-1.4046006654492311,-1.170500554541026,0,0,0,0,-1.170500554541026,-1.4046006654492311
3883,17,44,7,57,50,1,5829.472,60,1234.469,LESS,1068,2142,3210,6,2,-7.0,-0.6561859224721414,7.0,-0.34921514788478913,-0.08816615245792167,-0.2129754970289601,107,57,50,0,-1.0570864565366473,-0.8973837584814532,-1.170500554541026,0.20452454264372044,0.744594504540542,0.744594504540542,-1.170500554541026,-0.8973837584814532,0,1,1,0,-0.8973837584814532,-1.170500554541026
3884,17,45,18,42,50,0,2945.771,90,1654.55,LESS,396,1502,1898,3,2,8.0,0.7499267685395902,8.0,-0.17460757394239454,1.207336495903378,-1.0181824815640257,92,42,50,1,-1.3562618687640005,-1.4826340357519663,-1.170500554541026,-0.847315962381128,0.18691626359477068,0.18691626359477068,-1.170500554541026,-1.4826340357519663,1,0,1,0,-1.4826340357519663,-1.170500554541026
3885,17,46,51,108,110,1,7390.815,30,1948.695,LESS,180,3300,3480,11,1,2.0,0.18748169213489754,2.0,-1.222253017596762,-1.3836688008192208,0.2229935194727274,218,108,110,1,1.156811593945765,1.092467184238291,1.170500554541026,1.957592051018468,0.00766254329077274,0.00766254329077274,1.170500554541026,1.092467184238291,0,1,1,2,1.170500554541026,1.092467184238291
3886,17,47,31,78,80,0,3348.937,70,1013.522,LESS,-246,1722,1476,5,2,2.0,0.18748169213489754,2.0,-1.222253017596762,0.3436680636625115,-0.905607676087638,158,78,80,1,-0.03989005496364707,-0.07803337030273506,0.0,-0.14608895903122907,-0.3458656273087787,0.3458656273087787,0.0,-0.07803337030273506,1,1,0,1,-0.07803337030273506,0.0
3887,17,48,58,110,92,1,10930.143,30,1119.618,LESS,-660,5354,4694,8,1,-18.0,-1.6873352292140782,18.0,1.571468165481551,-1.3836688008192208,1.2112692200951305,202,110,92,0,0.8376911542365885,1.170500554541026,0.4682002218164104,0.9057515459936194,-0.6894352578914414,0.6894352578914414,0.4682002218164104,1.170500554541026,0,1,0,2,1.170500554541026,0.4682002218164104
3888,17,49,12,50,48,0,4471.189,70,2105.744,LESS,-486,2650,2164,3,1,-2.0,-0.18748169213489754,2.0,-1.222253017596762,0.3436680636625115,-0.5922446926131215,98,50,48,0,-1.2365917038730592,-1.170500554541026,-1.248533924843761,-0.847315962381128,-0.5450364276465541,0.5450364276465541,-1.248533924843761,-1.170500554541026,1,0,0,0,-1.170500554541026,-1.248533924843761
3889,17,50,54,110,101,1,3547.778,30,1934.032,LESS,-104,1594,1490,5,1,-9.0,-0.8436676146070391,9.0,0.0,-1.3836688008192208,-0.8500859135984143,211,110,101,0,1.0171964015730004,1.170500554541026,0.8193503881787182,-0.14608895903122907,-0.2280229037755949,0.2280229037755949,0.8193503881787182,1.170500554541026,0,1,0,2,1.170500554541026,0.8193503881787182
3890,17,51,14,46,50,0,2703.865,30,1833.302,LESS,-770,1892,1122,3,1,4.0,0.3749633842697951,4.0,-0.8730378697119728,-1.3836688008192208,-1.0857291519022263,96,46,50,1,-1.2764817588367063,-1.3265672951464962,-1.170500554541026,-0.847315962381128,-0.7807218747129219,0.7807218747129219,-1.170500554541026,-1.3265672951464962,0,0,0,0,-1.3265672951464962,-1.170500554541026
3891,17,52,22,80,83,0,8335.483,60,2142.302,LESS,-1836,4668,2832,5,1,3.0,0.28122253820234633,3.0,-1.0476454436543674,-0.08816615245792167,0.4867702673625994,163,80,83,1,0.05983508244547061,0.0,0.1170500554541026,-0.14608895903122907,-1.6653721795465413,1.6653721795465413,0.1170500554541026,0.0,0,1,0,1,0.1170500554541026,0.0
3892,17,53,6,50,56,0,8974.254,70,1685.04,LESS,-1694,4390,2696,10,2,6.0,0.5624450764046927,6.0,-0.5238227218271837,0.3436680636625115,0.6651323342753788,106,50,56,1,-1.077031484018471,-1.170500554541026,-0.9364004436328208,1.6069785493435185,-1.5475294560133575,1.5475294560133575,-0.9364004436328208,-1.170500554541026,1,1,0,0,-1.170500554541026,-0.9364004436328208
3893,17,54,13,50,47,0,7330.768,60,1123.613,LESS,178,2740,2918,4,1,-3.0,-0.28122253820234633,3.0,-1.0476454436543674,-0.08816615245792167,0.2062267798556947,97,50,47,0,-1.2565367313548828,-1.170500554541026,-1.2875506099951286,-0.4967024607061786,0.0060027866212912775,0.0060027866212912775,-1.2875506099951286,-1.170500554541026,0,0,1,0,-1.170500554541026,-1.2875506099951286
3894,17,55,46,110,124,0,3614.821,70,795.2439999999998,LESS,-482,1748,1266,3,2,14.0,1.3123718449442827,14.0,0.8730378697119728,0.3436680636625115,-0.8313657023614711,234,110,124,1,1.4759320336549415,1.170500554541026,1.7167341466601715,-0.847315962381128,-0.5417169143075913,0.5417169143075913,1.7167341466601715,1.170500554541026,1,0,0,2,1.7167341466601715,1.170500554541026
3895,17,56,27,91,80,1,2288.655,70,724.628,LESS,-88,826,738,4,2,-11.0,-1.0311493067419364,11.0,0.34921514788478913,0.3436680636625115,-1.2016669665538853,171,91,80,0,0.21939530230005888,0.4291835366650429,0.0,-0.4967024607061786,-0.21474485041974317,0.21474485041974317,0.0,0.4291835366650429,1,0,0,1,0.4291835366650429,0.0
3896,17,57,40,64,80,0,2827.265,10,2060.319,LESS,-1700,2580,880,3,1,16.0,1.4998535370791803,16.0,1.222253017596762,-2.247337233060088,-1.051272548429249,144,64,80,1,-0.3191204397091766,-0.6242669624218805,0.0,-0.847315962381128,-1.5525087260218018,1.5525087260218018,0.0,-0.6242669624218805,0,0,0,1,-0.6242669624218805,0.0
3897,17,58,22,83,80,1,5201.602,20,1069.843,LESS,108,2046,2154,5,2,-3.0,-0.28122253820234633,3.0,-1.0476454436543674,-1.8155030169396544,-0.388293711150338,163,83,80,0,0.05983508244547061,0.1170500554541026,0.0,-0.14608895903122907,-0.0520886968105599,0.0520886968105599,0.0,0.1170500554541026,0,0,0,1,0.1170500554541026,0.0
3898,17,59,54,101,110,1,4749.154,30,1901.504,LESS,520,1680,2200,3,2,9.0,0.8436676146070391,9.0,0.0,-1.3836688008192208,-0.5146293783151795,211,101,110,1,1.0171964015730004,0.8193503881787182,1.170500554541026,-0.847315962381128,0.28982117710262134,0.28982117710262134,1.170500554541026,0.8193503881787182,0,0,1,2,1.170500554541026,0.8193503881787182
3899,17,60,6,56,50,0,7701.936,60,1289.502,LESS,-3462,3904,442,5,1,-6.0,-0.5624450764046927,6.0,-0.5238227218271837,-0.08816615245792167,0.3098668819453049,106,56,50,0,-1.077031484018471,-0.9364004436328208,-1.170500554541026,-0.14608895903122907,-3.0147543518349704,3.0147543518349704,-1.170500554541026,-0.9364004436328208,0,1,0,0,-0.9364004436328208,-1.170500554541026
3900,17,61,18,50,42,1,6227.031,90,1618.4229999999998,LESS,102,2138,2240,5,2,-8.0,-0.7499267685395902,8.0,-0.17460757394239454,1.207336495903378,-0.10196631696321254,92,50,42,0,-1.3562618687640005,-1.170500554541026,-1.4826340357519663,-0.14608895903122907,-0.057067966819004286,0.057067966819004286,-1.4826340357519663,-1.170500554541026,1,1,0,0,-1.170500554541026,-1.4826340357519663
3901,17,62,43,110,117,1,12798.777,10,1692.656,LESS,-354,5554,5200,9,1,7.0,0.6561859224721414,7.0,-0.34921514788478913,-2.247337233060088,1.7330421599178438,227,110,117,1,1.3363168412821769,1.170500554541026,1.4436173506005987,1.2563650476685688,-0.4354924874607777,0.4354924874607777,1.4436173506005987,1.170500554541026,0,1,0,2,1.4436173506005987,1.170500554541026
3902,17,63,32,77,80,0,8515.495,10,1727.946,LESS,-2788,4570,1782,6,1,3.0,0.28122253820234633,3.0,-1.0476454436543674,-2.247337233060088,0.5370344659394028,157,77,80,1,-0.05983508244547061,-0.1170500554541026,0.0,0.20452454264372044,-2.4554163542197176,2.4554163542197176,0.0,-0.1170500554541026,0,1,0,1,-0.1170500554541026,0.0
3903,17,64,27,80,91,0,4721.237,90,1851.284,LESS,2082,1574,3656,3,2,11.0,1.0311493067419364,11.0,0.34921514788478913,1.207336495903378,-0.5224245565903425,171,80,91,1,0.21939530230005888,0.0,0.4291835366650429,-0.847315962381128,1.5860911359676433,1.5860911359676433,0.4291835366650429,0.0,1,0,1,1,0.4291835366650429,0.0
3904,17,65,16,44,50,0,13318.478,70,2231.031,LESS,-1794,4438,2644,7,2,6.0,0.5624450764046927,6.0,-0.5238227218271837,0.3436680636625115,1.8781566759754575,94,44,50,1,-1.3163718138003533,-1.4046006654492311,-1.170500554541026,0.55513804431867,-1.6305172894874305,1.6305172894874305,-1.170500554541026,-1.4046006654492311,1,1,0,0,-1.4046006654492311,-1.170500554541026
3905,17,66,7,50,57,1,12227.114,80,771.887,LESS,-1434,4540,3106,9,2,7.0,0.6561859224721414,7.0,-0.34921514788478913,0.7755022797829446,1.5734184539926217,107,50,57,1,-1.0570864565366473,-1.170500554541026,-0.8973837584814532,1.2563650476685688,-1.3317610889807674,1.3317610889807674,-0.8973837584814532,-1.170500554541026,1,1,0,0,-1.170500554541026,-0.8973837584814532
3906,17,67,14,50,46,1,10870.699,30,1620.168,LESS,252,3902,4154,8,1,-4.0,-0.3749633842697951,4.0,-0.8730378697119728,-1.3836688008192208,1.1946708543184077,96,50,46,0,-1.2764817588367063,-1.170500554541026,-1.3265672951464962,0.9057515459936194,0.06741378339210538,0.06741378339210538,-1.3265672951464962,-1.170500554541026,0,1,1,0,-1.170500554541026,-1.3265672951464962
3907,17,68,51,110,108,0,5250.7069999999985,10,1792.364,LESS,-1052,3126,2074,5,1,-2.0,-0.18748169213489754,2.0,-1.222253017596762,-2.247337233060088,-0.37458227262894017,218,110,108,0,1.156811593945765,1.170500554541026,1.092467184238291,-0.14608895903122907,-1.014747565109808,1.014747565109808,1.092467184238291,1.170500554541026,0,1,0,2,1.170500554541026,1.092467184238291
3908,17,69,50,133,110,1,7656.267,80,1867.646,LESS,-878,3084,2206,4,2,-23.0,-2.1560394595513217,23.0,2.444506035193524,0.7755022797829446,0.2971148671640457,243,133,110,0,1.6554372809913533,2.0678843130224793,1.170500554541026,-0.4967024607061786,-0.8703487348649208,0.8703487348649208,1.170500554541026,2.0678843130224793,1,0,0,2,2.0678843130224793,1.170500554541026
3909,17,70,49,131,110,1,5846.14,70,1602.484,LESS,70,2396,2466,6,2,-21.0,-1.9685577674164243,21.0,2.0952908873087353,0.3436680636625115,-0.20832134251771536,241,131,110,0,1.6155472260277064,1.9898509427197442,1.170500554541026,0.20452454264372044,-0.08362407353070768,0.08362407353070768,1.170500554541026,1.9898509427197442,1,1,0,2,1.9898509427197442,1.170500554541026
3910,17,71,47,126,110,1,4033.852,60,1736.725,LESS,-572,1840,1268,4,1,-16.0,-1.4998535370791803,16.0,1.222253017596762,-0.08816615245792167,-0.7143609616006527,236,126,110,0,1.5158220886185887,1.7947675169629065,1.170500554541026,-0.4967024607061786,-0.6164059644342571,0.6164059644342571,1.170500554541026,1.7947675169629065,0,0,0,2,1.7947675169629065,1.170500554541026
3911,17,72,50,110,133,0,8756.368,30,1186.447,LESS,2140,2652,4792,2,1,23.0,2.1560394595513217,23.0,2.444506035193524,-1.3836688008192208,0.6042926948563101,243,110,133,1,1.6554372809913533,1.170500554541026,2.0678843130224793,-1.1979294640560776,1.6342240793826057,1.6342240793826057,2.0678843130224793,1.170500554541026,0,0,1,2,2.0678843130224793,1.170500554541026
3912,17,73,47,110,126,0,13434.458,70,2018.805,LESS,-1956,5506,3550,8,2,16.0,1.4998535370791803,16.0,1.222253017596762,0.3436680636625115,1.9105414156091358,236,110,126,1,1.5158220886185887,1.170500554541026,1.7947675169629065,0.9057515459936194,-1.764957579715429,1.764957579715429,1.7947675169629065,1.170500554541026,1,1,0,2,1.7947675169629065,1.170500554541026
3913,17,74,12,48,50,1,8655.99,30,1945.724,LESS,-2270,4008,1738,7,2,2.0,0.18748169213489754,2.0,-1.222253017596762,-1.3836688008192208,0.5762644538238102,98,48,50,1,-1.2365917038730592,-1.248533924843761,-1.170500554541026,0.55513804431867,-2.025539376824019,2.025539376824019,-1.170500554541026,-1.248533924843761,0,1,0,0,-1.248533924843761,-1.170500554541026
3914,17,75,32,80,77,1,8542.576,20,1106.427,LESS,690,3384,4074,8,2,-3.0,-0.28122253820234633,3.0,-1.0476454436543674,-1.8155030169396544,0.5445962104989784,157,80,77,0,-0.05983508244547061,0.0,-0.1170500554541026,0.9057515459936194,0.43090049400854563,0.43090049400854563,-0.1170500554541026,0.0,0,1,1,1,0.0,-0.1170500554541026
3915,17,76,43,117,110,0,6812.149,10,1832.587,LESS,-3804,4964,1160,5,1,-7.0,-0.6561859224721414,7.0,-0.34921514788478913,-2.247337233060088,0.06141438733906734,227,117,110,0,1.3363168412821769,1.4436173506005987,1.170500554541026,-0.14608895903122907,-3.2985727423163005,3.2985727423163005,1.170500554541026,1.4436173506005987,0,1,0,2,1.4436173506005987,1.170500554541026
3916,17,77,40,80,64,1,2079.317,100,2612.246,LESS,1592,596,2188,1,2,-16.0,-1.4998535370791803,16.0,1.222253017596762,1.639170712023811,-1.2601197741537724,144,80,64,0,-0.3191204397091766,0.0,-0.6242669624218805,-1.548542965731027,1.179450751944685,1.179450751944685,-0.6242669624218805,0.0,1,0,1,1,0.0,-0.6242669624218805
3917,17,78,31,80,78,0,12903.296,30,1718.31,LESS,-1260,5638,4378,10,1,-2.0,-0.18748169213489754,2.0,-1.222253017596762,-1.3836688008192208,1.7622266796779091,158,80,78,0,-0.03989005496364707,0.0,-0.07803337030273506,1.6069785493435185,-1.18736225873588,1.18736225873588,-0.07803337030273506,0.0,0,1,0,1,0.0,-0.07803337030273506
3918,17,79,46,124,110,1,4904.169,30,1800.0179999999998,LESS,1098,1614,2712,6,2,-14.0,-1.3123718449442827,14.0,0.8730378697119728,-1.3836688008192208,-0.4713450153705807,234,124,110,0,1.4759320336549415,1.7167341466601715,1.170500554541026,0.20452454264372044,0.7694908545827639,0.7694908545827639,1.170500554541026,1.7167341466601715,0,1,1,2,1.7167341466601715,1.170500554541026
3919,17,80,58,92,110,0,3006.609000000001,70,1382.53,LESS,-1334,1872,538,2,1,18.0,1.6873352292140782,18.0,1.571468165481551,0.3436680636625115,-1.0011948734433689,202,92,110,1,0.8376911542365885,0.4682002218164104,1.170500554541026,-1.1979294640560776,-1.2487732555066942,1.2487732555066942,1.170500554541026,0.4682002218164104,1,0,0,2,1.170500554541026,0.4682002218164104
3920,17,81,48,128,110,0,8105.937,70,1989.411,MORE,-1794,4766,2972,5,2,-18.0,-1.6873352292140782,18.0,1.571468165481551,0.3436680636625115,0.4226748419103468,238,128,110,1,1.5557121435822359,1.8728008872656416,1.170500554541026,-0.14608895903122907,-1.6305172894874305,1.6305172894874305,1.170500554541026,1.8728008872656416,1,1,0,2,1.8728008872656416,1.170500554541026
3921,17,82,8,50,58,0,6189.041,70,1383.456,MORE,-834,3252,2418,9,2,8.0,0.7499267685395902,8.0,-0.17460757394239454,0.3436680636625115,-0.11257414812965004,108,50,58,0,-1.0371414290548238,-1.170500554541026,-0.8583670733300858,1.2563650476685688,-0.8338340881363286,0.8338340881363286,-0.8583670733300858,-1.170500554541026,1,1,0,0,-1.170500554541026,-0.8583670733300858
3922,17,83,4,54,50,0,7687.597,70,1853.206,MORE,-410,3574,3164,13,2,-4.0,-0.3749633842697951,4.0,-0.8730378697119728,0.3436680636625115,0.3058630469598996,104,54,50,1,-1.116921538982118,-1.0144338139355558,-1.170500554541026,2.658819054368367,-0.48196567420625863,0.48196567420625863,-1.170500554541026,-1.0144338139355558,1,1,0,0,-1.0144338139355558,-1.170500554541026
3923,17,84,37,80,69,1,9285.34,30,1950.352,MORE,-2066,5498,3432,10,1,-11.0,-1.0311493067419364,11.0,0.34921514788478913,-1.3836688008192208,0.7519959238053179,149,80,69,1,-0.21939530230005888,0.0,-0.4291835366650429,1.6069785493435185,-1.8562441965369096,1.8562441965369096,-0.4291835366650429,0.0,0,1,0,1,0.0,-0.4291835366650429
3924,17,85,52,105,110,1,5532.585,70,2174.53,MORE,1100,2222,3322,7,2,5.0,0.4687042303372438,5.0,-0.6984302957695783,0.3436680636625115,-0.2958743433440468,215,105,110,0,1.0969765115002945,0.9754171287841883,1.170500554541026,0.55513804431867,0.7711506112522454,0.7711506112522454,1.170500554541026,0.9754171287841883,1,1,1,2,1.170500554541026,0.9754171287841883
3925,17,86,5,55,50,0,13944.792,70,1046.618,MORE,-1520,6540,5020,13,2,-5.0,-0.4687042303372438,5.0,-0.6984302957695783,0.3436680636625115,2.0530404129898345,105,55,50,1,-1.0969765115002945,-0.9754171287841883,-1.170500554541026,2.658819054368367,-1.4031306257684701,1.4031306257684701,-1.170500554541026,-0.9754171287841883,1,1,0,0,-0.9754171287841883,-1.170500554541026
3926,17,87,30,96,80,0,2445.729,70,908.982,MORE,1388,534,1922,2,2,-16.0,-1.4998535370791803,16.0,1.222253017596762,0.3436680636625115,-1.1578076753552278,176,96,80,1,0.3191204397091766,0.6242669624218805,0.0,-1.1979294640560776,1.010155571657576,1.010155571657576,0.0,0.6242669624218805,1,0,1,1,0.6242669624218805,0.0
3927,17,88,33,80,75,0,4590.124,70,1298.36,MORE,-608,2442,1834,5,2,-5.0,-0.4687042303372438,5.0,-0.6984302957695783,0.3436680636625115,-0.5590348373938469,155,80,75,1,-0.09972513740911768,0.0,-0.19508342575683765,-0.14608895903122907,-0.6462815844849233,0.6462815844849233,-0.19508342575683765,0.0,1,1,0,1,0.0,-0.19508342575683765
3928,17,89,48,110,128,1,8380.514000000001,70,1765.172,MORE,-830,4236,3406,5,2,18.0,1.6873352292140782,18.0,1.571468165481551,0.3436680636625115,0.49934413536091105,238,110,128,0,1.5557121435822359,1.170500554541026,1.8728008872656416,-0.14608895903122907,-0.8305145747973657,0.8305145747973657,1.8728008872656416,1.170500554541026,1,1,0,2,1.8728008872656416,1.170500554541026
3929,17,90,9,59,50,0,3432.429,30,1569.177,MORE,-190,1654,1464,5,1,-9.0,-0.8436676146070391,9.0,0.0,-1.3836688008192208,-0.8822944610376721,109,59,50,1,-1.0171964015730004,-0.8193503881787182,-1.170500554541026,-0.14608895903122907,-0.2993924405632978,0.2993924405632978,-1.170500554541026,-0.8193503881787182,0,1,0,0,-0.8193503881787182,-1.170500554541026
3930,17,91,44,110,119,1,3722.621,70,1174.496,MORE,928,1214,2142,6,2,9.0,0.8436676146070391,9.0,0.0,0.3436680636625115,-0.8012650390358073,229,110,119,0,1.376206896245824,1.170500554541026,1.5216507209033339,0.20452454264372044,0.6284115376768397,0.6284115376768397,1.5216507209033339,1.170500554541026,1,1,1,2,1.5216507209033339,1.170500554541026
3931,17,92,2,52,50,0,2249.913,80,909.602,MORE,190,1106,1296,3,2,-2.0,-0.18748169213489754,2.0,-1.222253017596762,0.7755022797829446,-1.2124847763735778,102,52,50,1,-1.156811593945765,-1.092467184238291,-1.170500554541026,-0.847315962381128,0.015961326638180052,0.015961326638180052,-1.170500554541026,-1.092467184238291,1,0,0,0,-1.092467184238291,-1.170500554541026
3932,17,93,8,58,50,0,5482.09,70,1298.126,MORE,700,2210,2910,5,2,-8.0,-0.7499267685395902,8.0,-0.17460757394239454,0.3436680636625115,-0.3099739073016478,108,58,50,1,-1.0371414290548238,-0.8583670733300858,-1.170500554541026,-0.14608895903122907,0.43919927735595293,0.43919927735595293,-1.170500554541026,-0.8583670733300858,1,1,1,0,-0.8583670733300858,-1.170500554541026
3933,17,94,44,119,110,0,3675.066,70,1913.276,MORE,678,1326,2004,3,1,-9.0,-0.8436676146070391,9.0,0.0,0.3436680636625115,-0.8145436758117993,229,119,110,1,1.376206896245824,1.5216507209033339,1.170500554541026,-0.847315962381128,0.42094195399165685,0.42094195399165685,1.170500554541026,1.5216507209033339,0,0,1,2,1.5216507209033339,1.170500554541026
3934,17,95,34,74,80,1,6204.276,40,1487.664,MORE,428,2316,2744,6,2,6.0,0.5624450764046927,6.0,-0.5238227218271837,-0.9518345846987879,-0.10832012581270682,154,74,80,0,-0.11967016489094122,-0.2341001109082052,0.0,0.20452454264372044,0.2134723703064741,0.2134723703064741,0.0,-0.2341001109082052,0,1,1,1,-0.2341001109082052,0.0
3935,17,96,24,86,80,0,7792.313,70,2540.591,MORE,-984,3970,2986,10,2,-6.0,-0.5624450764046927,6.0,-0.5238227218271837,0.3436680636625115,0.3351025744256716,166,86,80,1,0.11967016489094122,0.2341001109082052,0.0,1.6069785493435185,-0.9583158383474383,0.9583158383474383,0.0,0.2341001109082052,0,1,0,1,0.2341001109082052,0.0
3936,17,97,39,66,80,1,6074.708000000001,80,1998.812,MORE,232,1932,2164,5,2,14.0,1.3123718449442827,14.0,0.8730378697119728,0.7755022797829446,-0.14449900100546711,146,66,80,0,-0.2792303847455295,-0.5462335921191455,0.0,-0.14608895903122907,0.05081621669729076,0.05081621669729076,0.0,-0.5462335921191455,1,1,0,1,-0.5462335921191455,0.0
3937,17,98,9,50,59,0,4961.477,70,1955.29,MORE,798,1762,2560,5,1,9.0,0.8436676146070391,9.0,0.0,0.3436680636625115,-0.4553430783217204,109,50,59,0,-1.0171964015730004,-1.170500554541026,-0.8193503881787182,-0.14608895903122907,0.5205273541605446,0.5205273541605446,-0.8193503881787182,-1.170500554541026,0,1,1,0,-1.170500554541026,-0.8193503881787182
3938,17,99,57,94,110,1,2630.567,100,2650.241,MORE,722,1024,1746,2,2,16.0,1.4998535370791803,16.0,1.222253017596762,1.639170712023811,-1.1061959276020823,204,94,110,0,0.8775812092002355,0.5462335921191455,1.170500554541026,-1.1979294640560776,0.457456600720249,0.457456600720249,1.170500554541026,0.5462335921191455,1,0,1,2,1.170500554541026,0.5462335921191455
3939,17,100,60,110,87,0,7520.661,80,1592.465,MORE,966,2642,3608,5,2,-23.0,-2.1560394595513217,23.0,2.444506035193524,0.7755022797829446,0.2592500197527289,197,110,87,1,0.7379660168274708,1.170500554541026,0.27311679605957273,-0.14608895903122907,0.6599469143969874,0.6599469143969874,0.27311679605957273,1.170500554541026,1,1,1,2,1.170500554541026,0.27311679605957273
3940,17,101,33,75,80,0,8540.538,20,1277.149,MORE,-388,3948,3560,12,1,5.0,0.4687042303372438,5.0,-0.6984302957695783,-1.8155030169396544,0.5440271460105031,155,75,80,0,-0.09972513740911768,-0.19508342575683765,0.0,2.3082055526934173,-0.46370835084196255,0.46370835084196255,0.0,-0.19508342575683765,0,1,0,1,-0.19508342575683765,0.0
3941,17,102,15,50,45,0,5538.106,70,1645.7979999999998,MORE,232,2152,2384,6,2,-5.0,-0.4687042303372438,5.0,-0.6984302957695783,0.3436680636625115,-0.29433273144960354,95,50,45,1,-1.2964267863185297,-1.170500554541026,-1.3655839802978638,0.20452454264372044,0.05081621669729076,0.05081621669729076,-1.3655839802978638,-1.170500554541026,0,1,0,0,-1.170500554541026,-1.3655839802978638
3942,17,103,59,89,110,1,11191.67,70,2168.697,MORE,2794,3080,5874,9,2,21.0,1.9685577674164243,21.0,2.0952908873087353,0.3436680636625115,1.2842946020763075,199,89,110,0,0.7778560717911179,0.3511501663623078,1.170500554541026,1.2563650476685688,2.1769645103030437,2.1769645103030437,1.170500554541026,0.3511501663623078,0,1,1,2,1.170500554541026,0.3511501663623078
3943,17,104,29,80,94,1,3857.111,70,1810.016,MORE,420,1478,1898,4,2,14.0,1.3123718449442827,14.0,0.8730378697119728,0.3436680636625115,-0.7637118088811827,174,80,94,0,0.2792303847455295,0.0,0.5462335921191455,-0.4967024607061786,0.20683334362854822,0.20683334362854822,0.5462335921191455,0.0,0,0,1,1,0.5462335921191455,0.0
3944,17,105,55,110,98,1,5781.801,90,1393.902,MORE,316,2638,2954,4,2,-12.0,-1.124890152809385,12.0,0.5238227218271837,1.207336495903378,-0.2262865241291243,208,110,98,1,0.9573613191275298,1.170500554541026,0.7023003327246156,-0.4967024607061786,0.12052599681551217,0.12052599681551217,0.7023003327246156,1.170500554541026,1,0,1,2,1.170500554541026,0.7023003327246156
3945,17,106,29,94,80,0,3470.306,80,1430.703,MORE,-456,1894,1438,3,2,-14.0,-1.3123718449442827,14.0,0.8730378697119728,0.7755022797829446,-0.8717181825146093,174,94,80,1,0.2792303847455295,0.5462335921191455,0.0,-0.847315962381128,-0.5201400776043322,0.5201400776043322,0.0,0.5462335921191455,1,0,0,1,0.5462335921191455,0.0
3946,17,107,57,110,94,0,6867.0059999999985,80,2753.246,MORE,1876,2554,4430,7,2,-16.0,-1.4998535370791803,16.0,1.222253017596762,0.7755022797829446,0.07673193917632043,204,110,94,1,0.8775812092002355,1.170500554541026,0.5462335921191455,0.55513804431867,1.4151361990110527,1.4151361990110527,0.5462335921191455,1.170500554541026,1,1,1,2,1.170500554541026,0.5462335921191455
3947,17,108,39,80,66,1,10484.592,30,2767.49,MORE,296,4806,5102,11,2,-14.0,-1.3123718449442827,14.0,0.8730378697119728,-1.3836688008192208,1.08685938108388,146,80,66,1,-0.2792303847455295,0.0,-0.5462335921191455,1.957592051018468,0.10392843012069755,0.10392843012069755,-0.5462335921191455,0.0,0,1,1,1,0.0,-0.5462335921191455
3948,17,109,4,50,54,1,6690.687,80,2090.133,MORE,1916,2254,4170,7,2,4.0,0.3749633842697951,4.0,-0.8730378697119728,0.7755022797829446,0.027498925661314167,104,50,54,0,-1.116921538982118,-1.170500554541026,-1.0144338139355558,0.55513804431867,1.4483313324006821,1.4483313324006821,-1.0144338139355558,-1.170500554541026,1,1,1,0,-1.170500554541026,-1.0144338139355558
3949,17,110,55,98,110,1,3292.039,90,1178.069,MORE,-182,1742,1560,3,2,12.0,1.124890152809385,12.0,0.5238227218271837,1.207336495903378,-0.9214951300941652,208,98,110,0,0.9573613191275298,0.7023003327246156,1.170500554541026,-0.847315962381128,-0.2927534138853719,0.2927534138853719,1.170500554541026,0.7023003327246156,1,0,0,2,1.170500554541026,0.7023003327246156
3950,17,111,2,50,52,0,5662.382,30,975.951,MORE,-842,2828,1986,5,1,2.0,0.18748169213489754,2.0,-1.222253017596762,-1.3836688008192208,-0.25963152518373905,102,50,52,0,-1.156811593945765,-1.170500554541026,-1.092467184238291,-0.14608895903122907,-0.8404731148142545,0.8404731148142545,-1.092467184238291,-1.170500554541026,0,0,0,0,-1.170500554541026,-1.092467184238291
3951,17,112,59,110,89,0,2884.823,70,1513.162,MORE,256,890,1146,3,2,-21.0,-1.9685577674164243,21.0,2.0952908873087353,0.3436680636625115,-1.035200804647259,199,110,89,1,0.7778560717911179,1.170500554541026,0.3511501663623078,-0.847315962381128,0.0707332967310683,0.0707332967310683,0.3511501663623078,1.170500554541026,0,0,0,2,1.170500554541026,0.3511501663623078
3952,17,113,60,87,110,1,12863.287,30,2034.216,MORE,3704,3592,7296,9,2,23.0,2.1560394595513217,23.0,2.444506035193524,-1.3836688008192208,1.7510550893347137,197,87,110,0,0.7379660168274708,0.27311679605957273,1.170500554541026,1.2563650476685688,2.932153794917109,2.932153794917109,1.170500554541026,0.27311679605957273,0,1,1,2,1.170500554541026,0.27311679605957273
3953,17,114,52,110,105,0,13077.122,30,1520.921,MORE,-944,6158,5214,15,1,-5.0,-0.4687042303372438,5.0,-0.6984302957695783,-1.3836688008192208,1.8107635804501432,215,110,105,1,1.0969765115002945,1.170500554541026,0.9754171287841883,3.360046057718266,-0.9251207049578091,0.9251207049578091,0.9754171287841883,1.170500554541026,0,1,0,2,1.170500554541026,0.9754171287841883
3954,17,115,30,80,96,1,2517.831,90,1790.625,MORE,806,738,1544,2,2,16.0,1.4998535370791803,16.0,1.222253017596762,1.207336495903378,-1.137674855066665,176,80,96,0,0.3191204397091766,0.0,0.6242669624218805,-1.1979294640560776,0.5271663808384704,0.5271663808384704,0.6242669624218805,0.0,1,0,1,1,0.6242669624218805,0.0
3955,17,116,24,80,86,1,5439.781999999998,80,1337.69,MORE,356,2496,2852,2,2,6.0,0.5624450764046927,6.0,-0.5238227218271837,0.7755022797829446,-0.3217874403627075,166,80,86,0,0.11967016489094122,0.0,0.2341001109082052,-1.1979294640560776,0.15372113020514142,0.15372113020514142,0.2341001109082052,0.0,1,0,1,1,0.2341001109082052,0.0
3956,17,117,5,50,55,1,9844.08,60,941.09,MORE,-976,3448,2472,5,2,5.0,0.4687042303372438,5.0,-0.6984302957695783,-0.08816615245792167,0.9080111800815832,105,50,55,0,-1.0969765115002945,-1.170500554541026,-0.9754171287841883,-0.14608895903122907,-0.9516768116695125,0.9516768116695125,-0.9754171287841883,-1.170500554541026,0,0,0,0,-1.170500554541026,-0.9754171287841883
3957,17,118,34,80,74,0,3222.062,70,930.497,MORE,-720,1714,994,3,1,-6.0,-0.5624450764046927,6.0,-0.5238227218271837,0.3436680636625115,-0.9410345931511224,154,80,74,1,-0.11967016489094122,0.0,-0.2341001109082052,-0.847315962381128,-0.7392279579758853,0.7392279579758853,-0.2341001109082052,0.0,0,0,0,1,0.0,-0.2341001109082052
3958,17,119,15,45,50,1,10498.829,40,1601.188,MORE,-3764,5498,1734,5,2,5.0,0.4687042303372438,5.0,-0.6984302957695783,-0.9518345846987879,1.090834734922168,95,45,50,0,-1.2964267863185297,-1.3655839802978638,-1.170500554541026,-0.14608895903122907,-3.265377608926671,3.265377608926671,-1.170500554541026,-1.3655839802978638,0,0,0,0,-1.3655839802978638,-1.170500554541026
3959,17,120,37,69,80,1,8477.369,70,1620.5,MORE,2214,2894,5108,6,2,11.0,1.0311493067419364,11.0,0.34921514788478913,0.3436680636625115,0.5263886599101425,149,69,80,0,-0.21939530230005888,-0.4291835366650429,0.0,0.20452454264372044,1.6956350761534198,1.6956350761534198,0.0,-0.4291835366650429,0,1,1,1,-0.4291835366650429,0.0
3960,17,121,48,128,110,1,5271.764,70,2117.242,LESS,1102,1868,2970,6,2,-18.0,-1.6873352292140782,18.0,1.571468165481551,0.3436680636625115,-0.36870259111086456,238,128,110,0,1.5557121435822359,1.8728008872656416,1.170500554541026,0.20452454264372044,0.7728103679217269,0.7728103679217269,1.170500554541026,1.8728008872656416,1,1,1,2,1.8728008872656416,1.170500554541026
3961,17,122,8,50,58,0,4316.538,70,1317.454,LESS,130,1732,1862,5,1,8.0,0.7499267685395902,8.0,-0.17460757394239454,0.3436680636625115,-0.6354274169542835,108,50,58,1,-1.0371414290548238,-1.170500554541026,-0.8583670733300858,-0.14608895903122907,-0.033831373446263815,0.033831373446263815,-0.8583670733300858,-1.170500554541026,1,1,1,0,-1.170500554541026,-0.8583670733300858
3962,17,123,4,54,50,1,12920.204,60,2214.647,LESS,700,5192,5892,11,1,-4.0,-0.3749633842697951,4.0,-0.8730378697119728,-0.08816615245792167,1.7669478486529584,104,54,50,0,-1.116921538982118,-1.0144338139355558,-1.170500554541026,1.957592051018468,0.43919927735595293,0.43919927735595293,-1.170500554541026,-1.0144338139355558,0,1,1,0,-1.0144338139355558,-1.170500554541026
3963,17,124,37,80,69,1,6095.05,80,2072.271,LESS,2652,1520,4172,6,2,-11.0,-1.0311493067419364,11.0,0.34921514788478913,0.7755022797829446,-0.13881896674414415,149,80,69,0,-0.21939530230005888,0.0,-0.4291835366650429,0.20452454264372044,2.05912178676986,2.05912178676986,-0.4291835366650429,0.0,1,1,1,1,0.0,-0.4291835366650429
3964,17,125,52,105,110,0,4053.583,80,2413.638,LESS,-144,2036,1892,5,2,5.0,0.4687042303372438,5.0,-0.6984302957695783,0.7755022797829446,-0.7088515349950991,215,105,110,1,1.0969765115002945,0.9754171287841883,1.170500554541026,-0.14608895903122907,-0.2612180371652241,0.2612180371652241,1.170500554541026,0.9754171287841883,1,1,0,2,1.170500554541026,0.9754171287841883
3965,17,126,5,55,50,1,3514.554,70,2280.619,LESS,1714,1002,2716,4,2,-5.0,-0.4687042303372438,5.0,-0.6984302957695783,0.3436680636625115,-0.8593629492044611,105,55,50,0,-1.0969765115002945,-0.9754171287841883,-1.170500554541026,-0.4967024607061786,1.2806959087830543,1.2806959087830543,-1.170500554541026,-0.9754171287841883,1,0,1,0,-0.9754171287841883,-1.170500554541026
3966,17,127,30,96,80,1,12553.764,70,1862.331,LESS,752,5156,5908,14,2,-16.0,-1.4998535370791803,16.0,1.222253017596762,0.3436680636625115,1.6646279315003032,176,96,80,0,0.3191204397091766,0.6242669624218805,0.0,3.009432556043316,0.482352950762471,0.482352950762471,0.0,0.6242669624218805,1,1,1,1,0.6242669624218805,0.0
3967,17,128,33,80,75,0,8568.648000000001,80,1179.063,LESS,526,3498,4024,5,2,-5.0,-0.4687042303372438,5.0,-0.6984302957695783,0.7755022797829446,0.5518762150836424,155,80,75,0,-0.09972513740911768,0.0,-0.19508342575683765,-0.14608895903122907,0.29480044711106573,0.29480044711106573,-0.19508342575683765,0.0,1,1,1,1,0.0,-0.19508342575683765
3968,17,129,48,110,128,0,8922.804,70,1348.375,LESS,964,2676,3640,5,2,18.0,1.6873352292140782,18.0,1.571468165481551,0.3436680636625115,0.6507661085972208,238,110,128,1,1.5557121435822359,1.170500554541026,1.8728008872656416,-0.14608895903122907,0.658287157727506,0.658287157727506,1.8728008872656416,1.170500554541026,1,1,1,2,1.8728008872656416,1.170500554541026
3969,17,130,9,59,50,1,2577.67,90,1152.504,LESS,1652,560,2212,2,2,-9.0,-0.8436676146070391,9.0,0.0,1.207336495903378,-1.1209661946515967,109,59,50,0,-1.0171964015730004,-0.8193503881787182,-1.170500554541026,-1.1979294640560776,1.229243452029129,1.229243452029129,-1.170500554541026,-0.8193503881787182,1,0,1,0,-0.8193503881787182,-1.170500554541026
3970,17,131,44,110,119,1,5706.84,70,1008.563,LESS,380,2192,2572,5,2,9.0,0.8436676146070391,9.0,0.0,0.3436680636625115,-0.2472176542177615,229,110,119,1,1.376206896245824,1.170500554541026,1.5216507209033339,-0.14608895903122907,0.17363821023891896,0.17363821023891896,1.5216507209033339,1.170500554541026,1,1,1,2,1.5216507209033339,1.170500554541026
3971,17,132,2,52,50,0,8982.118,40,1682.7220000000002,LESS,-3630,5750,2120,4,1,-2.0,-0.18748169213489754,2.0,-1.222253017596762,-0.9518345846987879,0.6673281748727166,102,52,50,0,-1.156811593945765,-1.092467184238291,-1.170500554541026,-0.4967024607061786,-3.154173912071413,3.154173912071413,-1.170500554541026,-1.092467184238291,0,0,0,0,-1.092467184238291,-1.170500554541026
3972,17,133,8,58,50,0,16282.19,80,1308.448,LESS,3402,5264,8666,4,1,-8.0,-0.7499267685395902,8.0,-0.17460757394239454,0.7755022797829446,2.7057048866083866,108,58,50,0,-1.0371414290548238,-0.8583670733300858,-1.170500554541026,-0.4967024607061786,2.681530537825408,2.681530537825408,-1.170500554541026,-0.8583670733300858,1,0,1,0,-0.8583670733300858,-1.170500554541026
3973,17,134,44,119,110,1,15123.462,70,1592.908,LESS,1560,5576,7136,6,2,-9.0,-0.8436676146070391,9.0,0.0,0.3436680636625115,2.382156821543268,229,119,110,0,1.376206896245824,1.5216507209033339,1.170500554541026,0.20452454264372044,1.1528946452329818,1.1528946452329818,1.170500554541026,1.5216507209033339,1,1,1,2,1.5216507209033339,1.170500554541026
3974,17,135,34,74,80,1,8323.117,80,1289.418,LESS,822,3424,4246,8,2,6.0,0.5624450764046927,6.0,-0.5238227218271837,0.7755022797829446,0.4833173471150562,154,74,80,1,-0.11967016489094122,-0.2341001109082052,0.0,0.9057515459936194,0.5404444341943222,0.5404444341943222,0.0,-0.2341001109082052,1,1,1,1,-0.2341001109082052,0.0
3975,17,136,24,86,80,0,9225.887,70,1163.191,LESS,256,3696,3952,8,2,-6.0,-0.5624450764046927,6.0,-0.5238227218271837,0.3436680636625115,0.7353950449862021,166,86,80,0,0.11967016489094122,0.2341001109082052,0.0,0.9057515459936194,0.0707332967310683,0.0707332967310683,0.0,0.2341001109082052,1,1,1,1,0.2341001109082052,0.0
3976,17,137,39,66,80,0,3566.353,70,1069.515,LESS,-404,1884,1480,3,2,14.0,1.3123718449442827,14.0,0.8730378697119728,0.3436680636625115,-0.8448992733268539,146,66,80,1,-0.2792303847455295,-0.5462335921191455,0.0,-0.847315962381128,-0.47698640419781424,0.47698640419781424,0.0,-0.5462335921191455,1,0,0,1,-0.5462335921191455,0.0
3977,17,138,9,50,59,0,2282.687,80,1553.771,LESS,784,810,1594,3,2,9.0,0.8436676146070391,9.0,0.0,0.7755022797829446,-1.2033333928871652,109,50,59,1,-1.0171964015730004,-1.170500554541026,-0.8193503881787182,-0.847315962381128,0.5089090574741744,0.5089090574741744,-0.8193503881787182,-1.170500554541026,1,0,1,0,-1.170500554541026,-0.8193503881787182
3978,17,139,57,94,110,0,4023.027,60,2224.178,LESS,-888,2240,1352,4,2,16.0,1.4998535370791803,16.0,1.222253017596762,-0.08816615245792167,-0.7173835931451823,204,94,110,1,0.8775812092002355,0.5462335921191455,1.170500554541026,-0.4967024607061786,-0.8786475182123281,0.8786475182123281,1.170500554541026,0.5462335921191455,0,0,0,2,1.170500554541026,0.5462335921191455
3979,17,140,60,110,87,1,7287.8780000000015,70,1358.4070000000004,LESS,2990,1328,4318,3,2,-23.0,-2.1560394595513217,23.0,2.444506035193524,0.3436680636625115,0.1942507367199092,197,110,87,0,0.7379660168274708,1.170500554541026,0.27311679605957273,-0.847315962381128,2.339620663912227,2.339620663912227,0.27311679605957273,1.170500554541026,1,0,1,2,1.170500554541026,0.27311679605957273
3980,17,141,33,75,80,0,14257.749,60,1866.404,LESS,604,5228,5832,12,1,5.0,0.4687042303372438,5.0,-0.6984302957695783,-0.08816615245792167,2.140426436110519,155,75,80,1,-0.09972513740911768,-0.19508342575683765,0.0,2.3082055526934173,0.3595309572208428,0.3595309572208428,0.0,-0.19508342575683765,0,1,1,1,-0.19508342575683765,0.0
3981,17,142,15,50,45,1,5033.45,70,1587.073,LESS,870,1818,2688,4,2,-5.0,-0.4687042303372438,5.0,-0.6984302957695783,0.3436680636625115,-0.4352462783074532,95,50,45,0,-1.2964267863185297,-1.170500554541026,-1.3655839802978638,-0.4967024607061786,0.5802785942618772,0.5802785942618772,-1.3655839802978638,-1.170500554541026,1,0,1,0,-1.170500554541026,-1.3655839802978638
3982,17,143,59,89,110,0,2468.377,80,1434.37,LESS,-288,1300,1012,3,1,21.0,1.9685577674164243,21.0,2.0952908873087353,0.7755022797829446,-1.151483743787513,199,89,110,1,0.7778560717911179,0.3511501663623078,1.170500554541026,-0.847315962381128,-0.3807205173678894,0.3807205173678894,1.170500554541026,0.3511501663623078,1,0,0,2,1.170500554541026,0.3511501663623078
3983,17,144,29,80,94,0,3251.114,80,1134.36,LESS,-212,1920,1708,3,2,14.0,1.3123718449442827,14.0,0.8730378697119728,0.7755022797829446,-0.9329224923075492,174,80,94,1,0.2792303847455295,0.0,0.5462335921191455,-0.847315962381128,-0.31764976392759386,0.31764976392759386,0.5462335921191455,0.0,1,0,0,1,0.5462335921191455,0.0
3984,17,145,55,110,98,0,9190.952,30,1288.067,LESS,-366,3120,2754,5,1,-12.0,-1.124890152809385,12.0,0.5238227218271837,-1.3836688008192208,0.7256402520986129,208,110,98,0,0.9573613191275298,1.170500554541026,0.7023003327246156,-0.14608895903122907,-0.44545102747766646,0.44545102747766646,0.7023003327246156,1.170500554541026,0,1,0,2,1.170500554541026,0.7023003327246156
3985,17,146,29,94,80,1,3479.847,70,2284.591,LESS,1528,822,2350,4,2,-14.0,-1.3123718449442827,14.0,0.8730378697119728,0.3436680636625115,-0.8690540783514352,174,94,80,0,0.2792303847455295,0.5462335921191455,0.0,-0.4967024607061786,1.1263385385212783,1.1263385385212783,0.0,0.5462335921191455,0,0,1,1,0.5462335921191455,0.0
3986,17,147,57,110,94,0,7210.041999999998,20,1721.618,LESS,-1336,3596,2260,6,1,-16.0,-1.4998535370791803,16.0,1.222253017596762,-1.8155030169396544,0.17251682920027578,204,110,94,0,0.8775812092002355,1.170500554541026,0.5462335921191455,0.20452454264372044,-1.2504330121761755,1.2504330121761755,0.5462335921191455,1.170500554541026,0,1,0,2,1.170500554541026,0.5462335921191455
3987,17,148,39,80,66,1,6443.748000000001,80,1226.075,LESS,2878,1464,4342,3,2,-14.0,-1.3123718449442827,14.0,0.8730378697119728,0.7755022797829446,-0.04145309382825959,146,80,66,0,-0.2792303847455295,0.0,-0.5462335921191455,-0.847315962381128,2.2466742904212653,2.2466742904212653,-0.5462335921191455,0.0,1,0,1,1,0.0,-0.5462335921191455
3988,17,149,4,50,54,0,3443.126,70,1170.907,LESS,-568,1774,1206,3,1,4.0,0.3749633842697951,4.0,-0.8730378697119728,0.3436680636625115,-0.8793075705405049,104,50,54,1,-1.116921538982118,-1.170500554541026,-1.0144338139355558,-0.847315962381128,-0.6130864510952941,0.6130864510952941,-1.0144338139355558,-1.170500554541026,0,0,0,0,-1.170500554541026,-1.0144338139355558
3989,17,150,55,98,110,0,3965.528,60,2893.465,LESS,-290,2072,1782,2,2,12.0,1.124890152809385,12.0,0.5238227218271837,-0.08816615245792167,-0.7334388625381542,208,98,110,1,0.9573613191275298,0.7023003327246156,1.170500554541026,-1.1979294640560776,-0.38238027403737085,0.38238027403737085,1.170500554541026,0.7023003327246156,0,0,0,2,1.170500554541026,0.7023003327246156
3990,17,151,2,50,52,1,3753.102,70,1778.819,LESS,2062,58,2120,1,2,2.0,0.18748169213489754,2.0,-1.222253017596762,0.3436680636625115,-0.7927539229056629,102,50,52,1,-1.156811593945765,-1.170500554541026,-1.092467184238291,-1.548542965731027,1.5694935692728287,1.5694935692728287,-1.092467184238291,-1.170500554541026,0,0,1,0,-1.170500554541026,-1.092467184238291
3991,17,152,59,110,89,1,5763.076999999998,80,1168.568,LESS,1844,1362,3206,3,2,-21.0,-1.9685577674164243,21.0,2.0952908873087353,0.7755022797829446,-0.2315147692136307,199,110,89,0,0.7778560717911179,1.170500554541026,0.3511501663623078,-0.847315962381128,1.3885800922993494,1.3885800922993494,0.3511501663623078,1.170500554541026,1,0,1,2,1.170500554541026,0.3511501663623078
3992,17,153,60,87,110,0,1628.609,70,1540.039,LESS,-832,1260,428,1,1,23.0,2.1560394595513217,23.0,2.444506035193524,0.3436680636625115,-1.385969586456029,197,87,110,1,0.7379660168274708,0.27311679605957273,1.170500554541026,-1.548542965731027,-0.8321743314668472,0.8321743314668472,1.170500554541026,0.27311679605957273,0,0,0,2,1.170500554541026,0.27311679605957273
3993,17,154,52,110,105,0,10223.509,40,1596.649,LESS,156,4528,4684,11,1,-5.0,-0.4687042303372438,5.0,-0.6984302957695783,-0.9518345846987879,1.0139579758607418,215,110,105,0,1.0969765115002945,1.170500554541026,0.9754171287841883,1.957592051018468,-0.012254536743004807,0.012254536743004807,0.9754171287841883,1.170500554541026,0,1,1,2,1.170500554541026,0.9754171287841883
3994,17,155,30,80,96,0,3848.055,70,1140.505,LESS,-178,1976,1798,3,2,16.0,1.4998535370791803,16.0,1.222253017596762,0.3436680636625115,-0.7662404879820846,176,80,96,1,0.3191204397091766,0.0,0.6242669624218805,-0.847315962381128,-0.289433900546409,0.289433900546409,0.6242669624218805,0.0,0,0,0,1,0.6242669624218805,0.0
3995,17,156,24,80,86,0,7369.800999999998,70,1365.785,LESS,1010,2576,3586,5,1,6.0,0.5624450764046927,6.0,-0.5238227218271837,0.3436680636625115,0.21712584471275004,166,80,86,1,0.11967016489094122,0.0,0.2341001109082052,-0.14608895903122907,0.6964615611255796,0.6964615611255796,0.2341001109082052,0.0,1,1,1,1,0.2341001109082052,0.0
3996,17,157,5,50,55,0,9430.724,70,1473.526,LESS,2844,2140,4984,3,2,5.0,0.4687042303372438,5.0,-0.6984302957695783,0.3436680636625115,0.7925910521628161,105,50,55,1,-1.0969765115002945,-1.170500554541026,-0.9754171287841883,-0.847315962381128,2.2184584270400802,2.2184584270400802,-0.9754171287841883,-1.170500554541026,0,0,1,0,-1.170500554541026,-0.9754171287841883
3997,17,158,34,80,74,1,11885.698,30,1937.232,LESS,1982,3398,5380,10,2,-6.0,-0.5624450764046927,6.0,-0.5238227218271837,-1.3836688008192208,1.4780859115993483,154,80,74,0,-0.11967016489094122,0.0,-0.2341001109082052,1.6069785493435185,1.5031033024935703,1.5031033024935703,-0.2341001109082052,0.0,0,1,1,1,0.0,-0.2341001109082052
3998,17,159,15,45,50,1,3495.468,70,1015.159,LESS,964,1064,2028,4,2,5.0,0.4687042303372438,5.0,-0.6984302957695783,0.3436680636625115,-0.8646922744385394,95,45,50,1,-1.2964267863185297,-1.3655839802978638,-1.170500554541026,-0.4967024607061786,0.658287157727506,0.658287157727506,-1.170500554541026,-1.3655839802978638,0,0,1,0,-1.3655839802978638,-1.170500554541026
3999,17,160,37,69,80,0,10982.379,30,1164.335,LESS,716,3086,3802,5,2,11.0,1.0311493067419364,11.0,0.34921514788478913,-1.3836688008192208,1.2258549181422491,149,69,80,1,-0.21939530230005888,-0.4291835366650429,0.0,-0.14608895903122907,0.4524773307118046,0.4524773307118046,0.0,-0.4291835366650429,0,1,1,1,-0.4291835366650429,0.0
4000,17,161,3,50,53,0,5097.561,70,1727.61,MORE,-334,2668,2334,5,2,3.0,0.28122253820234633,3.0,-1.0476454436543674,0.3436680636625115,-0.4173447604366589,103,50,53,0,-1.1368665664639415,-1.170500554541026,-1.0534504990869233,-0.14608895903122907,-0.418894920765963,0.418894920765963,-1.0534504990869233,-1.170500554541026,0,0,0,0,-1.170500554541026,-1.0534504990869233
4001,17,162,20,50,40,0,4035.593,70,1582.013,MORE,472,1562,2034,3,2,-10.0,-0.9374084606744876,10.0,0.17460757394239454,0.3436680636625115,-0.7138748275111352,90,50,40,1,-1.3961519237276474,-1.170500554541026,-1.5606674060547012,-0.847315962381128,0.24998701703506626,0.24998701703506626,-1.5606674060547012,-1.170500554541026,0,0,1,0,-1.170500554541026,-1.5606674060547012
4002,17,163,25,80,88,1,2430.067,90,1126.198,MORE,664,1084,1748,2,2,8.0,0.7499267685395902,8.0,-0.17460757394239454,1.207336495903378,-1.162180927572357,168,80,88,0,0.1595602198545883,0.0,0.31213348121094026,-1.1979294640560776,0.40932365730528664,0.40932365730528664,0.31213348121094026,0.0,1,0,1,1,0.31213348121094026,0.0
4003,17,164,42,115,110,1,6841.13,90,1730.135,MORE,704,3240,3944,6,2,-5.0,-0.4687042303372438,5.0,-0.6984302957695783,1.207336495903378,0.06950666307043149,225,115,110,1,1.2964267863185297,1.3655839802978638,1.170500554541026,0.20452454264372044,0.4425187906949159,0.4425187906949159,1.170500554541026,1.3655839802978638,1,1,1,2,1.3655839802978638,1.170500554541026
4004,17,165,53,103,110,1,4750.34,80,2733.197,MORE,1622,1854,3476,6,2,7.0,0.6561859224721414,7.0,-0.34921514788478913,0.7755022797829446,-0.5142982151732108,213,103,110,0,1.0570864565366473,0.8973837584814532,1.170500554541026,0.20452454264372044,1.204347101986907,1.204347101986907,1.170500554541026,0.8973837584814532,1,1,1,2,1.170500554541026,0.8973837584814532
4005,17,166,26,90,80,0,4076.55,60,2076.784,MORE,-342,2094,1752,5,2,-10.0,-0.9374084606744876,10.0,0.17460757394239454,-0.08816615245792167,-0.7024385300359105,170,90,80,1,0.19945027481823535,0.3901668515136753,0.0,-0.14608895903122907,-0.4255339474438889,0.4255339474438889,0.0,0.3901668515136753,0,0,0,1,0.3901668515136753,0.0
4006,17,167,35,80,72,0,5521.174,70,1353.149,MORE,-770,2652,1882,5,2,-8.0,-0.7499267685395902,8.0,-0.17460757394239454,0.3436680636625115,-0.2990606018710333,152,80,72,1,-0.1595602198545883,0.0,-0.31213348121094026,-0.14608895903122907,-0.7807218747129219,0.7807218747129219,-0.31213348121094026,0.0,1,0,0,1,0.0,-0.31213348121094026
4007,17,168,28,93,80,0,9502.706,70,1818.496,MORE,1276,3468,4744,10,2,-13.0,-1.218630998876834,13.0,0.6984302957695783,0.3436680636625115,0.8126903652194759,173,93,80,1,0.25928535726370594,0.5072169069677779,0.0,1.6069785493435185,0.9172091981666141,0.9172091981666141,0.0,0.5072169069677779,1,1,1,1,0.5072169069677779,0.0
4008,17,169,26,80,90,1,5340.182,70,1834.438,MORE,1000,1940,2940,6,2,10.0,0.9374084606744876,10.0,0.17460757394239454,0.3436680636625115,-0.3495984428417063,170,80,90,0,0.19945027481823535,0.0,0.3901668515136753,0.20452454264372044,0.6881627777781723,0.6881627777781723,0.3901668515136753,0.0,0,1,1,1,0.3901668515136753,0.0
4009,17,170,25,88,80,0,4030.4040000000014,60,1031.06,MORE,-338,1832,1494,5,1,-8.0,-0.7499267685395902,8.0,-0.17460757394239454,-0.08816615245792167,-0.7153237360639814,168,88,80,1,0.1595602198545883,0.31213348121094026,0.0,-0.14608895903122907,-0.422214434104926,0.422214434104926,0.0,0.31213348121094026,0,0,0,1,0.31213348121094026,0.0
4010,17,171,36,80,70,0,7517.559,70,2168.856,MORE,-600,3296,2696,8,2,-10.0,-0.9374084606744876,10.0,0.17460757394239454,0.3436680636625115,0.2583838578080516,150,80,70,1,-0.19945027481823535,0.0,-0.3901668515136753,0.9057515459936194,-0.6396425578069975,0.6396425578069975,-0.3901668515136753,0.0,0,1,0,1,0.0,-0.3901668515136753
4011,17,172,28,80,93,1,8643.44,30,2553.384,MORE,766,3500,4266,11,1,13.0,1.218630998876834,13.0,0.6984302957695783,-1.3836688008192208,0.5727601558206834,173,80,93,0,0.25928535726370594,0.0,0.5072169069677779,1.957592051018468,0.4939712474488412,0.4939712474488412,0.5072169069677779,0.0,0,1,1,1,0.5072169069677779,0.0
4012,17,173,21,82,80,1,8397.546999999999,90,3444.753,MORE,1912,3378,5290,10,2,-2.0,-0.18748169213489754,2.0,-1.222253017596762,1.207336495903378,0.5041002077025247,162,82,80,1,0.03989005496364707,0.07803337030273506,0.0,1.6069785493435185,1.4450118190617192,1.4450118190617192,0.0,0.07803337030273506,1,1,1,1,0.07803337030273506,0.0
4013,17,174,19,50,41,0,5101.478,70,1895.51,MORE,-882,2794,1912,5,2,-9.0,-0.8436676146070391,9.0,0.0,0.3436680636625115,-0.4162510285419777,91,50,41,1,-1.376206896245824,-1.170500554541026,-1.5216507209033339,-0.14608895903122907,-0.8736682482038837,0.8736682482038837,-1.5216507209033339,-1.170500554541026,0,0,0,0,-1.170500554541026,-1.5216507209033339
4014,17,175,56,96,110,1,6750.531999999998,70,2249.196,MORE,986,1890,2876,4,2,14.0,1.3123718449442827,14.0,0.8730378697119728,0.3436680636625115,0.04420926143797746,206,96,110,0,0.9174712641638826,0.6242669624218805,1.170500554541026,-0.4967024607061786,0.6765444810918021,0.6765444810918021,1.170500554541026,0.6242669624218805,0,0,1,2,1.170500554541026,0.6242669624218805
4015,17,176,23,80,85,0,10678.701,70,1813.926,MORE,-564,4752,4188,8,2,5.0,0.4687042303372438,5.0,-0.6984302957695783,0.3436680636625115,1.1410598417284183,165,80,85,0,0.09972513740911768,0.0,0.19508342575683765,0.9057515459936194,-0.6097669377563312,0.6097669377563312,0.19508342575683765,0.0,0,1,0,1,0.19508342575683765,0.0
4016,17,177,10,60,50,0,3040.401,70,1164.89,MORE,-460,1450,990,3,1,-10.0,-0.9374084606744876,10.0,0.17460757394239454,0.3436680636625115,-0.9917592369396512,110,60,50,1,-0.9972513740911768,-0.7803337030273506,-1.170500554541026,-0.847315962381128,-0.5234595909432952,0.5234595909432952,-1.170500554541026,-0.7803337030273506,0,0,0,0,-0.7803337030273506,-1.170500554541026
4017,17,178,19,41,50,0,8784.855,20,1422.3270000000002,MORE,-1212,4506,3294,9,1,9.0,0.8436676146070391,9.0,0.0,-1.8155030169396544,0.6122470324830093,91,41,50,0,-1.376206896245824,-1.5216507209033339,-1.170500554541026,1.2563650476685688,-1.147528098668325,1.147528098668325,-1.170500554541026,-1.5216507209033339,0,1,0,0,-1.5216507209033339,-1.170500554541026
4018,17,179,56,110,96,0,7283.052,80,988.624,MORE,-786,3340,2554,5,2,-14.0,-1.3123718449442827,14.0,0.8730378697119728,0.7755022797829446,0.19290318754356686,206,110,96,1,0.9174712641638826,1.170500554541026,0.6242669624218805,-0.14608895903122907,-0.7939999280687735,0.7939999280687735,0.6242669624218805,1.170500554541026,1,0,0,2,1.170500554541026,0.6242669624218805
4019,17,180,35,72,80,1,2988.272,70,1159.549,MORE,1126,880,2006,2,2,8.0,0.7499267685395902,8.0,-0.17460757394239454,0.3436680636625115,-1.00631505770499,152,72,80,0,-0.1595602198545883,-0.31213348121094026,0.0,-1.1979294640560776,0.7927274479555044,0.7927274479555044,0.0,-0.31213348121094026,0,0,1,1,-0.31213348121094026,0.0
4020,17,181,11,49,50,0,2952.379000000001,60,1543.8770000000004,MORE,-48,1360,1312,3,1,1.0,0.09374084606744876,1.0,-1.3968605915391563,-0.08816615245792167,-1.0163373499939328,99,49,50,0,-1.2166466763912356,-1.2095172396923934,-1.170500554541026,-0.847315962381128,-0.18154971703011397,0.18154971703011397,-1.170500554541026,-1.2095172396923934,0,0,0,0,-1.2095172396923934,-1.170500554541026
4021,17,182,17,43,50,1,4316.585,80,1287.81,MORE,856,1608,2464,4,2,7.0,0.6561859224721414,7.0,-0.34921514788478913,0.7755022797829446,-0.6354142932884549,93,43,50,0,-1.3363168412821769,-1.4436173506005987,-1.170500554541026,-0.4967024607061786,0.568660297575507,0.568660297575507,-1.170500554541026,-1.4436173506005987,1,0,1,0,-1.4436173506005987,-1.170500554541026
4022,17,183,1,51,50,0,12613.209,10,1756.196,MORE,-1498,5736,4238,9,1,-1.0,-0.09374084606744876,1.0,-1.3968605915391563,-2.247337233060088,1.6812265765039591,101,51,50,1,-1.1767566214275886,-1.1314838693896585,-1.170500554541026,1.2563650476685688,-1.3848733024041742,1.3848733024041742,-1.170500554541026,-1.1314838693896585,0,1,0,0,-1.1314838693896585,-1.170500554541026
4023,17,184,41,112,110,0,8638.511999999999,20,1003.276,MORE,-760,4224,3464,7,1,-2.0,-0.18748169213489754,2.0,-1.222253017596762,-1.8155030169396544,0.5713841254972241,222,112,110,1,1.2365917038730592,1.248533924843761,1.170500554541026,0.55513804431867,-0.7724230913655145,0.7724230913655145,1.170500554541026,1.248533924843761,0,1,0,2,1.248533924843761,1.170500554541026
4024,17,185,20,40,50,1,3047.884,80,1843.859,MORE,1110,1086,2196,4,2,10.0,0.9374084606744876,10.0,0.17460757394239454,0.7755022797829446,-0.9896697818036034,90,40,50,0,-1.3961519237276474,-1.5606674060547012,-1.170500554541026,-0.4967024607061786,0.7794493945996527,0.7794493945996527,-1.170500554541026,-1.5606674060547012,1,0,1,0,-1.5606674060547012,-1.170500554541026
4025,17,186,1,50,51,1,4555.576,70,1851.764,MORE,402,1296,1698,5,2,1.0,0.09374084606744876,1.0,-1.3968605915391563,0.3436680636625115,-0.5686815694585503,101,50,51,0,-1.1767566214275886,-1.170500554541026,-1.1314838693896585,-0.14608895903122907,0.19189553360321504,0.19189553360321504,-1.1314838693896585,-1.170500554541026,1,1,1,0,-1.170500554541026,-1.1314838693896585
4026,17,187,23,85,80,0,1776.571,80,998.053,MORE,-164,900,736,1,2,-5.0,-0.4687042303372438,5.0,-0.6984302957695783,0.7755022797829446,-1.3446546110664943,165,85,80,1,0.09972513740911768,0.19508342575683765,0.0,-1.548542965731027,-0.27781560386003873,0.27781560386003873,0.0,0.19508342575683765,1,0,0,1,0.19508342575683765,0.0
4027,17,188,11,50,49,1,8255.091999999999,70,1723.695,MORE,490,2920,3410,6,2,-1.0,-0.09374084606744876,1.0,-1.3968605915391563,0.3436680636625115,0.4643229350303778,99,50,49,1,-1.2166466763912356,-1.170500554541026,-1.2095172396923934,0.20452454264372044,0.26492482706039944,0.26492482706039944,-1.2095172396923934,-1.170500554541026,1,1,1,0,-1.170500554541026,-1.2095172396923934
4028,17,189,17,50,43,0,4504.07,80,1051.128,MORE,-18,2010,1992,4,2,-7.0,-0.6561859224721414,7.0,-0.34921514788478913,0.7755022797829446,-0.5830634318449293,93,50,43,1,-1.3363168412821769,-1.170500554541026,-1.4436173506005987,-0.4967024607061786,-0.15665336698789203,0.15665336698789203,-1.4436173506005987,-1.170500554541026,1,0,0,0,-1.170500554541026,-1.4436173506005987
4029,17,190,21,80,82,0,5685.101,70,1543.7620000000004,MORE,-744,3020,2276,5,2,2.0,0.18748169213489754,2.0,-1.222253017596762,0.3436680636625115,-0.2532877685038155,162,80,82,0,0.03989005496364707,0.0,0.07803337030273506,-0.14608895903122907,-0.7591450380096628,0.7591450380096628,0.07803337030273506,0.0,0,0,0,1,0.07803337030273506,0.0
4030,17,191,10,50,60,1,15205.986,80,1281.138,MORE,1226,4864,6090,12,2,10.0,0.9374084606744876,10.0,0.17460757394239454,0.7755022797829446,2.4051997449225557,110,50,60,0,-0.9972513740911768,-1.170500554541026,-0.7803337030273506,2.3082055526934173,0.8757152814295776,0.8757152814295776,-0.7803337030273506,-1.170500554541026,1,1,1,0,-1.170500554541026,-0.7803337030273506
4031,17,192,3,53,50,0,4380.422000000001,30,1382.503,MORE,408,1680,2088,4,1,-3.0,-0.28122253820234633,3.0,-1.0476454436543674,-1.3836688008192208,-0.6175892835971707,103,53,50,1,-1.1368665664639415,-1.0534504990869233,-1.170500554541026,-0.4967024607061786,0.19687480361165943,0.19687480361165943,-1.170500554541026,-1.0534504990869233,0,0,1,0,-1.0534504990869233,-1.170500554541026
4032,17,193,45,122,110,0,3073.457000000001,70,1079.399,MORE,352,1382,1734,3,2,-12.0,-1.124890152809385,12.0,0.5238227218271837,0.3436680636625115,-0.9825291114582674,232,122,110,1,1.4360419786912946,1.6387007763574364,1.170500554541026,-0.847315962381128,0.1504016168661785,0.1504016168661785,1.170500554541026,1.6387007763574364,0,0,1,2,1.6387007763574364,1.170500554541026
4033,17,194,38,67,80,1,3444.061,80,1127.84,MORE,1254,1182,2436,4,2,13.0,1.218630998876834,13.0,0.6984302957695783,0.7755022797829446,-0.8790464933585986,147,67,80,0,-0.25928535726370594,-0.5072169069677779,0.0,-0.4967024607061786,0.898951874802318,0.898951874802318,0.0,-0.5072169069677779,1,0,1,1,-0.5072169069677779,0.0
4034,17,195,38,80,67,1,17791.478,80,1003.688,MORE,736,5206,5942,11,2,-13.0,-1.218630998876834,13.0,0.6984302957695783,0.7755022797829446,3.1271387451377417,147,80,67,1,-0.25928535726370594,0.0,-0.5072169069677779,1.957592051018468,0.4690748974066193,0.4690748974066193,-0.5072169069677779,0.0,1,1,1,1,0.0,-0.5072169069677779
4035,17,196,36,70,80,1,1860.292,80,1543.183,MORE,740,464,1204,2,2,10.0,0.9374084606744876,10.0,0.17460757394239454,0.7755022797829446,-1.3212774530489817,150,70,80,0,-0.19945027481823535,-0.3901668515136753,0.0,-1.1979294640560776,0.4723944107455822,0.4723944107455822,0.0,-0.3901668515136753,1,0,1,1,-0.3901668515136753,0.0
4036,17,197,45,110,122,1,3502.3190000000004,100,2453.312,MORE,1600,1340,2940,4,2,12.0,1.124890152809385,12.0,0.5238227218271837,1.639170712023811,-0.8627792907238442,232,110,122,0,1.4360419786912946,1.170500554541026,1.6387007763574364,-0.4967024607061786,1.186089778622611,1.186089778622611,1.6387007763574364,1.170500554541026,1,0,1,2,1.6387007763574364,1.170500554541026
4037,17,198,42,110,115,1,14815.109,80,1577.189,MORE,590,5524,6114,10,2,5.0,0.4687042303372438,5.0,-0.6984302957695783,0.7755022797829446,2.296056359219907,225,110,115,0,1.2964267863185297,1.170500554541026,1.3655839802978638,1.6069785493435185,0.3479126605344725,0.3479126605344725,1.3655839802978638,1.170500554541026,1,1,1,2,1.3655839802978638,1.170500554541026
4038,17,199,41,110,112,0,3301.886,60,1951.137,MORE,-418,1750,1332,3,1,2.0,0.18748169213489754,2.0,-1.222253017596762,-0.08816615245792167,-0.91874558248964,222,110,112,0,1.2365917038730592,1.170500554541026,1.248533924843761,-0.847315962381128,-0.48860470088418445,0.48860470088418445,1.248533924843761,1.170500554541026,0,0,0,2,1.248533924843761,1.170500554541026
4039,17,200,53,110,103,1,3517.441,70,1849.595,MORE,-196,1372,1176,3,1,-7.0,-0.6561859224721414,7.0,-0.34921514788478913,0.3436680636625115,-0.8585568210502758,213,110,103,1,1.0570864565366473,1.170500554541026,0.8973837584814532,-0.847315962381128,-0.30437171057174217,0.30437171057174217,0.8973837584814532,1.170500554541026,0,0,0,2,1.170500554541026,0.8973837584814532
4040,17,201,3,50,53,0,6140.254,70,1918.991,LESS,-516,2850,2334,7,2,3.0,0.28122253820234633,3.0,-1.0476454436543674,0.3436680636625115,-0.1261967924865069,103,50,53,1,-1.1368665664639415,-1.170500554541026,-1.0534504990869233,0.55513804431867,-0.5699327776887761,0.5699327776887761,-1.0534504990869233,-1.170500554541026,0,1,0,0,-1.170500554541026,-1.0534504990869233
4041,17,202,20,50,40,1,6970.968000000002,70,1462.674,LESS,1198,2616,3814,6,2,-10.0,-0.9374084606744876,10.0,0.17460757394239454,0.3436680636625115,0.1057609295349731,90,50,40,0,-1.3961519237276474,-1.170500554541026,-1.5606674060547012,0.20452454264372044,0.852478688056837,0.852478688056837,-1.5606674060547012,-1.170500554541026,0,1,1,0,-1.170500554541026,-1.5606674060547012
4042,17,203,25,80,88,0,3131.329,60,1427.525,LESS,-260,1570,1310,3,1,8.0,0.7499267685395902,8.0,-0.17460757394239454,-0.08816615245792167,-0.966369690419466,168,80,88,1,0.1595602198545883,0.0,0.31213348121094026,-0.847315962381128,-0.35748392399514894,0.35748392399514894,0.31213348121094026,0.0,0,0,0,1,0.31213348121094026,0.0
4043,17,204,42,115,110,1,6617.151999999999,10,1964.042,LESS,-940,3810,2870,4,1,-5.0,-0.4687042303372438,5.0,-0.6984302957695783,-2.247337233060088,0.006965973178450426,225,115,110,0,1.2964267863185297,1.3655839802978638,1.170500554541026,-0.4967024607061786,-0.9218011916188461,0.9218011916188461,1.170500554541026,1.3655839802978638,0,0,0,2,1.3655839802978638,1.170500554541026
4044,17,205,53,103,110,0,3995.447,60,1555.351,LESS,-196,1824,1628,3,1,7.0,0.6561859224721414,7.0,-0.34921514788478913,-0.08816615245792167,-0.7250846719440859,213,103,110,1,1.0570864565366473,0.8973837584814532,1.170500554541026,-0.847315962381128,-0.30437171057174217,0.30437171057174217,1.170500554541026,0.8973837584814532,0,0,0,2,1.170500554541026,0.8973837584814532
4045,17,206,26,90,80,1,13947.518999999998,90,2055.077,LESS,1504,3868,5372,8,2,-10.0,-0.9374084606744876,10.0,0.17460757394239454,1.207336495903378,2.0538018648348157,170,90,80,0,0.19945027481823535,0.3901668515136753,0.0,0.9057515459936194,1.1064214584875007,1.1064214584875007,0.0,0.3901668515136753,1,1,1,1,0.3901668515136753,0.0
4046,17,207,35,80,72,1,13634.49,80,1293.934,LESS,-88,4526,4438,7,2,-8.0,-0.7499267685395902,8.0,-0.17460757394239454,0.7755022797829446,1.966395737374991,152,80,72,0,-0.1595602198545883,0.0,-0.31213348121094026,0.55513804431867,-0.21474485041974317,0.21474485041974317,-0.31213348121094026,0.0,1,1,0,1,0.0,-0.31213348121094026
4047,17,208,28,93,80,1,4056.044,80,867.173,LESS,924,1356,2280,4,2,-13.0,-1.218630998876834,13.0,0.6984302957695783,0.7755022797829446,-0.7081643575141672,173,93,80,0,0.25928535726370594,0.5072169069677779,0.0,-0.4967024607061786,0.6250920243378767,0.6250920243378767,0.0,0.5072169069677779,1,0,1,1,0.5072169069677779,0.0
4048,17,209,26,80,90,0,2312.452,80,1083.429,LESS,-306,1214,908,3,1,10.0,0.9374084606744876,10.0,0.17460757394239454,0.7755022797829446,-1.1950222032407052,170,80,90,1,0.19945027481823535,0.0,0.3901668515136753,-0.847315962381128,-0.39565832739322254,0.39565832739322254,0.3901668515136753,0.0,1,0,0,1,0.3901668515136753,0.0
4049,17,210,25,88,80,0,7872.835,70,1983.329,LESS,724,2690,3414,6,2,-8.0,-0.7499267685395902,8.0,-0.17460757394239454,0.3436680636625115,0.3575864854860529,168,88,80,0,0.1595602198545883,0.31213348121094026,0.0,0.20452454264372044,0.4591163573897305,0.4591163573897305,0.0,0.31213348121094026,0,1,1,1,0.31213348121094026,0.0
4050,17,211,36,80,70,1,11600.637,80,1071.43,LESS,1426,3032,4458,8,2,-10.0,-0.9374084606744876,10.0,0.17460757394239454,0.7755022797829446,1.3984892029882443,150,80,70,0,-0.19945027481823535,0.0,-0.3901668515136753,0.9057515459936194,1.0416909483777237,1.0416909483777237,-0.3901668515136753,0.0,1,1,1,1,0.0,-0.3901668515136753
4051,17,212,28,80,93,0,3214.68,80,1310.568,LESS,-716,1932,1216,3,1,13.0,1.218630998876834,13.0,0.6984302957695783,0.7755022797829446,-0.9430958463669854,173,80,93,1,0.25928535726370594,0.0,0.5072169069677779,-0.847315962381128,-0.7359084446369223,0.7359084446369223,0.5072169069677779,0.0,1,0,0,1,0.5072169069677779,0.0
4052,17,213,21,82,80,0,10573.491000000002,70,1465.425,LESS,-776,4380,3604,9,2,-2.0,-0.18748169213489754,2.0,-1.222253017596762,0.3436680636625115,1.1116823761579822,162,82,80,0,0.03989005496364707,0.07803337030273506,0.0,1.2563650476685688,-0.7857011447213662,0.7857011447213662,0.0,0.07803337030273506,0,1,0,1,0.07803337030273506,0.0
4053,17,214,19,50,41,1,1503.495,80,1498.878,LESS,824,476,1300,2,2,-9.0,-0.8436676146070391,9.0,0.0,0.7755022797829446,-1.4209047848913456,91,50,41,0,-1.376206896245824,-1.170500554541026,-1.5216507209033339,-1.1979294640560776,0.5421041908638036,0.5421041908638036,-1.5216507209033339,-1.170500554541026,1,0,1,0,-1.170500554541026,-1.5216507209033339
4054,17,215,56,96,110,0,3768.844,80,1992.22,LESS,206,1722,1928,3,2,14.0,1.3123718449442827,14.0,0.8730378697119728,0.7755022797829446,-0.7883583325339321,206,96,110,1,0.9174712641638826,0.6242669624218805,1.170500554541026,-0.847315962381128,0.02923937999403175,0.02923937999403175,1.170500554541026,0.6242669624218805,1,0,1,2,1.170500554541026,0.6242669624218805
4055,17,216,23,80,85,0,11161.013,80,997.708,LESS,-1432,4324,2892,5,1,5.0,0.4687042303372438,5.0,-0.6984302957695783,0.7755022797829446,1.27573434200604,165,80,85,1,0.09972513740911768,0.0,0.19508342575683765,-0.14608895903122907,-1.3301013323112858,1.3301013323112858,0.19508342575683765,0.0,1,1,0,1,0.19508342575683765,0.0
4056,17,217,10,60,50,1,1612.697,90,1916.159,LESS,1110,486,1596,2,2,-10.0,-0.9374084606744876,10.0,0.17460757394239454,1.207336495903378,-1.3904126454062886,110,60,50,0,-0.9972513740911768,-0.7803337030273506,-1.170500554541026,-1.1979294640560776,0.7794493945996527,0.7794493945996527,-1.170500554541026,-0.7803337030273506,1,0,1,0,-0.7803337030273506,-1.170500554541026
4057,17,218,19,41,50,0,10174.789,20,1418.3370000000002,LESS,-1226,4212,2986,6,1,9.0,0.8436676146070391,9.0,0.0,-1.8155030169396544,1.0003540397083641,91,41,50,1,-1.376206896245824,-1.5216507209033339,-1.170500554541026,0.20452454264372044,-1.1591463953546952,1.1591463953546952,-1.170500554541026,-1.5216507209033339,0,1,0,0,-1.5216507209033339,-1.170500554541026
4058,17,219,56,110,96,1,3083.707000000001,60,1332.876,LESS,1068,790,1858,2,2,-14.0,-1.3123718449442827,14.0,0.8730378697119728,-0.08816615245792167,-0.9796670353999366,206,110,96,0,0.9174712641638826,1.170500554541026,0.6242669624218805,-1.1979294640560776,0.744594504540542,0.744594504540542,0.6242669624218805,1.170500554541026,0,0,1,2,1.170500554541026,0.6242669624218805
4059,17,220,35,72,80,0,2981.672,80,1396.509,LESS,-802,1536,734,2,1,8.0,0.7499267685395902,8.0,-0.17460757394239454,0.7755022797829446,-1.0081579554596225,152,72,80,1,-0.1595602198545883,-0.31213348121094026,0.0,-1.1979294640560776,-0.8072779814246253,0.8072779814246253,0.0,-0.31213348121094026,1,0,0,1,-0.31213348121094026,0.0
4060,17,221,11,49,50,1,2556.866,80,1389.146,LESS,1202,642,1844,2,2,1.0,0.09374084606744876,1.0,-1.3968605915391563,0.7755022797829446,-1.1267752317557445,99,49,50,1,-1.2166466763912356,-1.2095172396923934,-1.170500554541026,-1.1979294640560776,0.8557982013958,0.8557982013958,-1.170500554541026,-1.2095172396923934,1,0,1,0,-1.2095172396923934,-1.170500554541026
4061,17,222,17,43,50,0,8286.367,70,1066.99,LESS,-236,2772,2536,3,1,7.0,0.6561859224721414,7.0,-0.34921514788478913,0.3436680636625115,0.4730557573449435,93,43,50,1,-1.3363168412821769,-1.4436173506005987,-1.170500554541026,-0.847315962381128,-0.3375668439613714,0.3375668439613714,-1.170500554541026,-1.4436173506005987,1,0,0,0,-1.4436173506005987,-1.170500554541026
4062,17,223,1,51,50,0,14342.408,60,2032.821,LESS,-1160,6026,4866,8,2,-1.0,-0.09374084606744876,1.0,-1.3968605915391563,-0.08816615245792167,2.164065508990736,101,51,50,0,-1.1767566214275886,-1.1314838693896585,-1.170500554541026,0.9057515459936194,-1.104374425261807,1.104374425261807,-1.170500554541026,-1.1314838693896585,0,1,0,0,-1.1314838693896585,-1.170500554541026
4063,17,224,41,112,110,1,7255.014,70,1444.704,LESS,1882,2188,4070,8,2,-2.0,-0.18748169213489754,2.0,-1.222253017596762,0.3436680636625115,0.1850742228095692,222,112,110,0,1.2365917038730592,1.248533924843761,1.170500554541026,0.9057515459936194,1.4201154690194973,1.4201154690194973,1.170500554541026,1.248533924843761,0,1,1,2,1.248533924843761,1.170500554541026
4064,17,225,20,40,50,0,5220.749,70,2063.176,LESS,-576,2658,2082,5,1,10.0,0.9374084606744876,10.0,0.17460757394239454,0.3436680636625115,-0.3829473530733762,90,40,50,1,-1.3961519237276474,-1.5606674060547012,-1.170500554541026,-0.14608895903122907,-0.61972547777322,0.61972547777322,-1.170500554541026,-1.5606674060547012,0,1,0,0,-1.5606674060547012,-1.170500554541026
4065,17,226,1,50,51,1,13476.043,20,994.896,LESS,754,4918,5672,14,1,1.0,0.09374084606744876,1.0,-1.3968605915391563,-1.8155030169396544,1.9221530675979832,101,50,51,1,-1.1767566214275886,-1.170500554541026,-1.1314838693896585,3.009432556043316,0.48401270743195246,0.48401270743195246,-1.1314838693896585,-1.170500554541026,0,1,1,0,-1.170500554541026,-1.1314838693896585
4066,17,227,23,85,80,0,13700.488,30,1025.474,LESS,-386,5496,5110,11,1,-5.0,-0.4687042303372438,5.0,-0.6984302957695783,-1.3836688008192208,1.9848241564674507,165,85,80,0,0.09972513740911768,0.19508342575683765,0.0,1.957592051018468,-0.46204859417248106,0.46204859417248106,0.0,0.19508342575683765,0,1,0,1,0.19508342575683765,0.0
4067,17,228,11,50,49,1,3857.125,70,1137.964,LESS,698,1442,2140,4,2,-1.0,-0.09374084606744876,1.0,-1.3968605915391563,0.3436680636625115,-0.7637078997041274,99,50,49,0,-1.2166466763912356,-1.170500554541026,-1.2095172396923934,-0.4967024607061786,0.4375395206864715,0.4375395206864715,-1.2095172396923934,-1.170500554541026,0,0,1,0,-1.170500554541026,-1.2095172396923934
4068,17,229,17,50,43,1,1733.65,90,880.831,LESS,974,520,1494,2,2,-7.0,-0.6561859224721414,7.0,-0.34921514788478913,1.207336495903378,-1.3566393102371883,93,50,43,0,-1.3363168412821769,-1.170500554541026,-1.4436173506005987,-1.1979294640560776,0.6665859410749133,0.6665859410749133,-1.4436173506005987,-1.170500554541026,1,0,1,0,-1.170500554541026,-1.4436173506005987
4069,17,230,21,80,82,0,5214.45,20,1218.271,LESS,220,2270,2490,5,1,2.0,0.18748169213489754,2.0,-1.222253017596762,-1.8155030169396544,-0.3847062035213201,162,80,82,1,0.03989005496364707,0.0,0.07803337030273506,-0.14608895903122907,0.04085767668040199,0.04085767668040199,0.07803337030273506,0.0,0,1,1,1,0.07803337030273506,0.0
4070,17,231,10,50,60,0,5060.513,90,921.342,LESS,204,2196,2400,5,2,10.0,0.9374084606744876,10.0,0.17460757394239454,1.207336495903378,-0.4276895598326624,110,50,60,1,-0.9972513740911768,-1.170500554541026,-0.7803337030273506,-0.14608895903122907,0.027579623324550287,0.027579623324550287,-0.7803337030273506,-1.170500554541026,1,0,1,0,-1.170500554541026,-0.7803337030273506
4071,17,232,3,53,50,1,2134.451,80,1592.609,LESS,782,628,1410,2,2,-3.0,-0.28122253820234633,3.0,-1.0476454436543674,0.7755022797829446,-1.2447248764562109,103,53,50,0,-1.1368665664639415,-1.0534504990869233,-1.170500554541026,-1.1979294640560776,0.5072493008046929,0.5072493008046929,-1.170500554541026,-1.0534504990869233,1,0,1,0,-1.0534504990869233,-1.170500554541026
4072,17,233,45,122,110,1,2692.9770000000008,80,951.816,LESS,-88,1342,1254,4,2,-12.0,-1.124890152809385,12.0,0.5238227218271837,0.7755022797829446,-1.0887693747435043,232,122,110,0,1.4360419786912946,1.6387007763574364,1.170500554541026,-0.4967024607061786,-0.21474485041974317,0.21474485041974317,1.170500554541026,1.6387007763574364,1,0,0,2,1.6387007763574364,1.170500554541026
4073,17,234,38,67,80,0,7441.111,70,934.567,LESS,-164,3280,3116,9,1,13.0,1.218630998876834,13.0,0.6984302957695783,0.3436680636625115,0.23703751727075706,147,67,80,1,-0.25928535726370594,-0.5072169069677779,0.0,1.2563650476685688,-0.27781560386003873,0.27781560386003873,0.0,-0.5072169069677779,1,1,0,1,-0.5072169069677779,0.0
4074,17,235,38,80,67,1,9072.115,30,1421.41,LESS,240,3200,3440,8,1,-13.0,-1.218630998876834,13.0,0.6984302957695783,-1.3836688008192208,0.6924577611187253,147,80,67,0,-0.25928535726370594,0.0,-0.5072169069677779,0.9057515459936194,0.05745524337521661,0.05745524337521661,-0.5072169069677779,0.0,0,1,1,1,0.0,-0.5072169069677779
4075,17,236,36,70,80,0,1870.211,70,2256.514,LESS,278,862,1140,2,2,10.0,0.9374084606744876,10.0,0.17460757394239454,0.3436680636625115,-1.3185078011053146,150,70,80,1,-0.19945027481823535,-0.3901668515136753,0.0,-1.1979294640560776,0.08899062009536439,0.08899062009536439,0.0,-0.3901668515136753,1,0,1,1,-0.3901668515136753,0.0
4076,17,237,45,110,122,0,4735.279,80,1314.4070000000004,LESS,-42,2266,2224,5,2,12.0,1.124890152809385,12.0,0.5238227218271837,0.7755022797829446,-0.5185036520038956,232,110,122,1,1.4360419786912946,1.170500554541026,1.6387007763574364,-0.14608895903122907,-0.17657044702166957,0.17657044702166957,1.6387007763574364,1.170500554541026,1,0,0,2,1.6387007763574364,1.170500554541026
4077,17,238,42,110,115,0,3985.485,10,776.3510000000001,LESS,-206,1900,1694,5,1,5.0,0.4687042303372438,5.0,-0.6984302957695783,-2.247337233060088,-0.7278663306458509,225,110,115,1,1.2964267863185297,1.170500554541026,1.3655839802978638,-0.14608895903122907,-0.3126704939191495,0.3126704939191495,1.3655839802978638,1.170500554541026,0,0,0,2,1.3655839802978638,1.170500554541026
4078,17,239,41,110,112,0,4554.13,70,1291.767,LESS,208,1716,1924,5,2,2.0,0.18748169213489754,2.0,-1.222253017596762,0.3436680636625115,-0.5690853316029743,222,110,112,1,1.2365917038730592,1.170500554541026,1.248533924843761,-0.14608895903122907,0.03089913666351321,0.03089913666351321,1.248533924843761,1.170500554541026,1,1,1,2,1.248533924843761,1.170500554541026
4079,17,240,53,110,103,0,3471.15,10,1123.361,LESS,-574,1790,1216,2,1,-7.0,-0.6561859224721414,7.0,-0.34921514788478913,-2.247337233060088,-0.8714825149835623,213,110,103,0,1.0570864565366473,1.170500554541026,0.8973837584814532,-1.1979294640560776,-0.6180657211037385,0.6180657211037385,0.8973837584814532,1.170500554541026,0,0,0,2,1.170500554541026,0.8973837584814532
4080,18,1,49,110,131,0,4023.951,74,1548.214,LESS,-98,2262,2164,3,2,21.0,1.9685577674164243,21.0,2.0952908873087353,0.8410377649439175,-0.4649828009680572,241,110,131,1,1.6155472260277064,1.170500554541026,1.9898509427197442,-1.7128962999462027,-0.41037440303180495,0.41037440303180495,1.9898509427197442,1.170500554541026,1,0,0,2,1.9898509427197442,1.170500554541026
4081,18,2,13,47,50,1,5703.099,34,1764.67,LESS,1072,1968,3040,5,1,3.0,0.28122253820234633,3.0,-1.0476454436543674,-0.6546944587429309,0.4571169418776637,97,47,50,1,-1.2565367313548828,-1.2875506099951286,-1.170500554541026,-0.749015615334037,0.5831345753908568,0.5831345753908568,-1.170500554541026,-1.2875506099951286,0,0,1,0,-1.2875506099951286,-1.170500554541026
4082,18,3,16,50,44,1,4273.391,74,2719.159,LESS,1114,1376,2490,4,2,-6.0,-0.5624450764046927,6.0,-0.5238227218271837,0.8410377649439175,-0.3280034758249273,94,50,44,0,-1.3163718138003533,-1.170500554541026,-1.4046006654492311,-1.23095595764012,0.6187990002573113,0.6187990002573113,-1.4046006654492311,-1.170500554541026,1,0,1,0,-1.170500554541026,-1.4046006654492311
4083,18,4,7,57,50,0,5631.191,84,2378.804,LESS,2204,2488,4692,5,2,-7.0,-0.6561859224721414,7.0,-0.34921514788478913,1.2149708208656296,0.4176288513052124,107,57,50,0,-1.0570864565366473,-0.8973837584814532,-1.170500554541026,-0.749015615334037,1.5443757408391072,1.5443757408391072,-1.170500554541026,-0.8973837584814532,1,0,1,0,-0.8973837584814532,-1.170500554541026
4084,18,5,18,42,50,0,4558.732,54,1712.116,LESS,-592,2254,1662,5,1,8.0,0.7499267685395902,8.0,-0.17460757394239454,0.09317165310049327,-0.17130921020728004,92,42,50,1,-1.3562618687640005,-1.4826340357519663,-1.170500554541026,-0.749015615334037,-0.829855971699151,0.829855971699151,-1.170500554541026,-1.4826340357519663,1,0,0,0,-1.4826340357519663,-1.170500554541026
4085,18,6,51,108,110,0,8729.055,0,2266.079,LESS,-2776,6088,3312,9,1,2.0,0.18748169213489754,2.0,-1.222253017596762,-1.926066848876752,2.1188127837346444,218,108,110,1,1.156811593945765,1.092467184238291,1.170500554541026,1.1787457538902946,-2.6844060647547865,2.6844060647547865,1.170500554541026,1.092467184238291,0,1,0,2,1.170500554541026,1.092467184238291
4086,18,7,31,78,80,0,7565.496,14,3789.964,LESS,-2294,6094,3800,10,1,2.0,0.18748169213489754,2.0,-1.222253017596762,-1.402560570586355,1.4798473949268538,158,78,80,1,-0.03989005496364707,-0.07803337030273506,0.0,1.6606860961963776,-2.2751143317635703,2.2751143317635703,0.0,-0.07803337030273506,0,1,0,1,-0.07803337030273506,0.0
4087,18,8,58,110,92,1,5851.781999999998,34,1476.892,LESS,1154,2080,3234,8,2,-18.0,-1.6873352292140782,18.0,1.571468165481551,-0.6546944587429309,0.5387658233732368,202,110,92,0,0.8376911542365885,1.170500554541026,0.4682002218164104,0.6968054115842117,0.6527651191777442,0.6527651191777442,0.4682002218164104,1.170500554541026,0,1,1,2,1.170500554541026,0.4682002218164104
4088,18,9,12,50,48,0,5886.286999999998,4,2100.568,LESS,-1662,4308,2646,9,1,-2.0,-0.18748169213489754,2.0,-1.222253017596762,-1.7764936265080669,0.5577141540902979,98,50,48,0,-1.2365917038730592,-1.170500554541026,-1.248533924843761,1.1787457538902946,-1.7384496528207307,1.7384496528207307,-1.248533924843761,-1.170500554541026,0,1,0,0,-1.170500554541026,-1.248533924843761
4089,18,10,54,110,101,1,5691.9209999999985,54,2297.411,LESS,1434,1868,3302,5,2,-9.0,-0.8436676146070391,9.0,0.0,0.09317165310049327,0.4509785723441079,211,110,101,0,1.0171964015730004,1.170500554541026,0.8193503881787182,-0.749015615334037,0.8905279516207742,0.8905279516207742,0.8193503881787182,1.170500554541026,1,0,1,2,1.170500554541026,0.8193503881787182
4090,18,11,14,46,50,0,8676.572,24,2196.18,LESS,-1982,4746,2764,7,1,4.0,0.3749633842697951,4.0,-0.8730378697119728,-1.0286275146646429,2.08999188122708,96,46,50,1,-1.2764817588367063,-1.3265672951464962,-1.170500554541026,0.21486506927812885,-2.0101786041841936,2.0101786041841936,-1.170500554541026,-1.3265672951464962,0,1,0,0,-1.3265672951464962,-1.170500554541026
4091,18,12,22,80,83,0,8534.586,44,3421.31,LESS,-992,4382,3390,7,1,3.0,0.28122253820234633,3.0,-1.0476454436543674,-0.2807614028212188,2.012020639807209,163,80,83,1,0.05983508244547061,0.0,0.1170500554541026,0.21486506927812885,-1.16951716090348,1.16951716090348,0.1170500554541026,0.0,0,1,0,1,0.1170500554541026,0.0
4092,18,13,6,50,56,1,5737.74,4,1835.524,LESS,1028,2790,3818,6,1,6.0,0.5624450764046927,6.0,-0.5238227218271837,-1.7764936265080669,0.4761399566398634,106,50,56,1,-1.077031484018471,-1.170500554541026,-0.9364004436328208,-0.2670752730279541,0.5457718445783806,0.5457718445783806,-0.9364004436328208,-1.170500554541026,0,0,1,0,-1.170500554541026,-0.9364004436328208
4093,18,14,13,50,47,0,7827.2159999999985,24,2367.535,LESS,-1368,4390,3022,6,1,-3.0,-0.28122253820234633,3.0,-1.0476454436543674,-1.0286275146646429,1.62357025002812,97,50,47,0,-1.2565367313548828,-1.170500554541026,-1.2875506099951286,-0.2670752730279541,-1.488798678755549,1.488798678755549,-1.2875506099951286,-1.170500554541026,0,0,0,0,-1.170500554541026,-1.2875506099951286
4094,18,15,46,110,124,0,6763.5790000000015,54,2203.306,LESS,-862,3620,2758,8,2,14.0,1.3123718449442827,14.0,0.8730378697119728,0.09317165310049327,1.0394767667966291,234,110,124,1,1.4759320336549415,1.170500554541026,1.7167341466601715,0.6968054115842117,-1.059127274412073,1.059127274412073,1.7167341466601715,1.170500554541026,1,1,0,2,1.7167341466601715,1.170500554541026
4095,18,16,27,91,80,1,9908.079,74,2141.013,LESS,1026,3958,4984,10,2,-11.0,-1.0311493067419364,11.0,0.34921514788478913,0.8410377649439175,2.76627073694004,171,91,80,0,0.21939530230005888,0.4291835366650429,0.0,1.6606860961963776,0.544073538632359,0.544073538632359,0.0,0.4291835366650429,1,1,1,1,0.4291835366650429,0.0
4096,18,17,40,64,80,0,7691.736,94,3795.213,LESS,2796,3434,6230,10,2,16.0,1.4998535370791803,16.0,1.222253017596762,1.5889038767873416,1.5491717615323248,144,64,80,1,-0.3191204397091766,-0.6242669624218805,0.0,1.6606860961963776,2.0470743008615138,2.0470743008615138,0.0,-0.6242669624218805,1,1,1,1,-0.6242669624218805,0.0
4097,18,18,22,83,80,1,4923.352,84,2492.383,LESS,2598,1192,3790,6,2,-3.0,-0.28122253820234633,3.0,-1.0476454436543674,1.2149708208656296,0.028920911399872257,163,83,80,0,0.05983508244547061,0.1170500554541026,0.0,-0.2670752730279541,1.878942012205371,1.878942012205371,0.0,0.1170500554541026,1,0,1,1,0.1170500554541026,0.0
4098,18,19,54,101,110,0,5201.37,74,2953.335,LESS,-32,2670,2638,6,2,9.0,0.8436676146070391,9.0,0.0,0.8410377649439175,0.18159377067522,211,101,110,1,1.0171964015730004,0.8193503881787182,1.170500554541026,-0.2670752730279541,-0.35433030681309075,0.35433030681309075,1.170500554541026,0.8193503881787182,1,0,0,2,1.170500554541026,0.8193503881787182
4099,18,20,6,56,50,0,5645.46,44,2316.044,LESS,10,2602,2612,7,1,-6.0,-0.5624450764046927,6.0,-0.5238227218271837,-0.2807614028212188,0.4254646354235068,106,56,50,0,-1.077031484018471,-0.9364004436328208,-1.170500554541026,0.21486506927812885,-0.3186658819466362,0.3186658819466362,-1.170500554541026,-0.9364004436328208,1,1,0,0,-0.9364004436328208,-1.170500554541026
4100,18,21,18,50,42,1,5919.066,24,2101.285,LESS,1232,2092,3324,8,1,-8.0,-0.7499267685395902,8.0,-0.17460757394239454,-1.0286275146646429,0.5757146564109635,92,50,42,0,-1.3562618687640005,-1.170500554541026,-1.4826340357519663,0.6968054115842117,0.7189990510725882,0.7189990510725882,-1.4826340357519663,-1.170500554541026,0,1,1,0,-1.170500554541026,-1.4826340357519663
4101,18,22,43,110,117,0,5664.624,14,3421.56,LESS,-364,3128,2764,8,1,7.0,0.6561859224721414,7.0,-0.34921514788478913,-1.402560570586355,0.4359884960194133,227,110,117,1,1.3363168412821769,1.170500554541026,1.4436173506005987,0.6968054115842117,-0.6362490938526836,0.6362490938526836,1.4436173506005987,1.170500554541026,0,1,0,2,1.4436173506005987,1.170500554541026
4102,18,23,32,77,80,0,6393.366999999998,54,2219.075,LESS,96,2646,2742,7,1,3.0,0.28122253820234633,3.0,-1.0476454436543674,0.09317165310049327,0.8361758129805256,157,77,80,1,-0.05983508244547061,-0.1170500554541026,0.0,0.21486506927812885,-0.2456387262677055,0.2456387262677055,0.0,-0.1170500554541026,1,1,0,1,-0.1170500554541026,0.0
4103,18,24,27,80,91,0,5747.181,44,2296.6910000000007,LESS,92,2720,2812,7,2,11.0,1.0311493067419364,11.0,0.34921514788478913,-0.2807614028212188,0.481324457155724,171,80,91,1,0.21939530230005888,0.0,0.4291835366650429,0.21486506927812885,-0.2490353381597488,0.2490353381597488,0.4291835366650429,0.0,0,1,0,1,0.4291835366650429,0.0
4104,18,25,16,44,50,0,8679.67,24,2210.399,LESS,-284,3688,3404,9,1,6.0,0.5624450764046927,6.0,-0.5238227218271837,-1.0286275146646429,2.0916931398435543,94,44,50,1,-1.3163718138003533,-1.4046006654492311,-1.170500554541026,1.1787457538902946,-0.5683168560118178,0.5683168560118178,-1.170500554541026,-1.4046006654492311,0,1,0,0,-1.4046006654492311,-1.170500554541026
4105,18,26,7,50,57,0,8494.314,0,1481.642,LESS,-342,4732,4390,9,1,7.0,0.6561859224721414,7.0,-0.34921514788478913,-1.926066848876752,1.9899053760878216,107,50,57,1,-1.0570864565366473,-1.170500554541026,-0.8973837584814532,1.1787457538902946,-0.6175677284464456,0.6175677284464456,-0.8973837584814532,-1.170500554541026,0,1,0,0,-1.170500554541026,-0.8973837584814532
4106,18,27,14,50,46,1,7389.205,4,1520.486,LESS,584,3424,4008,8,1,-4.0,-0.3749633842697951,4.0,-0.8730378697119728,-1.7764936265080669,1.383037652268068,96,50,46,0,-1.2764817588367063,-1.170500554541026,-1.3265672951464962,0.6968054115842117,0.1687479245615756,0.1687479245615756,-1.3265672951464962,-1.170500554541026,0,1,1,0,-1.170500554541026,-1.3265672951464962
4107,18,28,51,110,108,1,10777.297,14,1361.89,LESS,90,4996,5086,10,1,-2.0,-0.18748169213489754,2.0,-1.222253017596762,-1.402560570586355,3.2435995336136334,218,110,108,0,1.156811593945765,1.170500554541026,1.092467184238291,1.6606860961963776,-0.2507336441057704,0.2507336441057704,1.092467184238291,1.170500554541026,0,1,0,2,1.170500554541026,1.092467184238291
4108,18,29,50,133,110,1,4992.517,34,1929.464,LESS,1380,1444,2824,6,2,-23.0,-2.1560394595513217,23.0,2.444506035193524,-0.6546944587429309,0.06690269067955709,243,133,110,0,1.6554372809913533,2.0678843130224793,1.170500554541026,-0.2670752730279541,0.8446736910781899,0.8446736910781899,1.170500554541026,2.0678843130224793,0,0,1,2,2.0678843130224793,1.170500554541026
4109,18,30,49,131,110,1,5133.566,44,1789.912,LESS,2470,1222,3692,6,2,-21.0,-1.9685577674164243,21.0,2.0952908873087353,-0.2807614028212188,0.14435938099431556,241,131,110,0,1.6155472260277064,1.9898509427197442,1.170500554541026,-0.2670752730279541,1.7702504316599859,1.7702504316599859,1.170500554541026,1.9898509427197442,1,0,1,2,1.9898509427197442,1.170500554541026
4110,18,31,47,126,110,1,3539.847,64,1531.4820000000002,LESS,870,1032,1902,4,2,-16.0,-1.4998535370791803,16.0,1.222253017596762,0.4671047090222054,-0.7308272494089242,236,126,110,0,1.5158220886185887,1.7947675169629065,1.170500554541026,-1.23095595764012,0.4116056748426707,0.4116056748426707,1.170500554541026,1.7947675169629065,1,0,1,2,1.7947675169629065,1.170500554541026
4111,18,32,50,110,133,0,5347.944,74,2499.172,LESS,56,2884,2940,8,2,23.0,2.1560394595513217,23.0,2.444506035193524,0.8410377649439175,0.2620845003237496,243,110,133,1,1.6554372809913533,1.170500554541026,2.0678843130224793,0.6968054115842117,-0.2796048451881384,0.2796048451881384,2.0678843130224793,1.170500554541026,1,1,0,2,2.0678843130224793,1.170500554541026
4112,18,33,47,110,126,0,6035.228,84,2627.515,LESS,498,3292,3790,7,2,16.0,1.4998535370791803,16.0,1.222253017596762,1.2149708208656296,0.6395047156126806,236,110,126,1,1.5158220886185887,1.170500554541026,1.7947675169629065,0.21486506927812885,0.09572076888264493,0.09572076888264493,1.7947675169629065,1.170500554541026,1,1,1,2,1.7947675169629065,1.170500554541026
4113,18,34,12,48,50,0,8028.052,0,1459.024,LESS,-518,4562,4044,9,1,2.0,0.18748169213489754,2.0,-1.222253017596762,-1.926066848876752,1.733858815392319,98,48,50,1,-1.2365917038730592,-1.248533924843761,-1.170500554541026,1.1787457538902946,-0.7670186516963502,0.7670186516963502,-1.170500554541026,-1.248533924843761,0,1,0,0,-1.248533924843761,-1.170500554541026
4114,18,35,32,80,77,0,7310.241,14,2901.717,LESS,-1328,4648,3320,9,1,-3.0,-0.28122253820234633,3.0,-1.0476454436543674,-1.402560570586355,1.3396747777066418,157,80,77,0,-0.05983508244547061,0.0,-0.1170500554541026,1.1787457538902946,-1.4548325598351162,1.4548325598351162,-0.1170500554541026,0.0,0,1,0,1,0.0,-0.1170500554541026
4115,18,36,43,117,110,1,6028.14,44,1757.19,LESS,1508,2000,3508,8,2,-7.0,-0.6561859224721414,7.0,-0.34921514788478913,-0.2807614028212188,0.6356123589072025,227,117,110,0,1.3363168412821769,1.4436173506005987,1.170500554541026,0.6968054115842117,0.953365271623575,0.953365271623575,1.170500554541026,1.4436173506005987,1,1,1,2,1.4436173506005987,1.170500554541026
4116,18,37,40,80,64,0,5521.11,34,1220.441,LESS,8,2480,2488,7,1,-16.0,-1.4998535370791803,16.0,1.222253017596762,-0.6546944587429309,0.3571781573865108,144,80,64,0,-0.3191204397091766,0.0,-0.6242669624218805,0.21486506927812885,-0.32036418789265786,0.32036418789265786,-0.6242669624218805,0.0,0,1,0,1,0.0,-0.6242669624218805
4117,18,38,31,80,78,0,5207.763,14,2820.53,LESS,-928,3002,2074,7,1,-2.0,-0.18748169213489754,2.0,-1.222253017596762,-1.402560570586355,0.1851044699441425,158,80,78,0,-0.03989005496364707,0.0,-0.07803337030273506,0.21486506927812885,-1.1151713706307873,1.1151713706307873,-0.07803337030273506,0.0,0,1,0,1,0.0,-0.07803337030273506
4118,18,39,46,124,110,1,6076.576,54,1292.948,LESS,650,2188,2838,7,2,-14.0,-1.3123718449442827,14.0,0.8730378697119728,0.09317165310049327,0.6622108619244916,234,124,110,0,1.4759320336549415,1.7167341466601715,1.170500554541026,0.21486506927812885,0.22479202078028987,0.22479202078028987,1.170500554541026,1.7167341466601715,1,1,1,2,1.7167341466601715,1.170500554541026
4119,18,40,58,92,110,0,4206.846,54,1289.294,LESS,-1034,2656,1622,5,2,18.0,1.6873352292140782,18.0,1.571468165481551,0.09317165310049327,-0.3645464889409055,202,92,110,1,0.8376911542365885,0.4682002218164104,1.170500554541026,-0.749015615334037,-1.2051815857699344,1.2051815857699344,1.170500554541026,0.4682002218164104,1,0,0,2,1.170500554541026,0.4682002218164104
4120,18,41,49,110,131,1,7075.798000000002,74,1227.298,MORE,1272,2304,3576,8,2,21.0,1.9685577674164243,21.0,2.0952908873087353,0.8410377649439175,1.2109310159822568,241,110,131,0,1.6155472260277064,1.170500554541026,1.9898509427197442,0.6968054115842117,0.7529651699930211,0.7529651699930211,1.9898509427197442,1.170500554541026,1,1,1,2,1.9898509427197442,1.170500554541026
4121,18,42,13,47,50,1,6712.44,14,2162.617,MORE,-534,3742,3208,9,1,3.0,0.28122253820234633,3.0,-1.0476454436543674,-1.402560570586355,1.0113939183822016,97,47,50,0,-1.2565367313548828,-1.2875506099951286,-1.170500554541026,1.1787457538902946,-0.7806050992645234,0.7806050992645234,-1.170500554541026,-1.2875506099951286,0,1,0,0,-1.2875506099951286,-1.170500554541026
4122,18,43,16,50,44,0,4320.861,34,2029.358,MORE,-346,2168,1822,5,1,-6.0,-0.5624450764046927,6.0,-0.5238227218271837,-0.6546944587429309,-0.3019354491870808,94,50,44,1,-1.3163718138003533,-1.170500554541026,-1.4046006654492311,-0.749015615334037,-0.6209643403384888,0.6209643403384888,-1.4046006654492311,-1.170500554541026,0,0,0,0,-1.170500554541026,-1.4046006654492311
4123,18,44,7,57,50,0,6032.645,54,1029.605,MORE,62,2668,2730,9,1,-7.0,-0.6561859224721414,7.0,-0.34921514788478913,0.09317165310049327,0.6380862679024311,107,57,50,1,-1.0570864565366473,-0.8973837584814532,-1.170500554541026,1.1787457538902946,-0.27450992735007346,0.27450992735007346,-1.170500554541026,-0.8973837584814532,0,1,0,0,-0.8973837584814532,-1.170500554541026
4124,18,45,18,42,50,1,6490.056,64,1542.783,MORE,1586,2270,3856,8,2,8.0,0.7499267685395902,8.0,-0.17460757394239454,0.4671047090222054,0.8892723250426017,92,42,50,0,-1.3562618687640005,-1.4826340357519663,-1.170500554541026,0.6968054115842117,1.0195992035184192,1.0195992035184192,-1.170500554541026,-1.4826340357519663,1,1,1,0,-1.4826340357519663,-1.170500554541026
4125,18,46,51,108,110,1,5453.4540000000015,84,1490.19,MORE,1600,2186,3786,8,2,2.0,0.18748169213489754,2.0,-1.222253017596762,1.2149708208656296,0.3200250415194352,218,108,110,0,1.156811593945765,1.092467184238291,1.170500554541026,0.6968054115842117,1.0314873451405706,1.0314873451405706,1.170500554541026,1.092467184238291,1,1,1,2,1.170500554541026,1.092467184238291
4126,18,47,31,78,80,1,8890.216999999999,20,1913.574,MORE,-432,4854,4422,10,1,2.0,0.18748169213489754,2.0,-1.222253017596762,-1.1782007370333278,2.2073144755191096,158,78,80,0,-0.03989005496364707,-0.07803337030273506,0.0,1.6606860961963776,-0.6939914960174195,0.6939914960174195,0.0,-0.07803337030273506,0,1,0,1,-0.07803337030273506,0.0
4127,18,48,58,110,92,0,3306.7490000000007,74,2688.896,MORE,-378,1568,1190,5,1,-18.0,-1.6873352292140782,18.0,1.571468165481551,0.8410377649439175,-0.8588324078927808,202,110,92,1,0.8376911542365885,1.170500554541026,0.4682002218164104,-0.749015615334037,-0.6481372354748351,0.6481372354748351,0.4682002218164104,1.170500554541026,1,0,0,2,1.170500554541026,0.4682002218164104
4128,18,49,12,50,48,0,5462.7559999999985,44,2315.924,MORE,-256,2802,2546,7,2,-2.0,-0.18748169213489754,2.0,-1.222253017596762,-0.2807614028212188,0.32513321054798305,98,50,48,1,-1.2365917038730592,-1.170500554541026,-1.248533924843761,0.21486506927812885,-0.5445405727675149,0.5445405727675149,-1.248533924843761,-1.170500554541026,0,1,0,0,-1.170500554541026,-1.248533924843761
4129,18,50,54,110,101,0,4068.082,24,893.655,MORE,-822,2338,1516,5,1,-9.0,-0.8436676146070391,9.0,0.0,-1.0286275146646429,-0.4407483774678509,211,110,101,1,1.0171964015730004,1.170500554541026,0.8193503881787182,-0.749015615334037,-1.0251611554916402,1.0251611554916402,0.8193503881787182,1.170500554541026,0,0,0,2,1.170500554541026,0.8193503881787182
4130,18,51,14,46,50,0,5324.076,54,2520.742,MORE,-502,2724,2222,7,1,4.0,0.3749633842697951,4.0,-0.8730378697119728,0.09317165310049327,0.24897745040185945,96,46,50,0,-1.2764817588367063,-1.3265672951464962,-1.170500554541026,0.21486506927812885,-0.753432204128177,0.753432204128177,-1.170500554541026,-1.3265672951464962,0,1,0,0,-1.3265672951464962,-1.170500554541026
4131,18,52,22,80,83,1,3127.338,94,2076.589,MORE,2132,892,3024,4,2,3.0,0.28122253820234633,3.0,-1.0476454436543674,1.5889038767873416,-0.9573554904106376,163,80,83,0,0.05983508244547061,0.0,0.1170500554541026,-1.23095595764012,1.4832367267823279,1.4832367267823279,0.1170500554541026,0.0,1,0,1,1,0.1170500554541026,0.0
4132,18,53,6,50,56,1,5073.1579999999985,54,2019.24,MORE,576,2008,2584,8,2,6.0,0.5624450764046927,6.0,-0.5238227218271837,0.09317165310049327,0.11118648541523292,106,50,56,0,-1.077031484018471,-1.170500554541026,-0.9364004436328208,0.6968054115842117,0.16195470077748905,0.16195470077748905,-0.9364004436328208,-1.170500554541026,0,1,0,0,-1.170500554541026,-0.9364004436328208
4133,18,54,13,50,47,1,2805.148,74,2238.206,MORE,1420,788,2208,4,2,-3.0,-0.28122253820234633,3.0,-1.0476454436543674,0.8410377649439175,-1.1342852882292116,97,50,47,1,-1.2565367313548828,-1.170500554541026,-1.2875506099951286,-1.23095595764012,0.8786398099986227,0.8786398099986227,-1.2875506099951286,-1.170500554541026,1,0,1,0,-1.170500554541026,-1.2875506099951286
4134,18,55,46,110,124,1,2704.112,44,620.182,MORE,756,932,1688,4,2,14.0,1.3123718449442827,14.0,0.8730378697119728,-0.2807614028212188,-1.1897689439987806,234,110,124,0,1.4759320336549415,1.170500554541026,1.7167341466601715,-1.23095595764012,0.314802235919437,0.314802235919437,1.7167341466601715,1.170500554541026,0,0,0,2,1.7167341466601715,1.170500554541026
4135,18,56,27,91,80,0,9469.143,14,1257.82,MORE,-376,4990,4614,11,1,-11.0,-1.0311493067419364,11.0,0.34921514788478913,-1.402560570586355,2.525230177843564,171,91,80,1,0.21939530230005888,0.4291835366650429,0.0,2.1426264385024605,-0.6464389295288134,0.6464389295288134,0.0,0.4291835366650429,0,1,0,1,0.4291835366650429,0.0
4136,18,57,40,64,80,1,3309.7209999999995,84,1846.02,MORE,2632,1028,3660,4,2,16.0,1.4998535370791803,16.0,1.222253017596762,1.2149708208656296,-0.8572003418475386,144,64,80,0,-0.3191204397091766,-0.6242669624218805,0.0,-1.23095595764012,1.907813213287739,1.907813213287739,0.0,-0.6242669624218805,1,0,1,1,-0.6242669624218805,0.0
4137,18,58,22,83,80,1,3512.929,54,493.21,MORE,1320,950,2270,4,2,-3.0,-0.28122253820234633,3.0,-1.0476454436543674,0.09317165310049327,-0.7456091988725336,163,83,80,1,0.05983508244547061,0.1170500554541026,0.0,-1.23095595764012,0.7937245126975406,0.7937245126975406,0.0,0.1170500554541026,0,0,1,1,0.1170500554541026,0.0
4138,18,59,54,101,110,1,2829.821,94,1972.832,MORE,2280,822,3102,4,2,9.0,0.8436676146070391,9.0,0.0,1.5889038767873416,-1.1207361746577855,211,101,110,0,1.0171964015730004,0.8193503881787182,1.170500554541026,-1.23095595764012,1.6089113667879296,1.6089113667879296,1.170500554541026,0.8193503881787182,1,0,1,2,1.170500554541026,0.8193503881787182
4139,18,60,6,56,50,0,7894.319,14,3107.341,MORE,-838,4418,3580,9,1,-6.0,-0.5624450764046927,6.0,-0.5238227218271837,-1.402560570586355,1.6604196873881252,106,56,50,1,-1.077031484018471,-0.9364004436328208,-1.170500554541026,1.1787457538902946,-1.0387476030598133,1.0387476030598133,-1.170500554541026,-0.9364004436328208,0,1,0,0,-0.9364004436328208,-1.170500554541026
4140,18,61,18,50,42,1,4102.758,64,2533.638,MORE,1194,1618,2812,5,2,-8.0,-0.7499267685395902,8.0,-0.17460757394239454,0.4671047090222054,-0.4217061425469754,92,50,42,1,-1.3562618687640005,-1.170500554541026,-1.4826340357519663,-0.749015615334037,0.686731238098177,0.686731238098177,-1.4826340357519663,-1.170500554541026,0,0,1,0,-1.170500554541026,-1.4826340357519663
4141,18,62,43,110,117,1,5442.824000000001,44,2319.035,MORE,1802,1710,3512,8,2,7.0,0.6561859224721414,7.0,-0.34921514788478913,-0.2807614028212188,0.3141876047559991,227,110,117,0,1.3363168412821769,1.170500554541026,1.4436173506005987,0.6968054115842117,1.2030162456887568,1.2030162456887568,1.4436173506005987,1.170500554541026,0,1,1,2,1.4436173506005987,1.170500554541026
4142,18,63,32,77,80,0,4131.013,34,1658.784,MORE,-298,1784,1486,5,1,3.0,0.28122253820234633,3.0,-1.0476454436543674,-0.6546944587429309,-0.4061899830219628,157,77,80,0,-0.05983508244547061,-0.1170500554541026,0.0,-0.749015615334037,-0.5802049976339694,0.5802049976339694,0.0,-0.1170500554541026,0,0,0,1,-0.1170500554541026,0.0
4143,18,64,27,80,91,1,4778.66,54,2395.374,MORE,1182,1658,2840,6,2,11.0,1.0311493067419364,11.0,0.34921514788478913,0.09317165310049327,-0.05053632285930742,171,80,91,0,0.21939530230005888,0.0,0.4291835366650429,-0.2670752730279541,0.6765414024220472,0.6765414024220472,0.4291835366650429,0.0,0,0,1,1,0.4291835366650429,0.0
4144,18,65,16,44,50,1,3386.115,34,2154.0660000000007,MORE,-178,2128,1950,4,1,6.0,0.5624450764046927,6.0,-0.5238227218271837,-0.6546944587429309,-0.8152487760802827,94,44,50,0,-1.3163718138003533,-1.4046006654492311,-1.170500554541026,-1.23095595764012,-0.4783066408726707,0.4783066408726707,-1.170500554541026,-1.4046006654492311,0,0,0,0,-1.4046006654492311,-1.170500554541026
4145,18,66,7,50,57,1,2518.068,84,3082.993,MORE,1300,1502,2802,4,2,7.0,0.6561859224721414,7.0,-0.34921514788478913,1.2149708208656296,-1.291934521159334,107,50,57,0,-1.0570864565366473,-1.170500554541026,-0.8973837584814532,-1.23095595764012,0.7767414532373241,0.7767414532373241,-0.8973837584814532,-1.170500554541026,1,0,1,0,-1.170500554541026,-0.8973837584814532
4146,18,67,14,50,46,1,5298.538000000001,74,1881.16,MORE,-76,2264,2188,6,2,-4.0,-0.3749633842697951,4.0,-0.8730378697119728,0.8410377649439175,0.2349533243374549,96,50,46,1,-1.2764817588367063,-1.170500554541026,-1.3265672951464962,-0.2670752730279541,-0.3916930376255669,0.3916930376255669,-1.3265672951464962,-1.170500554541026,1,1,0,0,-1.170500554541026,-1.3265672951464962
4147,18,68,51,110,108,0,3416.423,54,2362.229,MORE,-352,1854,1502,6,2,-2.0,-0.18748169213489754,2.0,-1.222253017596762,0.09317165310049327,-0.7986052169621061,218,110,108,1,1.156811593945765,1.170500554541026,1.092467184238291,-0.2670752730279541,-0.6260592581765537,0.6260592581765537,1.092467184238291,1.170500554541026,0,0,0,2,1.170500554541026,1.092467184238291
4148,18,69,50,133,110,0,3039.393,94,1693.932,MORE,602,1580,2182,4,2,-23.0,-2.1560394595513217,23.0,2.444506035193524,1.5889038767873416,-1.0056502576881896,243,133,110,1,1.6554372809913533,2.0678843130224793,1.170500554541026,-1.23095595764012,0.18403267807577042,0.18403267807577042,1.170500554541026,2.0678843130224793,1,0,0,2,2.0678843130224793,1.170500554541026
4149,18,70,49,131,110,0,2373.224,84,2092.373,MORE,400,1470,1870,4,2,-21.0,-1.9685577674164243,21.0,2.0952908873087353,1.2149708208656296,-1.3714752258219045,241,131,110,1,1.6155472260277064,1.9898509427197442,1.170500554541026,-1.23095595764012,0.012503777527584373,0.012503777527584373,1.170500554541026,1.9898509427197442,1,0,0,2,1.9898509427197442,1.170500554541026
4150,18,71,47,126,110,0,5304.009,44,3145.539,MORE,-822,2776,1954,7,1,-16.0,-1.4998535370791803,16.0,1.222253017596762,-0.2807614028212188,0.23795770971212565,236,126,110,1,1.5158220886185887,1.7947675169629065,1.170500554541026,0.21486506927812885,-1.0251611554916402,1.0251611554916402,1.170500554541026,1.7947675169629065,0,1,0,2,1.7947675169629065,1.170500554541026
4151,18,72,50,110,133,1,2315.723,84,2345.756,MORE,1912,712,2624,3,2,23.0,2.1560394595513217,23.0,2.444506035193524,1.2149708208656296,-1.4030517499361408,243,110,133,0,1.6554372809913533,1.170500554541026,2.0678843130224793,-1.7128962999462027,1.296423072719947,1.296423072719947,2.0678843130224793,1.170500554541026,1,0,1,2,2.0678843130224793,1.170500554541026
4152,18,73,47,110,126,1,3882.361,94,1682.079,MORE,1762,1298,3060,6,2,16.0,1.4998535370791803,16.0,1.222253017596762,1.5889038767873416,-0.5427365800211994,236,110,126,0,1.5158220886185887,1.170500554541026,1.7947675169629065,-0.2670752730279541,1.1690501267683238,1.1690501267683238,1.7947675169629065,1.170500554541026,1,0,1,2,1.7947675169629065,1.170500554541026
4153,18,74,12,48,50,0,3421.09,34,2205.343,MORE,-126,1814,1688,5,2,2.0,0.18748169213489754,2.0,-1.222253017596762,-0.6546944587429309,-0.7960423460895795,98,48,50,0,-1.2365917038730592,-1.248533924843761,-1.170500554541026,-0.749015615334037,-0.434150686276108,0.434150686276108,-1.170500554541026,-1.248533924843761,0,0,0,0,-1.248533924843761,-1.170500554541026
4154,18,75,32,80,77,0,6181.335,14,2941.937,MORE,-902,3754,2852,9,1,-3.0,-0.28122253820234633,3.0,-1.0476454436543674,-1.402560570586355,0.7197389934297399,157,80,77,1,-0.05983508244547061,0.0,-0.1170500554541026,1.1787457538902946,-1.093093393332506,1.093093393332506,-0.1170500554541026,0.0,0,1,0,1,0.0,-0.1170500554541026
4155,18,76,43,117,110,0,4822.684,54,2108.7960000000007,MORE,-714,2516,1802,7,1,-7.0,-0.6561859224721414,7.0,-0.34921514788478913,0.09317165310049327,-0.026360658129908742,227,117,110,1,1.3363168412821769,1.4436173506005987,1.170500554541026,0.21486506927812885,-0.9334526344064714,0.9334526344064714,1.170500554541026,1.4436173506005987,0,1,0,2,1.4436173506005987,1.170500554541026
4156,18,77,40,80,64,0,5032.7170000000015,74,2202.329,MORE,-404,2494,2090,7,1,-16.0,-1.4998535370791803,16.0,1.222253017596762,0.8410377649439175,0.08897841578681356,144,80,64,1,-0.3191204397091766,0.0,-0.6242669624218805,0.21486506927812885,-0.6702152127731165,0.6702152127731165,-0.6242669624218805,0.0,1,1,0,1,0.0,-0.6242669624218805
4157,18,78,31,80,78,0,4728.562,64,2985.988,MORE,-1204,2784,1580,6,1,-2.0,-0.18748169213489754,2.0,-1.222253017596762,0.4671047090222054,-0.07804750883998622,158,80,78,1,-0.03989005496364707,0.0,-0.07803337030273506,-0.2670752730279541,-1.3495375911817742,1.3495375911817742,-0.07803337030273506,0.0,1,0,0,1,0.0,-0.07803337030273506
4158,18,79,46,124,110,0,5177.705,84,3806.263,MORE,598,2874,3472,5,2,-14.0,-1.3123718449442827,14.0,0.8730378697119728,1.2149708208656296,0.1685981976736478,234,124,110,1,1.4759320336549415,1.7167341466601715,1.170500554541026,-0.749015615334037,0.18063606618372713,0.18063606618372713,1.170500554541026,1.7167341466601715,1,0,0,2,1.7167341466601715,1.170500554541026
4159,18,80,58,92,110,1,3390.173,64,3018.965,MORE,1064,1484,2548,6,1,18.0,1.6873352292140782,18.0,1.571468165481551,0.4671047090222054,-0.8130203359687095,202,92,110,0,0.8376911542365885,0.4682002218164104,1.170500554541026,-0.2670752730279541,0.5763413516067701,0.5763413516067701,1.170500554541026,0.4682002218164104,1,0,1,2,1.170500554541026,0.4682002218164104
4160,18,81,48,128,110,1,5208.7959999999985,44,1743.221,LESS,1306,992,2298,5,2,-18.0,-1.6873352292140782,18.0,1.571468165481551,-0.2807614028212188,0.18567173919876348,238,128,110,0,1.5557121435822359,1.8728008872656416,1.170500554541026,-0.749015615334037,0.7818363710753891,0.7818363710753891,1.170500554541026,1.8728008872656416,1,0,1,2,1.8728008872656416,1.170500554541026
4161,18,82,8,50,58,0,4426.965,74,2474.62,LESS,-296,2216,1920,7,2,8.0,0.7499267685395902,8.0,-0.17460757394239454,0.8410377649439175,-0.24366871444130345,108,50,58,1,-1.0371414290548238,-1.170500554541026,-0.8583670733300858,0.21486506927812885,-0.5785066916879478,0.5785066916879478,-0.8583670733300858,-1.170500554541026,1,1,0,0,-1.170500554541026,-0.8583670733300858
4162,18,83,4,54,50,0,4649.958,4,1192.188,LESS,-932,2776,1844,7,1,-4.0,-0.3749633842697951,4.0,-0.8730378697119728,-1.7764936265080669,-0.12121269034075048,104,54,50,0,-1.116921538982118,-1.0144338139355558,-1.170500554541026,0.21486506927812885,-1.1185679825228305,1.1185679825228305,-1.170500554541026,-1.0144338139355558,0,1,0,0,-1.0144338139355558,-1.170500554541026
4163,18,84,37,80,69,1,4222.268,24,1179.6,LESS,1124,1390,2514,6,1,-11.0,-1.0311493067419364,11.0,0.34921514788478913,-1.0286275146646429,-0.35607753788110186,149,80,69,0,-0.21939530230005888,0.0,-0.4291835366650429,-0.2670752730279541,0.6272905299874195,0.6272905299874195,-0.4291835366650429,0.0,0,0,1,1,0.0,-0.4291835366650429
4164,18,85,52,105,110,1,4089.141,24,2496.385,LESS,1286,1254,2540,6,2,5.0,0.4687042303372438,5.0,-0.6984302957695783,-1.0286275146646429,-0.4291838825665151,215,105,110,1,1.0969765115002945,0.9754171287841883,1.170500554541026,-0.2670752730279541,0.7648533116151727,0.7648533116151727,1.170500554541026,0.9754171287841883,0,0,1,2,1.170500554541026,0.9754171287841883
4165,18,86,5,55,50,1,5405.467,0,3685.715,LESS,560,3318,3878,10,1,-5.0,-0.4687042303372438,5.0,-0.6984302957695783,-1.926066848876752,0.2936731056805815,105,55,50,0,-1.0969765115002945,-0.9754171287841883,-1.170500554541026,1.6606860961963776,0.14836825320931588,0.14836825320931588,-1.170500554541026,-0.9754171287841883,0,1,1,0,-0.9754171287841883,-1.170500554541026
4166,18,87,30,96,80,1,2681.7870000000007,74,2581.256,LESS,420,1062,1482,4,1,-16.0,-1.4998535370791803,16.0,1.222253017596762,0.8410377649439175,-1.2020286594967773,176,96,80,0,0.3191204397091766,0.6242669624218805,0.0,-1.23095595764012,0.029486836987800812,0.029486836987800812,0.0,0.6242669624218805,1,0,1,1,0.6242669624218805,0.0
4167,18,88,33,80,75,1,4838.84,54,1912.625,LESS,1200,1754,2954,8,2,-5.0,-0.4687042303372438,5.0,-0.6984302957695783,0.09317165310049327,-0.017488632885311238,155,80,75,0,-0.09972513740911768,0.0,-0.19508342575683765,0.6968054115842117,0.691826155936242,0.691826155936242,-0.19508342575683765,0.0,1,1,1,1,0.0,-0.19508342575683765
4168,18,89,48,110,128,0,2908.082000000001,84,1090.372,LESS,680,1364,2044,5,2,18.0,1.6873352292140782,18.0,1.571468165481551,1.2149708208656296,-1.0777593507120409,238,110,128,1,1.5557121435822359,1.170500554541026,1.8728008872656416,-0.749015615334037,0.2502666099706145,0.2502666099706145,1.8728008872656416,1.170500554541026,1,0,1,2,1.8728008872656416,1.170500554541026
4169,18,90,9,59,50,1,4764.191,44,2935.025,LESS,624,2184,2808,9,1,-9.0,-0.8436676146070391,9.0,0.0,-0.2807614028212188,-0.05848193645574728,109,59,50,0,-1.0171964015730004,-0.8193503881787182,-1.170500554541026,1.1787457538902946,0.2027140434820085,0.2027140434820085,-1.170500554541026,-0.8193503881787182,0,1,1,0,-0.8193503881787182,-1.170500554541026
4170,18,91,44,110,119,0,6443.599,64,1940.741,LESS,-600,3218,2618,8,2,9.0,0.8436676146070391,9.0,0.0,0.4671047090222054,0.8637605847115628,229,110,119,1,1.376206896245824,1.170500554541026,1.5216507209033339,0.6968054115842117,-0.8366491954832376,0.8366491954832376,1.5216507209033339,1.170500554541026,1,1,0,2,1.5216507209033339,1.170500554541026
4171,18,92,2,52,50,1,5246.056,14,1693.41,LESS,254,2964,3218,7,1,-2.0,-0.18748169213489754,2.0,-1.222253017596762,-1.402560570586355,0.2061329709772801,102,52,50,0,-1.156811593945765,-1.092467184238291,-1.170500554541026,0.21486506927812885,-0.11147255653199564,0.11147255653199564,-1.170500554541026,-1.092467184238291,0,1,0,0,-1.092467184238291,-1.170500554541026
4172,18,93,8,58,50,1,4727.949000000001,24,1749.543,LESS,1298,1526,2824,6,2,-8.0,-0.7499267685395902,8.0,-0.17460757394239454,-1.0286275146646429,-0.0783841361905015,108,58,50,0,-1.0371414290548238,-0.8583670733300858,-1.170500554541026,-0.2670752730279541,0.7750431472913025,0.7750431472913025,-1.170500554541026,-0.8583670733300858,0,0,1,0,-0.8583670733300858,-1.170500554541026
4173,18,94,44,119,110,1,5236.652,0,1301.762,LESS,972,2286,3258,9,1,-9.0,-0.8436676146070391,9.0,0.0,-1.926066848876752,0.20096878891487654,229,119,110,0,1.376206896245824,1.5216507209033339,1.170500554541026,1.1787457538902946,0.49821927808977456,0.49821927808977456,1.170500554541026,1.5216507209033339,0,1,1,2,1.5216507209033339,1.170500554541026
4174,18,95,34,74,80,0,3206.7870000000007,54,1812.731,LESS,-150,1736,1586,5,2,6.0,0.5624450764046927,6.0,-0.5238227218271837,0.09317165310049327,-0.9137262793647082,154,74,80,1,-0.11967016489094122,-0.2341001109082052,0.0,-0.749015615334037,-0.4545303576283677,0.4545303576283677,0.0,-0.2341001109082052,1,0,0,1,-0.2341001109082052,0.0
4175,18,96,24,86,80,1,6376.201999999998,14,1762.568,LESS,92,3288,3380,8,1,-6.0,-0.5624450764046927,6.0,-0.5238227218271837,-1.402560570586355,0.8267496980186837,166,86,80,0,0.11967016489094122,0.2341001109082052,0.0,0.6968054115842117,-0.2490353381597488,0.2490353381597488,0.0,0.2341001109082052,0,1,0,1,0.2341001109082052,0.0
4176,18,97,39,66,80,0,4663.721,64,2261.952,LESS,-926,2634,1708,7,1,14.0,1.3123718449442827,14.0,0.8730378697119728,0.4671047090222054,-0.11365477480216447,146,66,80,1,-0.2792303847455295,-0.5462335921191455,0.0,0.21486506927812885,-1.1134730646847657,1.1134730646847657,0.0,-0.5462335921191455,1,1,0,1,-0.5462335921191455,0.0
4177,18,98,9,50,59,0,2647.401,84,3069.539,LESS,-200,1756,1556,4,2,9.0,0.8436676146070391,9.0,0.0,1.2149708208656296,-1.2209116416743422,109,50,59,1,-1.0171964015730004,-1.170500554541026,-0.8193503881787182,-1.23095595764012,-0.4969880062789088,0.4969880062789088,-0.8193503881787182,-1.170500554541026,1,0,0,0,-1.170500554541026,-0.8193503881787182
4178,18,99,57,94,110,0,6164.809,64,1467.975,LESS,208,2616,2824,5,2,16.0,1.4998535370791803,16.0,1.222253017596762,0.4671047090222054,0.7106637836505734,204,94,110,1,0.8775812092002355,0.5462335921191455,1.170500554541026,-0.749015615334037,-0.15053359329049346,0.15053359329049346,1.170500554541026,0.5462335921191455,1,0,0,2,1.170500554541026,0.5462335921191455
4179,18,100,60,110,87,1,5970.937,54,4192.04,LESS,2006,2230,4236,8,2,-23.0,-2.1560394595513217,23.0,2.444506035193524,0.09317165310049327,0.6041994807154027,197,110,87,0,0.7379660168274708,1.170500554541026,0.27311679605957273,0.6968054115842117,1.3762434521829643,1.3762434521829643,0.27311679605957273,1.170500554541026,1,1,1,2,1.170500554541026,0.27311679605957273
4180,18,101,33,75,80,0,3411.9390000000008,64,2257.915,LESS,-1138,2156,1018,5,1,5.0,0.4687042303372438,5.0,-0.6984302957695783,0.4671047090222054,-0.8010675938621288,155,75,80,1,-0.09972513740911768,-0.19508342575683765,0.0,-0.749015615334037,-1.2934934949630599,1.2934934949630599,0.0,-0.19508342575683765,1,0,0,1,-0.19508342575683765,0.0
4181,18,102,15,50,45,1,2627.966,74,2439.044,LESS,1904,700,2604,4,2,-5.0,-0.4687042303372438,5.0,-0.6984302957695783,0.8410377649439175,-1.231584321213136,95,50,45,0,-1.2964267863185297,-1.170500554541026,-1.3655839802978638,-1.23095595764012,1.2896298489358606,1.2896298489358606,-1.3655839802978638,-1.170500554541026,1,0,1,0,-1.170500554541026,-1.3655839802978638
4182,18,103,59,89,110,0,2841.398,100,2841.046,LESS,744,1646,2390,5,2,21.0,1.9685577674164243,21.0,2.0952908873087353,1.8132637103403688,-1.1143786953153303,199,89,110,1,0.7778560717911179,0.3511501663623078,1.170500554541026,-0.749015615334037,0.30461240024330716,0.30461240024330716,1.170500554541026,0.3511501663623078,1,0,1,2,1.170500554541026,0.3511501663623078
4183,18,104,29,80,94,0,3157.693,94,2520.303,LESS,560,1748,2308,5,2,14.0,1.3123718449442827,14.0,0.8730378697119728,1.5889038767873416,-0.9406861213650968,174,80,94,1,0.2792303847455295,0.0,0.5462335921191455,-0.749015615334037,0.14836825320931588,0.14836825320931588,0.5462335921191455,0.0,1,0,1,1,0.5462335921191455,0.0
4184,18,105,55,110,98,1,6867.889,24,1601.112,LESS,710,2730,3440,10,2,-12.0,-1.124890152809385,12.0,0.5238227218271837,-1.0286275146646429,1.09675833112344,208,110,98,0,0.9573613191275298,1.170500554541026,0.7023003327246156,1.6606860961963776,0.2757411991609392,0.2757411991609392,0.7023003327246156,1.170500554541026,0,1,1,2,1.170500554541026,0.7023003327246156
4185,18,106,29,94,80,1,2251.285,74,1920.052,LESS,858,684,1542,4,2,-14.0,-1.3123718449442827,14.0,0.8730378697119728,0.8410377649439175,-1.4384377094998555,174,94,80,0,0.2792303847455295,0.5462335921191455,0.0,-1.23095595764012,0.40141583916654083,0.40141583916654083,0.0,0.5462335921191455,1,0,1,1,0.5462335921191455,0.0
4186,18,107,57,110,94,1,6441.036999999998,4,1443.799,LESS,402,3098,3500,8,1,-16.0,-1.4998535370791803,16.0,1.222253017596762,-1.7764936265080669,0.8623536690965175,204,110,94,0,0.8775812092002355,1.170500554541026,0.5462335921191455,0.6968054115842117,0.014202083473606016,0.014202083473606016,0.5462335921191455,1.170500554541026,0,1,1,2,1.170500554541026,0.5462335921191455
4187,18,108,39,80,66,1,3046.216,64,1670.503,LESS,1238,892,2130,5,1,-14.0,-1.3123718449442827,14.0,0.8730378697119728,0.4671047090222054,-1.0019034250412544,146,80,66,0,-0.2792303847455295,0.0,-0.5462335921191455,-0.749015615334037,0.7240939689106531,0.7240939689106531,-0.5462335921191455,0.0,1,0,1,1,0.0,-0.5462335921191455
4188,18,109,4,50,54,0,6263.325,74,2528.2270000000008,LESS,100,3002,3102,9,2,4.0,0.3749633842697951,4.0,-0.8730378697119728,0.8410377649439175,0.7647635879955081,104,50,54,1,-1.116921538982118,-1.170500554541026,-1.0144338139355558,1.1787457538902946,-0.24224211437566223,0.24224211437566223,-1.0144338139355558,-1.170500554541026,1,1,0,0,-1.170500554541026,-1.0144338139355558
4189,18,110,55,98,110,0,3785.637,14,1651.5320000000004,LESS,-1630,3082,1452,7,1,12.0,1.124890152809385,12.0,0.5238227218271837,-1.402560570586355,-0.5958523122419502,208,98,110,1,0.9573613191275298,0.7023003327246156,1.170500554541026,0.21486506927812885,-1.7112767576843844,1.7112767576843844,1.170500554541026,0.7023003327246156,0,1,0,2,1.170500554541026,0.7023003327246156
4190,18,111,2,50,52,1,2733.086,54,1899.542,LESS,1362,628,1990,4,2,2.0,0.18748169213489754,2.0,-1.222253017596762,0.09317165310049327,-1.173857947499835,102,50,52,1,-1.156811593945765,-1.170500554541026,-1.092467184238291,-1.23095595764012,0.8293889375639951,0.8293889375639951,-1.092467184238291,-1.170500554541026,1,0,1,0,-1.170500554541026,-1.092467184238291
4191,18,112,59,110,89,1,2549.217,74,1772.1570000000004,LESS,1506,540,2046,4,2,-21.0,-1.9685577674164243,21.0,2.0952908873087353,0.8410377649439175,-1.2748291290855551,199,110,89,0,0.7778560717911179,1.170500554541026,0.3511501663623078,-1.23095595764012,0.9516669656775534,0.9516669656775534,0.3511501663623078,1.170500554541026,1,0,1,2,1.170500554541026,0.3511501663623078
4192,18,113,60,87,110,0,2723.61,100,1747.292,LESS,902,1356,2258,5,2,23.0,2.1560394595513217,23.0,2.444506035193524,1.8132637103403688,-1.1790616681743709,197,87,110,1,0.7379660168274708,0.27311679605957273,1.170500554541026,-0.749015615334037,0.438778569979017,0.438778569979017,1.170500554541026,0.27311679605957273,1,0,1,2,1.170500554541026,0.27311679605957273
4193,18,114,52,110,105,0,7797.760999999998,4,1449.62,LESS,-1046,4408,3362,11,1,-5.0,-0.4687042303372438,5.0,-0.6984302957695783,-1.7764936265080669,1.6073951136342337,215,110,105,0,1.0969765115002945,1.170500554541026,0.9754171287841883,2.1426264385024605,-1.2153714214460642,1.2153714214460642,0.9754171287841883,1.170500554541026,0,1,0,2,1.170500554541026,0.9754171287841883
4194,18,115,30,80,96,0,2058.104,94,1787.583,LESS,1066,1064,2130,3,2,16.0,1.4998535370791803,16.0,1.222253017596762,1.5889038767873416,-1.5445225515880332,176,80,96,1,0.3191204397091766,0.0,0.6242669624218805,-1.7128962999462027,0.5780396575527919,0.5780396575527919,0.6242669624218805,0.0,1,0,1,1,0.6242669624218805,0.0
4195,18,116,24,80,86,0,3299.447,44,1193.7,LESS,-776,1898,1122,5,1,6.0,0.5624450764046927,6.0,-0.5238227218271837,-0.2807614028212188,-0.8628422821398752,166,80,86,1,0.11967016489094122,0.0,0.2341001109082052,-0.749015615334037,-0.9861001187331424,0.9861001187331424,0.2341001109082052,0.0,0,0,0,1,0.2341001109082052,0.0
4196,18,117,5,50,55,1,7186.69,24,1253.391,LESS,1024,2812,3836,10,2,5.0,0.4687042303372438,5.0,-0.6984302957695783,-1.0286275146646429,1.2718270684348374,105,50,55,1,-1.0969765115002945,-1.170500554541026,-0.9754171287841883,1.6606860961963776,0.5423752326863372,0.5423752326863372,-0.9754171287841883,-1.170500554541026,0,1,1,0,-1.170500554541026,-0.9754171287841883
4197,18,118,34,80,74,0,4215.198,44,1978.062,LESS,-682,2136,1454,4,1,-6.0,-0.5624450764046927,6.0,-0.5238227218271837,-0.2807614028212188,-0.3599600099335469,154,80,74,0,-0.11967016489094122,0.0,-0.2341001109082052,-1.23095595764012,-0.9062797392701251,0.9062797392701251,-0.2341001109082052,0.0,0,0,0,1,0.0,-0.2341001109082052
4198,18,119,15,45,50,0,5900.335999999998,20,3005.876,LESS,-2092,4658,2566,9,1,5.0,0.4687042303372438,5.0,-0.6984302957695783,-1.1782007370333278,0.565429125782632,95,45,50,1,-1.2964267863185297,-1.3655839802978638,-1.170500554541026,1.1787457538902946,-2.103585431215384,2.103585431215384,-1.170500554541026,-1.3655839802978638,0,1,0,0,-1.3655839802978638,-1.170500554541026
4199,18,120,37,69,80,0,2816.864,64,1623.158,LESS,-312,1402,1090,5,1,11.0,1.0311493067419364,11.0,0.34921514788478913,0.4671047090222054,-1.1278514773994452,149,69,80,1,-0.21939530230005888,-0.4291835366650429,0.0,-0.749015615334037,-0.5920931392561208,0.5920931392561208,0.0,-0.4291835366650429,1,0,0,1,-0.4291835366650429,0.0
4200,18,121,48,128,110,0,6173.666,74,2308.675,MORE,-684,2826,2142,10,2,-18.0,-1.6873352292140782,18.0,1.571468165481551,0.8410377649439175,0.715527582090249,238,128,110,1,1.5557121435822359,1.8728008872656416,1.170500554541026,1.6606860961963776,-0.9079780452161468,0.9079780452161468,1.170500554541026,1.8728008872656416,1,1,0,2,1.8728008872656416,1.170500554541026
4201,18,122,8,50,58,1,3306.925,54,2173.463,MORE,1072,1052,2124,6,2,8.0,0.7499267685395902,8.0,-0.17460757394239454,0.09317165310049327,-0.8587357579520131,108,50,58,0,-1.0371414290548238,-1.170500554541026,-0.8583670733300858,-0.2670752730279541,0.5831345753908568,0.5831345753908568,-0.8583670733300858,-1.170500554541026,0,1,1,0,-1.170500554541026,-0.8583670733300858
4202,18,123,4,54,50,0,6664.722,4,2708.7270000000008,MORE,-1966,4788,2822,9,1,-4.0,-0.3749633842697951,4.0,-0.8730378697119728,-1.7764936265080669,0.985189703191455,104,54,50,1,-1.116921538982118,-1.0144338139355558,-1.170500554541026,1.1787457538902946,-1.9965921566160205,1.9965921566160205,-1.170500554541026,-1.0144338139355558,0,1,0,0,-1.0144338139355558,-1.170500554541026
4203,18,124,37,80,69,0,6250.446,14,1958.329,MORE,-2320,4762,2442,9,1,-11.0,-1.0311493067419364,11.0,0.34921514788478913,-1.402560570586355,0.7576911187503256,149,80,69,1,-0.21939530230005888,0.0,-0.4291835366650429,1.1787457538902946,-2.2971923090618516,2.2971923090618516,-0.4291835366650429,0.0,0,1,0,1,0.0,-0.4291835366650429
4204,18,125,52,105,110,1,3739.708,74,2060.356,MORE,1374,1294,2668,6,2,5.0,0.4687042303372438,5.0,-0.6984302957695783,0.8410377649439175,-0.6210741027506851,215,105,110,0,1.0969765115002945,0.9754171287841883,1.170500554541026,-0.2670752730279541,0.839578773240125,0.839578773240125,1.170500554541026,0.9754171287841883,1,1,1,2,1.170500554541026,0.9754171287841883
4205,18,126,5,55,50,0,7016.376,54,1539.984,MORE,-636,3114,2478,9,1,-5.0,-0.4687042303372438,5.0,-0.6984302957695783,0.09317165310049327,1.1782995797304316,105,55,50,1,-1.0969765115002945,-0.9754171287841883,-1.170500554541026,1.1787457538902946,-0.8672187025116272,0.8672187025116272,-1.170500554541026,-0.9754171287841883,0,1,0,0,-0.9754171287841883,-1.170500554541026
4206,18,127,30,96,80,0,2834.9240000000004,64,2279.198,MORE,-458,1508,1050,5,1,-16.0,-1.4998535370791803,16.0,1.222253017596762,0.4671047090222054,-1.1179338755229018,176,96,80,1,0.3191204397091766,0.6242669624218805,0.0,-0.749015615334037,-0.7160694733157009,0.7160694733157009,0.0,0.6242669624218805,1,0,0,1,0.6242669624218805,0.0
4207,18,128,33,80,75,1,7416.059,84,1492.854,MORE,1996,2694,4690,8,2,-5.0,-0.4687042303372438,5.0,-0.6984302957695783,1.2149708208656296,1.3977844562986708,155,80,75,1,-0.09972513740911768,0.0,-0.19508342575683765,0.6968054115842117,1.3677519224528563,1.3677519224528563,-0.19508342575683765,0.0,1,1,1,1,0.0,-0.19508342575683765
4208,18,129,48,110,128,1,2708.862,94,2774.308,MORE,3372,656,4028,4,2,18.0,1.6873352292140782,18.0,1.571468165481551,1.5889038767873416,-1.1871604938928235,238,110,128,0,1.5557121435822359,1.170500554541026,1.8728008872656416,-1.23095595764012,2.5361864133157472,2.5361864133157472,1.8728008872656416,1.170500554541026,1,0,1,2,1.8728008872656416,1.170500554541026
4209,18,130,9,59,50,0,3080.123,74,2204.839,MORE,478,1824,2302,5,2,-9.0,-0.8436676146070391,9.0,0.0,0.8410377649439175,-0.9832834844638484,109,59,50,1,-1.0171964015730004,-0.8193503881787182,-1.170500554541026,-0.749015615334037,0.07873770942242848,0.07873770942242848,-1.170500554541026,-0.8193503881787182,1,0,0,0,-0.8193503881787182,-1.170500554541026
4210,18,131,44,110,119,1,5181.807,44,1341.2120000000002,MORE,248,2142,2390,7,2,9.0,0.8436676146070391,9.0,0.0,-0.2807614028212188,0.17085080027041294,229,110,119,0,1.376206896245824,1.170500554541026,1.5216507209033339,0.21486506927812885,-0.11656747437006057,0.11656747437006057,1.5216507209033339,1.170500554541026,0,1,0,2,1.5216507209033339,1.170500554541026
4211,18,132,2,52,50,1,7452.2040000000015,4,2157.18,MORE,1170,3242,4412,11,1,-2.0,-0.18748169213489754,2.0,-1.222253017596762,-1.7764936265080669,1.4176333887365264,102,52,50,1,-1.156811593945765,-1.092467184238291,-1.170500554541026,2.1426264385024605,0.6663515667459173,0.6663515667459173,-1.170500554541026,-1.092467184238291,0,1,1,0,-1.092467184238291,-1.170500554541026
4212,18,133,8,58,50,0,2372.702,94,2111.031,MORE,420,1624,2044,3,2,-8.0,-0.7499267685395902,8.0,-0.17460757394239454,1.5889038767873416,-1.3717618807598642,108,58,50,1,-1.0371414290548238,-0.8583670733300858,-1.170500554541026,-1.7128962999462027,0.029486836987800812,0.029486836987800812,-1.170500554541026,-0.8583670733300858,1,0,0,0,-0.8583670733300858,-1.170500554541026
4213,18,134,44,119,110,1,10680.274,44,2536.874,MORE,1546,3596,5142,12,2,-9.0,-0.8436676146070391,9.0,0.0,-0.2807614028212188,3.1903196063230546,229,119,110,1,1.376206896245824,1.5216507209033339,1.170500554541026,2.6245667808085433,0.9856330845979863,0.9856330845979863,1.170500554541026,1.5216507209033339,0,1,1,2,1.5216507209033339,1.170500554541026
4214,18,135,34,74,80,1,6787.801,24,1528.683,MORE,322,2976,3298,10,1,6.0,0.5624450764046927,6.0,-0.5238227218271837,-1.0286275146646429,1.052778214894836,154,74,80,0,-0.11967016489094122,-0.2341001109082052,0.0,1.6606860961963776,-0.05373015436725974,0.05373015436725974,0.0,-0.2341001109082052,0,1,0,1,-0.2341001109082052,0.0
4215,18,136,24,86,80,0,6399.58,14,1652.122,MORE,-1454,4110,2656,9,1,-6.0,-0.5624450764046927,6.0,-0.5238227218271837,-1.402560570586355,0.8395876657191179,166,86,80,1,0.11967016489094122,0.2341001109082052,0.0,1.1787457538902946,-1.5618258344344798,1.5618258344344798,0.0,0.2341001109082052,0,1,0,1,0.2341001109082052,0.0
4216,18,137,39,66,80,1,1399.156,54,2009.495,MORE,794,342,1136,2,2,14.0,1.3123718449442827,14.0,0.8730378697119728,0.09317165310049327,-1.9063821264133034,146,66,80,0,-0.2792303847455295,-0.5462335921191455,0.0,-2.1948366422522856,0.34707004889384824,0.34707004889384824,0.0,-0.5462335921191455,0,0,1,1,-0.5462335921191455,0.0
4217,18,138,9,50,59,1,2122.0660000000007,84,1563.226,MORE,1922,662,2584,4,2,9.0,0.8436676146070391,9.0,0.0,1.2149708208656296,-1.5093979861823044,109,50,59,0,-1.0171964015730004,-1.170500554541026,-0.8193503881787182,-1.23095595764012,1.3049146024500553,1.3049146024500553,-0.8193503881787182,-1.170500554541026,1,0,1,0,-1.170500554541026,-0.8193503881787182
4218,18,139,57,94,110,1,3394.367,64,2546.805,MORE,1056,958,2014,6,2,16.0,1.4998535370791803,16.0,1.222253017596762,0.4671047090222054,-0.8107172118119971,204,94,110,0,0.8775812092002355,0.5462335921191455,1.170500554541026,-0.2670752730279541,0.5695481278226836,0.5695481278226836,1.170500554541026,0.5462335921191455,1,0,1,2,1.170500554541026,0.5462335921191455
4219,18,140,60,110,87,0,4659.232,84,2494.98,MORE,-252,2550,2298,8,2,-23.0,-2.1560394595513217,23.0,2.444506035193524,1.2149708208656296,-0.11611989743914115,197,110,87,1,0.7379660168274708,1.170500554541026,0.27311679605957273,0.6968054115842117,-0.5411439608754716,0.5411439608754716,0.27311679605957273,1.170500554541026,1,1,0,2,1.170500554541026,0.27311679605957273
4220,18,141,33,75,80,0,6347.686,24,2475.3,MORE,-126,2752,2626,7,1,5.0,0.4687042303372438,5.0,-0.6984302957695783,-1.0286275146646429,0.8110902110246919,155,75,80,0,-0.09972513740911768,-0.19508342575683765,0.0,0.21486506927812885,-0.434150686276108,0.434150686276108,0.0,-0.19508342575683765,0,1,0,1,-0.19508342575683765,0.0
4221,18,142,15,50,45,1,4806.331,44,3158.224,MORE,1548,1682,3230,8,2,-5.0,-0.4687042303372438,5.0,-0.6984302957695783,-0.2807614028212188,-0.035340865410479684,95,50,45,1,-1.2964267863185297,-1.170500554541026,-1.3655839802978638,0.6968054115842117,0.9873313905440079,0.9873313905440079,-1.3655839802978638,-1.170500554541026,0,1,1,0,-1.170500554541026,-1.3655839802978638
4222,18,143,59,89,110,1,3109.061,94,2660.011,MORE,2724,784,3508,4,2,21.0,1.9685577674164243,21.0,2.0952908873087353,1.5889038767873416,-0.9673922572709688,199,89,110,0,0.7778560717911179,0.3511501663623078,1.170500554541026,-1.23095595764012,1.9859352868047346,1.9859352868047346,1.170500554541026,0.3511501663623078,1,0,1,2,1.170500554541026,0.3511501663623078
4223,18,144,29,80,94,1,4449.014,74,2092.286,MORE,1126,1534,2660,6,2,14.0,1.3123718449442827,14.0,0.8730378697119728,0.8410377649439175,-0.2315605636231473,174,80,94,0,0.2792303847455295,0.0,0.5462335921191455,-0.2670752730279541,0.6289888359334411,0.6289888359334411,0.5462335921191455,0.0,1,0,1,1,0.5462335921191455,0.0
4224,18,145,55,110,98,0,3725.623,84,2505.987,MORE,1086,2114,3200,6,2,-12.0,-1.124890152809385,12.0,0.5238227218271837,1.2149708208656296,-0.6288088437490854,208,110,98,1,0.9573613191275298,1.170500554541026,0.7023003327246156,-0.2670752730279541,0.5950227170130082,0.5950227170130082,0.7023003327246156,1.170500554541026,1,0,1,2,1.170500554541026,0.7023003327246156
4225,18,146,29,94,80,0,4789.33,54,2530.498,MORE,-1020,2872,1852,7,1,-14.0,-1.3123718449442827,14.0,0.8730378697119728,0.09317165310049327,-0.04467692020024228,174,94,80,1,0.2792303847455295,0.5462335921191455,0.0,0.21486506927812885,-1.193293444147783,1.193293444147783,0.0,0.5462335921191455,0,1,0,1,0.5462335921191455,0.0
4226,18,147,57,110,94,0,4982.5329999999985,54,3118.883,MORE,-1098,2910,1812,7,1,-16.0,-1.4998535370791803,16.0,1.222253017596762,0.09317165310049327,0.061420003130530525,204,110,94,1,0.8775812092002355,1.170500554541026,0.5462335921191455,0.21486506927812885,-1.259527376042627,1.259527376042627,0.5462335921191455,1.170500554541026,0,1,0,2,1.170500554541026,0.5462335921191455
4227,18,148,39,80,66,0,3483.972,74,1445.683,MORE,-772,2068,1296,5,1,-14.0,-1.3123718449442827,14.0,0.8730378697119728,0.8410377649439175,-0.7615108598658371,146,80,66,1,-0.2792303847455295,0.0,-0.5462335921191455,-0.749015615334037,-0.9827035068410991,0.9827035068410991,-0.5462335921191455,0.0,1,0,0,1,0.0,-0.5462335921191455
4228,18,149,4,50,54,1,6542.814,24,1481.964,MORE,2254,2026,4280,8,2,4.0,0.3749633842697951,4.0,-0.8730378697119728,-1.0286275146646429,0.9182442430826168,104,50,54,0,-1.116921538982118,-1.170500554541026,-1.0144338139355558,0.6968054115842117,1.5868333894896482,1.5868333894896482,-1.0144338139355558,-1.170500554541026,0,1,1,0,-1.170500554541026,-1.0144338139355558
4229,18,150,55,98,110,1,2421.26,94,1321.2579999999996,MORE,1836,790,2626,4,2,12.0,1.124890152809385,12.0,0.5238227218271837,1.5889038767873416,-1.345096381760906,208,98,110,0,0.9573613191275298,0.7023003327246156,1.170500554541026,-1.23095595764012,1.2318874467711247,1.2318874467711247,1.170500554541026,0.7023003327246156,1,0,1,2,1.170500554541026,0.7023003327246156
4230,18,151,2,50,52,1,5013.56,24,2145.031,MORE,1024,1730,2754,6,1,2.0,0.18748169213489754,2.0,-1.222253017596762,-1.0286275146646429,0.07845839922264146,102,50,52,0,-1.156811593945765,-1.170500554541026,-1.092467184238291,-0.2670752730279541,0.5423752326863372,0.5423752326863372,-1.092467184238291,-1.170500554541026,0,0,1,0,-1.170500554541026,-1.092467184238291
4231,18,152,59,110,89,0,2292.479,94,2299.181,MORE,1104,1638,2742,3,2,-21.0,-1.9685577674164243,21.0,2.0952908873087353,1.5889038767873416,-1.4158161318862168,199,110,89,1,0.7778560717911179,1.170500554541026,0.3511501663623078,-1.7128962999462027,0.610307470527203,0.610307470527203,0.3511501663623078,1.170500554541026,1,0,1,2,1.170500554541026,0.3511501663623078
4232,18,153,60,87,110,1,2516.337,100,2486.675,MORE,3534,624,4158,4,2,23.0,2.1560394595513217,23.0,2.444506035193524,1.8132637103403688,-1.292885095292684,197,87,110,0,0.7379660168274708,0.27311679605957273,1.170500554541026,-1.23095595764012,2.6737491949435004,2.6737491949435004,1.170500554541026,0.27311679605957273,1,0,1,2,1.170500554541026,0.27311679605957273
4233,18,154,52,110,105,1,5471.705,64,1221.634,MORE,1378,1858,3236,8,2,-5.0,-0.4687042303372438,5.0,-0.6984302957695783,0.4671047090222054,0.33004753054760644,215,110,105,1,1.0969765115002945,1.170500554541026,0.9754171287841883,0.6968054115842117,0.8429753851321683,0.8429753851321683,0.9754171287841883,1.170500554541026,1,1,1,2,1.170500554541026,0.9754171287841883
4234,18,155,30,80,96,1,3739.22,64,1318.869,MORE,1282,1148,2430,6,2,16.0,1.4998535370791803,16.0,1.222253017596762,0.4671047090222054,-0.6213420866773604,176,80,96,0,0.3191204397091766,0.0,0.6242669624218805,-0.2670752730279541,0.7614566997231293,0.7614566997231293,0.6242669624218805,0.0,1,0,1,1,0.6242669624218805,0.0
4235,18,156,24,80,86,1,5058.54,64,935.057,MORE,1184,1930,3114,6,2,6.0,0.5624450764046927,6.0,-0.5238227218271837,0.4671047090222054,0.10315904885757544,166,80,86,0,0.11967016489094122,0.0,0.2341001109082052,-0.2670752730279541,0.6782397083680688,0.6782397083680688,0.2341001109082052,0.0,1,0,1,1,0.2341001109082052,0.0
4236,18,157,5,50,55,1,2488.417,54,3109.567,MORE,882,796,1678,4,2,5.0,0.4687042303372438,5.0,-0.6984302957695783,0.09317165310049327,-1.3082172904418028,105,50,55,0,-1.0969765115002945,-1.170500554541026,-0.9754171287841883,-1.23095595764012,0.42179551051880054,0.42179551051880054,-0.9754171287841883,-1.170500554541026,0,0,1,0,-1.170500554541026,-0.9754171287841883
4237,18,158,34,80,74,1,3917.856,84,2476.952,MORE,2064,1518,3582,6,2,-6.0,-0.5624450764046927,6.0,-0.5238227218271837,1.2149708208656296,-0.5232445933873178,154,80,74,1,-0.11967016489094122,0.0,-0.2341001109082052,-0.2670752730279541,1.425494324617592,1.425494324617592,-0.2341001109082052,0.0,1,0,1,1,0.0,-0.2341001109082052
4238,18,159,15,45,50,1,2324.17,94,1884.26,MORE,1504,756,2260,4,2,5.0,0.4687042303372438,5.0,-0.6984302957695783,1.5889038767873416,-1.3984131019266637,95,45,50,0,-1.2964267863185297,-1.3655839802978638,-1.170500554541026,-1.23095595764012,0.9499686597315318,0.9499686597315318,-1.170500554541026,-1.3655839802978638,1,0,1,0,-1.3655839802978638,-1.170500554541026
4239,18,160,37,69,80,1,3251.9040000000005,74,3132.2870000000007,MORE,1308,1680,2988,6,2,11.0,1.0311493067419364,11.0,0.34921514788478913,0.8410377649439175,-0.8889503965372445,149,69,80,0,-0.21939530230005888,-0.4291835366650429,0.0,-0.2670752730279541,0.7835346770214108,0.7835346770214108,0.0,-0.4291835366650429,1,0,1,1,-0.4291835366650429,0.0
4240,18,161,3,50,53,1,6017.063,14,2156.036,LESS,-292,3180,2888,7,1,3.0,0.28122253820234633,3.0,-1.0476454436543674,-1.402560570586355,0.6295294532601111,103,50,53,1,-1.1368665664639415,-1.170500554541026,-1.0534504990869233,0.21486506927812885,-0.5751100797959044,0.5751100797959044,-1.0534504990869233,-1.170500554541026,0,1,0,0,-1.170500554541026,-1.0534504990869233
4241,18,162,20,50,40,1,2575.931,64,1739.507,LESS,1188,608,1796,4,2,-10.0,-0.9374084606744876,10.0,0.17460757394239454,0.4671047090222054,-1.2601592056896544,90,50,40,0,-1.3961519237276474,-1.170500554541026,-1.5606674060547012,-1.23095595764012,0.6816363202601121,0.6816363202601121,-1.5606674060547012,-1.170500554541026,1,0,1,0,-1.170500554541026,-1.5606674060547012
4242,18,163,25,80,88,0,2723.84,54,2559.601,LESS,-588,1678,1090,5,1,8.0,0.7499267685395902,8.0,-0.17460757394239454,0.09317165310049327,-1.1789353642745035,168,80,88,1,0.1595602198545883,0.0,0.31213348121094026,-0.749015615334037,-0.8264593598071077,0.8264593598071077,0.31213348121094026,0.0,1,0,0,1,0.31213348121094026,0.0
4243,18,164,42,115,110,0,5661.448,4,2570.266,LESS,-2204,4380,2176,9,1,-5.0,-0.4687042303372438,5.0,-0.6984302957695783,-1.7764936265080669,0.4342444039064622,225,115,110,0,1.2964267863185297,1.3655839802978638,1.170500554541026,1.1787457538902946,-2.1986905641925962,2.1986905641925962,1.170500554541026,1.3655839802978638,0,1,0,2,1.3655839802978638,1.170500554541026
4244,18,165,53,103,110,0,5683.16,54,1917.416,LESS,-538,2938,2400,7,1,7.0,0.6561859224721414,7.0,-0.34921514788478913,0.09317165310049327,0.4461674920539429,213,103,110,1,1.0570864565366473,0.8973837584814532,1.170500554541026,0.21486506927812885,-0.7840017111565667,0.7840017111565667,1.170500554541026,0.8973837584814532,1,1,0,2,1.170500554541026,0.8973837584814532
4245,18,166,26,90,80,0,5453.071,24,2226.4770000000008,LESS,538,2360,2898,8,1,-10.0,-0.9374084606744876,10.0,0.17460757394239454,-1.0286275146646429,0.31981471806878553,170,90,80,0,0.19945027481823535,0.3901668515136753,0.0,0.6968054115842117,0.1296868878030778,0.1296868878030778,0.0,0.3901668515136753,0,1,1,1,0.3901668515136753,0.0
4246,18,167,35,80,72,1,8881.82,74,2091.707000000001,LESS,3318,2804,6122,12,2,-8.0,-0.7499267685395902,8.0,-0.17460757394239454,0.8410377649439175,2.2027032848791688,152,80,72,0,-0.1595602198545883,0.0,-0.31213348121094026,2.6245667808085433,2.490332152773163,2.490332152773163,-0.31213348121094026,0.0,1,1,1,1,0.0,-0.31213348121094026
4247,18,168,28,93,80,1,2949.378,64,2051.21,LESS,1670,670,2340,4,2,-13.0,-1.218630998876834,13.0,0.6984302957695783,0.4671047090222054,-1.055081760064548,173,93,80,0,0.25928535726370594,0.5072169069677779,0.0,-1.23095595764012,1.0909280532513281,1.0909280532513281,0.0,0.5072169069677779,1,0,1,1,0.5072169069677779,0.0
4248,18,169,26,80,90,0,4752.435,44,1833.408,LESS,-922,2684,1762,7,1,10.0,0.9374084606744876,10.0,0.17460757394239454,-0.2807614028212188,-0.06493771318114237,170,80,90,1,0.19945027481823535,0.0,0.3901668515136753,0.21486506927812885,-1.1100764527927223,1.1100764527927223,0.3901668515136753,0.0,0,1,0,1,0.3901668515136753,0.0
4249,18,170,25,88,80,1,3419.387,64,1331.8429999999996,LESS,796,1200,1996,6,2,-8.0,-0.7499267685395902,8.0,-0.17460757394239454,0.4671047090222054,-0.7969775440959888,168,88,80,0,0.1595602198545883,0.31213348121094026,0.0,-0.2670752730279541,0.3487683548398699,0.3487683548398699,0.0,0.31213348121094026,1,0,1,1,0.31213348121094026,0.0
4250,18,171,36,80,70,1,3879.152,44,1413.625,LESS,1582,1140,2722,6,2,-10.0,-0.9374084606744876,10.0,0.17460757394239454,-0.2807614028212188,-0.5444987939980447,150,80,70,0,-0.19945027481823535,0.0,-0.3901668515136753,-0.2670752730279541,1.016202591626376,1.016202591626376,-0.3901668515136753,0.0,1,0,1,1,0.0,-0.3901668515136753
4251,18,172,28,80,93,0,8826.808,0,2301.072,LESS,-1286,5018,3732,13,1,13.0,1.218630998876834,13.0,0.6984302957695783,-1.926066848876752,2.172493588620455,173,80,93,1,0.25928535726370594,0.0,0.5072169069677779,3.106507123114626,-1.4191681349686616,1.4191681349686616,0.5072169069677779,0.0,0,1,0,1,0.5072169069677779,0.0
4252,18,173,21,82,80,1,3863.504,14,1508.245,LESS,424,1714,2138,5,1,-2.0,-0.18748169213489754,2.0,-1.222253017596762,-1.402560570586355,-0.5530918523681526,162,82,80,0,0.03989005496364707,0.07803337030273506,0.0,-0.749015615334037,0.0328834488798441,0.0328834488798441,0.0,0.07803337030273506,0,0,1,1,0.07803337030273506,0.0
4253,18,174,19,50,41,0,5034.392,34,1893.863,LESS,-1076,3074,1998,7,1,-9.0,-0.8436676146070391,9.0,0.0,-0.6546944587429309,0.08989823766628165,91,50,41,0,-1.376206896245824,-1.170500554541026,-1.5216507209033339,0.21486506927812885,-1.240846010636389,1.240846010636389,-1.5216507209033339,-1.170500554541026,0,0,0,0,-1.170500554541026,-1.5216507209033339
4254,18,175,56,96,110,0,6175.267,64,1601.3970000000004,LESS,-732,2952,2220,6,2,14.0,1.3123718449442827,14.0,0.8730378697119728,0.4671047090222054,0.7164067670628039,206,96,110,1,0.9174712641638826,0.6242669624218805,1.170500554541026,-0.2670752730279541,-0.9487373879206662,0.9487373879206662,1.170500554541026,0.6242669624218805,1,0,0,2,1.170500554541026,0.6242669624218805
4255,18,176,23,80,85,0,4978.406,84,1262.632,LESS,764,2344,3108,7,2,5.0,0.4687042303372438,5.0,-0.6984302957695783,1.2149708208656296,0.05915367184899788,165,80,85,1,0.09972513740911768,0.0,0.19508342575683765,0.21486506927812885,0.32159545970352355,0.32159545970352355,0.19508342575683765,0.0,1,1,1,1,0.19508342575683765,0.0
4256,18,177,10,60,50,1,4372.513,74,2000.103,LESS,2010,1106,3116,6,2,-10.0,-0.9374084606744876,10.0,0.17460757394239454,0.8410377649439175,-0.27357088816121106,110,60,50,0,-0.9972513740911768,-0.7803337030273506,-1.170500554541026,-0.2670752730279541,1.3796400640750077,1.3796400640750077,-1.170500554541026,-0.7803337030273506,1,0,1,0,-0.7803337030273506,-1.170500554541026
4257,18,178,19,41,50,0,4613.582,54,1321.1170000000004,LESS,-124,2286,2162,7,2,9.0,0.8436676146070391,9.0,0.0,0.09317165310049327,-0.14118847582586275,91,41,50,1,-1.376206896245824,-1.5216507209033339,-1.170500554541026,0.21486506927812885,-0.4324523803300863,0.4324523803300863,-1.170500554541026,-1.5216507209033339,1,1,0,0,-1.5216507209033339,-1.170500554541026
4258,18,179,56,110,96,1,2679.603,64,2111.611,LESS,994,872,1866,4,2,-14.0,-1.3123718449442827,14.0,0.8730378697119728,0.4671047090222054,-1.203227997398127,206,110,96,0,0.9174712641638826,1.170500554541026,0.6242669624218805,-1.23095595764012,0.5169006434960126,0.5169006434960126,0.6242669624218805,1.170500554541026,1,0,1,2,1.170500554541026,0.6242669624218805
4259,18,180,35,72,80,0,3975.951,84,1199.218,LESS,620,2000,2620,7,2,8.0,0.7499267685395902,8.0,-0.17460757394239454,1.2149708208656296,-0.4913418757229892,152,72,80,1,-0.1595602198545883,-0.31213348121094026,0.0,0.21486506927812885,0.1993174315899652,0.1993174315899652,0.0,-0.31213348121094026,1,1,1,1,-0.31213348121094026,0.0
4260,18,181,11,49,50,0,4491.585999999998,14,2375.832000000001,LESS,-1768,3614,1846,7,1,1.0,0.09374084606744876,1.0,-1.3968605915391563,-1.402560570586355,-0.20818226090508646,99,49,50,1,-1.2166466763912356,-1.2095172396923934,-1.170500554541026,0.21486506927812885,-1.8284598679598778,1.8284598679598778,-1.170500554541026,-1.2095172396923934,0,1,0,0,-1.2095172396923934,-1.170500554541026
4261,18,182,17,43,50,0,4356.596,24,1116.619,LESS,-496,1954,1458,5,1,7.0,0.6561859224721414,7.0,-0.34921514788478913,-1.0286275146646429,-0.28231166717942485,93,43,50,1,-1.3363168412821769,-1.4436173506005987,-1.170500554541026,-0.749015615334037,-0.7483372862901121,0.7483372862901121,-1.170500554541026,-1.4436173506005987,0,0,0,0,-1.4436173506005987,-1.170500554541026
4262,18,183,1,51,50,0,6134.14,34,1287.95,LESS,342,2660,3002,7,1,-1.0,-0.09374084606744876,1.0,-1.3968605915391563,-0.6546944587429309,0.6938219823243439,101,51,50,0,-1.1767566214275886,-1.1314838693896585,-1.170500554541026,0.21486506927812885,-0.0367470949070433,0.0367470949070433,-1.170500554541026,-1.1314838693896585,0,1,0,0,-1.1314838693896585,-1.170500554541026
4263,18,184,41,112,110,1,4599.457,34,2853.482,LESS,1072,1652,2724,6,2,-2.0,-0.18748169213489754,2.0,-1.222253017596762,-0.6546944587429309,-0.1489451827198922,222,112,110,0,1.2365917038730592,1.248533924843761,1.170500554541026,-0.2670752730279541,0.5831345753908568,0.5831345753908568,1.170500554541026,1.248533924843761,0,0,1,2,1.248533924843761,1.170500554541026
4264,18,185,20,40,50,0,3430.558,74,1786.151,LESS,-608,1986,1378,5,2,10.0,0.9374084606744876,10.0,0.17460757394239454,0.8410377649439175,-0.7908430185941692,90,40,50,1,-1.3961519237276474,-1.5606674060547012,-1.170500554541026,-0.749015615334037,-0.8434424192673242,0.8434424192673242,-1.170500554541026,-1.5606674060547012,1,0,0,0,-1.5606674060547012,-1.170500554541026
4265,18,186,1,50,51,0,8016.2040000000015,4,2517.612,LESS,-2090,5548,3458,11,1,1.0,0.09374084606744876,1.0,-1.3968605915391563,-1.7764936265080669,1.7273525171069777,101,50,51,1,-1.1767566214275886,-1.170500554541026,-1.1314838693896585,2.1426264385024605,-2.1018871252693625,2.1018871252693625,-1.1314838693896585,-1.170500554541026,0,1,0,0,-1.170500554541026,-1.1314838693896585
4266,18,187,23,85,80,1,5871.491999999998,24,2397.388,LESS,604,2166,2770,6,2,-5.0,-0.4687042303372438,5.0,-0.6984302957695783,-1.0286275146646429,0.5495895184444808,165,85,80,0,0.09972513740911768,0.19508342575683765,0.0,-0.2670752730279541,0.18573098402179206,0.18573098402179206,0.0,0.19508342575683765,0,0,1,1,0.19508342575683765,0.0
4267,18,188,11,50,49,1,4372.459,34,1483.192,LESS,806,1732,2538,6,2,-1.0,-0.09374084606744876,1.0,-1.3968605915391563,-0.6546944587429309,-0.2736005421203104,99,50,49,0,-1.2166466763912356,-1.170500554541026,-1.2095172396923934,-0.2670752730279541,0.3572598845699781,0.3572598845699781,-1.2095172396923934,-1.170500554541026,0,0,1,0,-1.170500554541026,-1.2095172396923934
4268,18,189,17,50,43,1,3623.74,64,1499.6760000000004,LESS,1644,950,2594,6,2,-7.0,-0.6561859224721414,7.0,-0.34921514788478913,0.4671047090222054,-0.6847576273586011,93,50,43,0,-1.3363168412821769,-1.170500554541026,-1.4436173506005987,-0.2670752730279541,1.0688500759530468,1.0688500759530468,-1.4436173506005987,-1.170500554541026,1,0,1,0,-1.170500554541026,-1.4436173506005987
4269,18,190,21,80,82,0,6436.606,30,2256.549,LESS,-2394,4814,2420,9,1,2.0,0.18748169213489754,2.0,-1.222253017596762,-0.8042676811116157,0.8599203970082034,162,80,82,1,0.03989005496364707,0.0,0.07803337030273506,1.1787457538902946,-2.3600296290646523,2.3600296290646523,0.07803337030273506,0.0,0,1,0,1,0.07803337030273506,0.0
4270,18,191,10,50,60,0,2586.793,84,1562.135,LESS,750,1458,2208,5,2,10.0,0.9374084606744876,10.0,0.17460757394239454,1.2149708208656296,-1.2541943667315694,110,50,60,1,-0.9972513740911768,-1.170500554541026,-0.7803337030273506,-0.749015615334037,0.3097073180813721,0.3097073180813721,-0.7803337030273506,-1.170500554541026,1,0,1,0,-1.170500554541026,-0.7803337030273506
4271,18,192,3,53,50,0,3935.492,24,1626.97,LESS,-1780,3298,1518,5,1,-3.0,-0.28122253820234633,3.0,-1.0476454436543674,-1.0286275146646429,-0.5135598300044432,103,53,50,0,-1.1368665664639415,-1.0534504990869233,-1.170500554541026,-0.749015615334037,-1.8386497036360077,1.8386497036360077,-1.170500554541026,-1.0534504990869233,0,0,0,0,-1.0534504990869233,-1.170500554541026
4272,18,193,45,122,110,1,3661.471,34,2266.363,LESS,1416,1110,2526,6,2,-12.0,-1.124890152809385,12.0,0.5238227218271837,-0.6546944587429309,-0.6640377471590522,232,122,110,0,1.4360419786912946,1.6387007763574364,1.170500554541026,-0.2670752730279541,0.8752431981065794,0.8752431981065794,1.170500554541026,1.6387007763574364,0,0,1,2,1.6387007763574364,1.170500554541026
4273,18,194,38,67,80,0,3447.305,44,2615.057,LESS,-1322,2584,1262,5,1,13.0,1.218630998876834,13.0,0.6984302957695783,-0.2807614028212188,-0.7816464472416517,147,67,80,1,-0.25928535726370594,-0.5072169069677779,0.0,-0.749015615334037,-1.4497376419970511,1.4497376419970511,0.0,-0.5072169069677779,0,0,0,1,-0.5072169069677779,0.0
4274,18,195,38,80,67,1,6868.153,24,2522.6220000000008,LESS,990,2926,3916,8,2,-13.0,-1.218630998876834,13.0,0.6984302957695783,-1.0286275146646429,1.0969033060345923,147,80,67,0,-0.25928535726370594,0.0,-0.5072169069677779,0.6968054115842117,0.5135040316039693,0.5135040316039693,-0.5072169069677779,0.0,0,1,1,1,0.0,-0.5072169069677779
4275,18,196,36,70,80,0,3567.491,34,1269.976,LESS,-716,2114,1398,5,1,10.0,0.9374084606744876,10.0,0.17460757394239454,-0.6546944587429309,-0.7156466189396461,150,70,80,1,-0.19945027481823535,-0.3901668515136753,0.0,-0.749015615334037,-0.935150940352493,0.935150940352493,0.0,-0.3901668515136753,0,0,0,1,-0.3901668515136753,0.0
4276,18,197,45,110,122,1,1691.779,64,1261.538,LESS,1292,322,1614,2,2,12.0,1.124890152809385,12.0,0.5238227218271837,0.4671047090222054,-1.7456889694963764,232,110,122,1,1.4360419786912946,1.170500554541026,1.6387007763574364,-2.1948366422522856,0.7699482294532376,0.7699482294532376,1.6387007763574364,1.170500554541026,1,0,1,2,1.6387007763574364,1.170500554541026
4277,18,198,42,110,115,0,2812.001,44,1845.755,LESS,-530,1660,1130,5,1,5.0,0.4687042303372438,5.0,-0.6984302957695783,-0.2807614028212188,-1.1305219811605542,225,110,115,1,1.2964267863185297,1.170500554541026,1.3655839802978638,-0.749015615334037,-0.77720848737248,0.77720848737248,1.3655839802978638,1.170500554541026,0,0,0,2,1.3655839802978638,1.170500554541026
4278,18,199,41,110,112,0,3308.4120000000007,44,2087.043,LESS,-1064,2188,1124,5,1,2.0,0.18748169213489754,2.0,-1.222253017596762,-0.2807614028212188,-0.8579191757820006,222,110,112,1,1.2365917038730592,1.170500554541026,1.248533924843761,-0.749015615334037,-1.2306561749602591,1.2306561749602591,1.248533924843761,1.170500554541026,0,0,0,2,1.248533924843761,1.170500554541026
4279,18,200,53,110,103,1,4751.335,54,1692.418,LESS,1182,1816,2998,7,2,-7.0,-0.6561859224721414,7.0,-0.34921514788478913,0.09317165310049327,-0.0655417753109431,213,110,103,0,1.0570864565366473,1.170500554541026,0.8973837584814532,0.21486506927812885,0.6765414024220472,0.6765414024220472,0.8973837584814532,1.170500554541026,1,1,1,2,1.170500554541026,0.8973837584814532
4280,18,201,3,50,53,1,4483.769,44,1852.436,MORE,904,1554,2458,6,1,3.0,0.28122253820234633,3.0,-1.0476454436543674,-0.2807614028212188,-0.21247494605840428,103,50,53,0,-1.1368665664639415,-1.170500554541026,-1.0534504990869233,-0.2670752730279541,0.44047687592503865,0.44047687592503865,-1.0534504990869233,-1.170500554541026,0,0,1,0,-1.170500554541026,-1.0534504990869233
4281,18,202,20,50,40,0,4823.128,24,1601.5410000000004,MORE,-814,2512,1698,7,1,-10.0,-0.9374084606744876,10.0,0.17460757394239454,-1.0286275146646429,-0.02611683668842589,90,50,40,1,-1.3961519237276474,-1.170500554541026,-1.5606674060547012,0.21486506927812885,-1.0183679317075536,1.0183679317075536,-1.5606674060547012,-1.170500554541026,0,1,0,0,-1.170500554541026,-1.5606674060547012
4282,18,203,25,80,88,1,4383.019,44,3006.177,MORE,2418,1136,3554,6,2,8.0,0.7499267685395902,8.0,-0.17460757394239454,-0.2807614028212188,-0.26780154567422515,168,80,88,0,0.1595602198545883,0.0,0.31213348121094026,-0.2670752730279541,1.726094477063423,1.726094477063423,0.31213348121094026,0.0,0,0,1,1,0.31213348121094026,0.0
4283,18,204,42,115,110,0,3856.271,74,2523.0,MORE,-146,2124,1978,7,2,-5.0,-0.4687042303372438,5.0,-0.6984302957695783,0.8410377649439175,-0.5570638354452863,225,115,110,1,1.2964267863185297,1.3655839802978638,1.170500554541026,0.21486506927812885,-0.4511337457363244,0.4511337457363244,1.170500554541026,1.3655839802978638,1,1,0,2,1.3655839802978638,1.170500554541026
4284,18,205,53,103,110,1,6145.383000000002,24,1770.188,MORE,692,2456,3148,8,2,7.0,0.6561859224721414,7.0,-0.34921514788478913,-1.0286275146646429,0.6999960464382968,213,103,110,0,1.0570864565366473,0.8973837584814532,1.170500554541026,0.6968054115842117,0.2604564456467444,0.2604564456467444,1.170500554541026,0.8973837584814532,0,1,0,2,1.170500554541026,0.8973837584814532
4285,18,206,26,90,80,0,6684.002,84,1690.187,MORE,1658,2948,4606,9,2,-10.0,-0.9374084606744876,10.0,0.17460757394239454,1.2149708208656296,0.9957772648846864,170,90,80,1,0.19945027481823535,0.3901668515136753,0.0,1.1787457538902946,1.0807382175751983,1.0807382175751983,0.0,0.3901668515136753,1,1,1,1,0.3901668515136753,0.0
4286,18,207,35,80,72,0,4152.188,24,1938.872,MORE,-140,2178,2038,5,1,-8.0,-0.7499267685395902,8.0,-0.17460757394239454,-1.0286275146646429,-0.3945617870233026,152,80,72,1,-0.1595602198545883,0.0,-0.31213348121094026,-0.749015615334037,-0.4460388278982595,0.4460388278982595,-0.31213348121094026,0.0,0,0,0,1,0.0,-0.31213348121094026
4287,18,208,28,93,80,0,5040.3290000000015,54,1156.432,MORE,-336,2480,2144,7,1,-13.0,-1.218630998876834,13.0,0.6984302957695783,0.09317165310049327,0.09315852572503323,173,93,80,1,0.25928535726370594,0.5072169069677779,0.0,0.21486506927812885,-0.6124728106083807,0.6124728106083807,0.0,0.5072169069677779,0,1,0,1,0.5072169069677779,0.0
4288,18,209,26,80,90,1,3192.435,84,2213.572,MORE,1586,1000,2586,4,2,10.0,0.9374084606744876,10.0,0.17460757394239454,1.2149708208656296,-0.9216076427164334,170,80,90,0,0.19945027481823535,0.0,0.3901668515136753,-1.23095595764012,1.0195992035184192,1.0195992035184192,0.3901668515136753,0.0,1,0,1,1,0.3901668515136753,0.0
4289,18,210,25,88,80,1,5972.8409999999985,64,2635.056,MORE,954,2316,3270,10,2,-8.0,-0.7499267685395902,8.0,-0.17460757394239454,0.4671047090222054,0.6052450573473476,168,88,80,1,0.1595602198545883,0.31213348121094026,0.0,1.6606860961963776,0.4829345245755797,0.4829345245755797,0.0,0.31213348121094026,1,1,1,1,0.31213348121094026,0.0
4290,18,211,36,80,70,0,4411.7,94,2616.311,MORE,344,2580,2924,7,2,-10.0,-0.9374084606744876,10.0,0.17460757394239454,1.5889038767873416,-0.25205144936076274,150,80,70,1,-0.19945027481823535,0.0,-0.3901668515136753,0.21486506927812885,-0.035048788961021655,0.035048788961021655,-0.3901668515136753,0.0,1,1,0,1,0.0,-0.3901668515136753
4291,18,212,28,80,93,1,2609.029,84,1860.889,MORE,2316,784,3100,4,2,13.0,1.218630998876834,13.0,0.6984302957695783,1.2149708208656296,-1.2419835253513474,173,80,93,0,0.25928535726370594,0.0,0.5072169069677779,-1.23095595764012,1.6394808738163191,1.6394808738163191,0.5072169069677779,0.0,1,0,1,1,0.5072169069677779,0.0
4292,18,213,21,82,80,1,6391.76,74,1748.969,MORE,2056,2026,4082,8,2,-2.0,-0.18748169213489754,2.0,-1.222253017596762,0.8410377649439175,0.8352933331236271,162,82,80,1,0.03989005496364707,0.07803337030273506,0.0,0.6968054115842117,1.4187011008335055,1.4187011008335055,0.0,0.07803337030273506,1,1,1,1,0.07803337030273506,0.0
4293,18,214,19,50,41,0,1840.682,54,1467.3,MORE,-500,1202,702,3,1,-9.0,-0.8436676146070391,9.0,0.0,0.09317165310049327,-1.6639192755748422,91,50,41,1,-1.376206896245824,-1.170500554541026,-1.5216507209033339,-1.7128962999462027,-0.7517338981821554,0.7517338981821554,-1.5216507209033339,-1.170500554541026,0,0,0,0,-1.170500554541026,-1.5216507209033339
4294,18,215,56,96,110,1,2030.775,84,1503.476,MORE,1438,668,2106,4,2,14.0,1.3123718449442827,14.0,0.8730378697119728,1.2149708208656296,-1.5595302006292318,206,96,110,0,0.9174712641638826,0.6242669624218805,1.170500554541026,-1.23095595764012,0.8939245635128175,0.8939245635128175,1.170500554541026,0.6242669624218805,1,0,1,2,1.170500554541026,0.6242669624218805
4295,18,216,23,80,85,0,2881.835,54,1690.9229999999998,MORE,-574,1778,1204,5,2,5.0,0.4687042303372438,5.0,-0.6984302957695783,0.09317165310049327,-1.0921728222764726,165,80,85,0,0.09972513740911768,0.0,0.19508342575683765,-0.749015615334037,-0.8145712181849563,0.8145712181849563,0.19508342575683765,0.0,0,0,0,1,0.19508342575683765,0.0
4296,18,217,10,60,50,0,3080.954,44,2310.961,MORE,-418,1744,1326,5,1,-10.0,-0.9374084606744876,10.0,0.17460757394239454,-0.2807614028212188,-0.9828271429821536,110,60,50,1,-0.9972513740911768,-0.7803337030273506,-1.170500554541026,-0.749015615334037,-0.682103354395268,0.682103354395268,-1.170500554541026,-0.7803337030273506,0,0,0,0,-0.7803337030273506,-1.170500554541026
4297,18,218,19,41,50,1,3003.969,64,1555.687,MORE,1424,806,2230,4,2,9.0,0.8436676146070391,9.0,0.0,0.4671047090222054,-1.0251032548573296,91,41,50,0,-1.376206896245824,-1.5216507209033339,-1.170500554541026,-1.23095595764012,0.882036421890666,0.882036421890666,-1.170500554541026,-1.5216507209033339,1,0,1,0,-1.5216507209033339,-1.170500554541026
4298,18,219,56,110,96,0,5303.755,84,3359.031,MORE,1234,2248,3482,7,2,-14.0,-1.3123718449442827,14.0,0.8730378697119728,1.2149708208656296,0.23781822627488086,206,110,96,1,0.9174712641638826,1.170500554541026,0.6242669624218805,0.21486506927812885,0.7206973570186099,0.7206973570186099,0.6242669624218805,1.170500554541026,1,1,1,2,1.170500554541026,0.6242669624218805
4299,18,220,35,72,80,1,5176.889,54,2472.515,MORE,1232,2068,3300,8,2,8.0,0.7499267685395902,8.0,-0.17460757394239454,0.09317165310049327,0.16815009340281406,152,72,80,0,-0.1595602198545883,-0.31213348121094026,0.0,0.6968054115842117,0.7189990510725882,0.7189990510725882,0.0,-0.31213348121094026,0,1,1,1,-0.31213348121094026,0.0
4300,18,221,11,49,50,1,3426.235,24,2157.574,MORE,1152,1070,2222,6,2,1.0,0.09374084606744876,1.0,-1.3968605915391563,-1.0286275146646429,-0.7932169827642852,99,49,50,0,-1.2166466763912356,-1.2095172396923934,-1.170500554541026,-0.2670752730279541,0.6510668132317226,0.6510668132317226,-1.170500554541026,-1.2095172396923934,0,1,1,0,-1.2095172396923934,-1.170500554541026
4301,18,222,17,43,50,1,3665.522,44,1407.179,MORE,836,1324,2160,6,2,7.0,0.6561859224721414,7.0,-0.34921514788478913,-0.2807614028212188,-0.661813151079214,93,43,50,0,-1.3363168412821769,-1.4436173506005987,-1.170500554541026,-0.2670752730279541,0.38273447376030273,0.38273447376030273,-1.170500554541026,-1.4436173506005987,0,0,1,0,-1.4436173506005987,-1.170500554541026
4302,18,223,1,51,50,0,4475.915,24,1429.034,MORE,-1026,2674,1648,7,1,-1.0,-0.09374084606744876,1.0,-1.3968605915391563,-1.0286275146646429,-0.21678794966518014,101,51,50,1,-1.1767566214275886,-1.1314838693896585,-1.170500554541026,0.21486506927812885,-1.198388361985848,1.198388361985848,-1.170500554541026,-1.1314838693896585,0,1,0,0,-1.1314838693896585,-1.170500554541026
4303,18,224,41,112,110,0,6056.958000000001,54,1657.776,MORE,-668,3164,2496,8,1,-2.0,-0.18748169213489754,2.0,-1.222253017596762,0.09317165310049327,0.6514376884131954,222,112,110,1,1.2365917038730592,1.248533924843761,1.170500554541026,0.6968054115842117,-0.8943915976479736,0.8943915976479736,1.170500554541026,1.248533924843761,0,1,0,2,1.248533924843761,1.170500554541026
4304,18,225,20,40,50,1,2049.054,64,1964.631,MORE,864,562,1426,4,2,10.0,0.9374084606744876,10.0,0.17460757394239454,0.4671047090222054,-1.5494923354741192,90,40,50,0,-1.3961519237276474,-1.5606674060547012,-1.170500554541026,-1.23095595764012,0.40651075700460576,0.40651075700460576,-1.170500554541026,-1.5606674060547012,1,0,1,0,-1.5606674060547012,-1.170500554541026
4305,18,226,1,50,51,1,5343.713000000002,34,1324.888,MORE,766,1832,2598,7,2,1.0,0.09374084606744876,1.0,-1.3968605915391563,-0.6546944587429309,0.2597610577135811,101,50,51,0,-1.1767566214275886,-1.170500554541026,-1.1314838693896585,0.21486506927812885,0.3232937656495452,0.3232937656495452,-1.1314838693896585,-1.170500554541026,0,1,1,0,-1.170500554541026,-1.1314838693896585
4306,18,227,23,85,80,1,8228.405,44,1730.4029999999998,MORE,1344,3234,4578,12,2,-5.0,-0.4687042303372438,5.0,-0.6984302957695783,-0.2807614028212188,1.8438821425667968,165,85,80,1,0.09972513740911768,0.19508342575683765,0.0,2.6245667808085433,0.8141041840498003,0.8141041840498003,0.0,0.19508342575683765,0,1,1,1,0.19508342575683765,0.0
4307,18,228,11,50,49,0,5846.507,74,3643.275,MORE,-508,2938,2430,9,1,-1.0,-0.09374084606744876,1.0,-1.3968605915391563,0.8410377649439175,0.5358690708871486,99,50,49,1,-1.2166466763912356,-1.170500554541026,-1.2095172396923934,1.1787457538902946,-0.758527121966242,0.758527121966242,-1.2095172396923934,-1.170500554541026,1,1,0,0,-1.170500554541026,-1.2095172396923934
4308,18,229,17,50,43,0,4909.27,84,2121.511,MORE,410,2896,3306,8,2,-7.0,-0.6561859224721414,7.0,-0.34921514788478913,1.2149708208656296,0.021187817843644388,93,50,43,1,-1.3363168412821769,-1.170500554541026,-1.4436173506005987,0.6968054115842117,0.020995307257692594,0.020995307257692594,-1.4436173506005987,-1.170500554541026,1,1,0,0,-1.170500554541026,-1.4436173506005987
4309,18,230,21,80,82,0,5775.86,64,3452.095,MORE,-770,3048,2278,9,1,2.0,0.18748169213489754,2.0,-1.222253017596762,0.4671047090222054,0.4970734551744052,162,80,82,0,0.03989005496364707,0.0,0.07803337030273506,1.1787457538902946,-0.9810052008950775,0.9810052008950775,0.07803337030273506,0.0,1,1,0,1,0.07803337030273506,0.0
4310,18,231,10,50,60,1,4950.632000000001,14,2973.032,MORE,768,2458,3226,8,1,10.0,0.9374084606744876,10.0,0.17460757394239454,-1.402560570586355,0.04390165221892615,110,50,60,0,-0.9972513740911768,-1.170500554541026,-0.7803337030273506,0.6968054115842117,0.32499207159556687,0.32499207159556687,-0.7803337030273506,-1.170500554541026,0,1,1,0,-1.170500554541026,-0.7803337030273506
4311,18,232,3,53,50,0,5227.608,64,3330.406,MORE,-150,2700,2550,7,1,-3.0,-0.28122253820234633,3.0,-1.0476454436543674,0.4671047090222054,0.19600229991313486,103,53,50,1,-1.1368665664639415,-1.0534504990869233,-1.170500554541026,0.21486506927812885,-0.4545303576283677,0.4545303576283677,-1.170500554541026,-1.0534504990869233,1,1,0,0,-1.0534504990869233,-1.170500554541026
4312,18,233,45,122,110,0,4857.927,84,3418.042,MORE,748,2402,3150,7,2,-12.0,-1.124890152809385,12.0,0.5238227218271837,1.2149708208656296,-0.007007056638490918,232,122,110,1,1.4360419786912946,1.6387007763574364,1.170500554541026,0.21486506927812885,0.3080090121353504,0.3080090121353504,1.170500554541026,1.6387007763574364,1,1,0,2,1.6387007763574364,1.170500554541026
4313,18,234,38,67,80,1,2799.935,74,1547.925,MORE,1158,1026,2184,4,2,13.0,1.218630998876834,13.0,0.6984302957695783,0.8410377649439175,-1.1371479935770754,147,67,80,0,-0.25928535726370594,-0.5072169069677779,0.0,-1.23095595764012,0.6561617310697875,0.6561617310697875,0.0,-0.5072169069677779,1,0,1,1,-0.5072169069677779,0.0
4314,18,235,38,80,67,0,4223.308,54,1704.362,MORE,-1582,2840,1258,5,1,-13.0,-1.218630998876834,13.0,0.6984302957695783,0.09317165310049327,-0.35550642459474496,147,80,67,1,-0.25928535726370594,0.0,-0.5072169069677779,-0.749015615334037,-1.670517414979865,1.670517414979865,-0.5072169069677779,0.0,0,0,0,1,0.0,-0.5072169069677779
4315,18,236,36,70,80,1,3835.246,74,2797.432,MORE,1108,1420,2528,6,2,10.0,0.9374084606744876,10.0,0.17460757394239454,0.8410377649439175,-0.5686096593353372,150,70,80,0,-0.19945027481823535,-0.3901668515136753,0.0,-0.2670752730279541,0.6137040824192463,0.6137040824192463,0.0,-0.3901668515136753,1,0,1,1,-0.3901668515136753,0.0
4316,18,237,45,110,122,1,6018.67,74,3850.727,MORE,1094,2768,3862,8,2,12.0,1.124890152809385,12.0,0.5238227218271837,0.8410377649439175,0.6304119331170105,232,110,122,0,1.4360419786912946,1.170500554541026,1.6387007763574364,0.6968054115842117,0.6018159407970948,0.6018159407970948,1.6387007763574364,1.170500554541026,1,1,1,2,1.6387007763574364,1.170500554541026
4317,18,238,42,110,115,1,7156.798000000002,24,2192.768,MORE,-180,3986,3806,9,1,5.0,0.4687042303372438,5.0,-0.6984302957695783,-1.0286275146646429,1.2554119546312046,225,110,115,0,1.2964267863185297,1.170500554541026,1.3655839802978638,1.1787457538902946,-0.4800049468186924,0.4800049468186924,1.3655839802978638,1.170500554541026,0,1,0,2,1.3655839802978638,1.170500554541026
4318,18,239,41,110,112,0,9089.21,34,3370.28,MORE,44,4220,4264,11,2,2.0,0.18748169213489754,2.0,-1.222253017596762,-0.6546944587429309,2.3165909622421967,222,110,112,0,1.2365917038730592,1.170500554541026,1.248533924843761,2.1426264385024605,-0.28979468086426824,0.28979468086426824,1.248533924843761,1.170500554541026,0,1,0,2,1.248533924843761,1.170500554541026
4319,18,240,53,110,103,0,2933.12,44,2234.341,MORE,-596,1746,1150,5,1,-7.0,-0.6561859224721414,7.0,-0.34921514788478913,-0.2807614028212188,-1.064009798343,213,110,103,1,1.0570864565366473,1.170500554541026,0.8973837584814532,-0.749015615334037,-0.8332525835911944,0.8332525835911944,0.8973837584814532,1.170500554541026,0,0,0,2,1.170500554541026,0.8973837584814532
4320,19,1,49,110,131,0,5250.488,64,1519.233,LESS,-1466,3152,1686,4,1,21.0,1.9685577674164243,21.0,2.0952908873087353,0.06443724977485171,1.273621009088164,241,110,131,1,1.6155472260277064,1.170500554541026,1.9898509427197442,1.4301938838683883,-1.8905537052157737,1.8905537052157737,1.9898509427197442,1.170500554541026,0,1,0,2,1.9898509427197442,1.170500554541026
4321,19,2,13,47,50,0,1981.468,64,896.034,LESS,-166,982,816,2,1,3.0,0.28122253820234633,3.0,-1.0476454436543674,0.06443724977485171,-0.6361494608774507,97,47,50,1,-1.2565367313548828,-1.2875506099951286,-1.170500554541026,-0.4767312946227961,-0.05259392599014864,0.05259392599014864,-1.170500554541026,-1.2875506099951286,1,1,1,0,-1.2875506099951286,-1.170500554541026
4322,19,3,16,50,44,0,5031.873,24,1180.937,LESS,64,2402,2466,4,1,-6.0,-0.5624450764046927,6.0,-0.5238227218271837,-1.6830135915770574,1.1459055251536718,94,50,44,0,-1.3163718138003533,-1.170500554541026,-1.4046006654492311,1.4301938838683883,0.2725835734113081,0.2725835734113081,-1.4046006654492311,-1.170500554541026,0,1,1,0,-1.170500554541026,-1.4046006654492311
4323,19,4,7,57,50,1,6773.9,0,1160.903,LESS,-144,3474,3330,5,1,-7.0,-0.6561859224721414,7.0,-0.34921514788478913,-2.7314840963882028,2.163602487081953,107,57,50,0,-1.0570864565366473,-0.8973837584814532,-1.170500554541026,2.3836564731139807,-0.021489991264791907,0.021489991264791907,-1.170500554541026,-0.8973837584814532,0,1,1,0,-0.8973837584814532,-1.170500554541026
4324,19,5,18,42,50,0,3211.765,24,2881.635,LESS,-158,1622,1464,4,1,8.0,0.7499267685395902,8.0,-0.17460757394239454,-1.6830135915770574,0.08259342839434497,92,42,50,1,-1.3562618687640005,-1.4826340357519663,-1.170500554541026,1.4301938838683883,-0.041283404271837104,0.041283404271837104,-1.170500554541026,-1.4826340357519663,0,1,1,0,-1.4826340357519663,-1.170500554541026
4325,19,6,51,108,110,0,2708.039,64,1212.47,LESS,-368,1474,1106,4,1,2.0,0.18748169213489754,2.0,-1.222253017596762,0.06443724977485171,-0.2116846854605408,218,108,110,1,1.156811593945765,1.092467184238291,1.170500554541026,1.4301938838683883,-0.338184599377515,0.338184599377515,1.170500554541026,1.092467184238291,1,1,1,2,1.170500554541026,1.092467184238291
4326,19,7,31,78,80,0,3911.197,54,1084.257,LESS,-810,2160,1350,4,1,2.0,0.18748169213489754,2.0,-1.222253017596762,-0.3724254605631256,0.4912035254108791,158,78,80,1,-0.03989005496364707,-0.07803337030273506,0.0,1.4301938838683883,-0.9630909243142276,0.9630909243142276,0.0,-0.07803337030273506,0,1,0,1,-0.07803337030273506,0.0
4327,19,8,58,110,92,1,3129.698,54,1549.07,LESS,502,1152,1654,3,2,-18.0,-1.6873352292140782,18.0,1.571468165481551,-0.3724254605631256,0.03464966140648069,202,110,92,0,0.8376911542365885,1.170500554541026,0.4682002218164104,0.4767312946227961,0.8918346374888648,0.8918346374888648,0.4682002218164104,1.170500554541026,0,1,1,2,1.170500554541026,0.4682002218164104
4328,19,9,12,50,48,0,2607.471,34,1246.274,LESS,-386,1366,980,2,1,-2.0,-0.18748169213489754,2.0,-1.222253017596762,-1.2461508812390802,-0.2704367875044262,98,50,48,0,-1.2365917038730592,-1.170500554541026,-1.248533924843761,-0.4767312946227961,-0.36363327324371597,0.36363327324371597,-1.248533924843761,-1.170500554541026,0,0,0,0,-1.170500554541026,-1.248533924843761
4329,19,10,54,110,101,1,3674.246,24,1226.53,LESS,494,1506,2000,3,2,-9.0,-0.8436676146070391,9.0,0.0,-1.6830135915770574,0.35277609987392233,211,110,101,0,1.0171964015730004,1.170500554541026,0.8193503881787182,0.4767312946227961,0.8805241157705532,0.8805241157705532,0.8193503881787182,1.170500554541026,0,1,1,2,1.170500554541026,0.8193503881787182
4330,19,11,14,46,50,0,2795.76,84,1087.06,LESS,-222,1418,1196,4,2,4.0,0.3749633842697951,4.0,-0.8730378697119728,0.9381626704508064,-0.16043783613081694,96,46,50,1,-1.2764817588367063,-1.3265672951464962,-1.170500554541026,1.4301938838683883,-0.13176757801832942,0.13176757801832942,-1.170500554541026,-1.3265672951464962,1,1,1,0,-1.3265672951464962,-1.170500554541026
4331,19,12,22,80,83,0,3918.31,74,1156.431,LESS,-266,1778,1512,4,1,3.0,0.28122253820234633,3.0,-1.0476454436543674,0.501299960112829,0.4953589595632749,163,80,83,1,0.05983508244547061,0.0,0.1170500554541026,1.4301938838683883,-0.19397544746904288,0.19397544746904288,0.1170500554541026,0.0,1,1,1,1,0.1170500554541026,0.0
4332,19,13,6,50,56,0,2001.567,64,1832.254,LESS,-466,1052,586,2,1,6.0,0.5624450764046927,6.0,-0.5238227218271837,0.06443724977485171,-0.6244075698288065,106,50,56,1,-1.077031484018471,-1.170500554541026,-0.9364004436328208,-0.4767312946227961,-0.47673849042683136,0.47673849042683136,-0.9364004436328208,-1.170500554541026,1,0,0,0,-1.170500554541026,-0.9364004436328208
4333,19,14,13,50,47,0,3428.448,64,1178.775,LESS,-500,1690,1190,4,1,-3.0,-0.28122253820234633,3.0,-1.0476454436543674,0.06443724977485171,0.209180232618106,97,50,47,0,-1.2565367313548828,-1.170500554541026,-1.2875506099951286,1.4301938838683883,-0.5248082077296554,0.5248082077296554,-1.2875506099951286,-1.170500554541026,1,1,0,0,-1.170500554541026,-1.2875506099951286
4334,19,15,46,110,124,0,1862.359,64,1447.546,LESS,-402,978,576,2,1,14.0,1.3123718449442827,14.0,0.8730378697119728,0.06443724977485171,-0.7057332660873101,234,110,124,1,1.4759320336549415,1.170500554541026,1.7167341466601715,-0.4767312946227961,-0.38625431668033905,0.38625431668033905,1.7167341466601715,1.170500554541026,1,1,0,2,1.7167341466601715,1.170500554541026
4335,19,16,27,91,80,0,3863.608,14,1216.286,LESS,-2088,3146,1058,4,1,-11.0,-1.0311493067419364,11.0,0.34921514788478913,-2.119876301915035,0.4634019007970213,171,91,80,0,0.21939530230005888,0.4291835366650429,0.0,1.4301938838683883,-2.769946768814496,2.769946768814496,0.0,0.4291835366650429,0,1,0,1,0.4291835366650429,0.0
4336,19,17,40,64,80,0,5607.161,64,1645.826,LESS,-1130,3054,1924,4,1,16.0,1.4998535370791803,16.0,1.222253017596762,0.06443724977485171,1.48199035612001,144,64,80,1,-0.3191204397091766,-0.6242669624218805,0.0,1.4301938838683883,-1.4155117930466892,1.4155117930466892,0.0,-0.6242669624218805,0,1,0,1,-0.6242669624218805,0.0
4337,19,18,22,83,80,0,7464.361999999999,54,2224.139,LESS,-1132,3882,2750,4,1,-3.0,-0.28122253820234633,3.0,-1.0476454436543674,-0.3724254605631256,2.566972285441522,163,83,80,0,0.05983508244547061,0.1170500554541026,0.0,1.4301938838683883,-1.418339423476267,1.418339423476267,0.0,0.1170500554541026,0,1,0,1,0.1170500554541026,0.0
4338,19,19,54,101,110,0,5934.56,64,883.438,LESS,-1436,3378,1942,4,1,9.0,0.8436676146070391,9.0,0.0,0.06443724977485171,1.673257751882738,211,101,110,1,1.0171964015730004,0.8193503881787182,1.170500554541026,1.4301938838683883,-1.8481392487721056,1.8481392487721056,1.170500554541026,0.8193503881787182,0,1,0,2,1.170500554541026,0.8193503881787182
4339,19,20,6,56,50,0,4244.22,64,1151.596,LESS,150,1668,1818,2,1,-6.0,-0.5624450764046927,6.0,-0.5238227218271837,0.06443724977485171,0.6857564774330016,106,56,50,0,-1.077031484018471,-0.9364004436328208,-1.170500554541026,-0.4767312946227961,0.39417168188315715,0.39417168188315715,-1.170500554541026,-0.9364004436328208,0,0,1,0,-0.9364004436328208,-1.170500554541026
4340,19,21,18,50,42,1,3393.821,84,1134.981,LESS,816,1300,2116,3,2,-8.0,-0.7499267685395902,8.0,-0.17460757394239454,0.9381626704508064,0.18895104403452465,92,50,42,0,-1.3562618687640005,-1.170500554541026,-1.4826340357519663,0.4767312946227961,1.3357726149325926,1.3357726149325926,-1.4826340357519663,-1.170500554541026,1,1,1,0,-1.170500554541026,-1.4826340357519663
4341,19,22,43,110,117,0,4506.252,64,1083.818,LESS,-820,2520,1700,4,1,7.0,0.6561859224721414,7.0,-0.34921514788478913,0.06443724977485171,0.8388362921132515,227,110,117,1,1.3363168412821769,1.170500554541026,1.4436173506005987,1.4301938838683883,-0.977229076462117,0.977229076462117,1.4436173506005987,1.170500554541026,0,1,0,2,1.4436173506005987,1.170500554541026
4342,19,23,32,77,80,0,6678.861,64,1202.231,LESS,-2414,4266,1852,4,1,3.0,0.28122253820234633,3.0,-1.0476454436543674,0.06443724977485171,2.1080804420363237,157,77,80,1,-0.05983508244547061,-0.1170500554541026,0.0,1.4301938838683883,-3.230850528835691,3.230850528835691,0.0,-0.1170500554541026,0,1,0,1,-0.1170500554541026,0.0
4343,19,24,27,80,91,0,4279.275,64,1148.238,LESS,160,1756,1916,4,1,11.0,1.0311493067419364,11.0,0.34921514788478913,0.06443724977485171,0.7062357047930801,171,80,91,1,0.21939530230005888,0.0,0.4291835366650429,1.4301938838683883,0.4083098340310466,0.4083098340310466,0.4291835366650429,0.0,0,1,1,1,0.4291835366650429,0.0
4344,19,25,16,44,50,0,2231.603,84,1589.55,LESS,54,1124,1178,2,2,6.0,0.5624450764046927,6.0,-0.5238227218271837,0.9381626704508064,-0.4900199062999783,94,44,50,1,-1.3163718138003533,-1.4046006654492311,-1.170500554541026,-0.4767312946227961,0.2584454212634187,0.2584454212634187,-1.170500554541026,-1.4046006654492311,1,0,1,0,-1.4046006654492311,-1.170500554541026
4345,19,26,7,50,57,0,3026.398,70,1458.6629999999998,LESS,-482,1516,1034,4,1,7.0,0.6561859224721414,7.0,-0.34921514788478913,0.3265548759776381,-0.025698482547195797,107,50,57,1,-1.0570864565366473,-1.170500554541026,-0.8973837584814532,1.4301938838683883,-0.49935953386345444,0.49935953386345444,-0.8973837584814532,-1.170500554541026,1,1,0,0,-1.170500554541026,-0.8973837584814532
4346,19,27,14,50,46,1,4290.022,34,1241.829,LESS,156,1936,2092,3,2,-4.0,-0.3749633842697951,4.0,-0.8730378697119728,-1.2461508812390802,0.7125141317347081,96,50,46,0,-1.2764817588367063,-1.170500554541026,-1.3265672951464962,0.4767312946227961,0.4026545731718908,0.4026545731718908,-1.3265672951464962,-1.170500554541026,0,1,1,0,-1.170500554541026,-1.3265672951464962
4347,19,28,51,110,108,1,6269.315,74,764.99,LESS,-514,3126,2612,3,2,-2.0,-0.18748169213489754,2.0,-1.222253017596762,0.501299960112829,1.868822543065826,218,110,108,0,1.156811593945765,1.170500554541026,1.092467184238291,0.4767312946227961,-0.5446016207367006,0.5446016207367006,1.092467184238291,1.170500554541026,1,1,0,2,1.170500554541026,1.092467184238291
4348,19,29,50,133,110,1,3411.278,84,1019.982,LESS,778,1294,2072,3,2,-23.0,-2.1560394595513217,23.0,2.444506035193524,0.9381626704508064,0.19914947142077166,243,133,110,0,1.6554372809913533,2.0678843130224793,1.170500554541026,0.4767312946227961,1.2820476367706128,1.2820476367706128,1.170500554541026,2.0678843130224793,1,1,1,2,2.0678843130224793,1.170500554541026
4349,19,30,49,131,110,1,4039.778,84,1274.942,LESS,1054,1344,2398,3,2,-21.0,-1.9685577674164243,21.0,2.0952908873087353,0.9381626704508064,0.5663208990576136,241,131,110,0,1.6155472260277064,1.9898509427197442,1.170500554541026,0.4767312946227961,1.6722606360523609,1.6722606360523609,1.170500554541026,1.9898509427197442,1,1,1,2,1.9898509427197442,1.170500554541026
4350,19,31,47,126,110,1,4837.984,74,2098.181,LESS,-480,2232,1752,3,2,-16.0,-1.4998535370791803,16.0,1.222253017596762,0.501299960112829,1.0326350383866405,236,126,110,0,1.5158220886185887,1.7947675169629065,1.170500554541026,0.4767312946227961,-0.49653190343387654,0.49653190343387654,1.170500554541026,1.7947675169629065,1,1,0,2,1.7947675169629065,1.170500554541026
4351,19,32,50,110,133,0,2340.152,64,707.9889999999998,LESS,-348,1206,858,2,1,23.0,2.1560394595513217,23.0,2.444506035193524,0.06443724977485171,-0.4266052821177164,243,110,133,1,1.6554372809913533,1.170500554541026,2.0678843130224793,-0.4767312946227961,-0.3099082950817362,0.3099082950817362,2.0678843130224793,1.170500554541026,0,0,1,2,2.0678843130224793,1.170500554541026
4352,19,33,47,110,126,0,2047.578,100,1531.739,LESS,252,1240,1492,2,2,16.0,1.4998535370791803,16.0,1.222253017596762,1.63714300699157,-0.5975278171525954,236,110,126,1,1.5158220886185887,1.170500554541026,1.7947675169629065,-0.4767312946227961,0.5383808337916293,0.5383808337916293,1.7947675169629065,1.170500554541026,1,0,1,2,1.7947675169629065,1.170500554541026
4353,19,34,12,48,50,0,2577.729,94,2746.796,LESS,240,1744,1984,2,2,2.0,0.18748169213489754,2.0,-1.222253017596762,1.3750253807887836,-0.287812145659995,98,48,50,1,-1.2365917038730592,-1.248533924843761,-1.170500554541026,-0.4767312946227961,0.521415051214162,0.521415051214162,-1.170500554541026,-1.248533924843761,1,0,1,0,-1.248533924843761,-1.170500554541026
4354,19,35,32,80,77,1,3224.245,84,918.9,LESS,934,1232,2166,3,2,-3.0,-0.28122253820234633,3.0,-1.0476454436543674,0.9381626704508064,0.08988427869968753,157,80,77,0,-0.05983508244547061,0.0,-0.1170500554541026,0.4767312946227961,1.5026028102776878,1.5026028102776878,-0.1170500554541026,0.0,1,1,1,1,0.0,-0.1170500554541026
4355,19,36,43,117,110,0,2181.192,64,1469.942,LESS,-684,1392,708,2,1,-7.0,-0.6561859224721414,7.0,-0.34921514788478913,0.06443724977485171,-0.5194701510710218,227,117,110,0,1.3363168412821769,1.4436173506005987,1.170500554541026,-0.4767312946227961,-0.7849502072508209,0.7849502072508209,1.170500554541026,1.4436173506005987,1,0,0,2,1.4436173506005987,1.170500554541026
4356,19,37,40,80,64,1,3352.925,84,985.95,LESS,1120,1044,2164,3,2,-16.0,-1.4998535370791803,16.0,1.222253017596762,0.9381626704508064,0.16505948841855614,144,80,64,0,-0.3191204397091766,0.0,-0.6242669624218805,0.4767312946227961,1.7655724402284312,1.7655724402284312,-0.6242669624218805,0.0,1,1,1,1,0.0,-0.6242669624218805
4357,19,38,31,80,78,0,3536.414,74,777.704,LESS,-560,1834,1274,4,1,-2.0,-0.18748169213489754,2.0,-1.222253017596762,0.501299960112829,0.2722542665978027,158,80,78,0,-0.03989005496364707,0.0,-0.07803337030273506,1.4301938838683883,-0.6096371206169919,0.6096371206169919,-0.07803337030273506,0.0,1,1,0,1,0.0,-0.07803337030273506
4358,19,39,46,124,110,0,6068.604,24,1253.598,LESS,58,2700,2758,4,1,-14.0,-1.3123718449442827,14.0,0.8730378697119728,-1.6830135915770574,1.751566625146307,234,124,110,0,1.4759320336549415,1.7167341466601715,1.170500554541026,1.4301938838683883,0.2641006821225744,0.2641006821225744,1.170500554541026,1.7167341466601715,0,1,1,2,1.7167341466601715,1.170500554541026
4359,19,40,58,92,110,0,3674.74,94,841.658,LESS,-604,2172,1568,4,2,18.0,1.6873352292140782,18.0,1.571468165481551,1.3750253807887836,0.35306469603184193,202,92,110,1,0.8376911542365885,0.4682002218164104,1.170500554541026,1.4301938838683883,-0.6718449900677054,0.6718449900677054,1.170500554541026,0.4682002218164104,1,1,0,2,1.170500554541026,0.4682002218164104
4360,19,41,49,110,131,1,6475.39,94,1025.321,MORE,-986,3880,2894,3,2,21.0,1.9685577674164243,21.0,2.0952908873087353,1.3750253807887836,1.9892121245300465,241,110,131,0,1.6155472260277064,1.170500554541026,1.9898509427197442,0.4767312946227961,-1.2119224021170814,1.2119224021170814,1.9898509427197442,1.170500554541026,1,1,0,2,1.9898509427197442,1.170500554541026
4361,19,42,13,47,50,1,5457.523,44,1375.59,MORE,-932,2790,1858,3,2,3.0,0.28122253820234633,3.0,-1.0476454436543674,-0.8092881709011028,1.3945714251912564,97,47,50,0,-1.2565367313548828,-1.2875506099951286,-1.170500554541026,0.4767312946227961,-1.1355763805184786,1.1355763805184786,-1.170500554541026,-1.2875506099951286,0,1,0,0,-1.2875506099951286,-1.170500554541026
4362,19,43,16,50,44,1,3612.663,54,1586.714,MORE,542,1326,1868,3,2,-6.0,-0.5624450764046927,6.0,-0.5238227218271837,-0.3724254605631256,0.31679914199299997,94,50,44,1,-1.3163718138003533,-1.170500554541026,-1.4046006654492311,0.4767312946227961,0.9483872460804225,0.9483872460804225,-1.4046006654492311,-1.170500554541026,0,1,1,0,-1.170500554541026,-1.4046006654492311
4363,19,44,7,57,50,0,2453.851,60,1626.8629999999996,MORE,-258,1128,870,2,1,-7.0,-0.6561859224721414,7.0,-0.34921514788478913,-0.1103078343603392,-0.3601820137790032,107,57,50,1,-1.0570864565366473,-0.8973837584814532,-1.170500554541026,-0.4767312946227961,-0.18266492575073134,0.18266492575073134,-1.170500554541026,-0.8973837584814532,0,0,0,0,-0.8973837584814532,-1.170500554541026
4364,19,45,18,42,50,1,2498.278,74,2615.904,MORE,1782,968,2750,3,2,8.0,0.7499267685395902,8.0,-0.17460757394239454,0.501299960112829,-0.3342276382569317,92,42,50,0,-1.3562618687640005,-1.4826340357519663,-1.170500554541026,0.4767312946227961,2.701518112418711,2.701518112418711,-1.170500554541026,-1.4826340357519663,1,1,1,0,-1.4826340357519663,-1.170500554541026
4365,19,46,51,108,110,0,3784.341,74,1565.4620000000002,MORE,76,1592,1668,3,2,2.0,0.18748169213489754,2.0,-1.222253017596762,0.501299960112829,0.4170939015058683,218,108,110,0,1.156811593945765,1.092467184238291,1.170500554541026,0.4767312946227961,0.2895493559887754,0.2895493559887754,1.170500554541026,1.092467184238291,1,1,0,2,1.170500554541026,1.092467184238291
4366,19,47,31,78,80,1,3312.0370000000007,84,1384.756,MORE,1184,1028,2212,3,2,2.0,0.18748169213489754,2.0,-1.222253017596762,0.9381626704508064,0.1411726064245784,158,78,80,0,-0.03989005496364707,-0.07803337030273506,0.0,0.4767312946227961,1.8560566139749235,1.8560566139749235,0.0,-0.07803337030273506,1,1,1,1,-0.07803337030273506,0.0
4367,19,48,58,110,92,0,2071.87,74,1569.747,MORE,-358,1188,830,2,2,-18.0,-1.6873352292140782,18.0,1.571468165481551,0.501299960112829,-0.5833363639781258,202,110,92,1,0.8376911542365885,1.170500554541026,0.4682002218164104,-0.4767312946227961,-0.32404644722962556,0.32404644722962556,0.4682002218164104,1.170500554541026,1,0,0,2,1.170500554541026,0.4682002218164104
4368,19,49,12,50,48,1,2598.527,84,1289.139,MORE,1190,942,2132,3,2,-2.0,-0.18748169213489754,2.0,-1.222253017596762,0.9381626704508064,-0.27566189688992165,98,50,48,1,-1.2365917038730592,-1.170500554541026,-1.248533924843761,0.4767312946227961,1.864539505263657,1.864539505263657,-1.248533924843761,-1.170500554541026,1,1,1,0,-1.170500554541026,-1.248533924843761
4369,19,50,54,110,101,1,8246.877,34,1344.4520000000002,MORE,-1522,4468,2946,7,2,-9.0,-0.8436676146070391,9.0,0.0,-1.2461508812390802,3.024119699438728,211,110,101,1,1.0171964015730004,1.170500554541026,0.8193503881787182,4.290581651605165,-1.9697273572439546,1.9697273572439546,0.8193503881787182,1.170500554541026,0,1,0,2,1.170500554541026,0.8193503881787182
4370,19,51,14,46,50,1,4932.687,84,1121.508,MORE,932,1756,2688,3,2,4.0,0.3749633842697951,4.0,-0.8730378697119728,0.9381626704508064,1.0879607913086635,96,46,50,0,-1.2764817588367063,-1.3265672951464962,-1.170500554541026,0.4767312946227961,1.49977517984811,1.49977517984811,-1.170500554541026,-1.3265672951464962,1,1,1,0,-1.3265672951464962,-1.170500554541026
4371,19,52,22,80,83,0,5044.238,74,1286.59,MORE,-658,2772,2114,4,2,3.0,0.28122253820234633,3.0,-1.0476454436543674,0.501299960112829,1.1531291921429,163,80,83,0,0.05983508244547061,0.0,0.1170500554541026,1.4301938838683883,-0.7481910116663084,0.7481910116663084,0.1170500554541026,0.0,1,1,0,1,0.1170500554541026,0.0
4372,19,53,6,50,56,1,3705.313,84,1008.355,MORE,1548,1112,2660,3,2,6.0,0.5624450764046927,6.0,-0.5238227218271837,0.9381626704508064,0.3709255266716849,106,50,56,0,-1.077031484018471,-1.170500554541026,-0.9364004436328208,0.4767312946227961,2.3706853521580986,2.3706853521580986,-0.9364004436328208,-1.170500554541026,1,1,1,0,-1.170500554541026,-0.9364004436328208
4373,19,54,13,50,47,1,5147.894,24,1279.433,MORE,394,2178,2572,3,2,-3.0,-0.28122253820234633,3.0,-1.0476454436543674,-1.6830135915770574,1.2136853122751583,97,50,47,1,-1.2565367313548828,-1.170500554541026,-1.2875506099951286,0.4767312946227961,0.739142594291659,0.739142594291659,-1.2875506099951286,-1.170500554541026,0,1,1,0,-1.170500554541026,-1.2875506099951286
4374,19,55,46,110,124,1,2795.16,84,1771.841,MORE,1654,1104,2758,3,2,14.0,1.3123718449442827,14.0,0.8730378697119728,0.9381626704508064,-0.1607883577801125,234,110,124,0,1.4759320336549415,1.170500554541026,1.7167341466601715,0.4767312946227961,2.5205497649257262,2.5205497649257262,1.7167341466601715,1.170500554541026,1,1,1,2,1.7167341466601715,1.170500554541026
4375,19,56,27,91,80,0,3196.865,24,1929.997,MORE,-358,1620,1262,2,1,-11.0,-1.0311493067419364,11.0,0.34921514788478913,-1.6830135915770574,0.07388880743684463,171,91,80,1,0.21939530230005888,0.4291835366650429,0.0,-0.4767312946227961,-0.32404644722962556,0.32404644722962556,0.0,0.4291835366650429,0,0,0,1,0.4291835366650429,0.0
4376,19,57,40,64,80,1,1691.781,84,1094.282,MORE,492,516,1008,1,2,16.0,1.4998535370791803,16.0,1.222253017596762,0.9381626704508064,-0.8053854025764704,144,64,80,0,-0.3191204397091766,-0.6242669624218805,0.0,-1.4301938838683883,0.8776964853409753,0.8776964853409753,0.0,-0.6242669624218805,1,0,1,1,-0.6242669624218805,0.0
4377,19,58,22,83,80,1,3112.119,84,723.818,MORE,-42,1498,1456,1,2,-3.0,-0.28122253820234633,3.0,-1.0476454436543674,0.9381626704508064,0.02437996128487696,163,83,80,1,0.05983508244547061,0.1170500554541026,0.0,-1.4301938838683883,0.12271916064368021,0.12271916064368021,0.0,0.1170500554541026,1,0,0,1,0.1170500554541026,0.0
4378,19,59,54,101,110,1,4105.096,40,1706.4160000000004,MORE,402,1668,2070,3,1,9.0,0.8436676146070391,9.0,0.0,-0.9840332550362938,0.6044798542053991,211,101,110,0,1.0171964015730004,0.8193503881787182,1.170500554541026,0.4767312946227961,0.7504531160099706,0.7504531160099706,1.170500554541026,0.8193503881787182,0,1,1,2,1.170500554541026,0.8193503881787182
4379,19,60,6,56,50,0,2207.039,24,2056.543,MORE,-472,1208,736,2,1,-6.0,-0.5624450764046927,6.0,-0.5238227218271837,-1.6830135915770574,-0.5043702626221284,106,56,50,1,-1.077031484018471,-0.9364004436328208,-1.170500554541026,-0.4767312946227961,-0.485221381715565,0.485221381715565,-1.170500554541026,-0.9364004436328208,0,0,0,0,-0.9364004436328208,-1.170500554541026
4380,19,61,18,50,42,0,2066.628,64,1465.92,MORE,-394,1142,748,2,1,-8.0,-0.7499267685395902,8.0,-0.17460757394239454,0.06443724977485171,-0.5863987547874691,92,50,42,1,-1.3562618687640005,-1.170500554541026,-1.4826340357519663,-0.4767312946227961,-0.3749437949620275,0.3749437949620275,-1.4826340357519663,-1.170500554541026,0,0,0,0,-1.170500554541026,-1.4826340357519663
4381,19,62,43,110,117,1,3205.343,74,1318.247,MORE,814,1238,2052,3,2,7.0,0.6561859224721414,7.0,-0.34921514788478913,0.501299960112829,0.07884167834138743,227,110,117,0,1.3363168412821769,1.170500554541026,1.4436173506005987,0.4767312946227961,1.3329449845030148,1.3329449845030148,1.4436173506005987,1.170500554541026,1,1,1,2,1.4436173506005987,1.170500554541026
4382,19,63,32,77,80,1,1857.539,84,874.959,MORE,538,734,1272,1,2,3.0,0.28122253820234633,3.0,-1.0476454436543674,0.9381626704508064,-0.7085491233366491,157,77,80,0,-0.05983508244547061,-0.1170500554541026,0.0,-1.4301938838683883,0.9427319852212667,0.9427319852212667,0.0,-0.1170500554541026,1,0,1,1,-0.1170500554541026,0.0
4383,19,64,27,80,91,1,4413.562,24,1039.724,MORE,-588,2280,1692,3,2,11.0,1.0311493067419364,11.0,0.34921514788478913,-1.6830135915770574,0.7846865393246134,171,80,91,0,0.21939530230005888,0.0,0.4291835366650429,0.4767312946227961,-0.6492239466310823,0.6492239466310823,0.4291835366650429,0.0,0,1,0,1,0.4291835366650429,0.0
4384,19,65,16,44,50,1,1605.789,74,1248.102,MORE,348,478,826,1,2,6.0,0.5624450764046927,6.0,-0.5238227218271837,0.501299960112829,-0.8556221653534748,94,44,50,0,-1.3163718138003533,-1.4046006654492311,-1.170500554541026,-1.4301938838683883,0.6741070944113677,0.6741070944113677,-1.170500554541026,-1.4046006654492311,1,0,1,0,-1.4046006654492311,-1.170500554541026
4385,19,66,7,50,57,1,1532.701,74,1114.248,MORE,1266,428,1694,1,2,7.0,0.6561859224721414,7.0,-0.34921514788478913,0.501299960112829,-0.8983203758596348,107,50,57,0,-1.0570864565366473,-1.170500554541026,-0.8973837584814532,-1.4301938838683883,1.9719894615876168,1.9719894615876168,-0.8973837584814532,-1.170500554541026,1,0,1,0,-1.170500554541026,-0.8973837584814532
4386,19,67,14,50,46,0,2053.726,94,1065.148,MORE,102,1176,1278,2,2,-4.0,-0.3749633842697951,4.0,-0.8730378697119728,1.3750253807887836,-0.5939361386528159,96,50,46,1,-1.2764817588367063,-1.170500554541026,-1.3265672951464962,-0.4767312946227961,0.3263085515732879,0.3263085515732879,-1.3265672951464962,-1.170500554541026,1,1,1,0,-1.170500554541026,-1.3265672951464962
4387,19,68,51,110,108,0,7380.932,74,949.727,MORE,-832,3708,2876,6,2,-2.0,-0.18748169213489754,2.0,-1.222253017596762,0.501299960112829,2.5182322501070087,218,110,108,1,1.156811593945765,1.170500554541026,1.092467184238291,3.337119062359573,-0.9941948590395844,0.9941948590395844,1.092467184238291,1.170500554541026,1,1,0,2,1.170500554541026,1.092467184238291
4388,19,69,50,133,110,0,2119.062,94,872.175,MORE,132,1104,1236,2,2,-23.0,-2.1560394595513217,23.0,2.444506035193524,1.3750253807887836,-0.5557666678555516,243,133,110,1,1.6554372809913533,2.0678843130224793,1.170500554541026,-0.4767312946227961,0.3687230080169562,0.3687230080169562,1.170500554541026,2.0678843130224793,1,1,1,2,2.0678843130224793,1.170500554541026
4389,19,70,49,131,110,0,3491.948,94,1220.279,MORE,202,1838,2040,4,2,-21.0,-1.9685577674164243,21.0,2.0952908873087353,1.3750253807887836,0.2462771071685268,241,131,110,1,1.6155472260277064,1.9898509427197442,1.170500554541026,1.4301938838683883,0.46769007305218213,0.46769007305218213,1.170500554541026,1.9898509427197442,1,1,1,2,1.9898509427197442,1.170500554541026
4390,19,71,47,126,110,0,2192.829,94,1138.5839999999996,MORE,0,1280,1280,2,2,-16.0,-1.4998535370791803,16.0,1.222253017596762,1.3750253807887836,-0.5126717836829391,236,126,110,1,1.5158220886185887,1.7947675169629065,1.170500554541026,-0.4767312946227961,0.18209939966481578,0.18209939966481578,1.170500554541026,1.7947675169629065,1,1,0,2,1.7947675169629065,1.170500554541026
4391,19,72,50,110,133,1,2675.105,100,1365.138,MORE,788,1260,2048,3,2,23.0,2.1560394595513217,23.0,2.444506035193524,1.63714300699157,-0.2309248187903607,243,110,133,0,1.6554372809913533,1.170500554541026,2.0678843130224793,0.4767312946227961,1.2961857889185022,1.2961857889185022,2.0678843130224793,1.170500554541026,1,1,1,2,2.0678843130224793,1.170500554541026
4392,19,73,47,110,126,0,4438.233,34,884.7560000000002,MORE,-612,2270,1658,4,1,16.0,1.4998535370791803,16.0,1.222253017596762,-1.2461508812390802,0.7990994053408879,236,110,126,0,1.5158220886185887,1.170500554541026,1.7947675169629065,1.4301938838683883,-0.683155511786017,0.683155511786017,1.7947675169629065,1.170500554541026,0,1,0,2,1.7947675169629065,1.170500554541026
4393,19,74,12,48,50,0,2502.728,74,971.176,MORE,-872,1572,700,2,2,2.0,0.18748169213489754,2.0,-1.222253017596762,0.501299960112829,-0.331627936024658,98,48,50,0,-1.2365917038730592,-1.248533924843761,-1.170500554541026,-0.4767312946227961,-1.0507474676311421,1.0507474676311421,-1.170500554541026,-1.248533924843761,1,1,0,0,-1.248533924843761,-1.170500554541026
4394,19,75,32,80,77,0,2094.72,74,808.7689999999999,MORE,-468,1206,738,2,1,-3.0,-0.28122253820234633,3.0,-1.0476454436543674,0.501299960112829,-0.5699873311674626,157,80,77,1,-0.05983508244547061,0.0,-0.1170500554541026,-0.4767312946227961,-0.47956612085640926,0.47956612085640926,-0.1170500554541026,0.0,1,1,0,1,0.0,-0.1170500554541026
4395,19,76,43,117,110,0,1977.153,84,1136.497,MORE,-240,1142,902,2,2,-7.0,-0.6561859224721414,7.0,-0.34921514788478913,0.9381626704508064,-0.6386702957386329,227,117,110,1,1.3363168412821769,1.4436173506005987,1.170500554541026,-0.4767312946227961,-0.15721625188453037,0.15721625188453037,1.170500554541026,1.4436173506005987,1,1,0,2,1.4436173506005987,1.170500554541026
4396,19,77,40,80,64,0,3124.778,74,2043.655,MORE,-66,1928,1862,1,2,-16.0,-1.4998535370791803,16.0,1.222253017596762,0.501299960112829,0.03177538388225906,144,80,64,1,-0.3191204397091766,0.0,-0.6242669624218805,-1.4301938838683883,0.0887875954887456,0.0887875954887456,-0.6242669624218805,0.0,1,0,0,1,0.0,-0.6242669624218805
4397,19,78,31,80,78,1,3230.196,84,1412.955,MORE,-224,1682,1458,3,2,-2.0,-0.18748169213489754,2.0,-1.222253017596762,0.9381626704508064,0.09336086925794823,158,80,78,1,-0.03989005496364707,0.0,-0.07803337030273506,0.4767312946227961,-0.1345952084479073,0.1345952084479073,-0.07803337030273506,0.0,1,1,0,1,0.0,-0.07803337030273506
4398,19,79,46,124,110,0,5512.344,74,1101.26,MORE,-672,2790,2118,4,1,-14.0,-1.3123718449442827,14.0,0.8730378697119728,0.501299960112829,1.4265980040846205,234,124,110,1,1.4759320336549415,1.7167341466601715,1.170500554541026,1.4301938838683883,-0.7679844246733536,0.7679844246733536,1.170500554541026,1.7167341466601715,1,1,0,2,1.7167341466601715,1.170500554541026
4399,19,80,58,92,110,1,5433.436,74,948.669,MORE,172,2708,2880,3,1,18.0,1.6873352292140782,18.0,1.571468165481551,0.501299960112829,1.3804997335802958,202,92,110,0,0.8376911542365885,0.4682002218164104,1.170500554541026,0.4767312946227961,0.4252756166085139,0.4252756166085139,1.170500554541026,0.4682002218164104,1,1,1,2,1.170500554541026,0.4682002218164104
4400,19,81,48,128,110,1,6718.911,64,1136.472,LESS,-660,3314,2654,5,2,-18.0,-1.6873352292140782,18.0,1.571468165481551,0.06443724977485171,2.1314777621267864,238,128,110,0,1.5557121435822359,1.8728008872656416,1.170500554541026,2.3836564731139807,-0.7510186420958862,0.7510186420958862,1.170500554541026,1.8728008872656416,1,1,0,2,1.8728008872656416,1.170500554541026
4401,19,82,8,50,58,0,1726.19,84,1512.908,LESS,714,862,1576,2,2,8.0,0.7499267685395902,8.0,-0.17460757394239454,0.9381626704508064,-0.7852835701921329,108,50,58,1,-1.0371414290548238,-1.170500554541026,-0.8583670733300858,-0.4767312946227961,1.1915634630241205,1.1915634630241205,-0.8583670733300858,-1.170500554541026,1,1,1,0,-1.170500554541026,-0.8583670733300858
4402,19,83,4,54,50,0,2436.73,74,1315.924,LESS,-276,1196,920,2,1,-4.0,-0.3749633842697951,4.0,-0.8730378697119728,0.501299960112829,-0.370184149041645,104,54,50,0,-1.116921538982118,-1.0144338139355558,-1.170500554541026,-0.4767312946227961,-0.2081135996169323,0.2081135996169323,-1.170500554541026,-1.0144338139355558,1,1,1,0,-1.0144338139355558,-1.170500554541026
4403,19,84,37,80,69,0,1861.533,84,1048.37,LESS,-480,1048,568,2,1,-11.0,-1.0311493067419364,11.0,0.34921514788478913,0.9381626704508064,-0.7062158175578399,149,80,69,0,-0.21939530230005888,0.0,-0.4291835366650429,-0.4767312946227961,-0.49653190343387654,0.49653190343387654,-0.4291835366650429,0.0,1,1,0,1,0.0,-0.4291835366650429
4404,19,85,52,105,110,0,2405.278,20,1156.009,LESS,-966,1872,906,2,1,5.0,0.4687042303372438,5.0,-0.6984302957695783,-1.8577586757122484,-0.3885584938977055,215,105,110,1,1.0969765115002945,0.9754171287841883,1.170500554541026,-0.4767312946227961,-1.1836460978213026,1.1836460978213026,1.170500554541026,0.9754171287841883,0,1,0,2,1.170500554541026,0.9754171287841883
4405,19,86,5,55,50,0,1832.501,64,1705.352,LESS,-132,1090,958,2,1,-5.0,-0.4687042303372438,5.0,-0.6984302957695783,0.06443724977485171,-0.7231763917617426,105,55,50,0,-1.0969765115002945,-0.9754171287841883,-1.170500554541026,-0.4767312946227961,-0.004524208687324599,0.004524208687324599,-1.170500554541026,-0.9754171287841883,1,1,1,0,-0.9754171287841883,-1.170500554541026
4406,19,87,30,96,80,0,2390.579,44,1971.697,LESS,-708,1626,918,2,1,-16.0,-1.4998535370791803,16.0,1.222253017596762,-0.8092881709011028,-0.3971456901026917,176,96,80,0,0.3191204397091766,0.6242669624218805,0.0,-0.4767312946227961,-0.8188817724057554,0.8188817724057554,0.0,0.6242669624218805,0,1,0,1,0.6242669624218805,0.0
4407,19,88,33,80,75,0,1867.803,74,865.55,LESS,-414,984,570,2,1,-5.0,-0.4687042303372438,5.0,-0.6984302957695783,0.501299960112829,-0.7025528663227039,155,80,75,0,-0.09972513740911768,0.0,-0.19508342575683765,-0.4767312946227961,-0.40322009925780633,0.40322009925780633,-0.19508342575683765,0.0,1,1,0,1,0.0,-0.19508342575683765
4408,19,89,48,110,128,0,1857.648,74,2125.1620000000007,LESS,324,976,1300,2,2,18.0,1.6873352292140782,18.0,1.571468165481551,0.501299960112829,-0.7084854452370272,238,110,128,1,1.5557121435822359,1.170500554541026,1.8728008872656416,-0.4767312946227961,0.6401755292564332,0.6401755292564332,1.8728008872656416,1.170500554541026,1,0,1,2,1.8728008872656416,1.170500554541026
4409,19,90,9,59,50,1,5911.941999999999,64,4703.927,LESS,2084,1226,3310,3,2,-9.0,-0.8436676146070391,9.0,0.0,0.06443724977485171,1.6600442541098015,109,59,50,0,-1.0171964015730004,-0.8193503881787182,-1.170500554541026,0.4767312946227961,3.128490307284972,3.128490307284972,-1.170500554541026,-0.8193503881787182,0,1,1,0,-0.8193503881787182,-1.170500554541026
4410,19,91,44,110,119,0,6027.022,74,1523.828,LESS,-656,1362,706,2,1,9.0,0.8436676146070391,9.0,0.0,0.501299960112829,1.7272743064446434,229,110,119,1,1.376206896245824,1.170500554541026,1.5216507209033339,-0.4767312946227961,-0.7453633812367305,0.7453633812367305,1.5216507209033339,1.170500554541026,1,0,0,2,1.5216507209033339,1.170500554541026
4411,19,92,2,52,50,0,3998.225,64,1207.675,LESS,-706,1702,996,2,1,-2.0,-0.18748169213489754,2.0,-1.222253017596762,0.06443724977485171,0.5420455222356667,102,52,50,0,-1.156811593945765,-1.092467184238291,-1.170500554541026,-0.4767312946227961,-0.8160541419761776,0.8160541419761776,-1.170500554541026,-1.092467184238291,0,0,0,0,-1.092467184238291,-1.170500554541026
4412,19,93,8,58,50,0,3395.021,34,1729.04,LESS,-654,1398,744,1,1,-8.0,-0.7499267685395902,8.0,-0.17460757394239454,-1.2461508812390802,0.1896520873331154,108,58,50,0,-1.0371414290548238,-0.8583670733300858,-1.170500554541026,-1.4301938838683883,-0.7425357508071526,0.7425357508071526,-1.170500554541026,-0.8583670733300858,0,0,0,0,-0.8583670733300858,-1.170500554541026
4413,19,94,44,119,110,0,5094.321,34,1670.846,LESS,502,1454,1956,2,2,-9.0,-0.8436676146070391,9.0,0.0,-1.2461508812390802,1.1823878184123282,229,119,110,0,1.376206896245824,1.5216507209033339,1.170500554541026,-0.4767312946227961,0.8918346374888648,0.8918346374888648,1.170500554541026,1.5216507209033339,0,0,1,2,1.5216507209033339,1.170500554541026
4414,19,95,34,74,80,0,3976.193,74,3222.901,LESS,-474,1686,1212,2,1,6.0,0.5624450764046927,6.0,-0.5238227218271837,0.501299960112829,0.529174367273543,154,74,80,1,-0.11967016489094122,-0.2341001109082052,0.0,-0.4767312946227961,-0.4880490121451429,0.4880490121451429,0.0,-0.2341001109082052,1,0,0,1,-0.2341001109082052,0.0
4415,19,96,24,86,80,0,2346.636,74,1475.969,LESS,-606,1224,618,2,1,-6.0,-0.5624450764046927,6.0,-0.5238227218271837,0.501299960112829,-0.42281731149433177,166,86,80,0,0.11967016489094122,0.2341001109082052,0.0,-0.4767312946227961,-0.6746726204972833,0.6746726204972833,0.0,0.2341001109082052,1,0,0,1,0.2341001109082052,0.0
4416,19,97,39,66,80,0,1985.611,74,998.703,LESS,-558,980,422,2,1,14.0,1.3123718449442827,14.0,0.8730378697119728,0.501299960112829,-0.6337291088890665,146,66,80,1,-0.2792303847455295,-0.5462335921191455,0.0,-0.4767312946227961,-0.606809490187414,0.606809490187414,0.0,-0.5462335921191455,1,0,0,1,-0.5462335921191455,0.0
4417,19,98,9,50,59,0,10616.105,74,1292.793,LESS,1254,3010,4264,4,1,9.0,0.8436676146070391,9.0,0.0,0.501299960112829,4.4082292096331255,109,50,59,1,-1.0171964015730004,-1.170500554541026,-0.8193503881787182,1.4301938838683883,1.9550236790101494,1.9550236790101494,-0.8193503881787182,-1.170500554541026,1,1,1,0,-1.170500554541026,-0.8193503881787182
4418,19,99,57,94,110,0,3424.41,34,2114.686,LESS,-1768,2442,674,2,1,16.0,1.4998535370791803,16.0,1.222253017596762,-1.2461508812390802,0.20682122191834854,204,94,110,1,0.8775812092002355,0.5462335921191455,1.170500554541026,-0.4767312946227961,-2.3175259000820345,2.3175259000820345,1.170500554541026,0.5462335921191455,0,0,0,2,1.170500554541026,0.5462335921191455
4419,19,100,60,110,87,1,4641.089,74,1284.543,LESS,100,1712,1812,2,2,-23.0,-2.1560394595513217,23.0,2.444506035193524,0.501299960112829,0.9176084381566384,197,110,87,0,0.7379660168274708,1.170500554541026,0.27311679605957273,-0.4767312946227961,0.32348092114371,0.32348092114371,0.27311679605957273,1.170500554541026,1,0,1,2,1.170500554541026,0.27311679605957273
4420,19,101,33,75,80,0,2079.65,94,1225.211,LESS,-474,1386,912,2,1,5.0,0.4687042303372438,5.0,-0.6984302957695783,1.3750253807887836,-0.5787912665922631,155,75,80,1,-0.09972513740911768,-0.19508342575683765,0.0,-0.4767312946227961,-0.4880490121451429,0.4880490121451429,0.0,-0.19508342575683765,1,0,0,1,-0.19508342575683765,0.0
4421,19,102,15,50,45,1,5748.041,74,1234.773,LESS,546,1608,2154,3,2,-5.0,-0.4687042303372438,5.0,-0.6984302957695783,0.501299960112829,1.5642928393745499,95,50,45,0,-1.2964267863185297,-1.170500554541026,-1.3655839802978638,0.4767312946227961,0.9540425069395783,0.9540425069395783,-1.3655839802978638,-1.170500554541026,1,1,1,0,-1.170500554541026,-1.3655839802978638
4422,19,103,59,89,110,0,2637.771,94,976.835,LESS,-620,1508,888,1,1,21.0,1.9685577674164243,21.0,2.0952908873087353,1.3750253807887836,-0.2527354442150127,199,89,110,1,0.7778560717911179,0.3511501663623078,1.170500554541026,-1.4301938838683883,-0.6944660335043285,0.6944660335043285,1.170500554541026,0.3511501663623078,1,0,0,2,1.170500554541026,0.3511501663623078
4423,19,104,29,80,94,0,2630.658,84,1192.413,LESS,-946,1472,526,2,1,14.0,1.3123718449442827,14.0,0.8730378697119728,0.9381626704508064,-0.2568908783674088,174,80,94,1,0.2792303847455295,0.0,0.5462335921191455,-0.4767312946227961,-1.1553697935255238,1.1553697935255238,0.5462335921191455,0.0,1,0,0,1,0.5462335921191455,0.0
4424,19,105,55,110,98,1,5044.573,24,1210.116,LESS,-620,2238,1618,3,2,-12.0,-1.124890152809385,12.0,0.5238227218271837,-1.6830135915770574,1.1533249000637564,208,110,98,0,0.9573613191275298,1.170500554541026,0.7023003327246156,0.4767312946227961,-0.6944660335043285,0.6944660335043285,0.7023003327246156,1.170500554541026,0,1,0,2,1.170500554541026,0.7023003327246156
4425,19,106,29,94,80,0,5757.9659999999985,84,1247.345,LESS,-626,2640,2014,3,1,-14.0,-1.3123718449442827,14.0,0.8730378697119728,0.9381626704508064,1.5700910516566424,174,94,80,0,0.2792303847455295,0.5462335921191455,0.0,0.4767312946227961,-0.7029489247930621,0.7029489247930621,0.0,0.5462335921191455,1,1,0,1,0.5462335921191455,0.0
4426,19,107,57,110,94,1,2029.046,74,1747.898,LESS,822,534,1356,1,2,-16.0,-1.4998535370791803,16.0,1.222253017596762,0.501299960112829,-0.60835426249383,204,110,94,0,0.8775812092002355,1.170500554541026,0.5462335921191455,-1.4301938838683883,1.3442555062213264,1.3442555062213264,0.5462335921191455,1.170500554541026,1,0,1,2,1.170500554541026,0.5462335921191455
4427,19,108,39,80,66,0,5845.337,24,1673.826,LESS,-640,2794,2154,4,1,-14.0,-1.3123718449442827,14.0,0.8730378697119728,-1.6830135915770574,1.6211334300242783,146,80,66,0,-0.2792303847455295,0.0,-0.5462335921191455,1.4301938838683883,-0.7227423378001073,0.7227423378001073,-0.5462335921191455,0.0,0,1,0,1,0.0,-0.5462335921191455
4428,19,109,4,50,54,0,11578.54,24,1498.144,LESS,286,4496,4782,6,1,4.0,0.3749633842697951,4.0,-0.8730378697119728,-1.6830135915770574,4.97048638219902,104,50,54,1,-1.116921538982118,-1.170500554541026,-1.0144338139355558,3.337119062359573,0.5864505510944533,0.5864505510944533,-1.0144338139355558,-1.170500554541026,0,1,1,0,-1.170500554541026,-1.0144338139355558
4429,19,110,55,98,110,0,2576.067,64,2952.032,LESS,-1100,1766,666,2,1,12.0,1.124890152809385,12.0,0.5238227218271837,0.06443724977485171,-0.28878309062854296,208,98,110,1,0.9573613191275298,0.7023003327246156,1.170500554541026,-0.4767312946227961,-1.3730973366030208,1.3730973366030208,1.170500554541026,0.7023003327246156,0,0,0,2,1.170500554541026,0.7023003327246156
4430,19,111,2,50,52,0,3327.818,60,2046.219,LESS,-796,1724,928,2,1,2.0,0.18748169213489754,2.0,-1.222253017596762,-0.1103078343603392,0.1503919100037937,102,50,52,1,-1.156811593945765,-1.170500554541026,-1.092467184238291,-0.4767312946227961,-0.9432975113071824,0.9432975113071824,-1.092467184238291,-1.170500554541026,0,0,0,0,-1.170500554541026,-1.092467184238291
4431,19,112,59,110,89,1,2789.167,64,1373.071,LESS,942,948,1890,3,2,-21.0,-1.9685577674164243,21.0,2.0952908873087353,0.06443724977485171,-0.16428948485382386,199,110,89,0,0.7778560717911179,1.170500554541026,0.3511501663623078,0.4767312946227961,1.5139133319959994,1.5139133319959994,0.3511501663623078,1.170500554541026,0,1,1,2,1.170500554541026,0.3511501663623078
4432,19,113,60,87,110,0,2646.031,64,1117.87,LESS,-990,1610,620,1,1,23.0,2.1560394595513217,23.0,2.444506035193524,0.06443724977485171,-0.247909929509714,197,87,110,1,0.7379660168274708,0.27311679605957273,1.170500554541026,-1.4301938838683883,-1.2175776629762372,1.2175776629762372,1.170500554541026,0.27311679605957273,0,0,0,2,1.170500554541026,0.27311679605957273
4433,19,114,52,110,105,0,1783.19,70,1392.543,LESS,-448,1046,598,2,1,-5.0,-0.4687042303372438,5.0,-0.6984302957695783,0.3265548759776381,-0.7519840135090781,215,110,105,0,1.0969765115002945,1.170500554541026,0.9754171287841883,-0.4767312946227961,-0.4512898165606304,0.4512898165606304,0.9754171287841883,1.170500554541026,1,0,0,2,1.170500554541026,0.9754171287841883
4434,19,115,30,80,96,0,1689.115,20,1216.579,LESS,-666,1286,620,2,1,16.0,1.4998535370791803,16.0,1.222253017596762,-1.8577586757122484,-0.8069428871048392,176,80,96,1,0.3191204397091766,0.0,0.6242669624218805,-0.4767312946227961,-0.7595015333846199,0.7595015333846199,0.6242669624218805,0.0,0,0,0,1,0.6242669624218805,0.0
4435,19,116,24,80,86,1,2818.893,74,972.208,LESS,188,1276,1464,3,2,6.0,0.5624450764046927,6.0,-0.5238227218271837,0.501299960112829,-0.14692347394223626,166,80,86,1,0.11967016489094122,0.0,0.2341001109082052,0.4767312946227961,0.44789666004513695,0.44789666004513695,0.2341001109082052,0.0,1,1,1,1,0.2341001109082052,0.0
4436,19,117,5,50,55,0,2723.774000000001,64,1395.876,LESS,-758,1536,778,2,1,5.0,0.4687042303372438,5.0,-0.6984302957695783,0.06443724977485171,-0.2024922552077708,105,50,55,1,-1.0969765115002945,-1.170500554541026,-0.9754171287841883,-0.4767312946227961,-0.8895725331452026,0.8895725331452026,-0.9754171287841883,-1.170500554541026,0,0,0,0,-1.170500554541026,-0.9754171287841883
4437,19,118,34,80,74,0,2757.361,74,825.033,LESS,-746,1610,864,2,1,-6.0,-0.5624450764046927,6.0,-0.5238227218271837,0.501299960112829,-0.18287063748296847,154,80,74,0,-0.11967016489094122,0.0,-0.2341001109082052,-0.4767312946227961,-0.8726067505677353,0.8726067505677353,-0.2341001109082052,0.0,1,0,0,1,0.0,-0.2341001109082052
4438,19,119,15,45,50,0,1913.764,70,1415.294,LESS,-78,1076,998,2,2,5.0,0.4687042303372438,5.0,-0.6984302957695783,0.3265548759776381,-0.6757023237839341,95,45,50,1,-1.2964267863185297,-1.3655839802978638,-1.170500554541026,-0.4767312946227961,0.07182181291127829,0.07182181291127829,-1.170500554541026,-1.3655839802978638,1,0,1,0,-1.3655839802978638,-1.170500554541026
4439,19,120,37,69,80,0,1948.715,84,965.91,LESS,-180,974,794,2,2,11.0,1.0311493067419364,11.0,0.34921514788478913,0.9381626704508064,-0.6552838535097332,149,69,80,1,-0.21939530230005888,-0.4291835366650429,0.0,-0.4767312946227961,-0.07238733899719384,0.07238733899719384,0.0,-0.4291835366650429,1,0,1,1,-0.4291835366650429,0.0
4440,19,121,48,128,110,0,4996.449000000001,14,1013.63,MORE,-1104,2698,1594,4,1,-18.0,-1.6873352292140782,18.0,1.571468165481551,-2.119876301915035,1.1252107269792777,238,128,110,1,1.5557121435822359,1.8728008872656416,1.170500554541026,1.4301938838683883,-1.3787525974621766,1.3787525974621766,1.170500554541026,1.8728008872656416,0,1,0,2,1.8728008872656416,1.170500554541026
4441,19,122,8,50,58,1,3088.427,64,1805.837,MORE,1500,1070,2570,3,2,8.0,0.7499267685395902,8.0,-0.17460757394239454,0.06443724977485171,0.010539029759702638,108,50,58,0,-1.0371414290548238,-1.170500554541026,-0.8583670733300858,0.4767312946227961,2.302822221848229,2.302822221848229,-0.8583670733300858,-1.170500554541026,0,1,1,0,-1.170500554541026,-0.8583670733300858
4442,19,123,4,54,50,0,1749.507,14,1069.547,MORE,-270,1008,738,2,1,-4.0,-0.3749633842697951,4.0,-0.8730378697119728,-2.119876301915035,-0.7716617146977681,104,54,50,1,-1.116921538982118,-1.0144338139355558,-1.170500554541026,-0.4767312946227961,-0.19963070832819865,0.19963070832819865,-1.170500554541026,-1.0144338139355558,0,1,0,0,-1.0144338139355558,-1.170500554541026
4443,19,124,37,80,69,0,2484.297,64,1367.071,MORE,-778,1430,652,2,1,-11.0,-1.0311493067419364,11.0,0.34921514788478913,0.06443724977485171,-0.3423953768882613,149,80,69,1,-0.21939530230005888,0.0,-0.4291835366650429,-0.4767312946227961,-0.9178488374409814,0.9178488374409814,-0.4291835366650429,0.0,0,0,0,1,0.0,-0.4291835366650429
4444,19,125,52,105,110,1,2170.206,84,831.836,MORE,766,762,1528,3,2,5.0,0.4687042303372438,5.0,-0.6984302957695783,0.9381626704508064,-0.5258882024696189,215,105,110,0,1.0969765115002945,0.9754171287841883,1.170500554541026,0.4767312946227961,1.2650818541931457,1.2650818541931457,1.170500554541026,0.9754171287841883,1,1,1,2,1.170500554541026,0.9754171287841883
4445,19,126,5,55,50,0,2467.256,64,1087.058,MORE,-332,1196,864,2,1,-5.0,-0.4687042303372438,5.0,-0.6984302957695783,0.06443724977485171,-0.3523507759309971,105,55,50,1,-1.0969765115002945,-0.9754171287841883,-1.170500554541026,-0.4767312946227961,-0.2872872516451131,0.2872872516451131,-1.170500554541026,-0.9754171287841883,0,0,0,0,-0.9754171287841883,-1.170500554541026
4446,19,127,30,96,80,0,2455.878,64,1571.75,MORE,-908,1600,692,2,1,-16.0,-1.4998535370791803,16.0,1.222253017596762,0.06443724977485171,-0.35899783480713376,176,96,80,1,0.3191204397091766,0.6242669624218805,0.0,-0.4767312946227961,-1.1016448153635439,1.1016448153635439,0.0,0.6242669624218805,0,0,0,1,0.6242669624218805,0.0
4447,19,128,33,80,75,1,2301.282,70,1224.391,MORE,486,906,1392,3,2,-5.0,-0.4687042303372438,5.0,-0.6984302957695783,0.3265548759776381,-0.4493132429645645,155,80,75,1,-0.09972513740911768,0.0,-0.19508342575683765,0.4767312946227961,0.8692135940522417,0.8692135940522417,-0.19508342575683765,0.0,0,1,1,1,0.0,-0.19508342575683765
4448,19,129,48,110,128,1,2820.303,74,1106.626,MORE,832,1158,1990,3,2,18.0,1.6873352292140782,18.0,1.571468165481551,0.501299960112829,-0.14609974806639234,238,110,128,0,1.5557121435822359,1.170500554541026,1.8728008872656416,0.4767312946227961,1.3583936583692158,1.3583936583692158,1.8728008872656416,1.170500554541026,1,1,1,2,1.8728008872656416,1.170500554541026
4449,19,130,9,59,50,1,2337.382,4,714.684,MORE,-190,1268,1078,3,1,-9.0,-0.8436676146070391,9.0,0.0,-2.556739012253012,-0.4282235237319632,109,59,50,1,-1.0171964015730004,-0.8193503881787182,-1.170500554541026,0.4767312946227961,-0.08652549114508326,0.08652549114508326,-1.170500554541026,-0.8193503881787182,0,1,0,0,-0.8193503881787182,-1.170500554541026
4450,19,131,44,110,119,1,2160.222,64,1440.116,MORE,240,950,1190,3,2,9.0,0.8436676146070391,9.0,0.0,0.06443724977485171,-0.531720882713893,229,110,119,0,1.376206896245824,1.170500554541026,1.5216507209033339,0.4767312946227961,0.521415051214162,0.521415051214162,1.5216507209033339,1.170500554541026,0,1,1,2,1.5216507209033339,1.170500554541026
4451,19,132,2,52,50,1,2275.866,84,640.929,MORE,402,830,1232,3,2,-2.0,-0.18748169213489754,2.0,-1.222253017596762,0.9381626704508064,-0.4641613400287141,102,52,50,1,-1.156811593945765,-1.092467184238291,-1.170500554541026,0.4767312946227961,0.7504531160099706,0.7504531160099706,-1.170500554541026,-1.092467184238291,1,1,1,0,-1.092467184238291,-1.170500554541026
4452,19,133,8,58,50,0,2485.773,84,1086.143,MORE,-416,1578,1162,2,2,-8.0,-0.7499267685395902,8.0,-0.17460757394239454,0.9381626704508064,-0.3415330936309948,108,58,50,1,-1.0371414290548238,-0.8583670733300858,-1.170500554541026,-0.4767312946227961,-0.40604772968738423,0.40604772968738423,-1.170500554541026,-0.8583670733300858,1,0,0,0,-0.8583670733300858,-1.170500554541026
4453,19,134,44,119,110,0,2318.966,44,1216.867,MORE,-616,1290,674,2,1,-9.0,-0.8436676146070391,9.0,0.0,-0.8092881709011028,-0.4389822015543341,229,119,110,1,1.376206896245824,1.5216507209033339,1.170500554541026,-0.4767312946227961,-0.6888107726451727,0.6888107726451727,1.170500554541026,1.5216507209033339,0,0,0,2,1.5216507209033339,1.170500554541026
4454,19,135,34,74,80,1,1684.058,84,809.543,MORE,576,444,1020,1,2,6.0,0.5624450764046927,6.0,-0.5238227218271837,0.9381626704508064,-0.8098972004056498,154,74,80,0,-0.11967016489094122,-0.2341001109082052,0.0,-1.4301938838683883,0.9964569633832465,0.9964569633832465,0.0,-0.2341001109082052,1,0,1,1,-0.2341001109082052,0.0
4455,19,136,24,86,80,0,3506.286,34,1364.918,MORE,-1286,2376,1090,2,1,-6.0,-0.5624450764046927,6.0,-0.5238227218271837,-1.2461508812390802,0.2546534061811873,166,86,80,1,0.11967016489094122,0.2341001109082052,0.0,-0.4767312946227961,-1.6360669665537642,1.6360669665537642,0.0,0.2341001109082052,0,0,0,1,0.2341001109082052,0.0
4456,19,137,39,66,80,1,4650.377,74,1164.265,MORE,984,1250,2234,3,2,14.0,1.3123718449442827,14.0,0.8730378697119728,0.501299960112829,0.92303451328773,146,66,80,0,-0.2792303847455295,-0.5462335921191455,0.0,0.4767312946227961,1.573293571017135,1.573293571017135,0.0,-0.5462335921191455,1,1,1,1,-0.5462335921191455,0.0
4457,19,138,9,50,59,1,11545.02,24,1183.88,MORE,-742,4850,4108,5,2,9.0,0.8436676146070391,9.0,0.0,-1.6830135915770574,4.950903906058388,109,50,59,0,-1.0171964015730004,-1.170500554541026,-0.8193503881787182,2.3836564731139807,-0.8669514897085795,0.8669514897085795,-0.8193503881787182,-1.170500554541026,0,1,0,0,-1.170500554541026,-0.8193503881787182
4458,19,139,57,94,110,1,2498.708,74,1275.876,MORE,250,992,1242,3,2,16.0,1.4998535370791803,16.0,1.222253017596762,0.501299960112829,-0.33397643107493663,204,94,110,0,0.8775812092002355,0.5462335921191455,1.170500554541026,0.4767312946227961,0.5355532033620514,0.5355532033620514,1.170500554541026,0.5462335921191455,1,1,1,2,1.170500554541026,0.5462335921191455
4459,19,140,60,110,87,0,4453.313,74,3738.366,MORE,-1036,2448,1412,4,1,-23.0,-2.1560394595513217,23.0,2.444506035193524,0.501299960112829,0.8079091827931769,197,110,87,1,0.7379660168274708,1.170500554541026,0.27311679605957273,1.4301938838683883,-1.2826131628565285,1.2826131628565285,0.27311679605957273,1.170500554541026,1,1,0,2,1.170500554541026,0.27311679605957273
4460,19,141,33,75,80,0,5902.98,84,1058.306,MORE,244,2550,2794,4,2,5.0,0.4687042303372438,5.0,-0.6984302957695783,0.9381626704508064,1.6548086290748276,155,75,80,0,-0.09972513740911768,-0.19508342575683765,0.0,1.4301938838683883,0.5270703120733178,0.5270703120733178,0.0,-0.19508342575683765,1,1,1,1,-0.19508342575683765,0.0
4461,19,142,15,50,45,0,1932.701,64,1768.536,MORE,-496,1190,694,2,2,-5.0,-0.4687042303372438,5.0,-0.6984302957695783,0.06443724977485171,-0.6646392763294251,95,50,45,1,-1.2964267863185297,-1.170500554541026,-1.3655839802978638,-0.4767312946227961,-0.5191529468704996,0.5191529468704996,-1.3655839802978638,-1.170500554541026,0,0,0,0,-1.170500554541026,-1.3655839802978638
4462,19,143,59,89,110,1,3714.698,74,1009.687,MORE,272,912,1184,3,2,21.0,1.9685577674164243,21.0,2.0952908873087353,0.501299960112829,0.37640826946941225,199,89,110,0,0.7778560717911179,0.3511501663623078,1.170500554541026,0.4767312946227961,0.5666571380874081,0.5666571380874081,1.170500554541026,0.3511501663623078,1,1,1,2,1.170500554541026,0.3511501663623078
4463,19,144,29,80,94,1,2244.891,84,1632.23,MORE,430,974,1404,3,2,14.0,1.3123718449442827,14.0,0.8730378697119728,0.9381626704508064,-0.4822570201735847,174,80,94,0,0.2792303847455295,0.0,0.5462335921191455,0.4767312946227961,0.7900399420240609,0.7900399420240609,0.5462335921191455,0.0,1,1,1,1,0.5462335921191455,0.0
4464,19,145,55,110,98,0,2143.856,74,1387.9229999999998,MORE,-926,1628,702,2,1,-12.0,-1.124890152809385,12.0,0.5238227218271837,0.501299960112829,-0.5412819449011714,208,110,98,1,0.9573613191275298,1.170500554541026,0.7023003327246156,-0.4767312946227961,-1.1270934892297448,1.1270934892297448,0.7023003327246156,1.170500554541026,1,0,0,2,1.170500554541026,0.7023003327246156
4465,19,146,29,94,80,0,1826.174,34,1446.464,MORE,-586,1220,634,2,1,-14.0,-1.3123718449442827,14.0,0.8730378697119728,-1.2461508812390802,-0.7268726425535617,174,94,80,1,0.2792303847455295,0.5462335921191455,0.0,-0.4767312946227961,-0.6463963162015044,0.6463963162015044,0.0,0.5462335921191455,0,0,0,1,0.5462335921191455,0.0
4466,19,147,57,110,94,1,2775.116,34,742.863,MORE,154,1122,1276,3,2,-16.0,-1.4998535370791803,16.0,1.222253017596762,-1.2461508812390802,-0.17249811767757126,204,110,94,1,0.8775812092002355,1.170500554541026,0.5462335921191455,0.4767312946227961,0.3998269427423129,0.3998269427423129,0.5462335921191455,1.170500554541026,0,1,1,2,1.170500554541026,0.5462335921191455
4467,19,148,39,80,66,0,2241.94,24,904.906,MORE,-736,1362,626,2,1,-14.0,-1.3123718449442827,14.0,0.8730378697119728,-1.6830135915770574,-0.4839810024853688,146,80,66,1,-0.2792303847455295,0.0,-0.5462335921191455,-0.4767312946227961,-0.8584685984198459,0.8584685984198459,-0.5462335921191455,0.0,0,0,0,1,0.0,-0.5462335921191455
4468,19,149,4,50,54,1,1525.192,74,1184.412,MORE,1184,444,1628,1,2,4.0,0.3749633842697951,4.0,-0.8730378697119728,0.501299960112829,-0.9027071543005656,104,50,54,0,-1.116921538982118,-1.170500554541026,-1.0144338139355558,-1.4301938838683883,1.8560566139749235,1.8560566139749235,-1.0144338139355558,-1.170500554541026,0,0,1,0,-1.170500554541026,-1.0144338139355558
4469,19,150,55,98,110,1,1661.692,74,1415.895,MORE,444,606,1050,1,2,12.0,1.124890152809385,12.0,0.5238227218271837,0.501299960112829,-0.8229634790858815,208,98,110,0,0.9573613191275298,0.7023003327246156,1.170500554541026,-1.4301938838683883,0.8098333550311061,0.8098333550311061,1.170500554541026,0.7023003327246156,0,0,1,2,1.170500554541026,0.7023003327246156
4470,19,151,2,50,52,1,1982.42,64,958.07,MORE,100,922,1022,3,2,2.0,0.18748169213489754,2.0,-1.222253017596762,0.06443724977485171,-0.6355932998605688,102,50,52,0,-1.156811593945765,-1.170500554541026,-1.092467184238291,0.4767312946227961,0.32348092114371,0.32348092114371,-1.092467184238291,-1.170500554541026,0,1,0,0,-1.170500554541026,-1.092467184238291
4471,19,152,59,110,89,0,2120.983,64,1460.406,MORE,-454,1158,704,2,1,-21.0,-1.9685577674164243,21.0,2.0952908873087353,0.06443724977485171,-0.5546444143750576,199,110,89,1,0.7778560717911179,1.170500554541026,0.3511501663623078,-0.4767312946227961,-0.459772707849364,0.459772707849364,0.3511501663623078,1.170500554541026,0,0,0,2,1.170500554541026,0.3511501663623078
4472,19,153,60,87,110,1,1491.5179999999998,94,762.78,MORE,830,454,1284,1,2,23.0,2.1560394595513217,23.0,2.444506035193524,1.3750253807887836,-0.9223795976645164,197,87,110,0,0.7379660168274708,0.27311679605957273,1.170500554541026,-1.4301938838683883,1.355566027939638,1.355566027939638,1.170500554541026,0.27311679605957273,1,0,1,2,1.170500554541026,0.27311679605957273
4473,19,154,52,110,105,1,3125.0840000000007,24,1669.571,MORE,282,1264,1546,3,2,-5.0,-0.4687042303372438,5.0,-0.6984302957695783,-1.6830135915770574,0.03195414992340023,215,110,105,1,1.0969765115002945,1.170500554541026,0.9754171287841883,0.4767312946227961,0.5807952902352975,0.5807952902352975,0.9754171287841883,1.170500554541026,0,1,1,2,1.170500554541026,0.9754171287841883
4474,19,155,30,80,96,1,2151.289,54,2026.108,MORE,-158,1108,950,3,1,16.0,1.4998535370791803,16.0,1.222253017596762,-0.3724254605631256,-0.5369395658691513,176,80,96,0,0.3191204397091766,0.0,0.6242669624218805,0.4767312946227961,-0.041283404271837104,0.041283404271837104,0.6242669624218805,0.0,0,1,0,1,0.6242669624218805,0.0
4475,19,156,24,80,86,1,2179.713,84,829.255,MORE,364,792,1156,3,2,6.0,0.5624450764046927,6.0,-0.5238227218271837,0.9381626704508064,-0.5203341869365347,166,80,86,0,0.11967016489094122,0.0,0.2341001109082052,0.4767312946227961,0.6967281378479908,0.6967281378479908,0.2341001109082052,0.0,1,1,1,1,0.2341001109082052,0.0
4476,19,157,5,50,55,1,1432.141,70,1275.405,MORE,1110,462,1572,1,2,5.0,0.4687042303372438,5.0,-0.6984302957695783,0.3265548759776381,-0.9570678042815294,105,50,55,0,-1.0969765115002945,-1.170500554541026,-0.9754171287841883,-1.4301938838683883,1.7514342880805418,1.7514342880805418,-0.9754171287841883,-1.170500554541026,0,0,1,0,-1.170500554541026,-0.9754171287841883
4477,19,158,34,80,74,1,1377.872,94,684.579,MORE,544,444,988,1,2,-6.0,-0.5624450764046927,6.0,-0.5238227218271837,1.3750253807887836,-0.9887719032575416,154,80,74,1,-0.11967016489094122,0.0,-0.2341001109082052,-1.4301938838683883,0.9512148765100004,0.9512148765100004,-0.2341001109082052,0.0,1,0,1,1,0.0,-0.2341001109082052
4478,19,159,15,45,50,1,2309.258,44,774.707,MORE,30,1032,1062,3,2,5.0,0.4687042303372438,5.0,-0.6984302957695783,-0.8092881709011028,-0.4446536418399323,95,45,50,0,-1.2964267863185297,-1.3655839802978638,-1.170500554541026,0.4767312946227961,0.22451385610848407,0.22451385610848407,-1.170500554541026,-1.3655839802978638,0,1,0,0,-1.3655839802978638,-1.170500554541026
4479,19,160,37,69,80,1,1547.858,74,556.1080000000002,MORE,-200,1016,816,1,1,11.0,1.0311493067419364,11.0,0.34921514788478913,0.501299960112829,-0.8894656147956863,149,69,80,0,-0.21939530230005888,-0.4291835366650429,0.0,-1.4301938838683883,-0.10066364329297268,0.10066364329297268,0.0,-0.4291835366650429,0,0,0,1,-0.4291835366650429,0.0
4480,19,161,3,50,53,0,3952.368,14,1404.368,LESS,96,1720,1816,3,1,3.0,0.28122253820234633,3.0,-1.0476454436543674,-2.119876301915035,0.5152557367827746,103,50,53,1,-1.1368665664639415,-1.170500554541026,-1.0534504990869233,0.4767312946227961,0.3178256602845543,0.3178256602845543,-1.0534504990869233,-1.170500554541026,0,1,1,0,-1.170500554541026,-1.0534504990869233
4481,19,162,20,50,40,0,1830.854,14,626.71,LESS,-382,1030,648,2,1,-10.0,-0.9374084606744876,10.0,0.17460757394239454,-2.119876301915035,-0.7241385736890582,90,50,40,0,-1.3961519237276474,-1.170500554541026,-1.5606674060547012,-0.4767312946227961,-0.3579780123845602,0.3579780123845602,-1.5606674060547012,-1.170500554541026,0,0,0,0,-1.170500554541026,-1.5606674060547012
4482,19,163,25,80,88,0,6182.783,14,932.046,LESS,-1572,3462,1890,4,1,8.0,0.7499267685395902,8.0,-0.17460757394239454,-2.119876301915035,1.818270310804456,168,80,88,1,0.1595602198545883,0.0,0.31213348121094026,1.4301938838683883,-2.0404181179834016,2.0404181179834016,0.31213348121094026,0.0,0,1,0,1,0.31213348121094026,0.0
4483,19,164,42,115,110,0,1856.125,24,1797.2020000000002,LESS,-346,1016,670,2,1,-5.0,-0.4687042303372438,5.0,-0.6984302957695783,-1.6830135915770574,-0.7093751860234884,225,115,110,0,1.2964267863185297,1.3655839802978638,1.170500554541026,-0.4767312946227961,-0.3070806646521583,0.3070806646521583,1.170500554541026,1.3655839802978638,0,0,1,2,1.3655839802978638,1.170500554541026
4484,19,165,53,103,110,0,2229.554,24,1181.062,LESS,-366,1170,804,2,1,7.0,0.6561859224721414,7.0,-0.34921514788478913,-1.6830135915770574,-0.4912169377323217,213,103,110,1,1.0570864565366473,0.8973837584814532,1.170500554541026,-0.4767312946227961,-0.3353569689479371,0.3353569689479371,1.170500554541026,0.8973837584814532,0,0,1,2,1.170500554541026,0.8973837584814532
4485,19,166,26,90,80,1,3008.253,24,888.909,LESS,698,1114,1812,3,2,-10.0,-0.9374084606744876,10.0,0.17460757394239454,-1.6830135915770574,-0.036298841424634916,170,90,80,0,0.19945027481823535,0.3901668515136753,0.0,0.4767312946227961,1.1689424195874976,1.1689424195874976,0.0,0.3901668515136753,0,1,1,1,0.3901668515136753,0.0
4486,19,167,35,80,72,0,2037.898,64,1343.965,LESS,-512,1128,616,2,1,-8.0,-0.7499267685395902,8.0,-0.17460757394239454,0.06443724977485171,-0.6031828997612265,152,80,72,0,-0.1595602198545883,0.0,-0.31213348121094026,-0.4767312946227961,-0.5417739903071227,0.5417739903071227,-0.31213348121094026,0.0,0,0,0,1,0.0,-0.31213348121094026
4487,19,168,28,93,80,1,3785.298,54,1065.749,LESS,468,1552,2020,3,2,-13.0,-1.218630998876834,13.0,0.6984302957695783,-0.3724254605631256,0.4176529835364942,173,93,80,0,0.25928535726370594,0.5072169069677779,0.0,0.4767312946227961,0.8437649201860408,0.8437649201860408,0.0,0.5072169069677779,0,1,1,1,0.5072169069677779,0.0
4488,19,169,26,80,90,0,2218.548,44,1433.594,LESS,-60,936,876,2,1,10.0,0.9374084606744876,10.0,0.17460757394239454,-0.8092881709011028,-0.4976466731858956,170,80,90,1,0.19945027481823535,0.0,0.3901668515136753,-0.4767312946227961,0.09727048677747925,0.09727048677747925,0.3901668515136753,0.0,0,0,1,1,0.3901668515136753,0.0
4489,19,170,25,88,80,0,1848.757,30,1353.667,LESS,-1008,1602,594,2,1,-8.0,-0.7499267685395902,8.0,-0.17460757394239454,-1.420895965374271,-0.7136795918768348,168,88,80,0,0.1595602198545883,0.31213348121094026,0.0,-0.4767312946227961,-1.2430263368424381,1.2430263368424381,0.0,0.31213348121094026,0,0,0,1,0.31213348121094026,0.0
4490,19,171,36,80,70,1,2857.418,54,1422.499,LESS,426,1088,1514,3,2,-10.0,-0.9374084606744876,10.0,0.17460757394239454,-0.3724254605631256,-0.12441706304373285,150,80,70,0,-0.19945027481823535,0.0,-0.3901668515136753,0.4767312946227961,0.7843846811649051,0.7843846811649051,-0.3901668515136753,0.0,0,1,1,1,0.0,-0.3901668515136753
4491,19,172,28,80,93,0,1687.5839999999996,34,933.684,LESS,-388,974,586,2,1,13.0,1.218630998876834,13.0,0.6984302957695783,-1.2461508812390802,-0.8078373015132913,173,80,93,1,0.25928535726370594,0.0,0.5072169069677779,-0.4767312946227961,-0.36646090367329387,0.36646090367329387,0.5072169069677779,0.0,0,0,0,1,0.5072169069677779,0.0
4492,19,173,21,82,80,1,2839.998,34,1249.172,LESS,16,1338,1354,3,2,-2.0,-0.18748169213489754,2.0,-1.222253017596762,-1.2461508812390802,-0.13459387492827354,162,82,80,0,0.03989005496364707,0.07803337030273506,0.0,0.4767312946227961,0.20472044310143886,0.20472044310143886,0.0,0.07803337030273506,0,1,1,1,0.07803337030273506,0.0
4493,19,174,19,50,41,1,2783.62,14,694.5039999999998,LESS,198,1174,1372,3,1,-9.0,-0.8436676146070391,9.0,0.0,-2.119876301915035,-0.16753005750155905,91,50,41,0,-1.376206896245824,-1.170500554541026,-1.5216507209033339,0.4767312946227961,0.4620348121930264,0.4620348121930264,-1.5216507209033339,-1.170500554541026,0,1,1,0,-1.170500554541026,-1.5216507209033339
4494,19,175,56,96,110,0,2484.105,24,1810.997,LESS,-1140,1688,548,2,1,14.0,1.3123718449442827,14.0,0.8730378697119728,-1.6830135915770574,-0.3425075438160358,206,96,110,1,0.9174712641638826,0.6242669624218805,1.170500554541026,-0.4767312946227961,-1.4296499451945786,1.4296499451945786,1.170500554541026,0.6242669624218805,0,0,0,2,1.170500554541026,0.6242669624218805
4495,19,176,23,80,85,0,5557.585,64,1469.48,LESS,-792,2944,2152,4,1,5.0,0.4687042303372438,5.0,-0.6984302957695783,0.06443724977485171,1.4530279206442358,165,80,85,1,0.09972513740911768,0.0,0.19508342575683765,1.4301938838683883,-0.9376422504480266,0.9376422504480266,0.19508342575683765,0.0,0,1,0,1,0.19508342575683765,0.0
4496,19,177,10,60,50,0,2378.669,74,1133.674,LESS,-302,1220,918,2,1,-10.0,-0.9374084606744876,10.0,0.17460757394239454,0.501299960112829,-0.4041035448412039,110,60,50,0,-0.9972513740911768,-0.7803337030273506,-1.170500554541026,-0.4767312946227961,-0.2448727952014448,0.2448727952014448,-1.170500554541026,-0.7803337030273506,1,0,1,0,-0.7803337030273506,-1.170500554541026
4497,19,178,19,41,50,0,2282.908,64,1753.1660000000004,LESS,-874,1616,742,2,1,9.0,0.8436676146070391,9.0,0.0,0.06443724977485171,-0.4600473842714848,91,41,50,1,-1.376206896245824,-1.5216507209033339,-1.170500554541026,-0.4767312946227961,-1.05357509806072,1.05357509806072,-1.170500554541026,-1.5216507209033339,0,0,0,0,-1.5216507209033339,-1.170500554541026
4498,19,179,56,110,96,0,1793.275,60,1553.192,LESS,-480,1358,878,2,1,-14.0,-1.3123718449442827,14.0,0.8730378697119728,-0.1103078343603392,-0.7460923287871726,206,110,96,0,0.9174712641638826,1.170500554541026,0.6242669624218805,-0.4767312946227961,-0.49653190343387654,0.49653190343387654,0.6242669624218805,1.170500554541026,0,0,0,2,1.170500554541026,0.6242669624218805
4499,19,180,35,72,80,0,1625.402,74,1681.0220000000004,LESS,-30,1100,1070,2,2,8.0,0.7499267685395902,8.0,-0.17460757394239454,0.501299960112829,-0.8441641968407598,152,72,80,1,-0.1595602198545883,-0.31213348121094026,0.0,-0.4767312946227961,0.13968494322114752,0.13968494322114752,0.0,-0.31213348121094026,1,0,1,1,-0.31213348121094026,0.0
4500,19,181,11,49,50,0,3139.988,64,1529.466,LESS,-114,1460,1346,4,1,1.0,0.09374084606744876,1.0,-1.3968605915391563,0.06443724977485171,0.040661107691895314,99,49,50,1,-1.2166466763912356,-1.2095172396923934,-1.170500554541026,1.4301938838683883,0.020924465178876365,0.020924465178876365,-1.170500554541026,-1.2095172396923934,0,1,1,0,-1.2095172396923934,-1.170500554541026
4501,19,182,17,43,50,0,2142.799,54,781.222,LESS,-362,1180,818,2,1,7.0,0.6561859224721414,7.0,-0.34921514788478913,-0.3724254605631256,-0.5418994472066802,93,43,50,1,-1.3363168412821769,-1.4436173506005987,-1.170500554541026,-0.4767312946227961,-0.32970170808878135,0.32970170808878135,-1.170500554541026,-1.4436173506005987,0,0,1,0,-1.4436173506005987,-1.170500554541026
4502,19,183,1,51,50,0,2098.373,64,922.101,LESS,-396,1154,758,2,1,-1.0,-0.09374084606744876,1.0,-1.3968605915391563,0.06443724977485171,-0.5678532385260028,101,51,50,0,-1.1767566214275886,-1.1314838693896585,-1.170500554541026,-0.4767312946227961,-0.3777714253916054,0.3777714253916054,-1.170500554541026,-1.1314838693896585,0,0,0,0,-1.1314838693896585,-1.170500554541026
4503,19,184,41,112,110,0,1648.974,74,1433.904,LESS,-320,820,500,2,1,-2.0,-0.18748169213489754,2.0,-1.222253017596762,0.501299960112829,-0.8303933696454446,222,112,110,0,1.2365917038730592,1.248533924843761,1.170500554541026,-0.4767312946227961,-0.27032146906764576,0.27032146906764576,1.170500554541026,1.248533924843761,1,0,1,2,1.248533924843761,1.170500554541026
4504,19,185,20,40,50,0,1655.8,74,1553.697,LESS,396,770,1166,2,2,10.0,0.9374084606744876,10.0,0.17460757394239454,0.501299960112829,-0.8264056016819615,90,40,50,1,-1.3961519237276474,-1.5606674060547012,-1.170500554541026,-0.4767312946227961,0.7419702247212369,0.7419702247212369,-1.170500554541026,-1.5606674060547012,1,0,1,0,-1.5606674060547012,-1.170500554541026
4505,19,186,1,50,51,0,1556.447,74,751.7260000000001,LESS,-334,848,514,2,1,1.0,0.09374084606744876,1.0,-1.3968605915391563,0.501299960112829,-0.8844478973860239,101,50,51,1,-1.1767566214275886,-1.170500554541026,-1.1314838693896585,-0.4767312946227961,-0.29011488207469094,0.29011488207469094,-1.1314838693896585,-1.170500554541026,1,0,1,0,-1.170500554541026,-1.1314838693896585
4506,19,187,23,85,80,0,1820.525,70,1281.475,LESS,-296,930,634,2,2,-5.0,-0.4687042303372438,5.0,-0.6984302957695783,0.3265548759776381,-0.7301728038816769,165,85,80,0,0.09972513740911768,0.19508342575683765,0.0,-0.4767312946227961,-0.23638990391271114,0.23638990391271114,0.0,0.19508342575683765,1,0,1,1,0.19508342575683765,0.0
4507,19,188,11,50,49,0,1524.9260000000004,74,1437.463,LESS,-338,832,494,2,1,-1.0,-0.09374084606744876,1.0,-1.3968605915391563,0.501299960112829,-0.9028625522317528,99,50,49,0,-1.2166466763912356,-1.170500554541026,-1.2095172396923934,-0.4767312946227961,-0.29577014293384674,0.29577014293384674,-1.2095172396923934,-1.170500554541026,1,0,1,0,-1.170500554541026,-1.2095172396923934
4508,19,189,17,50,43,0,1508.1270000000004,74,1509.575,LESS,-414,898,484,2,1,-7.0,-0.6561859224721414,7.0,-0.34921514788478913,0.501299960112829,-0.9126765742092731,93,50,43,0,-1.3363168412821769,-1.170500554541026,-1.4436173506005987,-0.4767312946227961,-0.40322009925780633,0.40322009925780633,-1.4436173506005987,-1.170500554541026,1,0,0,0,-1.170500554541026,-1.4436173506005987
4509,19,190,21,80,82,0,1634.5220000000004,74,1520.277,LESS,-346,874,528,2,1,2.0,0.18748169213489754,2.0,-1.222253017596762,0.501299960112829,-0.8388362677714708,162,80,82,1,0.03989005496364707,0.0,0.07803337030273506,-0.4767312946227961,-0.3070806646521583,0.3070806646521583,0.07803337030273506,0.0,1,0,1,1,0.07803337030273506,0.0
4510,19,191,10,50,60,0,2090.5,74,1096.919,LESS,-446,1108,662,2,1,10.0,0.9374084606744876,10.0,0.17460757394239454,0.501299960112829,-0.5724526667675062,110,50,60,1,-0.9972513740911768,-1.170500554541026,-0.7803337030273506,-0.4767312946227961,-0.4484621861310525,0.4484621861310525,-0.7803337030273506,-1.170500554541026,1,0,0,0,-1.170500554541026,-0.7803337030273506
4511,19,192,3,53,50,0,2216.038,74,788.471,LESS,-414,1192,778,2,1,-3.0,-0.28122253820234633,3.0,-1.0476454436543674,0.501299960112829,-0.4991130220854476,103,53,50,0,-1.1368665664639415,-1.0534504990869233,-1.170500554541026,-0.4767312946227961,-0.40322009925780633,0.40322009925780633,-1.170500554541026,-1.0534504990869233,1,0,0,0,-1.0534504990869233,-1.170500554541026
4512,19,193,45,122,110,0,1694.099,74,829.428,LESS,28,800,828,2,2,-12.0,-1.124890152809385,12.0,0.5238227218271837,0.501299960112829,-0.8040312206046928,232,122,110,0,1.4360419786912946,1.6387007763574364,1.170500554541026,-0.4767312946227961,0.22168622567890617,0.22168622567890617,1.170500554541026,1.6387007763574364,1,0,1,2,1.6387007763574364,1.170500554541026
4513,19,194,38,67,80,0,1569.817,84,621.119,LESS,-244,820,576,2,2,13.0,1.218630998876834,13.0,0.6984302957695783,0.9381626704508064,-0.8766371066342266,147,67,80,1,-0.25928535726370594,-0.5072169069677779,0.0,-0.4767312946227961,-0.16287151274368614,0.16287151274368614,0.0,-0.5072169069677779,1,0,1,1,-0.5072169069677779,0.0
4514,19,195,38,80,67,1,2873.241,34,1059.623,LESS,86,1256,1342,3,2,-13.0,-1.218630998876834,13.0,0.6984302957695783,-1.2461508812390802,-0.11517322294906668,147,80,67,0,-0.25928535726370594,0.0,-0.5072169069677779,0.4767312946227961,0.30368750813666484,0.30368750813666484,-0.5072169069677779,0.0,0,1,1,1,0.0,-0.5072169069677779
4515,19,196,36,70,80,0,1660.14,100,665.082,LESS,0,914,914,2,2,10.0,0.9374084606744876,10.0,0.17460757394239454,1.63714300699157,-0.8238701617520587,150,70,80,1,-0.19945027481823535,-0.3901668515136753,0.0,-0.4767312946227961,0.18209939966481578,0.18209939966481578,0.0,-0.3901668515136753,1,0,1,1,-0.3901668515136753,0.0
4516,19,197,45,110,122,0,5719.129,54,1233.745,LESS,-1236,2994,1758,5,1,12.0,1.124890152809385,12.0,0.5238227218271837,-0.3724254605631256,1.5474023695005064,232,110,122,1,1.4360419786912946,1.170500554541026,1.6387007763574364,2.3836564731139807,-1.565376205814317,1.565376205814317,1.6387007763574364,1.170500554541026,0,1,0,2,1.6387007763574364,1.170500554541026
4517,19,198,42,110,115,0,2061.6710000000007,74,807.4580000000002,LESS,-718,1412,694,2,1,5.0,0.4687042303372438,5.0,-0.6984302957695783,0.501299960112829,-0.5892946478133968,225,110,115,1,1.2964267863185297,1.170500554541026,1.3655839802978638,-0.4767312946227961,-0.8330199245536449,0.8330199245536449,1.3655839802978638,1.170500554541026,1,0,0,2,1.3655839802978638,1.170500554541026
4518,19,199,41,110,112,0,2244.51,34,822.637,LESS,-444,1206,762,2,1,2.0,0.18748169213489754,2.0,-1.222253017596762,-1.2461508812390802,-0.4824796014208872,222,110,112,1,1.2365917038730592,1.170500554541026,1.248533924843761,-0.4767312946227961,-0.44563455570147464,0.44563455570147464,1.248533924843761,1.170500554541026,0,0,0,2,1.248533924843761,1.170500554541026
4519,19,200,53,110,103,0,1632.625,64,1835.076,LESS,-2570,3186,616,2,1,-7.0,-0.6561859224721414,7.0,-0.34921514788478913,0.06443724977485171,-0.839944500385993,213,110,103,0,1.0570864565366473,1.170500554541026,0.8973837584814532,-0.4767312946227961,-3.451405702342766,3.451405702342766,0.8973837584814532,1.170500554541026,0,0,0,2,1.170500554541026,0.8973837584814532
4520,19,201,3,50,53,1,2820.587,64,1144.225,MORE,858,998,1856,3,2,3.0,0.28122253820234633,3.0,-1.0476454436543674,0.06443724977485171,-0.1459338344857258,103,50,53,0,-1.1368665664639415,-1.170500554541026,-1.0534504990869233,0.4767312946227961,1.3951528539537283,1.3951528539537283,-1.0534504990869233,-1.170500554541026,0,1,1,0,-1.170500554541026,-1.0534504990869233
4521,19,202,20,50,40,0,1704.659,80,1121.67,MORE,686,972,1658,2,2,-10.0,-0.9374084606744876,10.0,0.17460757394239454,0.7634175863156154,-0.7978620395770952,90,50,40,1,-1.3961519237276474,-1.170500554541026,-1.5606674060547012,-0.4767312946227961,1.1519766370100302,1.1519766370100302,-1.5606674060547012,-1.170500554541026,1,0,1,0,-1.170500554541026,-1.5606674060547012
4522,19,203,25,80,88,0,5033.169,34,1610.14,MORE,-924,2608,1684,4,1,8.0,0.7499267685395902,8.0,-0.17460757394239454,-1.2461508812390802,1.1466626519161498,168,80,88,0,0.1595602198545883,0.0,0.31213348121094026,1.4301938838683883,-1.124265858800167,1.124265858800167,0.31213348121094026,0.0,0,1,0,1,0.31213348121094026,0.0
4523,19,204,42,115,110,0,2697.706,64,741.2560000000002,MORE,-240,1406,1166,2,1,-5.0,-0.4687042303372438,5.0,-0.6984302957695783,0.06443724977485171,-0.21772125246415494,225,115,110,1,1.2964267863185297,1.3655839802978638,1.170500554541026,-0.4767312946227961,-0.15721625188453037,0.15721625188453037,1.170500554541026,1.3655839802978638,0,0,0,2,1.3655839802978638,1.170500554541026
4524,19,205,53,103,110,1,1747.092,74,849.95,MORE,704,504,1208,1,2,7.0,0.6561859224721414,7.0,-0.34921514788478913,0.501299960112829,-0.7730725643361818,213,103,110,0,1.0570864565366473,0.8973837584814532,1.170500554541026,-1.4301938838683883,1.1774253108762311,1.1774253108762311,1.170500554541026,0.8973837584814532,0,0,1,2,1.170500554541026,0.8973837584814532
4525,19,206,26,90,80,0,2692.379000000001,60,1596.902,MORE,268,1272,1540,2,1,-10.0,-0.9374084606744876,10.0,0.17460757394239454,-0.1103078343603392,-0.2208333005071481,170,90,80,1,0.19945027481823535,0.3901668515136753,0.0,-0.4767312946227961,0.5610018772282523,0.5610018772282523,0.0,0.3901668515136753,0,0,1,1,0.3901668515136753,0.0
4526,19,207,35,80,72,1,4167.55,74,1785.38,MORE,-44,1928,1884,3,2,-8.0,-0.7499267685395902,8.0,-0.17460757394239454,0.501299960112829,0.6409656526805487,152,80,72,1,-0.1595602198545883,0.0,-0.31213348121094026,0.4767312946227961,0.11989153021410233,0.11989153021410233,-0.31213348121094026,0.0,1,1,0,1,0.0,-0.31213348121094026
4527,19,208,28,93,80,0,1764.523,64,813.5319999999998,MORE,-372,1088,716,2,1,-13.0,-1.218630998876834,13.0,0.6984302957695783,0.06443724977485171,-0.7628893262214042,173,93,80,1,0.25928535726370594,0.5072169069677779,0.0,-0.4767312946227961,-0.3438398602366708,0.3438398602366708,0.0,0.5072169069677779,0,0,0,1,0.5072169069677779,0.0
4528,19,209,26,80,90,1,1728.311,84,674.301,MORE,682,512,1194,1,2,10.0,0.9374084606744876,10.0,0.17460757394239454,0.9381626704508064,-0.7840444761618741,170,80,90,0,0.19945027481823535,0.0,0.3901668515136753,-1.4301938838683883,1.1463213761508744,1.1463213761508744,0.3901668515136753,0.0,1,0,1,1,0.3901668515136753,0.0
4529,19,210,25,88,80,0,2294.46,64,1037.55,MORE,-782,1568,786,2,1,-8.0,-0.7499267685395902,8.0,-0.17460757394239454,0.06443724977485171,-0.4532986741170523,168,88,80,1,0.1595602198545883,0.31213348121094026,0.0,-0.4767312946227961,-0.9235040983001372,0.9235040983001372,0.0,0.31213348121094026,0,0,0,1,0.31213348121094026,0.0
4530,19,211,36,80,70,0,2101.04,64,1079.706,MORE,-144,1014,870,2,1,-10.0,-0.9374084606744876,10.0,0.17460757394239454,0.06443724977485171,-0.5662951697948853,150,80,70,1,-0.19945027481823535,0.0,-0.3901668515136753,-0.4767312946227961,-0.021489991264791907,0.021489991264791907,-0.3901668515136753,0.0,0,0,0,1,0.0,-0.3901668515136753
4531,19,212,28,80,93,1,1214.529,80,1125.294,MORE,546,356,902,1,2,13.0,1.218630998876834,13.0,0.6984302957695783,0.7634175863156154,-1.0841973328589494,173,80,93,0,0.25928535726370594,0.0,0.5072169069677779,-1.4301938838683883,0.9540425069395783,0.9540425069395783,0.5072169069677779,0.0,1,0,1,1,0.5072169069677779,0.0
4532,19,213,21,82,80,0,2307.713,74,1110.097,MORE,-290,1188,898,2,1,-2.0,-0.18748169213489754,2.0,-1.222253017596762,0.501299960112829,-0.4455562350868675,162,82,80,1,0.03989005496364707,0.07803337030273506,0.0,-0.4767312946227961,-0.2279070126239775,0.2279070126239775,0.0,0.07803337030273506,0,1,0,1,0.07803337030273506,0.0
4533,19,214,19,50,41,0,1943.765,64,815.4019999999998,MORE,-358,1080,722,2,1,-9.0,-0.8436676146070391,9.0,0.0,0.06443724977485171,-0.6581756571164195,91,50,41,1,-1.376206896245824,-1.170500554541026,-1.5216507209033339,-0.4767312946227961,-0.32404644722962556,0.32404644722962556,-1.5216507209033339,-1.170500554541026,0,1,0,0,-1.170500554541026,-1.5216507209033339
4534,19,215,56,96,110,1,2984.033,64,1250.001,MORE,176,1260,1436,3,2,14.0,1.3123718449442827,14.0,0.8730378697119728,0.06443724977485171,-0.05044823200118926,206,96,110,0,0.9174712641638826,0.6242669624218805,1.170500554541026,0.4767312946227961,0.43093087746766967,0.43093087746766967,1.170500554541026,0.6242669624218805,0,1,1,2,1.170500554541026,0.6242669624218805
4535,19,216,23,80,85,1,1332.618,84,632.831,MORE,380,448,828,1,2,5.0,0.4687042303372438,5.0,-0.6984302957695783,0.9381626704508064,-1.015209414452892,165,80,85,0,0.09972513740911768,0.0,0.19508342575683765,-1.4301938838683883,0.7193491812846139,0.7193491812846139,0.19508342575683765,0.0,1,0,1,1,0.19508342575683765,0.0
4536,19,217,10,60,50,0,1997.231,64,939.834,MORE,-480,1120,640,2,1,-10.0,-0.9374084606744876,10.0,0.17460757394239454,0.06443724977485171,-0.6269406729477139,110,60,50,1,-0.9972513740911768,-0.7803337030273506,-1.170500554541026,-0.4767312946227961,-0.49653190343387654,0.49653190343387654,-1.170500554541026,-0.7803337030273506,0,0,0,0,-0.7803337030273506,-1.170500554541026
4537,19,218,19,41,50,1,1159.195,94,681.185,MORE,436,472,908,1,2,9.0,0.8436676146070391,9.0,0.0,1.3750253807887836,-1.116523607762461,91,41,50,0,-1.376206896245824,-1.5216507209033339,-1.170500554541026,-1.4301938838683883,0.7985228333127946,0.7985228333127946,-1.170500554541026,-1.5216507209033339,1,0,1,0,-1.5216507209033339,-1.170500554541026
4538,19,219,56,110,96,0,3082.875,14,984.416,MORE,-614,1924,1310,4,1,-14.0,-1.3123718449442827,14.0,0.8730378697119728,-2.119876301915035,0.007295536098223248,206,110,96,1,0.9174712641638826,1.170500554541026,0.6242669624218805,1.4301938838683883,-0.6859831422155949,0.6859831422155949,0.6242669624218805,1.170500554541026,0,1,0,2,1.170500554541026,0.6242669624218805
4539,19,220,35,72,80,1,1549.754,84,923.847,MORE,560,362,922,1,2,8.0,0.7499267685395902,8.0,-0.17460757394239454,0.9381626704508064,-0.8883579663839131,152,72,80,0,-0.1595602198545883,-0.31213348121094026,0.0,-1.4301938838683883,0.9738359199466234,0.9738359199466234,0.0,-0.31213348121094026,1,0,1,1,-0.31213348121094026,0.0
4540,19,221,11,49,50,1,1515.689,74,806.137,MORE,738,446,1184,1,2,1.0,0.09374084606744876,1.0,-1.3968605915391563,0.501299960112829,-0.9082588330226544,99,49,50,0,-1.2166466763912356,-1.2095172396923934,-1.170500554541026,-1.4301938838683883,1.225495028179055,1.225495028179055,-1.170500554541026,-1.2095172396923934,0,0,1,0,-1.2095172396923934,-1.170500554541026
4541,19,222,17,43,50,1,1488.156,64,656.8,MORE,426,486,912,1,2,7.0,0.6561859224721414,7.0,-0.34921514788478913,0.06443724977485171,-0.9243436873060678,93,43,50,0,-1.3363168412821769,-1.4436173506005987,-1.170500554541026,-1.4301938838683883,0.7843846811649051,0.7843846811649051,-1.170500554541026,-1.4436173506005987,0,0,1,0,-1.4436173506005987,-1.170500554541026
4542,19,223,1,51,50,0,1897.56,4,701.878,MORE,-992,1692,700,2,1,-1.0,-0.09374084606744876,1.0,-1.3968605915391563,-2.556739012253012,-0.6851687451259029,101,51,50,1,-1.1767566214275886,-1.1314838693896585,-1.170500554541026,-0.4767312946227961,-1.2204052934058152,1.2204052934058152,-1.170500554541026,-1.1314838693896585,0,0,0,0,-1.1314838693896585,-1.170500554541026
4543,19,224,41,112,110,1,7088.219,64,1335.06,MORE,-680,3252,2572,2,2,-2.0,-0.18748169213489754,2.0,-1.222253017596762,0.06443724977485171,2.347228510890043,222,112,110,1,1.2365917038730592,1.248533924843761,1.170500554541026,-0.4767312946227961,-0.7792949463916651,0.7792949463916651,1.170500554541026,1.248533924843761,0,0,0,2,1.248533924843761,1.170500554541026
4544,19,225,20,40,50,1,1622.081,24,1778.505,MORE,302,442,744,1,2,10.0,0.9374084606744876,10.0,0.17460757394239454,-1.6830135915770574,-0.8461043341696094,90,40,50,0,-1.3961519237276474,-1.5606674060547012,-1.170500554541026,-1.4301938838683883,0.6090715945310764,0.6090715945310764,-1.170500554541026,-1.5606674060547012,0,0,1,0,-1.5606674060547012,-1.170500554541026
4545,19,226,1,50,51,1,1302.495,74,1366.7,MORE,366,394,760,1,2,1.0,0.09374084606744876,1.0,-1.3968605915391563,0.501299960112829,-1.0328073538557634,101,50,51,0,-1.1767566214275886,-1.170500554541026,-1.1314838693896585,-1.4301938838683883,0.6995557682775687,0.6995557682775687,-1.1314838693896585,-1.170500554541026,1,0,1,0,-1.170500554541026,-1.1314838693896585
4546,19,227,23,85,80,0,2427.401,84,771.6339999999999,MORE,-584,1398,814,2,1,-5.0,-0.4687042303372438,5.0,-0.6984302957695783,0.9381626704508064,-0.3756341764854384,165,85,80,1,0.09972513740911768,0.19508342575683765,0.0,-0.4767312946227961,-0.6435686857719265,0.6435686857719265,0.0,0.19508342575683765,1,0,0,1,0.19508342575683765,0.0
4547,19,228,11,50,49,1,1189.172,84,591.677,MORE,290,428,718,1,2,-1.0,-0.09374084606744876,1.0,-1.3968605915391563,0.9381626704508064,-1.099010961960918,99,50,49,1,-1.2166466763912356,-1.170500554541026,-1.2095172396923934,-1.4301938838683883,0.5921058119536091,0.5921058119536091,-1.2095172396923934,-1.170500554541026,1,0,1,0,-1.170500554541026,-1.2095172396923934
4548,19,229,17,50,43,0,2249.489,84,598.008,MORE,-550,1376,826,2,1,-7.0,-0.6561859224721414,7.0,-0.34921514788478913,0.9381626704508064,-0.479570855934485,93,50,43,1,-1.3363168412821769,-1.170500554541026,-1.4436173506005987,-0.4767312946227961,-0.5954989684691026,0.5954989684691026,-1.4436173506005987,-1.170500554541026,1,0,0,0,-1.170500554541026,-1.4436173506005987
4549,19,230,21,80,82,1,1565.388,94,581.323,MORE,582,584,1166,1,2,2.0,0.18748169213489754,2.0,-1.222253017596762,1.3750253807887836,-0.8792245406087749,162,80,82,0,0.03989005496364707,0.0,0.07803337030273506,-1.4301938838683883,1.00493985467198,1.00493985467198,0.07803337030273506,0.0,1,0,1,1,0.07803337030273506,0.0
4550,19,231,10,50,60,1,1388.035,84,884.98,MORE,706,468,1174,1,2,10.0,0.9374084606744876,10.0,0.17460757394239454,0.9381626704508064,-0.982834650721228,110,50,60,0,-0.9972513740911768,-1.170500554541026,-0.7803337030273506,-1.4301938838683883,1.180252941305809,1.180252941305809,-0.7803337030273506,-1.170500554541026,1,0,1,0,-1.170500554541026,-0.7803337030273506
4551,19,232,3,53,50,1,1375.454,100,570.006,MORE,600,400,1000,1,2,-3.0,-0.28122253820234633,3.0,-1.0476454436543674,1.63714300699157,-0.990184505504202,103,53,50,1,-1.1368665664639415,-1.0534504990869233,-1.170500554541026,-1.4301938838683883,1.030388528538181,1.030388528538181,-1.170500554541026,-1.0534504990869233,1,0,1,0,-1.0534504990869233,-1.170500554541026
4552,19,233,45,122,110,0,3890.676,24,686.3330000000002,MORE,-602,1880,1278,4,1,-12.0,-1.124890152809385,12.0,0.5238227218271837,-1.6830135915770574,0.4792151008022304,232,122,110,1,1.4360419786912946,1.6387007763574364,1.170500554541026,1.4301938838683883,-0.6690173596381275,0.6690173596381275,1.170500554541026,1.6387007763574364,0,1,0,2,1.6387007763574364,1.170500554541026
4553,19,234,38,67,80,1,1456.266,74,1212.116,MORE,164,544,708,1,2,13.0,1.218630998876834,13.0,0.6984302957695783,0.501299960112829,-0.9429739129661135,147,67,80,0,-0.25928535726370594,-0.5072169069677779,0.0,-1.4301938838683883,0.41396509489020233,0.41396509489020233,0.0,-0.5072169069677779,1,0,1,1,-0.5072169069677779,0.0
4554,19,235,38,80,67,0,1537.374,34,1363.056,MORE,-418,1020,602,2,1,-13.0,-1.218630998876834,13.0,0.6984302957695783,-1.2461508812390802,-0.8955903964143729,147,80,67,1,-0.25928535726370594,0.0,-0.5072169069677779,-0.4767312946227961,-0.4088753601169621,0.4088753601169621,-0.5072169069677779,0.0,0,0,0,1,0.0,-0.5072169069677779
4555,19,236,36,70,80,0,2288.943,34,1521.747,MORE,-522,1356,834,2,1,10.0,0.9374084606744876,10.0,0.17460757394239454,-1.2461508812390802,-0.4565217206823226,150,70,80,0,-0.19945027481823535,-0.3901668515136753,0.0,-0.4767312946227961,-0.5559121424550121,0.5559121424550121,0.0,-0.3901668515136753,0,0,0,1,-0.3901668515136753,0.0
4556,19,237,45,110,122,1,3323.84,34,753.888,MORE,-110,1562,1452,3,2,12.0,1.124890152809385,12.0,0.5238227218271837,-1.2461508812390802,0.14806795146896576,232,110,122,0,1.4360419786912946,1.170500554541026,1.6387007763574364,0.4767312946227961,0.02657972603803213,0.02657972603803213,1.6387007763574364,1.170500554541026,0,1,0,2,1.6387007763574364,1.170500554541026
4557,19,238,42,110,115,1,1529.707,74,1086.814,MORE,456,462,918,1,2,5.0,0.4687042303372438,5.0,-0.6984302957695783,0.501299960112829,-0.9000694788896183,225,110,115,0,1.2964267863185297,1.170500554541026,1.3655839802978638,-1.4301938838683883,0.8267991376085735,0.8267991376085735,1.3655839802978638,1.170500554541026,1,0,1,2,1.3655839802978638,1.170500554541026
4558,19,239,41,110,112,0,2465.503,64,977.661,MORE,-504,1208,704,2,1,2.0,0.18748169213489754,2.0,-1.222253017596762,0.06443724977485171,-0.3533748833496881,222,110,112,0,1.2365917038730592,1.170500554541026,1.248533924843761,-0.4767312946227961,-0.5304634685888112,0.5304634685888112,1.248533924843761,1.170500554541026,0,0,0,2,1.248533924843761,1.170500554541026
4559,19,240,53,110,103,1,1531.841,64,986.281,MORE,608,416,1024,1,2,-7.0,-0.6561859224721414,7.0,-0.34921514788478913,0.06443724977485171,-0.8988227902236248,213,110,103,1,1.0570864565366473,1.170500554541026,0.8973837584814532,-1.4301938838683883,1.0416990502564927,1.0416990502564927,0.8973837584814532,1.170500554541026,0,0,1,2,1.170500554541026,0.8973837584814532
4560,20,1,49,110,131,1,3096.527,80,2499.221,MORE,292,1160,1452,2,2,21.0,1.9685577674164243,21.0,2.0952908873087353,0.8283393258853051,-0.3454807069007726,241,110,131,0,1.6155472260277064,1.170500554541026,1.9898509427197442,-0.4684392169568405,0.3035229405980832,0.3035229405980832,1.9898509427197442,1.170500554541026,1,0,1,2,1.9898509427197442,1.170500554541026
4561,20,2,13,47,50,1,4804.017,60,1153.9260000000004,MORE,1284,1404,2688,5,2,3.0,0.28122253820234633,3.0,-1.0476454436543674,0.12086089808290923,0.2323102004219943,97,47,50,0,-1.2565367313548828,-1.2875506099951286,-1.170500554541026,1.4811344027479294,1.2254532523736394,1.2254532523736394,-1.170500554541026,-1.2875506099951286,0,1,1,0,-1.2875506099951286,-1.170500554541026
4562,20,3,16,50,44,0,4758.3420000000015,40,2161.592,MORE,62,2082,2144,4,1,-6.0,-0.5624450764046927,6.0,-0.5238227218271837,-0.5866175297194867,0.21685441462414687,94,50,44,1,-1.3163718138003533,-1.170500554541026,-1.4046006654492311,0.8312765295130061,0.08976893685979899,0.08976893685979899,-1.4046006654492311,-1.170500554541026,0,1,0,0,-1.170500554541026,-1.4046006654492311
4563,20,4,7,57,50,0,11233.854,30,1965.888,MORE,-3164,6468,3304,5,1,-7.0,-0.6561859224721414,7.0,-0.34921514788478913,-0.9403567436206848,2.4080777622627654,107,57,50,1,-1.0570864565366473,-0.8973837584814532,-1.170500554541026,1.4811344027479294,-2.908363306878048,2.908363306878048,-1.170500554541026,-0.8973837584814532,0,1,0,0,-0.8973837584814532,-1.170500554541026
4564,20,5,18,42,50,1,2826.187,80,722.235,MORE,236,1238,1474,1,2,8.0,0.7499267685395902,8.0,-0.17460757394239454,0.8283393258853051,-0.4369600092015983,92,42,50,0,-1.3562618687640005,-1.4826340357519663,-1.170500554541026,-1.1182970901917637,0.2514784875139792,0.2514784875139792,-1.170500554541026,-1.4826340357519663,1,0,1,0,-1.4826340357519663,-1.170500554541026
4565,20,6,51,108,110,1,7828.68,10,2588.724,MORE,-1400,4064,2664,3,1,2.0,0.18748169213489754,2.0,-1.222253017596762,-1.6478351714230806,1.2558141618598957,218,108,110,0,1.156811593945765,1.092467184238291,1.170500554541026,0.18141865627808282,-1.2689630347287726,1.2689630347287726,1.170500554541026,1.092467184238291,0,1,0,2,1.170500554541026,1.092467184238291
4566,20,7,31,78,80,1,2204.878,80,1687.0770000000002,MORE,38,976,1014,0,2,2.0,0.18748169213489754,2.0,-1.222253017596762,0.8283393258853051,-0.6472023478611517,158,78,80,0,-0.03989005496364707,-0.07803337030273506,0.0,-1.768154963426687,0.06746417125232586,0.06746417125232586,0.0,-0.07803337030273506,1,0,0,1,-0.07803337030273506,0.0
4567,20,8,58,110,92,0,11649.615,20,2784.664,MORE,-4864,6576,1712,1,1,-18.0,-1.6873352292140782,18.0,1.571468165481551,-1.294095957521883,2.5487655117777965,202,110,92,1,0.8376911542365885,1.170500554541026,0.4682002218164104,-1.1182970901917637,-4.488284204074062,4.488284204074062,0.4682002218164104,1.170500554541026,0,0,0,2,1.170500554541026,0.4682002218164104
4568,20,9,12,50,48,0,4665.718,50,1938.24,MORE,-452,2398,1946,4,1,-2.0,-0.18748169213489754,2.0,-1.222253017596762,-0.23287831581828874,0.1855117391180737,98,50,48,1,-1.2365917038730592,-1.170500554541026,-1.248533924843761,0.8312765295130061,-0.3879247932335839,0.3879247932335839,-1.248533924843761,-1.170500554541026,0,1,0,0,-1.170500554541026,-1.248533924843761
4569,20,10,54,110,101,0,5082.372,60,2286.866,MORE,476,2018,2494,5,2,-9.0,-0.8436676146070391,9.0,0.0,0.12086089808290923,0.3265016674337068,211,110,101,1,1.0171964015730004,1.170500554541026,0.8193503881787182,1.4811344027479294,0.47452614358871054,0.47452614358871054,0.8193503881787182,1.170500554541026,0,1,1,2,1.170500554541026,0.8193503881787182
4570,20,11,14,46,50,0,8662.197,10,2686.308,MORE,-452,4518,4066,5,1,4.0,0.3749633842697951,4.0,-0.8730378697119728,-1.6478351714230806,1.5378647411891748,96,46,50,0,-1.2764817588367063,-1.3265672951464962,-1.170500554541026,1.4811344027479294,-0.3879247932335839,0.3879247932335839,-1.170500554541026,-1.3265672951464962,0,1,0,0,-1.3265672951464962,-1.170500554541026
4571,20,12,22,80,83,1,4227.617,10,1101.33,MORE,-1154,2470,1316,0,1,3.0,0.28122253820234633,3.0,-1.0476454436543674,-1.6478351714230806,0.03726444379627895,163,80,83,0,0.05983508244547061,0.0,0.1170500554541026,-1.768154963426687,-1.040339187252173,1.040339187252173,0.1170500554541026,0.0,0,0,0,1,0.1170500554541026,0.0
4572,20,13,6,50,56,1,2754.283,100,2146.752,MORE,2152,694,2846,3,2,6.0,0.5624450764046927,6.0,-0.5238227218271837,1.5358177536877011,-0.46129132440703796,106,50,56,0,-1.077031484018471,-1.170500554541026,-0.9364004436328208,0.18141865627808282,2.032142275177251,2.032142275177251,-0.9364004436328208,-1.170500554541026,1,0,1,0,-1.170500554541026,-0.9364004436328208
4573,20,14,13,50,47,1,11298.604,20,2485.231,MORE,-748,5598,4850,8,1,-3.0,-0.28122253820234633,3.0,-1.0476454436543674,-1.294095957521883,2.4299882632022434,97,50,47,1,-1.2565367313548828,-1.170500554541026,-1.2875506099951286,3.4307080224526993,-0.6630169023924192,0.6630169023924192,-1.2875506099951286,-1.170500554541026,0,1,0,0,-1.170500554541026,-1.2875506099951286
4574,20,15,46,110,124,1,10917.788,40,2331.359,MORE,830,3858,4688,3,1,14.0,1.3123718449442827,14.0,0.8730378697119728,-0.5866175297194867,2.301125416472232,234,110,124,0,1.4759320336549415,1.170500554541026,1.7167341466601715,0.18141865627808282,0.8035214362989392,0.8035214362989392,1.7167341466601715,1.170500554541026,0,0,1,2,1.7167341466601715,1.170500554541026
4575,20,16,27,91,80,0,5971.618,40,3085.238,MORE,-1172,2948,1776,3,1,-11.0,-1.0311493067419364,11.0,0.34921514788478913,-0.5866175297194867,0.6274101665599924,171,91,80,1,0.21939530230005888,0.4291835366650429,0.0,0.18141865627808282,-1.057067761457778,1.057067761457778,0.0,0.4291835366650429,0,1,0,1,0.4291835366650429,0.0
4576,20,17,40,64,80,1,1915.946,60,1076.33,MORE,272,686,958,1,2,16.0,1.4998535370791803,16.0,1.222253017596762,0.12086089808290923,-0.7449729248101129,144,64,80,0,-0.3191204397091766,-0.6242669624218805,0.0,-1.1182970901917637,0.28493563592518895,0.28493563592518895,0.0,-0.6242669624218805,0,0,1,1,-0.6242669624218805,0.0
4577,20,18,22,83,80,0,6732.477,30,1893.434,MORE,-286,2782,2496,3,1,-3.0,-0.28122253820234633,3.0,-1.0476454436543674,-0.9403567436206848,0.8848742875532004,163,83,80,1,0.05983508244547061,0.1170500554541026,0.0,0.18141865627808282,-0.23365016444856143,0.23365016444856143,0.0,0.1170500554541026,0,1,0,1,0.1170500554541026,0.0
4578,20,19,54,101,110,0,7365.374,10,1595.083,MORE,-1126,3456,2330,2,1,9.0,0.8436676146070391,9.0,0.0,-1.6478351714230806,1.0990378445121618,211,101,110,0,1.0171964015730004,0.8193503881787182,1.170500554541026,-0.4684392169568405,-1.014316960710121,1.014316960710121,1.170500554541026,0.8193503881787182,0,0,0,2,1.170500554541026,0.8193503881787182
4579,20,20,6,56,50,0,8669.064,10,1493.6070000000002,MORE,-3644,5926,2282,3,1,-6.0,-0.5624450764046927,6.0,-0.5238227218271837,-1.6478351714230806,1.5401884386401616,106,56,50,1,-1.077031484018471,-0.9364004436328208,-1.170500554541026,0.18141865627808282,-3.3544586190275107,3.3544586190275107,-1.170500554541026,-0.9364004436328208,0,1,0,0,-0.9364004436328208,-1.170500554541026
4580,20,21,18,50,42,1,1765.141,30,1340.215,MORE,150,830,980,2,1,-8.0,-0.7499267685395902,8.0,-0.17460757394239454,-0.9403567436206848,-0.7960032428669155,92,50,42,1,-1.3562618687640005,-1.170500554541026,-1.4826340357519663,-0.4684392169568405,0.1715530774205338,0.1715530774205338,-1.4826340357519663,-1.170500554541026,0,0,1,0,-1.170500554541026,-1.4826340357519663
4581,20,22,43,110,117,1,6596.93,60,1715.831,MORE,422,2742,3164,4,2,7.0,0.6561859224721414,7.0,-0.34921514788478913,0.12086089808290923,0.8390070648374721,227,110,117,0,1.3363168412821769,1.170500554541026,1.4436173506005987,0.8312765295130061,0.424340420971896,0.424340420971896,1.4436173506005987,1.170500554541026,0,1,1,2,1.4436173506005987,1.170500554541026
4582,20,23,32,77,80,1,2827.474,70,1463.479,MORE,476,1078,1554,3,2,3.0,0.28122253820234633,3.0,-1.0476454436543674,0.4746001119841072,-0.4365245062717278,157,77,80,0,-0.05983508244547061,-0.1170500554541026,0.0,0.18141865627808282,0.47452614358871054,0.47452614358871054,0.0,-0.1170500554541026,1,1,1,1,-0.1170500554541026,0.0
4583,20,24,27,80,91,1,4541.507000000001,80,2056.011,MORE,250,1780,2030,4,2,11.0,1.0311493067419364,11.0,0.34921514788478913,0.8283393258853051,0.14348046140080026,171,80,91,0,0.21939530230005888,0.0,0.4291835366650429,0.8312765295130061,0.2644896007850052,0.2644896007850052,0.4291835366650429,0.0,1,1,1,1,0.4291835366650429,0.0
4584,20,25,16,44,50,1,1557.1429999999998,30,3662.062,MORE,-624,2042,1418,3,1,6.0,0.5624450764046927,6.0,-0.5238227218271837,-0.9403567436206848,-0.8663868779929313,94,44,50,0,-1.3163718138003533,-1.4046006654492311,-1.170500554541026,0.18141865627808282,-0.5477756134204748,0.5477756134204748,-1.170500554541026,-1.4046006654492311,0,1,0,0,-1.4046006654492311,-1.170500554541026
4585,20,26,7,50,57,1,10289.994,70,4833.236,MORE,2006,3288,5294,7,2,7.0,0.6561859224721414,7.0,-0.34921514788478913,0.4746001119841072,2.088688643857582,107,50,57,0,-1.0570864565366473,-1.170500554541026,-0.8973837584814532,2.780850149217776,1.8964549510651227,1.8964549510651227,-0.8973837584814532,-1.170500554541026,1,1,1,0,-1.170500554541026,-0.8973837584814532
4586,20,27,14,50,46,0,7554.635999999998,40,2548.979,MORE,1430,2368,3798,3,1,-4.0,-0.3749633842697951,4.0,-0.8730378697119728,-0.5866175297194867,1.1630814773894966,96,50,46,1,-1.2764817588367063,-1.170500554541026,-1.3265672951464962,0.18141865627808282,1.3611405764857676,1.3611405764857676,-1.3265672951464962,-1.170500554541026,0,1,1,0,-1.170500554541026,-1.3265672951464962
4587,20,28,51,110,108,0,8190.703,30,1964.043,MORE,26,3632,3658,3,1,-2.0,-0.18748169213489754,2.0,-1.222253017596762,-0.9403567436206848,1.3783177183326776,218,110,108,1,1.156811593945765,1.170500554541026,1.092467184238291,0.18141865627808282,0.05631178844858929,0.05631178844858929,1.092467184238291,1.170500554541026,0,0,0,2,1.170500554541026,1.092467184238291
4588,20,29,50,133,110,0,4776.085999999998,50,1683.885,MORE,-762,2494,1732,4,1,-23.0,-2.1560394595513217,23.0,2.444506035193524,-0.23287831581828874,0.22285873784685006,243,133,110,1,1.6554372809913533,2.0678843130224793,1.170500554541026,0.8312765295130061,-0.6760280156634452,0.6760280156634452,1.170500554541026,2.0678843130224793,0,1,0,2,2.0678843130224793,1.170500554541026
4589,20,30,49,131,110,0,8277.179,50,2769.336,MORE,-1456,4236,2780,3,2,-21.0,-1.9685577674164243,21.0,2.0952908873087353,-0.23287831581828874,1.4075799960043731,241,131,110,1,1.6155472260277064,1.9898509427197442,1.170500554541026,0.18141865627808282,-1.3210074878128766,1.3210074878128766,1.170500554541026,1.9898509427197442,0,1,0,2,1.9898509427197442,1.170500554541026
4590,20,31,47,126,110,0,10069.583,50,1732.088,MORE,-584,4880,4296,5,1,-16.0,-1.4998535370791803,16.0,1.222253017596762,-0.23287831581828874,2.0141046218873693,236,126,110,1,1.5158220886185887,1.7947675169629065,1.170500554541026,1.4811344027479294,-0.5106010040746861,0.5106010040746861,1.170500554541026,1.7947675169629065,0,1,0,2,1.7947675169629065,1.170500554541026
4591,20,32,50,110,133,1,9180.159,10,2094.529,MORE,-558,4978,4420,2,1,23.0,2.1560394595513217,23.0,2.444506035193524,-1.6478351714230806,1.7131358900326317,243,110,133,0,1.6554372809913533,1.170500554541026,2.0678843130224793,-0.4684392169568405,-0.4864375079999236,0.4864375079999236,2.0678843130224793,1.170500554541026,0,0,0,2,2.0678843130224793,1.170500554541026
4592,20,33,47,110,126,1,11577.07,20,1337.638,MORE,-1950,5392,3442,4,1,16.0,1.4998535370791803,16.0,1.222253017596762,-1.294095957521883,2.5242172910727088,236,110,126,0,1.5158220886185887,1.170500554541026,1.7947675169629065,0.8312765295130061,-1.7801139132333652,1.7801139132333652,1.7947675169629065,1.170500554541026,0,1,0,2,1.7947675169629065,1.170500554541026
4593,20,34,12,48,50,1,9246.755,80,1033.869,MORE,2716,2622,5338,4,2,2.0,0.18748169213489754,2.0,-1.222253017596762,0.8283393258853051,1.7356710517402067,98,48,50,0,-1.2365917038730592,-1.248533924843761,-1.170500554541026,0.8312765295130061,2.5563042669528695,2.5563042669528695,-1.170500554541026,-1.248533924843761,1,1,1,0,-1.248533924843761,-1.170500554541026
4594,20,35,32,80,77,0,6187.411999999998,40,1964.946,MORE,-2346,3980,1634,4,2,-3.0,-0.28122253820234633,3.0,-1.0476454436543674,-0.5866175297194867,0.7004318598377322,157,80,77,1,-0.05983508244547061,0.0,-0.1170500554541026,0.8312765295130061,-2.148142545756672,2.148142545756672,-0.1170500554541026,0.0,0,1,0,1,0.0,-0.1170500554541026
4595,20,36,43,117,110,0,9929.634,40,1371.287,MORE,-638,4232,3594,5,1,-7.0,-0.6561859224721414,7.0,-0.34921514788478913,-0.5866175297194867,1.966747823493871,227,117,110,1,1.3363168412821769,1.4436173506005987,1.170500554541026,1.4811344027479294,-0.5607867266915006,0.5607867266915006,1.170500554541026,1.4436173506005987,0,1,0,2,1.4436173506005987,1.170500554541026
4596,20,37,40,80,64,0,15696.76,10,3382.8390000000004,MORE,-3546,8360,4814,9,1,-16.0,-1.4998535370791803,16.0,1.222253017596762,-1.6478351714230806,3.9182631847461886,144,80,64,1,-0.3191204397091766,0.0,-0.6242669624218805,4.080565895687623,-3.2633808261303288,3.2633808261303288,-0.6242669624218805,0.0,0,1,0,1,0.0,-0.6242669624218805
4597,20,38,31,80,78,0,17802.511000000002,20,2553.127,MORE,1178,6650,7828,6,1,-2.0,-0.18748169213489754,2.0,-1.222253017596762,-1.294095957521883,4.630820084573318,158,80,78,1,-0.03989005496364707,0.0,-0.07803337030273506,2.1309922759828526,1.1269405376072996,1.1269405376072996,-0.07803337030273506,0.0,0,1,1,1,0.0,-0.07803337030273506
4598,20,39,46,124,110,0,8895.783000000001,30,2144.357,MORE,-1274,4384,3110,5,1,-14.0,-1.3123718449442827,14.0,0.8730378697119728,-0.9403567436206848,1.6169070002231352,234,124,110,1,1.4759320336549415,1.7167341466601715,1.170500554541026,1.4811344027479294,-1.1518630152895388,1.1518630152895388,1.170500554541026,1.7167341466601715,0,1,0,2,1.7167341466601715,1.170500554541026
4599,20,40,58,92,110,1,5490.979,50,764.404,MORE,122,2122,2244,2,2,18.0,1.6873352292140782,18.0,1.571468165481551,-0.23287831581828874,0.4647686026827764,202,92,110,0,0.8376911542365885,0.4682002218164104,1.170500554541026,-0.4684392169568405,0.14553085087848183,0.14553085087848183,1.170500554541026,0.4682002218164104,0,0,0,2,1.170500554541026,0.4682002218164104
4600,20,41,49,110,131,0,4015.55,80,3086.612,LESS,-242,2054,1812,4,2,21.0,1.9685577674164243,21.0,2.0952908873087353,0.8283393258853051,-0.034496084431246375,241,110,131,1,1.6155472260277064,1.170500554541026,1.9898509427197442,0.8312765295130061,-0.19275809416819403,0.19275809416819403,1.9898509427197442,1.170500554541026,1,1,0,2,1.9898509427197442,1.170500554541026
4601,20,42,13,47,50,0,7637.121,50,2349.714,LESS,-306,3428,3122,2,1,3.0,0.28122253820234633,3.0,-1.0476454436543674,-0.23287831581828874,1.1909932560766454,97,47,50,1,-1.2565367313548828,-1.2875506099951286,-1.170500554541026,-0.4684392169568405,-0.25223746912145567,0.25223746912145567,-1.170500554541026,-1.2875506099951286,0,0,0,0,-1.2875506099951286,-1.170500554541026
4602,20,43,16,50,44,1,16415.783,60,2237.342,LESS,-1144,7294,6150,6,2,-6.0,-0.5624450764046927,6.0,-0.5238227218271837,0.12086089808290923,4.161570584236632,94,50,44,0,-1.3163718138003533,-1.170500554541026,-1.4046006654492311,2.1309922759828526,-1.031045534915726,1.031045534915726,-1.4046006654492311,-1.170500554541026,1,1,0,0,-1.170500554541026,-1.4046006654492311
4603,20,44,7,57,50,0,10304.574,40,1791.068,LESS,-588,4556,3968,6,1,-7.0,-0.6561859224721414,7.0,-0.34921514788478913,-0.5866175297194867,2.093622313412757,107,57,50,0,-1.0570864565366473,-0.8973837584814532,-1.170500554541026,2.1309922759828526,-0.514318465009265,0.514318465009265,-1.170500554541026,-0.8973837584814532,0,1,0,0,-0.8973837584814532,-1.170500554541026
4604,20,45,18,42,50,0,2612.929,70,993.105,LESS,-690,1306,616,1,1,8.0,0.7499267685395902,8.0,-0.17460757394239454,0.4746001119841072,-0.509123555291964,92,42,50,1,-1.3562618687640005,-1.4826340357519663,-1.170500554541026,-1.1182970901917637,-0.6091137188410258,0.6091137188410258,-1.170500554541026,-1.4826340357519663,1,0,0,0,-1.4826340357519663,-1.170500554541026
4605,20,46,51,108,110,1,15358.073,50,1343.045,LESS,-1524,7136,5612,4,1,2.0,0.18748169213489754,2.0,-1.222253017596762,-0.23287831581828874,3.8036562066506066,218,108,110,1,1.156811593945765,1.092467184238291,1.170500554541026,0.8312765295130061,-1.384204323700717,1.384204323700717,1.170500554541026,1.092467184238291,0,1,0,2,1.170500554541026,1.092467184238291
4606,20,47,31,78,80,0,2269.503,80,2945.513,LESS,-670,1552,882,2,2,2.0,0.18748169213489754,2.0,-1.222253017596762,0.8283393258853051,-0.6253341451860357,158,78,80,1,-0.03989005496364707,-0.07803337030273506,0.0,-0.4684392169568405,-0.5905264141681316,0.5905264141681316,0.0,-0.07803337030273506,1,0,0,1,-0.07803337030273506,0.0
4607,20,48,58,110,92,1,9017.939,30,1028.366,LESS,670,3054,3724,5,2,-18.0,-1.6873352292140782,18.0,1.571468165481551,-0.9403567436206848,1.6582428944742984,202,110,92,0,0.8376911542365885,1.170500554541026,0.4682002218164104,1.4811344027479294,0.6548229989157851,0.6548229989157851,0.4682002218164104,1.170500554541026,0,1,1,2,1.170500554541026,0.4682002218164104
4608,20,49,12,50,48,0,8244.176,70,2528.173,LESS,-1664,4446,2782,6,1,-2.0,-0.18748169213489754,2.0,-1.222253017596762,0.4746001119841072,1.3964122390544795,98,50,48,0,-1.2365917038730592,-1.170500554541026,-1.248533924843761,2.1309922759828526,-1.514315456410977,1.514315456410977,-1.248533924843761,-1.170500554541026,1,1,0,0,-1.170500554541026,-1.248533924843761
4609,20,50,54,110,101,1,3843.263,20,1800.4979999999996,LESS,-240,2288,2048,2,1,-9.0,-0.8436676146070391,9.0,0.0,-1.294095957521883,-0.0927956130082323,211,110,101,0,1.0171964015730004,1.170500554541026,0.8193503881787182,-0.4684392169568405,-0.1908993637009046,0.1908993637009046,0.8193503881787182,1.170500554541026,0,0,0,2,1.170500554541026,0.8193503881787182
4610,20,51,14,46,50,0,1992.862,60,1603.083,LESS,-360,1188,828,2,2,4.0,0.3749633842697951,4.0,-0.8730378697119728,0.12086089808290923,-0.7189456183968174,96,46,50,1,-1.2764817588367063,-1.3265672951464962,-1.170500554541026,-0.4684392169568405,-0.30242319173827026,0.30242319173827026,-1.170500554541026,-1.3265672951464962,0,0,0,0,-1.3265672951464962,-1.170500554541026
4611,20,52,22,80,83,0,2174.961,70,2432.388,LESS,-916,1514,598,1,1,3.0,0.28122253820234633,3.0,-1.0476454436543674,0.4746001119841072,-0.6573258452604779,163,80,83,1,0.05983508244547061,0.0,0.1170500554541026,-1.1182970901917637,-0.8191502616447311,0.8191502616447311,0.1170500554541026,0.0,1,0,0,1,0.1170500554541026,0.0
4612,20,53,6,50,56,0,1999.148,60,1114.723,LESS,-696,1280,584,2,2,6.0,0.5624450764046927,6.0,-0.5238227218271837,0.12086089808290923,-0.7168185232785848,106,50,56,1,-1.077031484018471,-1.170500554541026,-0.9364004436328208,-0.4684392169568405,-0.6146899102428941,0.6146899102428941,-0.9364004436328208,-1.170500554541026,0,0,0,0,-1.170500554541026,-0.9364004436328208
4613,20,54,13,50,47,1,5489.294,20,1705.188,LESS,174,2752,2926,5,1,-3.0,-0.28122253820234633,3.0,-1.0476454436543674,-1.294095957521883,0.4641984220791775,97,50,47,0,-1.2565367313548828,-1.170500554541026,-1.2875506099951286,1.4811344027479294,0.19385784302800693,0.19385784302800693,-1.2875506099951286,-1.170500554541026,0,1,1,0,-1.170500554541026,-1.2875506099951286
4614,20,55,46,110,124,0,2903.708,70,1582.537,LESS,-922,1820,898,1,2,14.0,1.3123718449442827,14.0,0.8730378697119728,0.4746001119841072,-0.410727979188791,234,110,124,1,1.4759320336549415,1.170500554541026,1.7167341466601715,-1.1182970901917637,-0.8247264530465994,0.8247264530465994,1.7167341466601715,1.170500554541026,1,0,0,2,1.7167341466601715,1.170500554541026
4615,20,56,27,91,80,0,2567.135,70,1972.465,LESS,-944,1584,640,2,1,-11.0,-1.0311493067419364,11.0,0.34921514788478913,0.4746001119841072,-0.5246196090374844,171,91,80,0,0.21939530230005888,0.4291835366650429,0.0,-0.4684392169568405,-0.8451724881867831,0.8451724881867831,0.0,0.4291835366650429,1,0,0,1,0.4291835366650429,0.0
4616,20,57,40,64,80,0,1695.776,80,2021.296,LESS,206,1152,1358,2,2,16.0,1.4998535370791803,16.0,1.222253017596762,0.8283393258853051,-0.8194753957266359,144,64,80,1,-0.3191204397091766,-0.6242669624218805,0.0,-0.4684392169568405,0.2235975305046378,0.2235975305046378,0.0,-0.6242669624218805,1,0,1,1,-0.6242669624218805,0.0
4617,20,58,22,83,80,0,1742.1029999999996,80,1642.175,LESS,-98,1196,1098,2,2,-3.0,-0.28122253820234633,3.0,-1.0476454436543674,0.8283393258853051,-0.8037989821818762,163,83,80,0,0.05983508244547061,0.1170500554541026,0.0,-0.4684392169568405,-0.05892950052335523,0.05892950052335523,0.0,0.1170500554541026,1,0,0,1,0.1170500554541026,0.0
4618,20,59,54,101,110,0,4612.399,70,1784.596,LESS,-894,2374,1480,4,2,9.0,0.8436676146070391,9.0,0.0,0.4746001119841072,0.1674693298579654,211,101,110,1,1.0171964015730004,0.8193503881787182,1.170500554541026,0.8312765295130061,-0.7987042265045474,0.7987042265045474,1.170500554541026,0.8193503881787182,1,1,0,2,1.170500554541026,0.8193503881787182
4619,20,60,6,56,50,0,13327.15,30,2476.5460000000007,LESS,384,5820,6204,7,1,-6.0,-0.5624450764046927,6.0,-0.5238227218271837,-0.9403567436206848,3.1164200630288708,106,56,50,0,-1.077031484018471,-0.9364004436328208,-1.170500554541026,2.780850149217776,0.3890245420933969,0.3890245420933969,-1.170500554541026,-0.9364004436328208,0,1,1,0,-0.9364004436328208,-1.170500554541026
4620,20,61,18,50,42,0,2056.19,80,1534.688,LESS,-694,1598,904,2,2,-8.0,-0.7499267685395902,8.0,-0.17460757394239454,0.8283393258853051,-0.6975163025127208,92,50,42,0,-1.3562618687640005,-1.170500554541026,-1.4826340357519663,-0.4684392169568405,-0.6128311797756046,0.6128311797756046,-1.4826340357519663,-1.170500554541026,1,0,0,0,-1.170500554541026,-1.4826340357519663
4621,20,62,43,110,117,0,2489.7470000000008,10,574.4730000000002,LESS,-810,1294,484,2,1,7.0,0.6561859224721414,7.0,-0.34921514788478913,-1.6478351714230806,-0.5508066336970104,227,110,117,1,1.3363168412821769,1.170500554541026,1.4436173506005987,-0.4684392169568405,-0.7206375468783914,0.7206375468783914,1.4436173506005987,1.170500554541026,0,0,0,2,1.4436173506005987,1.170500554541026
4622,20,63,32,77,80,0,1697.034,80,1275.376,LESS,334,802,1136,2,2,3.0,0.28122253820234633,3.0,-1.0476454436543674,0.8283393258853051,-0.8190497059940973,157,77,80,1,-0.05983508244547061,-0.1170500554541026,0.0,-0.4684392169568405,0.3425562804111612,0.3425562804111612,0.0,-0.1170500554541026,1,0,1,1,-0.1170500554541026,0.0
4623,20,64,27,80,91,0,1307.224,80,917.791,LESS,-42,814,772,2,2,11.0,1.0311493067419364,11.0,0.34921514788478913,0.8283393258853051,-0.950955997441478,171,80,91,1,0.21939530230005888,0.0,0.4291835366650429,-0.4684392169568405,-0.0068850474392512535,0.0068850474392512535,0.4291835366650429,0.0,1,0,1,1,0.4291835366650429,0.0
4624,20,65,16,44,50,0,4163.257000000001,40,2228.265,LESS,486,1256,1742,3,1,6.0,0.5624450764046927,6.0,-0.5238227218271837,-0.5866175297194867,0.015485913441610656,94,44,50,1,-1.3163718138003533,-1.4046006654492311,-1.170500554541026,0.18141865627808282,0.4838197959251577,0.4838197959251577,-1.170500554541026,-1.4046006654492311,0,1,1,0,-1.4046006654492311,-1.170500554541026
4625,20,66,7,50,57,0,1602.711,90,1331.385,LESS,250,738,988,2,2,7.0,0.6561859224721414,7.0,-0.34921514788478913,1.1820785397865032,-0.8509672995093772,107,50,57,1,-1.0570864565366473,-1.170500554541026,-0.8973837584814532,-0.4684392169568405,0.2644896007850052,0.2644896007850052,-0.8973837584814532,-1.170500554541026,1,1,1,0,-1.170500554541026,-0.8973837584814532
4626,20,67,14,50,46,0,2004.477,50,1835.966,LESS,-748,1220,472,1,1,-4.0,-0.3749633842697951,4.0,-0.8730378697119728,-0.23287831581828874,-0.7150152636723073,96,50,46,0,-1.2764817588367063,-1.170500554541026,-1.3265672951464962,-1.1182970901917637,-0.6630169023924192,0.6630169023924192,-1.3265672951464962,-1.170500554541026,0,0,0,0,-1.170500554541026,-1.3265672951464962
4627,20,68,51,110,108,0,6172.7159999999985,40,1812.761,LESS,-2710,3686,976,4,1,-2.0,-0.18748169213489754,2.0,-1.222253017596762,-0.5866175297194867,0.6954589374932293,218,110,108,0,1.156811593945765,1.170500554541026,1.092467184238291,0.8312765295130061,-2.486431490803348,2.486431490803348,1.092467184238291,1.170500554541026,0,1,0,2,1.170500554541026,1.092467184238291
4628,20,69,50,133,110,1,3332.7,50,2765.128,LESS,868,984,1852,2,2,-23.0,-2.1560394595513217,23.0,2.444506035193524,-0.23287831581828874,-0.2655630429875785,243,133,110,0,1.6554372809913533,2.0678843130224793,1.170500554541026,-0.4684392169568405,0.8388373151774384,0.8388373151774384,1.170500554541026,2.0678843130224793,0,1,1,2,2.0678843130224793,1.170500554541026
4629,20,70,49,131,110,1,3759.427,50,1767.484,LESS,322,1448,1770,4,1,-21.0,-1.9685577674164243,21.0,2.0952908873087353,-0.23287831581828874,-0.121164551336604,241,131,110,0,1.6155472260277064,1.9898509427197442,1.170500554541026,0.8312765295130061,0.3314038976074246,0.3314038976074246,1.170500554541026,1.9898509427197442,0,1,1,2,1.9898509427197442,1.170500554541026
4630,20,71,47,126,110,1,8489.855,80,1052.804,LESS,-540,3914,3374,3,2,-16.0,-1.4998535370791803,16.0,1.222253017596762,0.8283393258853051,1.4795466013758696,236,126,110,0,1.5158220886185887,1.7947675169629065,1.170500554541026,0.18141865627808282,-0.4697089337943187,0.4697089337943187,1.170500554541026,1.7947675169629065,1,1,0,2,1.7947675169629065,1.170500554541026
4631,20,72,50,110,133,0,1852.57,60,1344.08,LESS,-676,1192,516,2,1,23.0,2.1560394595513217,23.0,2.444506035193524,0.12086089808290923,-0.7664184832277247,243,110,133,1,1.6554372809913533,1.170500554541026,2.0678843130224793,-0.4684392169568405,-0.5961026055699998,0.5961026055699998,2.0678843130224793,1.170500554541026,1,1,0,2,2.0678843130224793,1.170500554541026
4632,20,73,47,110,126,0,4752.365,20,1201.9160000000004,LESS,-724,2738,2014,6,1,16.0,1.4998535370791803,16.0,1.222253017596762,-1.294095957521883,0.21483188081541646,236,110,126,1,1.5158220886185887,1.170500554541026,1.7947675169629065,2.1309922759828526,-0.6407121367849461,0.6407121367849461,1.7947675169629065,1.170500554541026,0,1,0,2,1.7947675169629065,1.170500554541026
4633,20,74,12,48,50,0,2084.81,80,2020.29,LESS,232,878,1110,2,2,2.0,0.18748169213489754,2.0,-1.222253017596762,0.8283393258853051,-0.6878316919044141,98,48,50,1,-1.2365917038730592,-1.248533924843761,-1.170500554541026,-0.4684392169568405,0.24776102657940038,0.24776102657940038,-1.170500554541026,-1.248533924843761,1,1,1,0,-1.248533924843761,-1.170500554541026
4634,20,75,32,80,77,0,1728.6270000000004,90,1612.321,LESS,66,828,894,2,2,-3.0,-0.28122253820234633,3.0,-1.0476454436543674,1.1820785397865032,-0.8083590734662064,157,80,77,0,-0.05983508244547061,0.0,-0.1170500554541026,-0.4684392169568405,0.09348639779437784,0.09348639779437784,-0.1170500554541026,0.0,1,1,1,1,0.0,-0.1170500554541026
4635,20,76,43,117,110,1,3484.634,40,1543.7720000000004,LESS,902,1090,1992,2,2,-7.0,-0.6561859224721414,7.0,-0.34921514788478913,-0.5866175297194867,-0.21415068700705892,227,117,110,0,1.3363168412821769,1.4436173506005987,1.170500554541026,-0.4684392169568405,0.8704357331213587,0.8704357331213587,1.170500554541026,1.4436173506005987,0,0,1,2,1.4436173506005987,1.170500554541026
4636,20,77,40,80,64,0,2587.182,70,1801.126,LESS,-604,1106,502,2,1,-16.0,-1.4998535370791803,16.0,1.222253017596762,0.4746001119841072,-0.5178359825921762,144,80,64,0,-0.3191204397091766,0.0,-0.6242669624218805,-0.4684392169568405,-0.5291883087475804,0.5291883087475804,-0.6242669624218805,0.0,1,0,0,1,0.0,-0.6242669624218805
4637,20,78,31,80,78,0,1938.383,80,3506.527,LESS,-774,1484,710,3,2,-2.0,-0.18748169213489754,2.0,-1.222253017596762,0.8283393258853051,-0.7373805555502047,158,80,78,0,-0.03989005496364707,0.0,-0.07803337030273506,0.18141865627808282,-0.6871803984671818,0.6871803984671818,-0.07803337030273506,0.0,1,1,0,1,0.0,-0.07803337030273506
4638,20,79,46,124,110,1,2779.519,10,2201.882,LESS,-720,2236,1516,3,1,-14.0,-1.3123718449442827,14.0,0.8730378697119728,-1.6478351714230806,-0.4527518124115375,234,124,110,0,1.4759320336549415,1.7167341466601715,1.170500554541026,0.18141865627808282,-0.6369946758503673,0.6369946758503673,1.170500554541026,1.7167341466601715,0,1,0,2,1.7167341466601715,1.170500554541026
4639,20,80,58,92,110,0,2253.028,80,1708.894,LESS,50,1016,1066,2,2,18.0,1.6873352292140782,18.0,1.571468165481551,0.8283393258853051,-0.6309090564289377,202,92,110,1,0.8376911542365885,0.4682002218164104,1.170500554541026,-0.4684392169568405,0.07861655405606242,0.07861655405606242,1.170500554541026,0.4682002218164104,1,0,1,2,1.170500554541026,0.4682002218164104
4640,20,81,48,128,110,0,3294.411,60,2293.986,MORE,-102,1376,1274,4,1,-18.0,-1.6873352292140782,18.0,1.571468165481551,0.12086089808290923,-0.2785195089408089,238,128,110,1,1.5557121435822359,1.8728008872656416,1.170500554541026,0.8312765295130061,-0.06264696145793408,0.06264696145793408,1.170500554541026,1.8728008872656416,0,1,0,2,1.8728008872656416,1.170500554541026
4641,20,82,8,50,58,1,2209.8520000000008,90,1644.3010000000004,MORE,1294,820,2114,1,2,8.0,0.7499267685395902,8.0,-0.17460757394239454,1.1820785397865032,-0.6455192153256617,108,50,58,0,-1.0371414290548238,-1.170500554541026,-0.8583670733300858,-1.1182970901917637,1.2347469047100865,1.2347469047100865,-0.8583670733300858,-1.170500554541026,1,0,1,0,-1.170500554541026,-0.8583670733300858
4642,20,83,4,54,50,0,3181.828,80,1615.6470000000004,MORE,726,1598,2324,4,2,-4.0,-0.3749633842697951,4.0,-0.8730378697119728,0.8283393258853051,-0.3166160329140791,104,54,50,1,-1.116921538982118,-1.0144338139355558,-1.170500554541026,0.8312765295130061,0.706867451999889,0.706867451999889,-1.170500554541026,-1.0144338139355558,1,1,1,0,-1.0144338139355558,-1.170500554541026
4643,20,84,37,80,69,0,5088.622,50,1677.809,MORE,-72,2446,2374,5,1,-11.0,-1.0311493067419364,11.0,0.34921514788478913,-0.23287831581828874,0.3286165806518032,149,80,69,1,-0.21939530230005888,0.0,-0.4291835366650429,1.4811344027479294,-0.03476600444859267,0.03476600444859267,-0.4291835366650429,0.0,0,1,0,1,0.0,-0.4291835366650429
4644,20,85,52,105,110,1,1506.849,80,2266.638,MORE,834,452,1286,1,2,5.0,0.4687042303372438,5.0,-0.6984302957695783,0.8283393258853051,-0.8834056692554811,215,105,110,0,1.0969765115002945,0.9754171287841883,1.170500554541026,-1.1182970901917637,0.8072388972335182,0.8072388972335182,1.170500554541026,0.9754171287841883,1,0,1,2,1.170500554541026,0.9754171287841883
4645,20,86,5,55,50,1,1570.053,70,1025.037,MORE,376,376,752,1,2,-5.0,-0.4687042303372438,5.0,-0.6984302957695783,0.4746001119841072,-0.8620183132496316,105,55,50,1,-1.0969765115002945,-0.9754171287841883,-1.170500554541026,-1.1182970901917637,0.3815896202242392,0.3815896202242392,-1.170500554541026,-0.9754171287841883,1,0,1,0,-0.9754171287841883,-1.170500554541026
4646,20,87,30,96,80,0,1812.311,90,1462.876,MORE,96,950,1046,2,2,-16.0,-1.4998535370791803,16.0,1.222253017596762,1.1820785397865032,-0.7800415698272991,176,96,80,1,0.3191204397091766,0.6242669624218805,0.0,-0.4684392169568405,0.12136735480371927,0.12136735480371927,0.0,0.6242669624218805,1,0,0,1,0.6242669624218805,0.0
4647,20,88,33,80,75,0,4295.981,60,2239.49,MORE,418,1300,1718,3,1,-5.0,-0.4687042303372438,5.0,-0.6984302957695783,0.12086089808290923,0.06039787215498875,155,80,75,1,-0.09972513740911768,0.0,-0.19508342575683765,0.18141865627808282,0.42062296003731714,0.42062296003731714,-0.19508342575683765,0.0,0,1,1,1,0.0,-0.19508342575683765
4648,20,89,48,110,128,1,2363.489,90,1679.751,MORE,804,860,1664,1,2,18.0,1.6873352292140782,18.0,1.571468165481551,1.1820785397865032,-0.5935305877914756,238,110,128,0,1.5557121435822359,1.170500554541026,1.8728008872656416,-1.1182970901917637,0.7793579402241767,0.7793579402241767,1.8728008872656416,1.170500554541026,1,0,1,2,1.8728008872656416,1.170500554541026
4649,20,90,9,59,50,0,2703.242,70,1139.148,MORE,-882,1626,744,2,1,-9.0,-0.8436676146070391,9.0,0.0,0.4746001119841072,-0.4785628900974146,109,59,50,1,-1.0171964015730004,-0.8193503881787182,-1.170500554541026,-0.4684392169568405,-0.7875518437008109,0.7875518437008109,-1.170500554541026,-0.8193503881787182,1,0,0,0,-0.8193503881787182,-1.170500554541026
4650,20,91,44,110,119,1,2496.354,70,2891.36,MORE,258,1164,1422,3,1,9.0,0.8436676146070391,9.0,0.0,0.4746001119841072,-0.5485709166358967,229,110,119,0,1.376206896245824,1.170500554541026,1.5216507209033339,0.18141865627808282,0.27192452265416295,0.27192452265416295,1.5216507209033339,1.170500554541026,1,1,1,2,1.5216507209033339,1.170500554541026
4651,20,92,2,52,50,1,1525.454,70,2210.635,MORE,532,606,1138,2,1,-2.0,-0.18748169213489754,2.0,-1.222253017596762,0.4746001119841072,-0.8771099955878522,102,52,50,1,-1.156811593945765,-1.092467184238291,-1.170500554541026,-0.4684392169568405,0.5265705966728146,0.5265705966728146,-1.170500554541026,-1.092467184238291,1,0,1,0,-1.092467184238291,-1.170500554541026
4652,20,93,8,58,50,1,1282.81,70,1068.826,MORE,574,440,1014,1,2,-8.0,-0.7499267685395902,8.0,-0.17460757394239454,0.4746001119841072,-0.9592173560505344,108,58,50,1,-1.0371414290548238,-0.8583670733300858,-1.170500554541026,-1.1182970901917637,0.5656039364858926,0.5656039364858926,-1.170500554541026,-0.8583670733300858,1,0,1,0,-0.8583670733300858,-1.170500554541026
4653,20,94,44,119,110,1,7640.016,80,885.395,MORE,1356,2570,3926,7,2,-9.0,-0.8436676146070391,9.0,0.0,0.8283393258853051,1.1919728838792676,229,119,110,1,1.376206896245824,1.5216507209033339,1.170500554541026,2.780850149217776,1.2923675491960587,1.2923675491960587,1.170500554541026,1.5216507209033339,1,1,1,2,1.5216507209033339,1.170500554541026
4654,20,95,34,74,80,1,1619.68,20,1279.638,MORE,354,416,770,1,2,6.0,0.5624450764046927,6.0,-0.5238227218271837,-1.294095957521883,-0.8452252255257169,154,74,80,0,-0.11967016489094122,-0.2341001109082052,0.0,-1.1182970901917637,0.3611435850840555,0.3611435850840555,0.0,-0.2341001109082052,0,0,1,1,-0.2341001109082052,0.0
4655,20,96,24,86,80,1,3026.844,90,1736.184,MORE,920,1166,2086,3,2,-6.0,-0.5624450764046927,6.0,-0.5238227218271837,1.1820785397865032,-0.3690604665450296,166,86,80,1,0.11967016489094122,0.2341001109082052,0.0,0.18141865627808282,0.8871643073269635,0.8871643073269635,0.0,0.2341001109082052,1,1,1,1,0.2341001109082052,0.0
4656,20,97,39,66,80,1,2465.649,50,1025.586,MORE,340,858,1198,3,2,14.0,1.3123718449442827,14.0,0.8730378697119728,-0.23287831581828874,-0.5589610622937603,146,66,80,0,-0.2792303847455295,-0.5462335921191455,0.0,0.18141865627808282,0.3481324718130295,0.3481324718130295,0.0,-0.5462335921191455,0,1,1,1,-0.5462335921191455,0.0
4657,20,98,9,50,59,1,1231.446,80,2299.405,MORE,376,630,1006,1,2,9.0,0.8436676146070391,9.0,0.0,0.8283393258853051,-0.9765982204560224,109,50,59,0,-1.0171964015730004,-1.170500554541026,-0.8193503881787182,-1.1182970901917637,0.3815896202242392,0.3815896202242392,-0.8193503881787182,-1.170500554541026,1,0,1,0,-1.170500554541026,-0.8193503881787182
4658,20,99,57,94,110,1,1580.251,90,1751.739,MORE,2108,240,2348,1,2,16.0,1.4998535370791803,16.0,1.222253017596762,1.1820785397865032,-0.8585674516499282,204,94,110,0,0.8775812092002355,0.5462335921191455,1.170500554541026,-1.1182970901917637,1.9912502048968836,1.9912502048968836,1.170500554541026,0.5462335921191455,1,0,1,2,1.170500554541026,0.5462335921191455
4659,20,100,60,110,87,0,3363.672,70,1755.78,MORE,142,1576,1718,1,1,-23.0,-2.1560394595513217,23.0,2.444506035193524,0.4746001119841072,-0.2550825482370377,197,110,87,1,0.7379660168274708,1.170500554541026,0.27311679605957273,-1.1182970901917637,0.1641181555513761,0.1641181555513761,0.27311679605957273,1.170500554541026,1,0,0,2,1.170500554541026,0.27311679605957273
4660,20,101,33,75,80,1,2525.554,90,2077.096,MORE,1706,428,2134,1,2,5.0,0.4687042303372438,5.0,-0.6984302957695783,1.1820785397865032,-0.5386900420809506,155,75,80,0,-0.09972513740911768,-0.19508342575683765,0.0,-1.1182970901917637,1.6176453809717086,1.6176453809717086,0.0,-0.19508342575683765,1,0,1,1,-0.19508342575683765,0.0
4661,20,102,15,50,45,0,4689.724,70,1785.424,MORE,-952,2622,1670,4,1,-5.0,-0.4687042303372438,5.0,-0.6984302957695783,0.4746001119841072,0.19363503619225306,95,50,45,1,-1.2964267863185297,-1.170500554541026,-1.3655839802978638,0.8312765295130061,-0.8526074100559409,0.8526074100559409,-1.3655839802978638,-1.170500554541026,1,1,0,0,-1.170500554541026,-1.3655839802978638
4662,20,103,59,89,110,1,1496.447,90,1299.178,MORE,1254,396,1650,1,2,21.0,1.9685577674164243,21.0,2.0952908873087353,1.1820785397865032,-0.8869255616226233,199,89,110,0,0.7778560717911179,0.3511501663623078,1.170500554541026,-1.1182970901917637,1.197572295364298,1.197572295364298,1.170500554541026,0.3511501663623078,1,0,1,2,1.170500554541026,0.3511501663623078
4663,20,104,29,80,94,1,3672.478,20,1653.217,MORE,908,1218,2126,3,1,14.0,1.3123718449442827,14.0,0.8730378697119728,-1.294095957521883,-0.15058688564064518,174,80,94,0,0.2792303847455295,0.0,0.5462335921191455,0.18141865627808282,0.876011924523227,0.876011924523227,0.5462335921191455,0.0,0,1,1,1,0.5462335921191455,0.0
4664,20,105,55,110,98,0,4749.541,40,2323.626,MORE,-586,2470,1884,4,1,-12.0,-1.124890152809385,12.0,0.5238227218271837,-0.5866175297194867,0.21387627842695192,208,110,98,1,0.9573613191275298,1.170500554541026,0.7023003327246156,0.8312765295130061,-0.5124597345419756,0.5124597345419756,0.7023003327246156,1.170500554541026,0,1,0,2,1.170500554541026,0.7023003327246156
4665,20,106,29,94,80,0,4006.099,60,2068.903,MORE,-732,2320,1588,4,1,-14.0,-1.3123718449442827,14.0,0.8730378697119728,0.12086089808290923,-0.037694171603122925,174,94,80,1,0.2792303847455295,0.5462335921191455,0.0,0.8312765295130061,-0.6481470586541038,0.6481470586541038,0.0,0.5462335921191455,0,1,0,1,0.5462335921191455,0.0
4666,20,107,57,110,94,0,7331.998,50,1397.411,MORE,30,3058,3088,4,1,-16.0,-1.4998535370791803,16.0,1.222253017596762,-0.23287831581828874,1.0877438695414126,204,110,94,1,0.8775812092002355,1.170500554541026,0.5462335921191455,0.8312765295130061,0.06002924938316814,0.06002924938316814,0.5462335921191455,1.170500554541026,0,1,0,2,1.170500554541026,0.5462335921191455
4667,20,108,39,80,66,0,2698.953,80,1125.788,MORE,-154,1494,1340,2,2,-14.0,-1.3123718449442827,14.0,0.8730378697119728,0.8283393258853051,-0.4800142281442011,146,80,66,1,-0.2792303847455295,0.0,-0.5462335921191455,-0.4684392169568405,-0.11097395360745921,0.11097395360745921,-0.5462335921191455,0.0,1,0,0,1,0.0,-0.5462335921191455
4668,20,109,4,50,54,1,2591.545,80,2015.856,MORE,256,1212,1468,3,2,4.0,0.3749633842697951,4.0,-0.8730378697119728,0.8283393258853051,-0.5163596039728875,104,50,54,0,-1.116921538982118,-1.170500554541026,-1.0144338139355558,0.18141865627808282,0.2700657921868735,0.2700657921868735,-1.0144338139355558,-1.170500554541026,1,1,1,0,-1.170500554541026,-1.0144338139355558
4669,20,110,55,98,110,1,2714.388,100,2432.337,MORE,712,1244,1956,1,2,12.0,1.124890152809385,12.0,0.5238227218271837,1.5358177536877011,-0.4747912384607905,208,98,110,0,0.9573613191275298,0.7023003327246156,1.170500554541026,-1.1182970901917637,0.693856338728863,0.693856338728863,1.170500554541026,0.7023003327246156,1,0,1,2,1.170500554541026,0.7023003327246156
4670,20,111,2,50,52,1,1393.027,10,524.695,MORE,554,464,1018,1,2,2.0,0.18748169213489754,2.0,-1.222253017596762,-1.6478351714230806,-0.9219214536251068,102,50,52,0,-1.156811593945765,-1.170500554541026,-1.092467184238291,-1.1182970901917637,0.5470166318129982,0.5470166318129982,-1.092467184238291,-1.170500554541026,0,0,1,0,-1.170500554541026,-1.092467184238291
4671,20,112,59,110,89,0,2143.869,80,1730.6029999999996,MORE,-776,1396,620,2,1,-21.0,-1.9685577674164243,21.0,2.0952908873087353,0.8283393258853051,-0.6678469463448059,199,110,89,1,0.7778560717911179,1.170500554541026,0.3511501663623078,-0.4684392169568405,-0.6890391289344712,0.6890391289344712,0.3511501663623078,1.170500554541026,1,0,0,2,1.170500554541026,0.3511501663623078
4672,20,113,60,87,110,1,1678.118,80,1862.228,MORE,1142,560,1702,1,2,23.0,2.1560394595513217,23.0,2.444506035193524,0.8283393258853051,-0.8254506177434591,197,87,110,0,0.7379660168274708,0.27311679605957273,1.170500554541026,-1.1182970901917637,1.09348338919609,1.09348338919609,1.170500554541026,0.27311679605957273,1,0,1,2,1.170500554541026,0.27311679605957273
4673,20,114,52,110,105,1,1719.466,80,2532.371,MORE,552,662,1214,1,1,-5.0,-0.4687042303372438,5.0,-0.6984302957695783,0.8283393258853051,-0.8114590286647635,215,110,105,1,1.0969765115002945,1.170500554541026,0.9754171287841883,-1.1182970901917637,0.5451579013457089,0.5451579013457089,0.9754171287841883,1.170500554541026,1,0,1,2,1.170500554541026,0.9754171287841883
4674,20,115,30,80,96,1,2563.033,80,1340.479,MORE,700,996,1696,1,2,16.0,1.4998535370791803,16.0,1.222253017596762,0.8283393258853051,-0.5260076688807855,176,80,96,0,0.3191204397091766,0.0,0.6242669624218805,-1.1182970901917637,0.6827039559251264,0.6827039559251264,0.6242669624218805,0.0,1,0,1,1,0.6242669624218805,0.0
4675,20,116,24,80,86,1,3619.667,20,2001.123,MORE,702,992,1694,1,1,6.0,0.5624450764046927,6.0,-0.5238227218271837,-1.294095957521883,-0.16845739475438684,166,80,86,0,0.11967016489094122,0.0,0.2341001109082052,-1.1182970901917637,0.6845626863924159,0.6845626863924159,0.2341001109082052,0.0,0,0,1,1,0.2341001109082052,0.0
4676,20,117,5,50,55,1,1547.646,60,873.6260000000002,MORE,616,524,1140,1,2,5.0,0.4687042303372438,5.0,-0.6984302957695783,0.12086089808290923,-0.8696005309260932,105,50,55,0,-1.0969765115002945,-1.170500554541026,-0.9754171287841883,-1.1182970901917637,0.6046372762989705,0.6046372762989705,-0.9754171287841883,-1.170500554541026,0,0,1,0,-1.170500554541026,-0.9754171287841883
4677,20,118,34,80,74,0,3393.361,70,2145.675,MORE,28,1442,1470,3,1,-6.0,-0.5624450764046927,6.0,-0.5238227218271837,0.4746001119841072,-0.24503620287190794,154,80,74,1,-0.11967016489094122,0.0,-0.2341001109082052,0.18141865627808282,0.05817051891587872,0.05817051891587872,-0.2341001109082052,0.0,1,1,0,1,0.0,-0.2341001109082052
4678,20,119,15,45,50,1,3168.93,30,1353.447,MORE,562,1100,1662,3,2,5.0,0.4687042303372438,5.0,-0.6984302957695783,-0.9403567436206848,-0.3209805370240001,95,45,50,0,-1.2964267863185297,-1.3655839802978638,-1.170500554541026,0.18141865627808282,0.5544515536821559,0.5544515536821559,-1.170500554541026,-1.3655839802978638,0,1,1,0,-1.3655839802978638,-1.170500554541026
4679,20,120,37,69,80,0,3071.428,70,2063.387,MORE,-902,1792,890,2,1,11.0,1.0311493067419364,11.0,0.34921514788478913,0.4746001119841072,-0.3539738599985326,149,69,80,0,-0.21939530230005888,-0.4291835366650429,0.0,-0.4684392169568405,-0.8061391483737051,0.8061391483737051,0.0,-0.4291835366650429,1,0,0,1,-0.4291835366650429,0.0
4680,20,121,48,128,110,1,3124.094,80,5048.653,LESS,1646,950,2596,2,2,-18.0,-1.6873352292140782,18.0,1.571468165481551,0.8283393258853051,-0.33615241687145075,238,128,110,0,1.5557121435822359,1.8728008872656416,1.170500554541026,-0.4684392169568405,1.5618834669530257,1.5618834669530257,1.170500554541026,1.8728008872656416,1,0,1,2,1.8728008872656416,1.170500554541026
4681,20,122,8,50,58,0,1254.202,80,1846.708,LESS,458,646,1104,2,2,8.0,0.7499267685395902,8.0,-0.17460757394239454,0.8283393258853051,-0.9688979060254624,108,50,58,1,-1.0371414290548238,-1.170500554541026,-0.8583670733300858,-0.4684392169568405,0.45779756938310573,0.45779756938310573,-0.8583670733300858,-1.170500554541026,1,0,1,0,-1.170500554541026,-0.8583670733300858
4682,20,123,4,54,50,1,3193.128,70,1978.408,LESS,934,944,1878,3,2,-4.0,-0.3749633842697951,4.0,-0.8730378697119728,0.4746001119841072,-0.3127922698157609,104,54,50,0,-1.116921538982118,-1.0144338139355558,-1.170500554541026,0.18141865627808282,0.9001754205979895,0.9001754205979895,-1.170500554541026,-1.0144338139355558,1,1,1,0,-1.0144338139355558,-1.170500554541026
4683,20,124,37,80,69,1,4459.433,90,1530.2279999999996,LESS,1956,1536,3492,3,2,-11.0,-1.0311493067419364,11.0,0.34921514788478913,1.1820785397865032,0.1157077594068737,149,80,69,0,-0.21939530230005888,0.0,-0.4291835366650429,0.18141865627808282,1.8499866893828871,1.8499866893828871,-0.4291835366650429,0.0,1,1,1,1,0.0,-0.4291835366650429
4684,20,125,52,105,110,1,4051.674,70,1461.986,LESS,244,1736,1980,3,2,5.0,0.4687042303372438,5.0,-0.6984302957695783,0.4746001119841072,-0.022272224416764585,215,105,110,1,1.0969765115002945,0.9754171287841883,1.170500554541026,0.18141865627808282,0.25891340938313695,0.25891340938313695,1.170500554541026,0.9754171287841883,1,1,1,2,1.170500554541026,0.9754171287841883
4685,20,126,5,55,50,1,6400.453,60,1616.796,LESS,2716,1762,4478,3,2,-5.0,-0.4687042303372438,5.0,-0.6984302957695783,0.12086089808290923,0.7725219761411664,105,55,50,0,-1.0969765115002945,-0.9754171287841883,-1.170500554541026,0.18141865627808282,2.5563042669528695,2.5563042669528695,-1.170500554541026,-0.9754171287841883,1,1,1,0,-0.9754171287841883,-1.170500554541026
4686,20,127,30,96,80,1,3182.051,100,2201.79,LESS,1930,982,2912,3,2,-16.0,-1.4998535370791803,16.0,1.222253017596762,1.5358177536877011,-0.3165405728104574,176,96,80,0,0.3191204397091766,0.6242669624218805,0.0,0.18141865627808282,1.8258231933081246,1.8258231933081246,0.0,0.6242669624218805,1,1,1,1,0.6242669624218805,0.0
4687,20,128,33,80,75,1,4598.638,80,2433.785,LESS,2864,1130,3994,3,2,-5.0,-0.4687042303372438,5.0,-0.6984302957695783,0.8283393258853051,0.16281279853088948,155,80,75,0,-0.09972513740911768,0.0,-0.19508342575683765,0.18141865627808282,2.6938503215322873,2.6938503215322873,-0.19508342575683765,0.0,1,1,1,1,0.0,-0.19508342575683765
4688,20,129,48,110,128,1,3294.045,0,1756.7679999999998,LESS,-1190,2532,1342,2,1,18.0,1.6873352292140782,18.0,1.571468165481551,-2.0015743853242784,-0.2786433582588606,238,110,128,1,1.5557121435822359,1.170500554541026,1.8728008872656416,-0.4684392169568405,-1.0737963356633828,1.0737963356633828,1.8728008872656416,1.170500554541026,0,0,0,2,1.8728008872656416,1.170500554541026
4689,20,130,9,59,50,1,6806.852,10,2101.245,LESS,18,3068,3086,4,1,-9.0,-0.8436676146070391,9.0,0.0,-1.6478351714230806,0.9100417548485468,109,59,50,0,-1.0171964015730004,-0.8193503881787182,-1.170500554541026,0.8312765295130061,0.04887686657943158,0.04887686657943158,-1.170500554541026,-0.8193503881787182,0,1,1,0,-0.8193503881787182,-1.170500554541026
4690,20,131,44,110,119,1,3292.094,20,1153.475,LESS,-58,1468,1410,3,1,9.0,0.8436676146070391,9.0,0.0,-1.294095957521883,-0.27930354956902154,229,110,119,1,1.376206896245824,1.170500554541026,1.5216507209033339,0.18141865627808282,-0.021754891177566675,0.021754891177566675,1.5216507209033339,1.170500554541026,0,1,1,2,1.5216507209033339,1.170500554541026
4691,20,132,2,52,50,1,6791.02,40,2117.633,LESS,-58,3102,3044,4,2,-2.0,-0.18748169213489754,2.0,-1.222253017596762,-0.5866175297194867,0.9046844258775226,102,52,50,0,-1.156811593945765,-1.092467184238291,-1.170500554541026,0.8312765295130061,-0.021754891177566675,0.021754891177566675,-1.170500554541026,-1.092467184238291,0,1,1,0,-1.092467184238291,-1.170500554541026
4692,20,133,8,58,50,1,3599.396,80,2351.798,LESS,528,1252,1780,3,2,-8.0,-0.7499267685395902,8.0,-0.17460757394239454,0.8283393258853051,-0.17531681968943166,108,58,50,0,-1.0371414290548238,-0.8583670733300858,-1.170500554541026,0.18141865627808282,0.5228531357382357,0.5228531357382357,-1.170500554541026,-0.8583670733300858,1,1,1,0,-0.8583670733300858,-1.170500554541026
4693,20,134,44,119,110,1,3967.937,50,1763.42,LESS,490,1410,1900,2,2,-9.0,-0.8436676146070391,9.0,0.0,-0.23287831581828874,-0.050607662519761724,229,119,110,0,1.376206896245824,1.5216507209033339,1.170500554541026,-0.4684392169568405,0.48753725685973653,0.48753725685973653,1.170500554541026,1.5216507209033339,0,0,1,2,1.5216507209033339,1.170500554541026
4694,20,135,34,74,80,0,2689.5,100,1422.183,LESS,-274,1766,1492,2,2,6.0,0.5624450764046927,6.0,-0.5238227218271837,1.5358177536877011,-0.4832129920883074,154,74,80,1,-0.11967016489094122,-0.2341001109082052,0.0,-0.4684392169568405,-0.22249778164482487,0.22249778164482487,0.0,-0.2341001109082052,1,0,0,1,-0.2341001109082052,0.0
4695,20,136,24,86,80,1,2853.552,20,1437.645,LESS,426,1188,1614,2,1,-6.0,-0.5624450764046927,6.0,-0.5238227218271837,-1.294095957521883,-0.4277000731674853,166,86,80,0,0.11967016489094122,0.2341001109082052,0.0,-0.4684392169568405,0.42805788190647487,0.42805788190647487,0.0,0.2341001109082052,0,0,1,1,0.2341001109082052,0.0
4696,20,137,39,66,80,0,3136.9040000000005,90,2832.524000000001,LESS,-322,1908,1586,3,2,14.0,1.3123718449442827,14.0,0.8730378697119728,1.1820785397865032,-0.3318176907396404,146,66,80,1,-0.2792303847455295,-0.5462335921191455,0.0,0.18141865627808282,-0.26710731285977113,0.26710731285977113,0.0,-0.5462335921191455,1,1,0,1,-0.5462335921191455,0.0
4697,20,138,9,50,59,0,1642.807,70,2112.196,LESS,-344,1112,768,2,2,9.0,0.8436676146070391,9.0,0.0,0.4746001119841072,-0.8373993698465308,109,50,59,1,-1.0171964015730004,-1.170500554541026,-0.8193503881787182,-0.4684392169568405,-0.2875533479999548,0.2875533479999548,-0.8193503881787182,-1.170500554541026,1,0,0,0,-1.170500554541026,-0.8193503881787182
4698,20,139,57,94,110,0,2324.876,40,1138.663,LESS,-640,1534,894,3,2,16.0,1.4998535370791803,16.0,1.222253017596762,-0.5866175297194867,-0.606596690845932,204,94,110,1,0.8775812092002355,0.5462335921191455,1.170500554541026,0.18141865627808282,-0.5626454571587901,0.5626454571587901,1.170500554541026,0.5462335921191455,0,1,0,2,1.170500554541026,0.5462335921191455
4699,20,140,60,110,87,1,3933.011,20,2096.633,LESS,-788,2186,1398,3,1,-23.0,-2.1560394595513217,23.0,2.444506035193524,-1.294095957521883,-0.06242613596859885,197,110,87,0,0.7379660168274708,1.170500554541026,0.27311679605957273,0.18141865627808282,-0.7001915117382078,0.7001915117382078,0.27311679605957273,1.170500554541026,0,1,0,2,1.170500554541026,0.27311679605957273
4700,20,141,33,75,80,0,1878.314,70,2397.341,LESS,-588,1138,550,2,1,5.0,0.4687042303372438,5.0,-0.6984302957695783,0.4746001119841072,-0.757707071085857,155,75,80,1,-0.09972513740911768,-0.19508342575683765,0.0,-0.4684392169568405,-0.514318465009265,0.514318465009265,0.0,-0.19508342575683765,1,0,0,1,-0.19508342575683765,0.0
4701,20,142,15,50,45,1,4850.387,60,2346.994,LESS,-140,2292,2152,5,1,-5.0,-0.4687042303372438,5.0,-0.6984302957695783,0.12086089808290923,0.2480011645696945,95,50,45,0,-1.2964267863185297,-1.170500554541026,-1.3655839802978638,1.4811344027479294,-0.09796284033643321,0.09796284033643321,-1.3655839802978638,-1.170500554541026,0,1,0,0,-1.170500554541026,-1.3655839802978638
4702,20,143,59,89,110,0,2801.713,80,2863.731,LESS,-906,1898,992,1,1,21.0,1.9685577674164243,21.0,2.0952908873087353,0.8283393258853051,-0.4452416709775485,199,89,110,1,0.7778560717911179,0.3511501663623078,1.170500554541026,-1.1182970901917637,-0.8098566093082841,0.8098566093082841,1.170500554541026,0.3511501663623078,1,0,0,2,1.170500554541026,0.3511501663623078
4703,20,144,29,80,94,0,3720.082,60,2004.703,LESS,-926,2360,1434,2,2,14.0,1.3123718449442827,14.0,0.8730378697119728,0.12086089808290923,-0.13447835302716404,174,80,94,1,0.2792303847455295,0.0,0.5462335921191455,-0.4684392169568405,-0.8284439139811783,0.8284439139811783,0.5462335921191455,0.0,0,0,0,1,0.5462335921191455,0.0
4704,20,145,55,110,98,1,4276.25,30,1867.07,LESS,1320,1224,2544,2,2,-12.0,-1.124890152809385,12.0,0.5238227218271837,-0.9403567436206848,0.05372117572198745,208,110,98,0,0.9573613191275298,1.170500554541026,0.7023003327246156,-0.4684392169568405,1.258910400784849,1.258910400784849,0.7023003327246156,1.170500554541026,0,0,1,2,1.170500554541026,0.7023003327246156
4705,20,146,29,94,80,1,3891.52,60,1742.48,LESS,1522,1142,2664,2,2,-14.0,-1.3123718449442827,14.0,0.8730378697119728,0.12086089808290923,-0.07646611426172438,174,94,80,0,0.2792303847455295,0.5462335921191455,0.0,-0.4684392169568405,1.4466421779810812,1.4466421779810812,0.0,0.5462335921191455,0,0,1,1,0.5462335921191455,0.0
4706,20,147,57,110,94,1,4596.197,90,2029.35,LESS,1714,1894,3608,3,2,-16.0,-1.4998535370791803,16.0,1.222253017596762,1.1820785397865032,0.16198679802442986,204,110,94,0,0.8775812092002355,1.170500554541026,0.5462335921191455,0.18141865627808282,1.6250803028408662,1.6250803028408662,0.5462335921191455,1.170500554541026,1,1,1,2,1.170500554541026,0.5462335921191455
4707,20,148,39,80,66,1,3366.531,80,1437.2479999999996,LESS,680,1404,2084,3,2,-14.0,-1.3123718449442827,14.0,0.8730378697119728,0.8283393258853051,-0.2541151023345518,146,80,66,0,-0.2792303847455295,0.0,-0.5462335921191455,0.18141865627808282,0.6641166512522322,0.6641166512522322,-0.5462335921191455,0.0,1,1,1,1,0.0,-0.5462335921191455
4708,20,149,4,50,54,0,2127.998,70,2620.436,LESS,-46,982,936,2,1,4.0,0.3749633842697951,4.0,-0.8730378697119728,0.4746001119841072,-0.6732174723743111,104,50,54,1,-1.116921538982118,-1.170500554541026,-1.0144338139355558,-0.4684392169568405,-0.01060250837383011,0.01060250837383011,-1.0144338139355558,-1.170500554541026,1,0,1,0,-1.170500554541026,-1.0144338139355558
4709,20,150,55,98,110,0,5089.17,0,2912.297,LESS,-1662,3466,1804,3,1,12.0,1.124890152809385,12.0,0.5238227218271837,-2.0015743853242784,0.3288020162427657,208,98,110,1,0.9573613191275298,0.7023003327246156,1.170500554541026,0.18141865627808282,-1.5124567259436876,1.5124567259436876,1.170500554541026,0.7023003327246156,0,1,0,2,1.170500554541026,0.7023003327246156
4710,20,151,2,50,52,0,4300.453,90,3532.88,LESS,-154,2390,2236,1,2,2.0,0.18748169213489754,2.0,-1.222253017596762,1.1820785397865032,0.06191113486080125,102,50,52,1,-1.156811593945765,-1.170500554541026,-1.092467184238291,-1.1182970901917637,-0.11097395360745921,0.11097395360745921,-1.092467184238291,-1.170500554541026,1,0,0,0,-1.170500554541026,-1.092467184238291
4711,20,152,59,110,89,1,4097.556,80,1976.637,LESS,1936,1178,3114,1,2,-21.0,-1.9685577674164243,21.0,2.0952908873087353,0.8283393258853051,-0.006746392693133428,199,110,89,0,0.7778560717911179,1.170500554541026,0.3511501663623078,-1.1182970901917637,1.8313993847099928,1.8313993847099928,0.3511501663623078,1.170500554541026,1,0,1,2,1.170500554541026,0.3511501663623078
4712,20,153,60,87,110,0,4457.96,90,2348.632,LESS,1364,1800,3164,4,2,23.0,2.1560394595513217,23.0,2.444506035193524,1.1820785397865032,0.11520931665963274,197,87,110,1,0.7379660168274708,0.27311679605957273,1.170500554541026,0.8312765295130061,1.2998024710652165,1.2998024710652165,1.170500554541026,0.27311679605957273,1,1,1,2,1.170500554541026,0.27311679605957273
4713,20,154,52,110,105,1,8144.823,10,2527.076,LESS,356,3586,3942,5,1,-5.0,-0.4687042303372438,5.0,-0.6984302957695783,-1.6478351714230806,1.3627925633812759,215,110,105,0,1.0969765115002945,1.170500554541026,0.9754171287841883,1.4811344027479294,0.3630023155513449,0.3630023155513449,0.9754171287841883,1.170500554541026,0,1,1,2,1.170500554541026,0.9754171287841883
4714,20,155,30,80,96,0,1909.219,70,2080.798,LESS,-62,1102,1040,2,1,16.0,1.4998535370791803,16.0,1.222253017596762,0.4746001119841072,-0.7472492482050144,176,80,96,1,0.3191204397091766,0.0,0.6242669624218805,-0.4684392169568405,-0.025472352112145533,0.025472352112145533,0.6242669624218805,0.0,1,0,1,1,0.6242669624218805,0.0
4715,20,156,24,80,86,0,4475.399,10,1887.047,LESS,-1184,3024,1840,4,1,6.0,0.5624450764046927,6.0,-0.5238227218271837,-1.6478351714230806,0.12111043211729396,166,80,86,1,0.11967016489094122,0.0,0.2341001109082052,0.8312765295130061,-1.0682201442615145,1.0682201442615145,0.2341001109082052,0.0,0,1,0,1,0.2341001109082052,0.0
4716,20,157,5,50,55,0,1875.828,0,3479.897,LESS,-2056,2912,856,2,1,5.0,0.4687042303372438,5.0,-0.6984302957695783,-2.0015743853242784,-0.7585482989674871,105,50,55,1,-1.0969765115002945,-1.170500554541026,-0.9754171287841883,-0.4684392169568405,-1.878626627999705,1.878626627999705,-0.9754171287841883,-1.170500554541026,0,1,0,0,-1.170500554541026,-0.9754171287841883
4717,20,158,34,80,74,1,3845.49,30,1695.835,LESS,1224,1004,2228,3,2,-6.0,-0.5624450764046927,6.0,-0.5238227218271837,-0.9403567436206848,-0.09204202713036026,154,80,74,0,-0.11967016489094122,0.0,-0.2341001109082052,0.18141865627808282,1.1696913383549565,1.1696913383549565,-0.2341001109082052,0.0,0,1,1,1,0.0,-0.2341001109082052
4718,20,159,15,45,50,1,6433.939,10,2233.093,LESS,-1150,3732,2582,3,1,5.0,0.4687042303372438,5.0,-0.6984302957695783,-1.6478351714230806,0.7838531735845541,95,45,50,1,-1.2964267863185297,-1.3655839802978638,-1.170500554541026,0.18141865627808282,-1.0366217263175943,1.0366217263175943,-1.170500554541026,-1.3655839802978638,0,1,0,0,-1.3655839802978638,-1.170500554541026
4719,20,160,37,69,80,0,3046.212,30,1705.859,LESS,-1014,1870,856,2,1,11.0,1.0311493067419364,11.0,0.34921514788478913,-0.9403567436206848,-0.3625066042717353,149,69,80,1,-0.21939530230005888,-0.4291835366650429,0.0,-0.4684392169568405,-0.9102280545419131,0.9102280545419131,0.0,-0.4291835366650429,0,0,0,1,-0.4291835366650429,0.0
4720,20,161,3,50,53,0,2580.315,50,2034.98,MORE,-1046,2008,962,4,1,3.0,0.28122253820234633,3.0,-1.0476454436543674,-0.23287831581828874,-0.5201596800431629,103,50,53,0,-1.1368665664639415,-1.170500554541026,-1.0534504990869233,0.8312765295130061,-0.9399677420185439,0.9399677420185439,-1.0534504990869233,-1.170500554541026,0,1,0,0,-1.170500554541026,-1.0534504990869233
4721,20,162,20,50,40,0,2722.576,80,1303.493,MORE,712,1108,1820,2,2,-10.0,-0.9374084606744876,10.0,0.17460757394239454,0.8283393258853051,-0.4720205329520268,90,50,40,1,-1.3961519237276474,-1.170500554541026,-1.5606674060547012,-0.4684392169568405,0.693856338728863,0.693856338728863,-1.5606674060547012,-1.170500554541026,1,0,1,0,-1.170500554541026,-1.5606674060547012
4722,20,163,25,80,88,1,2938.429,100,1416.189,MORE,814,1404,2218,2,2,8.0,0.7499267685395902,8.0,-0.17460757394239454,1.5358177536877011,-0.3989788748935074,168,80,88,0,0.1595602198545883,0.0,0.31213348121094026,-0.4684392169568405,0.7886515925606239,0.7886515925606239,0.31213348121094026,0.0,1,0,1,1,0.31213348121094026,0.0
4723,20,164,42,115,110,1,3295.707000000001,10,1834.338,MORE,-816,2206,1390,3,1,-5.0,-0.4687042303372438,5.0,-0.6984302957695783,-1.6478351714230806,-0.2780809605359042,225,115,110,1,1.2964267863185297,1.3655839802978638,1.170500554541026,0.18141865627808282,-0.7262137382802598,0.7262137382802598,1.170500554541026,1.3655839802978638,0,1,0,2,1.3655839802978638,1.170500554541026
4724,20,165,53,103,110,1,3683.539,20,3104.281,MORE,-1006,2928,1922,3,1,7.0,0.6561859224721414,7.0,-0.34921514788478913,-1.294095957521883,-0.146843996823787,213,103,110,0,1.0570864565366473,0.8973837584814532,1.170500554541026,0.18141865627808282,-0.9027931326727554,0.9027931326727554,1.170500554541026,0.8973837584814532,0,1,0,2,1.170500554541026,0.8973837584814532
4725,20,166,26,90,80,0,8249.112,40,2135.8720000000008,MORE,-960,3558,2598,4,1,-10.0,-0.9374084606744876,10.0,0.17460757394239454,-0.5866175297194867,1.3980825129176029,170,90,80,1,0.19945027481823535,0.3901668515136753,0.0,0.8312765295130061,-0.8600423319250986,0.8600423319250986,0.0,0.3901668515136753,0,1,0,1,0.3901668515136753,0.0
4726,20,167,35,80,72,0,2994.583,80,1827.536,MORE,-92,1756,1664,2,2,-8.0,-0.7499267685395902,8.0,-0.17460757394239454,0.8283393258853051,-0.3799771409976704,152,80,72,1,-0.1595602198545883,0.0,-0.31213348121094026,-0.4684392169568405,-0.05335330912148695,0.05335330912148695,-0.31213348121094026,0.0,1,0,0,1,0.0,-0.31213348121094026
4727,20,168,28,93,80,0,6765.163000000001,10,1890.713,MORE,-2698,4688,1990,5,1,-13.0,-1.218630998876834,13.0,0.6984302957695783,-1.6478351714230806,0.8959347761046723,173,93,80,1,0.25928535726370594,0.5072169069677779,0.0,1.4811344027479294,-2.4752791079996115,2.4752791079996115,0.0,0.5072169069677779,0,1,0,1,0.5072169069677779,0.0
4728,20,169,26,80,90,1,1664.428,80,1827.835,MORE,684,720,1404,0,2,10.0,0.9374084606744876,10.0,0.17460757394239454,0.8283393258853051,-0.8300831236563772,170,80,90,0,0.19945027481823535,0.0,0.3901668515136753,-1.768154963426687,0.6678341121868111,0.6678341121868111,0.3901668515136753,0.0,1,0,1,1,0.3901668515136753,0.0
4729,20,170,25,88,80,1,7255.334,80,3488.357,MORE,-580,3510,2930,3,2,-8.0,-0.7499267685395902,8.0,-0.17460757394239454,0.8283393258853051,1.0618018364290709,168,88,80,1,0.1595602198545883,0.31213348121094026,0.0,0.18141865627808282,-0.5068835431401073,0.5068835431401073,0.0,0.31213348121094026,1,1,0,1,0.31213348121094026,0.0
4730,20,171,36,80,70,1,2815.348,20,1931.219,MORE,-880,2232,1352,3,1,-10.0,-0.9374084606744876,10.0,0.17460757394239454,-1.294095957521883,-0.4406277763009496,150,80,70,1,-0.19945027481823535,0.0,-0.3901668515136753,0.18141865627808282,-0.7856931132335214,0.7856931132335214,-0.3901668515136753,0.0,0,1,0,1,0.0,-0.3901668515136753
4731,20,172,28,80,93,1,1796.995,90,3252.766,MORE,700,1078,1778,0,2,13.0,1.218630998876834,13.0,0.6984302957695783,1.1820785397865032,-0.7852242915630371,173,80,93,0,0.25928535726370594,0.0,0.5072169069677779,-1.768154963426687,0.6827039559251264,0.6827039559251264,0.5072169069677779,0.0,1,0,1,1,0.5072169069677779,0.0
4732,20,173,21,82,80,0,6647.187,0,2373.003,MORE,-1232,3988,2756,5,1,-2.0,-0.18748169213489754,2.0,-1.222253017596762,-2.0015743853242784,0.8560133358137707,162,82,80,1,0.03989005496364707,0.07803337030273506,0.0,1.4811344027479294,-1.1128296754764608,1.1128296754764608,0.0,0.07803337030273506,0,1,0,1,0.07803337030273506,0.0
4733,20,174,19,50,41,0,3679.261,90,2657.994,MORE,-238,2120,1882,2,2,-9.0,-0.8436676146070391,9.0,0.0,1.1820785397865032,-0.14829161262330964,91,50,41,1,-1.376206896245824,-1.170500554541026,-1.5216507209033339,-0.4684392169568405,-0.18904063323361517,0.18904063323361517,-1.5216507209033339,-1.170500554541026,1,0,0,0,-1.170500554541026,-1.5216507209033339
4734,20,175,56,96,110,1,3383.786,90,1759.675,MORE,1530,1206,2736,3,2,14.0,1.3123718449442827,14.0,0.8730378697119728,1.1820785397865032,-0.24827624992203146,206,96,110,0,0.9174712641638826,0.6242669624218805,1.170500554541026,0.18141865627808282,1.454077099850239,1.454077099850239,1.170500554541026,0.6242669624218805,1,1,1,2,1.170500554541026,0.6242669624218805
4735,20,176,23,80,85,1,2207.859,90,3640.195,MORE,552,1280,1832,2,2,5.0,0.4687042303372438,5.0,-0.6984302957695783,1.1820785397865032,-0.6461936188526486,165,80,85,0,0.09972513740911768,0.0,0.19508342575683765,-0.4684392169568405,0.5451579013457089,0.5451579013457089,0.19508342575683765,0.0,1,0,1,1,0.19508342575683765,0.0
4736,20,177,10,60,50,0,2432.117,90,2651.297,MORE,102,1530,1632,2,2,-10.0,-0.9374084606744876,10.0,0.17460757394239454,1.1820785397865032,-0.5703078254984332,110,60,50,1,-0.9972513740911768,-0.7803337030273506,-1.170500554541026,-0.4684392169568405,0.12694354620558754,0.12694354620558754,-1.170500554541026,-0.7803337030273506,1,0,0,0,-0.7803337030273506,-1.170500554541026
4737,20,178,19,41,50,1,1801.239,90,2132.695,MORE,1390,552,1942,1,2,9.0,0.8436676146070391,9.0,0.0,1.1820785397865032,-0.7837881808914209,91,41,50,0,-1.376206896245824,-1.5216507209033339,-1.170500554541026,-1.1182970901917637,1.323965967139979,1.323965967139979,-1.170500554541026,-1.5216507209033339,1,0,1,0,-1.5216507209033339,-1.170500554541026
4738,20,179,56,110,96,0,3039.056,100,3286.116,MORE,-326,1956,1630,2,2,-14.0,-1.3123718449442827,14.0,0.8730378697119728,1.5358177536877011,-0.3649280953099268,206,110,96,1,0.9174712641638826,1.170500554541026,0.6242669624218805,-0.4684392169568405,-0.27082477379435,0.27082477379435,0.6242669624218805,1.170500554541026,1,0,0,2,1.170500554541026,0.6242669624218805
4739,20,180,35,72,80,1,1626.9260000000004,70,2054.821,MORE,382,554,936,1,2,8.0,0.7499267685395902,8.0,-0.17460757394239454,0.4746001119841072,-0.8427732797371847,152,72,80,0,-0.1595602198545883,-0.31213348121094026,0.0,-1.1182970901917637,0.38716581162610747,0.38716581162610747,0.0,-0.31213348121094026,1,0,1,1,-0.31213348121094026,0.0
4740,20,181,11,49,50,1,1264.083,20,2552.559,MORE,-54,918,864,2,1,1.0,0.09374084606744876,1.0,-1.3968605915391563,-1.294095957521883,-0.9655543128241808,99,49,50,0,-1.2166466763912356,-1.2095172396923934,-1.170500554541026,-0.4684392169568405,-0.01803743024298782,0.01803743024298782,-1.170500554541026,-1.2095172396923934,0,0,0,0,-1.2095172396923934,-1.170500554541026
4741,20,182,17,43,50,1,2635.446,90,2045.26,MORE,392,1490,1882,3,2,7.0,0.6561859224721414,7.0,-0.34921514788478913,1.1820785397865032,-0.5015041151428641,93,43,50,0,-1.3363168412821769,-1.4436173506005987,-1.170500554541026,0.18141865627808282,0.3964594639625546,0.3964594639625546,-1.170500554541026,-1.4436173506005987,1,0,1,0,-1.4436173506005987,-1.170500554541026
4742,20,183,1,51,50,1,2029.802,20,2083.8,MORE,-70,1166,1096,2,1,-1.0,-0.09374084606744876,1.0,-1.3968605915391563,-1.294095957521883,-0.7064456353125809,101,51,50,1,-1.1767566214275886,-1.1314838693896585,-1.170500554541026,-0.4684392169568405,-0.03290727398130324,0.03290727398130324,-1.170500554541026,-1.1314838693896585,0,0,0,0,-1.1314838693896585,-1.170500554541026
4743,20,184,41,112,110,0,9669.532,0,2180.4210000000007,MORE,-402,4506,4104,7,1,-2.0,-0.18748169213489754,2.0,-1.222253017596762,-2.0015743853242784,1.878732918237344,222,112,110,1,1.2365917038730592,1.248533924843761,1.170500554541026,2.780850149217776,-0.3414565315513482,0.3414565315513482,1.170500554541026,1.248533924843761,0,1,0,2,1.248533924843761,1.170500554541026
4744,20,185,20,40,50,1,3250.198,90,3161.325,MORE,2092,950,3042,3,2,10.0,0.9374084606744876,10.0,0.17460757394239454,1.1820785397865032,-0.2934805742386798,90,40,50,0,-1.3961519237276474,-1.5606674060547012,-1.170500554541026,0.18141865627808282,1.9763803611585682,1.9763803611585682,-1.170500554541026,-1.5606674060547012,1,1,1,0,-1.5606674060547012,-1.170500554541026
4745,20,186,1,50,51,1,3584.592,60,1556.428,MORE,416,1482,1898,4,1,1.0,0.09374084606744876,1.0,-1.3968605915391563,0.12086089808290923,-0.18032628773434334,101,50,51,0,-1.1767566214275886,-1.170500554541026,-1.1314838693896585,0.8312765295130061,0.41876422957002774,0.41876422957002774,-1.1314838693896585,-1.170500554541026,0,1,1,0,-1.170500554541026,-1.1314838693896585
4746,20,187,23,85,80,0,9227.558,80,2516.972,MORE,-1814,4632,2818,2,2,-5.0,-0.4687042303372438,5.0,-0.6984302957695783,0.8283393258853051,1.72917505349256,165,85,80,1,0.09972513740911768,0.19508342575683765,0.0,-0.4684392169568405,-1.6537202414576841,1.6537202414576841,0.0,0.19508342575683765,1,0,0,1,0.19508342575683765,0.0
4747,20,188,11,50,49,0,4733.854,70,2041.743,MORE,-158,2092,1934,4,2,-1.0,-0.09374084606744876,1.0,-1.3968605915391563,0.4746001119841072,0.20856801544258766,99,50,49,1,-1.2166466763912356,-1.170500554541026,-1.2095172396923934,0.8312765295130061,-0.11469141454203806,0.11469141454203806,-1.2095172396923934,-1.170500554541026,1,1,0,0,-1.170500554541026,-1.2095172396923934
4748,20,189,17,50,43,0,4125.917,10,2760.643,MORE,-1276,2672,1396,2,1,-7.0,-0.6561859224721414,7.0,-0.34921514788478913,-1.6478351714230806,0.002850575911415616,93,50,43,1,-1.3363168412821769,-1.170500554541026,-1.4436173506005987,-0.4684392169568405,-1.153721745756828,1.153721745756828,-1.4436173506005987,-1.170500554541026,0,0,0,0,-1.170500554541026,-1.4436173506005987
4749,20,190,21,80,82,1,3572.783,90,1525.313,MORE,804,1632,2436,4,2,2.0,0.18748169213489754,2.0,-1.222253017596762,1.1820785397865032,-0.18432228936514333,162,80,82,0,0.03989005496364707,0.0,0.07803337030273506,0.8312765295130061,0.7793579402241767,0.7793579402241767,0.07803337030273506,0.0,1,1,1,1,0.07803337030273506,0.0
4750,20,191,10,50,60,1,3036.824,90,1178.25,MORE,1106,1122,2228,3,2,10.0,0.9374084606744876,10.0,0.17460757394239454,1.1820785397865032,-0.3656833731183733,110,50,60,0,-0.9972513740911768,-1.170500554541026,-0.7803337030273506,0.18141865627808282,1.0600262407848804,1.0600262407848804,-0.7803337030273506,-1.170500554541026,1,1,1,0,-1.170500554541026,-0.7803337030273506
4751,20,192,3,53,50,0,4321.795,50,2534.3520000000008,MORE,-1108,2616,1508,4,1,-3.0,-0.28122253820234633,3.0,-1.0476454436543674,-0.23287831581828874,0.06913297132489901,103,53,50,1,-1.1368665664639415,-1.0534504990869233,-1.170500554541026,0.8312765295130061,-0.9975883865045162,0.9975883865045162,-1.170500554541026,-1.0534504990869233,0,1,0,0,-1.0534504990869233,-1.170500554541026
4752,20,193,45,122,110,0,6443.981,80,2308.899,MORE,454,2760,3214,5,2,-12.0,-1.124890152809385,12.0,0.5238227218271837,0.8283393258853051,0.7872512469503335,232,122,110,1,1.4360419786912946,1.6387007763574364,1.170500554541026,1.4811344027479294,0.45408010844852686,0.45408010844852686,1.170500554541026,1.6387007763574364,1,1,1,2,1.6387007763574364,1.170500554541026
4753,20,194,38,67,80,1,1617.9779999999996,90,1875.736,MORE,744,540,1284,1,2,13.0,1.218630998876834,13.0,0.6984302957695783,1.1820785397865032,-0.8458011586932691,147,67,80,0,-0.25928535726370594,-0.5072169069677779,0.0,-1.1182970901917637,0.7235960262054939,0.7235960262054939,0.0,-0.5072169069677779,1,0,1,1,-0.5072169069677779,0.0
4754,20,195,38,80,67,1,1749.96,90,1544.0870000000002,MORE,812,682,1494,1,2,-13.0,-1.218630998876834,13.0,0.6984302957695783,1.1820785397865032,-0.8011402824771428,147,80,67,1,-0.25928535726370594,0.0,-0.5072169069677779,-1.1182970901917637,0.7867928620933344,0.7867928620933344,-0.5072169069677779,0.0,1,0,1,1,0.0,-0.5072169069677779
4755,20,196,36,70,80,1,1634.681,100,982.437,MORE,1070,470,1540,1,2,10.0,0.9374084606744876,10.0,0.17460757394239454,1.5358177536877011,-0.8401490954161709,150,70,80,0,-0.19945027481823535,-0.3901668515136753,0.0,-1.1182970901917637,1.0265690923736706,1.0265690923736706,0.0,-0.3901668515136753,1,0,1,1,-0.3901668515136753,0.0
4756,20,197,45,110,122,1,1437.083,100,1474.329,MORE,878,572,1450,2,2,12.0,1.124890152809385,12.0,0.5238227218271837,1.5358177536877011,-0.9070135149472746,232,110,122,0,1.4360419786912946,1.170500554541026,1.6387007763574364,-0.4684392169568405,0.8481309675138855,0.8481309675138855,1.6387007763574364,1.170500554541026,1,0,1,2,1.6387007763574364,1.170500554541026
4757,20,198,42,110,115,0,3759.423,90,1653.869,MORE,-272,2334,2062,2,2,5.0,0.4687042303372438,5.0,-0.6984302957695783,1.1820785397865032,-0.12116590488106367,225,110,115,0,1.2964267863185297,1.170500554541026,1.3655839802978638,-0.4684392169568405,-0.22063905117753543,0.22063905117753543,1.3655839802978638,1.170500554541026,1,0,0,2,1.3655839802978638,1.170500554541026
4758,20,199,41,110,112,1,3647.604,40,1836.884,MORE,-344,1774,1430,2,1,2.0,0.18748169213489754,2.0,-1.222253017596762,-0.5866175297194867,-0.15900390186255375,222,110,112,0,1.2365917038730592,1.170500554541026,1.248533924843761,-0.4684392169568405,-0.2875533479999548,0.2875533479999548,1.248533924843761,1.170500554541026,0,0,0,2,1.248533924843761,1.170500554541026
4759,20,200,53,110,103,1,1670.559,50,1695.321,MORE,124,844,968,1,2,-7.0,-0.6561859224721414,7.0,-0.34921514788478913,-0.23287831581828874,-0.8280084783859533,213,110,103,1,1.0570864565366473,1.170500554541026,0.8973837584814532,-1.1182970901917637,0.14738958134577126,0.14738958134577126,0.8973837584814532,1.170500554541026,0,0,0,2,1.170500554541026,0.8973837584814532
4760,20,201,3,50,53,1,3193.177,60,1281.594,LESS,1280,1002,2282,3,2,3.0,0.28122253820234633,3.0,-1.0476454436543674,0.12086089808290923,-0.31277568889613105,103,50,53,1,-1.1368665664639415,-1.170500554541026,-1.0534504990869233,0.18141865627808282,1.2217357914390605,1.2217357914390605,-1.0534504990869233,-1.170500554541026,1,1,1,0,-1.170500554541026,-1.0534504990869233
4761,20,202,20,50,40,0,4568.54,20,2162.528,LESS,-1852,3262,1410,4,1,-10.0,-0.9374084606744876,10.0,0.17460757394239454,-1.294095957521883,0.1526280532447674,90,50,40,0,-1.3961519237276474,-1.170500554541026,-1.5606674060547012,0.8312765295130061,-1.6890361203361834,1.6890361203361834,-1.5606674060547012,-1.170500554541026,0,1,0,0,-1.170500554541026,-1.5606674060547012
4762,20,203,25,80,88,0,2149.355,30,1161.097,LESS,-1030,1654,624,2,1,8.0,0.7499267685395902,8.0,-0.17460757394239454,-0.9403567436206848,-0.6659905601184897,168,80,88,1,0.1595602198545883,0.0,0.31213348121094026,-0.4684392169568405,-0.9250978982802286,0.9250978982802286,0.31213348121094026,0.0,0,0,0,1,0.31213348121094026,0.0
4763,20,204,42,115,110,1,3421.588,50,2071.937,LESS,-380,1982,1602,3,1,-5.0,-0.4687042303372438,5.0,-0.6984302957695783,-0.23287831581828874,-0.23548457800675504,225,115,110,0,1.2964267863185297,1.3655839802978638,1.170500554541026,0.18141865627808282,-0.3210104964111645,0.3210104964111645,1.170500554541026,1.3655839802978638,0,1,0,2,1.3655839802978638,1.170500554541026
4764,20,205,53,103,110,0,1821.59,80,1808.178,LESS,-128,1370,1242,2,2,7.0,0.6561859224721414,7.0,-0.34921514788478913,0.8283393258853051,-0.7769016850671844,213,103,110,1,1.0570864565366473,0.8973837584814532,1.170500554541026,-0.4684392169568405,-0.08681045753269664,0.08681045753269664,1.170500554541026,0.8973837584814532,1,0,0,2,1.170500554541026,0.8973837584814532
4765,20,206,26,90,80,0,1493.02,80,1645.035,LESS,728,906,1634,2,2,-10.0,-0.9374084606744876,10.0,0.17460757394239454,0.8283393258853051,-0.8880852108383699,170,90,80,0,0.19945027481823535,0.3901668515136753,0.0,-0.4684392169568405,0.7087261824671784,0.7087261824671784,0.0,0.3901668515136753,1,0,1,1,0.3901668515136753,0.0
4766,20,207,35,80,72,1,1677.622,10,2641.259,LESS,-36,1078,1042,1,1,-8.0,-0.7499267685395902,8.0,-0.17460757394239454,-1.6478351714230806,-0.8256184572564471,152,80,72,0,-0.1595602198545883,0.0,-0.31213348121094026,-1.1182970901917637,-0.0013088560373829704,0.0013088560373829704,-0.31213348121094026,0.0,0,0,1,1,0.0,-0.31213348121094026
4767,20,208,28,93,80,0,2038.466,0,1439.497,LESS,-1498,2070,572,1,1,-13.0,-1.218630998876834,13.0,0.6984302957695783,-2.0015743853242784,-0.7035138580131272,173,93,80,0,0.25928535726370594,0.5072169069677779,0.0,-1.1182970901917637,-1.3600408276259546,1.3600408276259546,0.0,0.5072169069677779,0,0,0,1,0.5072169069677779,0.0
4768,20,209,26,80,90,0,1666.171,100,1538.583,LESS,324,1216,1540,2,2,10.0,0.9374084606744876,10.0,0.17460757394239454,1.5358177536877011,-0.8294933166581143,170,80,90,1,0.19945027481823535,0.0,0.3901668515136753,-0.4684392169568405,0.3332626280747141,0.3332626280747141,0.3901668515136753,0.0,1,0,1,1,0.3901668515136753,0.0
4769,20,210,25,88,80,0,1792.346,60,2979.942,LESS,26,942,968,1,1,-8.0,-0.7499267685395902,8.0,-0.17460757394239454,0.12086089808290923,-0.7867974486111858,168,88,80,0,0.1595602198545883,0.31213348121094026,0.0,-1.1182970901917637,0.05631178844858929,0.05631178844858929,0.0,0.31213348121094026,0,0,1,1,0.31213348121094026,0.0
4770,20,211,36,80,70,0,1698.057,80,2097.3,LESS,1242,644,1886,1,2,-10.0,-0.9374084606744876,10.0,0.17460757394239454,0.8283393258853051,-0.8187035369985594,150,80,70,0,-0.19945027481823535,0.0,-0.3901668515136753,-1.1182970901917637,1.1864199125605615,1.1864199125605615,-0.3901668515136753,0.0,1,0,1,1,0.0,-0.3901668515136753
4771,20,212,28,80,93,0,1938.372,80,2111.363,LESS,1046,592,1638,1,2,13.0,1.218630998876834,13.0,0.6984302957695783,0.8283393258853051,-0.7373842777974683,173,80,93,1,0.25928535726370594,0.0,0.5072169069677779,-1.1182970901917637,1.0042643267661975,1.0042643267661975,0.5072169069677779,0.0,1,0,1,1,0.5072169069677779,0.0
4772,20,213,21,82,80,0,1712.332,70,1874.46,LESS,310,630,940,1,2,-2.0,-0.18748169213489754,2.0,-1.222253017596762,0.4746001119841072,-0.8138730752084272,162,82,80,0,0.03989005496364707,0.07803337030273506,0.0,-1.1182970901917637,0.3202515148036881,0.3202515148036881,0.0,0.07803337030273506,1,0,1,1,0.07803337030273506,0.0
4773,20,214,19,50,41,1,1719.9489999999996,80,1247.527,LESS,1454,546,2000,1,2,-9.0,-0.8436676146070391,9.0,0.0,0.8283393258853051,-0.8112955881712691,91,50,41,0,-1.376206896245824,-1.170500554541026,-1.5216507209033339,-1.1182970901917637,1.3834453420932407,1.3834453420932407,-1.5216507209033339,-1.170500554541026,1,0,1,0,-1.170500554541026,-1.5216507209033339
4774,20,215,56,96,110,0,2345.002,50,1883.404,LESS,-692,1434,742,2,1,14.0,1.3123718449442827,14.0,0.8730378697119728,-0.23287831581828874,-0.599786331897547,206,96,110,1,0.9174712641638826,0.6242669624218805,1.170500554541026,-0.4684392169568405,-0.6109724493083153,0.6109724493083153,1.170500554541026,0.6242669624218805,0,0,0,2,1.170500554541026,0.6242669624218805
4775,20,216,23,80,85,0,1547.602,70,1835.248,LESS,568,854,1422,2,2,5.0,0.4687042303372438,5.0,-0.6984302957695783,0.4746001119841072,-0.8696154199151486,165,80,85,1,0.09972513740911768,0.0,0.19508342575683765,-0.4684392169568405,0.5600277450840242,0.5600277450840242,0.19508342575683765,0.0,1,0,1,1,0.19508342575683765,0.0
4776,20,217,10,60,50,0,5882.052,0,1738.537,LESS,-1626,3602,1976,5,1,-10.0,-0.9374084606744876,10.0,0.17460757394239454,-2.0015743853242784,0.5971022757932696,110,60,50,0,-0.9972513740911768,-0.7803337030273506,-1.170500554541026,1.4811344027479294,-1.478999577532478,1.478999577532478,-1.170500554541026,-0.7803337030273506,0,1,0,0,-0.7803337030273506,-1.170500554541026
4777,20,218,19,41,50,0,1820.025,60,1935.532,LESS,344,684,1028,0,2,9.0,0.8436676146070391,9.0,0.0,0.12086089808290923,-0.7774312593369956,91,41,50,1,-1.376206896245824,-1.5216507209033339,-1.170500554541026,-1.768154963426687,0.35184993274760834,0.35184993274760834,-1.170500554541026,-1.5216507209033339,0,0,1,0,-1.5216507209033339,-1.170500554541026
4778,20,219,56,110,96,1,5016.392,80,1228.18,LESS,10,2286,2296,5,2,-14.0,-1.3123718449442827,14.0,0.8730378697119728,0.8283393258853051,0.30417495157290736,206,110,96,0,0.9174712641638826,1.170500554541026,0.6242669624218805,1.4811344027479294,0.04144194471027387,0.04144194471027387,0.6242669624218805,1.170500554541026,1,1,1,2,1.170500554541026,0.6242669624218805
4779,20,220,35,72,80,0,1697.219,90,1296.029,LESS,92,1130,1222,2,2,8.0,0.7499267685395902,8.0,-0.17460757394239454,1.1820785397865032,-0.8189871045628416,152,72,80,1,-0.1595602198545883,-0.31213348121094026,0.0,-0.4684392169568405,0.1176498938691404,0.1176498938691404,0.0,-0.31213348121094026,1,0,1,1,-0.31213348121094026,0.0
4780,20,221,11,49,50,0,1449.739,60,1864.728,LESS,302,842,1144,3,2,1.0,0.09374084606744876,1.0,-1.3968605915391563,0.12086089808290923,-0.9027309002771582,99,49,50,1,-1.2166466763912356,-1.2095172396923934,-1.170500554541026,0.18141865627808282,0.31281659293453035,0.31281659293453035,-1.170500554541026,-1.2095172396923934,0,1,1,0,-1.2095172396923934,-1.170500554541026
4781,20,222,17,43,50,0,1712.516,60,1932.671,LESS,904,456,1360,1,2,7.0,0.6561859224721414,7.0,-0.34921514788478913,0.12086089808290923,-0.8138108121632865,93,43,50,1,-1.3363168412821769,-1.4436173506005987,-1.170500554541026,-1.1182970901917637,0.8722944635886482,0.8722944635886482,-1.170500554541026,-1.4436173506005987,0,0,1,0,-1.4436173506005987,-1.170500554541026
4782,20,223,1,51,50,1,7505.361,60,2363.386,LESS,-718,3398,2680,5,2,-1.0,-0.09374084606744876,1.0,-1.3968605915391563,0.12086089808290923,1.1464075015780257,101,51,50,0,-1.1767566214275886,-1.1314838693896585,-1.170500554541026,1.4811344027479294,-0.6351359453830778,0.6351359453830778,-1.170500554541026,-1.1314838693896585,1,1,0,0,-1.1314838693896585,-1.170500554541026
4783,20,224,41,112,110,0,2245.645,20,2491.594,LESS,-926,1728,802,2,1,-2.0,-0.18748169213489754,2.0,-1.222253017596762,-1.294095957521883,-0.6334073611152105,222,112,110,0,1.2365917038730592,1.248533924843761,1.170500554541026,-0.4684392169568405,-0.8284439139811783,0.8284439139811783,1.170500554541026,1.248533924843761,0,1,0,2,1.248533924843761,1.170500554541026
4784,20,225,20,40,50,0,1769.582,10,1690.614,LESS,-1256,1890,634,2,1,10.0,0.9374084606744876,10.0,0.17460757394239454,-1.6478351714230806,-0.7945004701306648,90,40,50,1,-1.3961519237276474,-1.5606674060547012,-1.170500554541026,-0.4684392169568405,-1.135134441083934,1.135134441083934,-1.170500554541026,-1.5606674060547012,0,1,0,0,-1.5606674060547012,-1.170500554541026
4785,20,226,1,50,51,0,5769.417,40,1547.6760000000004,LESS,776,2092,2868,6,1,1.0,0.09374084606744876,1.0,-1.3968605915391563,-0.5866175297194867,0.5589881557420251,101,50,51,1,-1.1767566214275886,-1.170500554541026,-1.1314838693896585,2.1309922759828526,0.7533357136821247,0.7533357136821247,-1.1314838693896585,-1.170500554541026,0,1,1,0,-1.170500554541026,-1.1314838693896585
4786,20,227,23,85,80,1,4935.254,50,1462.348,LESS,250,1978,2228,4,2,-5.0,-0.4687042303372438,5.0,-0.6984302957695783,-0.23287831581828874,0.27671897898252346,165,85,80,0,0.09972513740911768,0.19508342575683765,0.0,0.8312765295130061,0.2644896007850052,0.2644896007850052,0.0,0.19508342575683765,0,1,1,1,0.19508342575683765,0.0
4787,20,228,11,50,49,0,3703.142,80,1520.886,LESS,-286,1988,1702,1,2,-1.0,-0.09374084606744876,1.0,-1.3968605915391563,0.8283393258853051,-0.14021061381349234,99,50,49,0,-1.2166466763912356,-1.170500554541026,-1.2095172396923934,-1.1182970901917637,-0.23365016444856143,0.23365016444856143,-1.2095172396923934,-1.170500554541026,1,0,0,0,-1.170500554541026,-1.2095172396923934
4788,20,229,17,50,43,1,3141.223,80,1356.08,LESS,1334,1120,2454,3,2,-7.0,-0.6561859224721414,7.0,-0.34921514788478913,0.8283393258853051,-0.3303562011094073,93,50,43,0,-1.3363168412821769,-1.170500554541026,-1.4436173506005987,0.18141865627808282,1.271921514055875,1.271921514055875,-1.4436173506005987,-1.170500554541026,1,1,1,0,-1.170500554541026,-1.4436173506005987
4789,20,230,21,80,82,0,2066.702,30,2285.633,LESS,-624,1222,598,2,1,2.0,0.18748169213489754,2.0,-1.222253017596762,-0.9403567436206848,-0.6939591876729401,162,80,82,1,0.03989005496364707,0.0,0.07803337030273506,-0.4684392169568405,-0.5477756134204748,0.5477756134204748,0.07803337030273506,0.0,0,0,0,1,0.07803337030273506,0.0
4790,20,231,10,50,60,0,1497.401,30,1443.706,LESS,-34,530,496,1,2,10.0,0.9374084606744876,10.0,0.17460757394239454,-0.9403567436206848,-0.8866027412690132,110,50,60,1,-0.9972513740911768,-1.170500554541026,-0.7803337030273506,-1.1182970901917637,0.0005498744299064574,0.0005498744299064574,-0.7803337030273506,-1.170500554541026,0,0,1,0,-1.170500554541026,-0.7803337030273506
4791,20,232,3,53,50,1,4243.157,10,1570.958,LESS,-860,2530,1670,3,1,-3.0,-0.28122253820234633,3.0,-1.0476454436543674,-1.6478351714230806,0.04252296402175364,103,53,50,0,-1.1368665664639415,-1.0534504990869233,-1.170500554541026,0.18141865627808282,-0.7671058085606272,0.7671058085606272,-1.170500554541026,-1.0534504990869233,0,1,0,0,-1.0534504990869233,-1.170500554541026
4792,20,233,45,122,110,1,2831.132,60,3210.616,LESS,-146,1862,1716,4,1,-12.0,-1.124890152809385,12.0,0.5238227218271837,0.12086089808290923,-0.4352866898634404,232,122,110,0,1.4360419786912946,1.6387007763574364,1.170500554541026,0.8312765295130061,-0.10353903173830149,0.10353903173830149,1.170500554541026,1.6387007763574364,1,1,0,2,1.6387007763574364,1.170500554541026
4793,20,234,38,67,80,0,1711.9129999999998,80,3074.349,LESS,586,1076,1662,2,2,13.0,1.218630998876834,13.0,0.6984302957695783,0.8283393258853051,-0.8140148589905687,147,67,80,1,-0.25928535726370594,-0.5072169069677779,0.0,-0.4684392169568405,0.5767563192896291,0.5767563192896291,0.0,-0.5072169069677779,1,0,1,1,-0.5072169069677779,0.0
4794,20,235,38,80,67,0,1567.025,30,2075.686,LESS,278,598,876,2,1,-13.0,-1.218630998876834,13.0,0.6984302957695783,-0.9403567436206848,-0.8630429464055349,147,80,67,0,-0.25928535726370594,0.0,-0.5072169069677779,-0.4684392169568405,0.2905118273270572,0.2905118273270572,-0.5072169069677779,0.0,0,0,1,1,0.0,-0.5072169069677779
4795,20,236,36,70,80,1,3318.7290000000007,20,1670.304,LESS,-274,1762,1488,3,2,10.0,0.9374084606744876,10.0,0.17460757394239454,-1.294095957521883,-0.27029063539878195,150,70,80,1,-0.19945027481823535,-0.3901668515136753,0.0,0.18141865627808282,-0.22249778164482487,0.22249778164482487,0.0,-0.3901668515136753,0,1,0,1,-0.3901668515136753,0.0
4796,20,237,45,110,122,0,2173.874,40,2010.016,LESS,-484,958,474,0,1,12.0,1.124890152809385,12.0,0.5238227218271837,-0.5866175297194867,-0.6576936709673692,232,110,122,1,1.4360419786912946,1.170500554541026,1.6387007763574364,-1.768154963426687,-0.4176644807102148,0.4176644807102148,1.6387007763574364,1.170500554541026,0,0,0,2,1.6387007763574364,1.170500554541026
4797,20,238,42,110,115,1,3151.8920000000007,50,3934.451,LESS,-436,2056,1620,3,1,5.0,0.4687042303372438,5.0,-0.6984302957695783,-0.23287831581828874,-0.32674595964958786,225,110,115,1,1.2964267863185297,1.170500554541026,1.3655839802978638,0.18141865627808282,-0.3730549494952685,0.3730549494952685,1.3655839802978638,1.170500554541026,0,1,0,2,1.3655839802978638,1.170500554541026
4798,20,239,41,110,112,0,1719.667,90,1806.462,LESS,402,818,1220,2,2,2.0,0.18748169213489754,2.0,-1.222253017596762,1.1820785397865032,-0.8113910130556695,222,110,112,1,1.2365917038730592,1.170500554541026,1.248533924843761,-0.4684392169568405,0.40575311629900174,0.40575311629900174,1.248533924843761,1.170500554541026,1,0,1,2,1.248533924843761,1.170500554541026
4799,20,240,53,110,103,1,2800.157,20,1098.01,LESS,-716,1686,970,2,1,-7.0,-0.6561859224721414,7.0,-0.34921514788478913,-1.294095957521883,-0.4457681997723258,213,110,103,0,1.0570864565366473,1.170500554541026,0.8973837584814532,-0.4684392169568405,-0.6332772149157884,0.6332772149157884,0.8973837584814532,1.170500554541026,0,0,0,2,1.170500554541026,0.8973837584814532
4800,21,1,49,110,131,0,4788.804,14,1631.606,LESS,-1788,3168,1380,5,1,21.0,1.9685577674164243,21.0,2.0952908873087353,-1.4004244385780742,0.6500539638280286,241,110,131,1,1.6155472260277064,1.170500554541026,1.9898509427197442,0.3828774846360424,-1.9536072902618393,1.9536072902618393,1.9898509427197442,1.170500554541026,0,1,0,2,1.9898509427197442,1.170500554541026
4801,21,2,13,47,50,0,3062.615,74,1181.769,LESS,-944,1942,998,4,2,3.0,0.28122253820234633,3.0,-1.0476454436543674,1.2833807138739182,-0.3782704217166741,97,47,50,1,-1.2565367313548828,-1.2875506099951286,-1.170500554541026,-0.13627842673486268,-0.8654466006230039,0.8654466006230039,-1.170500554541026,-1.2875506099951286,1,0,0,0,-1.2875506099951286,-1.170500554541026
4802,21,3,16,50,44,1,2814.627,74,1260.5739999999996,LESS,1154,1168,2322,5,2,-6.0,-0.5624450764046927,6.0,-0.5238227218271837,1.2833807138739182,-0.5260017001122955,94,50,44,0,-1.3163718138003533,-1.170500554541026,-1.4046006654492311,0.3828774846360424,1.8394836444744809,1.8394836444744809,-1.4046006654492311,-1.170500554541026,1,1,1,0,-1.170500554541026,-1.4046006654492311
4803,21,4,7,57,50,1,3524.661,44,2010.896,LESS,2,1250,1252,3,1,-7.0,-0.6561859224721414,7.0,-0.34921514788478913,-0.05852186235207801,-0.10302062633309332,107,57,50,0,-1.0570864565366473,-0.8973837584814532,-1.170500554541026,-0.6554343381057677,0.3542216605124681,0.3542216605124681,-1.170500554541026,-0.8973837584814532,1,0,1,0,-0.8973837584814532,-1.170500554541026
4804,21,5,18,42,50,0,1745.811,34,1231.951,LESS,-958,1458,500,2,1,8.0,0.7499267685395902,8.0,-0.17460757394239454,-0.5058227210940768,-1.1627161945624092,92,42,50,1,-1.3562618687640005,-1.4826340357519663,-1.170500554541026,-1.1745902494766727,-0.8834966594558756,0.8834966594558756,-1.170500554541026,-1.4826340357519663,0,0,0,0,-1.4826340357519663,-1.170500554541026
4805,21,6,51,108,110,1,5618.6309999999985,4,1769.939,LESS,-1134,3520,2386,8,1,2.0,0.18748169213489754,2.0,-1.222253017596762,-1.8477252973200728,1.1443980593375018,218,108,110,1,1.156811593945765,1.092467184238291,1.170500554541026,1.9403452187487575,-1.1104116847834054,1.1104116847834054,1.170500554541026,1.092467184238291,0,1,0,2,1.170500554541026,1.092467184238291
4806,21,7,31,78,80,0,3599.0370000000007,44,1639.708,LESS,-728,1850,1122,3,1,2.0,0.18748169213489754,2.0,-1.222253017596762,-0.05852186235207801,-0.05871339549146851,158,78,80,1,-0.03989005496364707,-0.07803337030273506,0.0,-0.6554343381057677,-0.5869599786301266,0.5869599786301266,0.0,-0.07803337030273506,1,0,0,1,-0.07803337030273506,0.0
4807,21,8,58,110,92,1,3127.332000000001,34,1262.297,LESS,-70,1634,1564,3,2,-18.0,-1.6873352292140782,18.0,1.571468165481551,-0.5058227210940768,-0.3397172451761576,202,110,92,0,0.8376911542365885,1.170500554541026,0.4682002218164104,-0.6554343381057677,0.2613927865148423,0.2613927865148423,0.4682002218164104,1.170500554541026,0,0,1,2,1.170500554541026,0.4682002218164104
4808,21,9,12,50,48,1,6084.625,14,1810.692,LESS,26,2730,2756,7,1,-2.0,-0.18748169213489754,2.0,-1.222253017596762,-1.4004244385780742,1.4219997551642738,98,50,48,0,-1.2365917038730592,-1.170500554541026,-1.248533924843761,1.4211893073778525,0.3851646185116767,0.3851646185116767,-1.248533924843761,-1.170500554541026,0,1,1,0,-1.170500554541026,-1.248533924843761
4809,21,10,54,110,101,1,4577.884,4,3291.931,LESS,580,2200,2780,5,1,-9.0,-0.8436676146070391,9.0,0.0,-1.8477252973200728,0.5244048145175598,211,110,101,0,1.0171964015730004,1.170500554541026,0.8193503881787182,0.3828774846360424,1.0994312323267417,1.0994312323267417,0.8193503881787182,1.170500554541026,0,1,1,2,1.170500554541026,0.8193503881787182
4810,21,11,14,46,50,0,1707.37,74,1403.06,LESS,308,1124,1432,2,2,4.0,0.3749633842697951,4.0,-0.8730378697119728,1.2833807138739182,-1.1856162464713969,96,46,50,1,-1.2764817588367063,-1.3265672951464962,-1.170500554541026,-1.1745902494766727,0.7487443750023777,0.7487443750023777,-1.170500554541026,-1.3265672951464962,1,0,1,0,-1.3265672951464962,-1.170500554541026
4811,21,12,22,80,83,1,4552.962,44,1457.919,LESS,716,1720,2436,7,2,3.0,0.28122253820234633,3.0,-1.0476454436543674,-0.05852186235207801,0.5095582940400544,163,80,83,1,0.05983508244547061,0.0,0.1170500554541026,1.4211893073778525,1.274774660988924,1.274774660988924,0.1170500554541026,0.0,1,1,1,1,0.1170500554541026,0.0
4812,21,13,6,50,56,0,1743.274,44,1327.4920000000004,LESS,-650,1140,490,2,1,6.0,0.5624450764046927,6.0,-0.5238227218271837,-0.05852186235207801,-1.1642275348421391,106,50,56,1,-1.077031484018471,-1.170500554541026,-0.9364004436328208,-1.1745902494766727,-0.4863953651326987,0.4863953651326987,-0.9364004436328208,-1.170500554541026,1,0,0,0,-1.170500554541026,-0.9364004436328208
4813,21,14,13,50,47,0,3854.483,34,1177.385,LESS,-760,2156,1396,4,1,-3.0,-0.28122253820234633,3.0,-1.0476454436543674,-0.5058227210940768,0.0934607586653773,97,50,47,0,-1.2565367313548828,-1.170500554541026,-1.2875506099951286,-0.13627842673486268,-0.6282172559624047,0.6282172559624047,-1.2875506099951286,-1.170500554541026,0,0,0,0,-1.170500554541026,-1.2875506099951286
4814,21,15,46,110,124,0,4319.938,4,2060.743,LESS,-882,2434,1552,6,1,14.0,1.3123718449442827,14.0,0.8730378697119728,-1.8477252973200728,0.37074136170114536,234,110,124,1,1.4759320336549415,1.170500554541026,1.7167341466601715,0.9020333960069474,-0.7855106257917152,0.7855106257917152,1.7167341466601715,1.170500554541026,0,1,0,2,1.7167341466601715,1.170500554541026
4815,21,16,27,91,80,1,4980.693,4,1152.707,LESS,250,2462,2712,5,1,-11.0,-1.0311493067419364,11.0,0.34921514788478913,-1.8477252973200728,0.7643659760223986,171,91,80,0,0.21939530230005888,0.4291835366650429,0.0,0.3828774846360424,0.6739655598376236,0.6739655598376236,0.0,0.4291835366650429,0,1,1,1,0.4291835366650429,0.0
4816,21,17,40,64,80,0,3518.896,74,1384.6570000000004,LESS,-262,1816,1554,4,2,16.0,1.4998535370791803,16.0,1.222253017596762,1.2833807138739182,-0.10645494904205803,144,64,80,1,-0.3191204397091766,-0.6242669624218805,0.0,-0.13627842673486268,0.013849122521173578,0.013849122521173578,0.0,-0.6242669624218805,1,0,1,1,-0.6242669624218805,0.0
4817,21,18,22,83,80,0,2390.111,4,873.4910000000001,LESS,-1368,1956,588,2,1,-3.0,-0.28122253820234633,3.0,-1.0476454436543674,-1.8477252973200728,-0.778894144018435,163,83,80,0,0.05983508244547061,0.1170500554541026,0.0,-1.1745902494766727,-1.4121055252756889,1.4121055252756889,0.0,0.1170500554541026,0,0,0,1,0.1170500554541026,0.0
4818,21,19,54,101,110,0,1910.192,44,1095.119,LESS,-908,1314,406,2,1,9.0,0.8436676146070391,9.0,0.0,-0.05852186235207801,-1.0647912333790022,211,101,110,1,1.0171964015730004,0.8193503881787182,1.170500554541026,-1.1745902494766727,-0.8190321636241911,0.8190321636241911,1.170500554541026,0.8193503881787182,1,0,0,2,1.170500554541026,0.8193503881787182
4819,21,20,6,56,50,0,4397.571,54,1185.384,LESS,-630,2266,1636,6,1,-6.0,-0.5624450764046927,6.0,-0.5238227218271837,0.3887789963899207,0.41698885083645537,106,56,50,0,-1.077031484018471,-0.9364004436328208,-1.170500554541026,0.9020333960069474,-0.46060956680002485,0.46060956680002485,-1.170500554541026,-0.9364004436328208,1,1,0,0,-0.9364004436328208,-1.170500554541026
4820,21,21,18,50,42,1,2894.042,24,1799.432,LESS,492,1052,1544,3,2,-8.0,-0.7499267685395902,8.0,-0.17460757394239454,-0.9531235798360754,-0.478692638892445,92,50,42,0,-1.3562618687640005,-1.170500554541026,-1.4826340357519663,-0.6554343381057677,0.9859737196629769,0.9859737196629769,-1.4826340357519663,-1.170500554541026,0,0,1,0,-1.170500554541026,-1.4826340357519663
4821,21,22,43,110,117,0,7190.021,24,1357.509,LESS,-250,3008,2758,7,1,7.0,0.6561859224721414,7.0,-0.34921514788478913,-0.9531235798360754,2.080505667601192,227,110,117,1,1.3363168412821769,1.170500554541026,1.4436173506005987,1.4211893073778525,0.029320601520777874,0.029320601520777874,1.4436173506005987,1.170500554541026,0,1,1,2,1.4436173506005987,1.170500554541026
4822,21,23,32,77,80,1,3078.663,24,809.573,LESS,604,1094,1698,3,2,3.0,0.28122253820234633,3.0,-1.0476454436543674,-0.9531235798360754,-0.3687103157611723,157,77,80,1,-0.05983508244547061,-0.1170500554541026,0.0,-0.6554343381057677,1.1303741903259503,1.1303741903259503,0.0,-0.1170500554541026,0,0,1,1,-0.1170500554541026,0.0
4823,21,24,27,80,91,0,2594.918,74,1537.279,LESS,-708,1590,882,2,2,11.0,1.0311493067419364,11.0,0.34921514788478913,1.2833807138739182,-0.6568866277903429,171,80,91,1,0.21939530230005888,0.0,0.4291835366650429,-1.1745902494766727,-0.5611741802974528,0.5611741802974528,0.4291835366650429,0.0,1,0,0,1,0.4291835366650429,0.0
4824,21,25,16,44,50,0,2040.314,74,1067.853,LESS,-256,1310,1054,2,2,6.0,0.5624450764046927,6.0,-0.5238227218271837,1.2833807138739182,-0.9872750253068572,94,44,50,1,-1.3163718138003533,-1.4046006654492311,-1.170500554541026,-1.1745902494766727,0.021584862020975728,0.021584862020975728,-1.170500554541026,-1.4046006654492311,1,0,1,0,-1.4046006654492311,-1.170500554541026
4825,21,26,7,50,57,0,1951.661,94,1304.234,LESS,520,1206,1726,3,2,7.0,0.6561859224721414,7.0,-0.34921514788478913,2.177982431357916,-1.0400873429335449,107,50,57,1,-1.0570864565366473,-1.170500554541026,-0.8973837584814532,-0.6554343381057677,1.0220738373287204,1.0220738373287204,-0.8973837584814532,-1.170500554541026,1,0,1,0,-1.170500554541026,-0.8973837584814532
4826,21,27,14,50,46,1,4415.8409999999985,54,1620.662,LESS,-12,2142,2130,5,1,-4.0,-0.3749633842697951,4.0,-0.8730378697119728,0.3887789963899207,0.42787264544058057,96,50,46,0,-1.2764817588367063,-1.170500554541026,-1.3265672951464962,0.3828774846360424,0.3361716016795964,0.3361716016795964,-1.3265672951464962,-1.170500554541026,1,1,1,0,-1.170500554541026,-1.3265672951464962
4827,21,28,51,110,108,0,6751.343000000002,4,2868.791,LESS,-1560,4466,2906,4,1,-2.0,-0.18748169213489754,2.0,-1.222253017596762,-1.8477252973200728,1.8191766446483304,218,110,108,0,1.156811593945765,1.170500554541026,1.092467184238291,-0.13627842673486268,-1.6596491892693577,1.6596491892693577,1.092467184238291,1.170500554541026,0,0,0,2,1.170500554541026,1.092467184238291
4828,21,29,50,133,110,0,4986.175,14,1734.9820000000002,LESS,-518,2590,2072,4,1,-23.0,-2.1560394595513217,23.0,2.444506035193524,-1.4004244385780742,0.7676317101231003,243,133,110,0,1.6554372809913533,2.0678843130224793,1.170500554541026,-0.13627842673486268,-0.31620909613705145,0.31620909613705145,1.170500554541026,2.0678843130224793,0,0,1,2,2.0678843130224793,1.170500554541026
4829,21,30,49,131,110,1,4287.637,24,1752.411,LESS,180,1920,2100,3,2,-21.0,-1.9685577674164243,21.0,2.0952908873087353,-0.9531235798360754,0.3514990273000573,241,131,110,0,1.6155472260277064,1.9898509427197442,1.170500554541026,-0.6554343381057677,0.5837152656732651,0.5837152656732651,1.170500554541026,1.9898509427197442,0,0,1,2,1.9898509427197442,1.170500554541026
4830,21,31,47,126,110,1,6453.49,14,1994.069,LESS,-942,3188,2246,6,1,-16.0,-1.4998535370791803,16.0,1.222253017596762,-1.4004244385780742,1.6417398151889562,236,126,110,0,1.5158220886185887,1.7947675169629065,1.170500554541026,0.9020333960069474,-0.8628680207897366,0.8628680207897366,1.170500554541026,1.7947675169629065,0,1,0,2,1.7947675169629065,1.170500554541026
4831,21,32,50,110,133,0,2378.002,74,2478.609,LESS,546,1248,1794,3,2,23.0,2.1560394595513217,23.0,2.444506035193524,1.2833807138739182,-0.7861077110059206,243,110,133,1,1.6554372809913533,1.170500554541026,2.0678843130224793,-0.6554343381057677,1.0555953751611962,1.0555953751611962,2.0678843130224793,1.170500554541026,1,0,1,2,2.0678843130224793,1.170500554541026
4832,21,33,47,110,126,0,2991.77,64,1422.496,LESS,-1210,2056,846,2,1,16.0,1.4998535370791803,16.0,1.222253017596762,0.8360798551319194,-0.4204741671315239,236,110,126,1,1.5158220886185887,1.170500554541026,1.7947675169629065,-1.1745902494766727,-1.2083977184475658,1.2083977184475658,1.7947675169629065,1.170500554541026,1,0,0,2,1.7947675169629065,1.170500554541026
4833,21,34,12,48,50,1,8537.773000000001,4,917.98,LESS,454,3804,4258,8,1,2.0,0.18748169213489754,2.0,-1.222253017596762,-1.8477252973200728,2.883387766413457,98,48,50,1,-1.2365917038730592,-1.248533924843761,-1.170500554541026,1.9403452187487575,0.9369807028308966,0.9369807028308966,-1.170500554541026,-1.248533924843761,0,1,1,0,-1.248533924843761,-1.170500554541026
4834,21,35,32,80,77,0,2556.424,54,1228.523,LESS,-1678,2126,448,2,1,-3.0,-0.28122253820234633,3.0,-1.0476454436543674,0.3887789963899207,-0.6798182528309138,157,80,77,0,-0.05983508244547061,0.0,-0.1170500554541026,-1.1745902494766727,-1.8117853994321333,1.8117853994321333,-0.1170500554541026,0.0,1,0,0,1,0.0,-0.1170500554541026
4835,21,36,43,117,110,1,4994.751,24,1660.382,LESS,36,2206,2242,5,2,-7.0,-0.6561859224721414,7.0,-0.34921514788478913,-0.9531235798360754,0.7727406002448838,227,117,110,0,1.3363168412821769,1.4436173506005987,1.170500554541026,0.3828774846360424,0.3980575176780136,0.3980575176780136,1.170500554541026,1.4436173506005987,0,1,1,2,1.4436173506005987,1.170500554541026
4836,21,37,40,80,64,1,5806.8319999999985,24,1881.394,LESS,116,2624,2740,7,2,-16.0,-1.4998535370791803,16.0,1.222253017596762,-0.9531235798360754,1.2565130581492765,144,80,64,0,-0.3191204397091766,0.0,-0.6242669624218805,1.4211893073778525,0.5012007110087089,0.5012007110087089,-0.6242669624218805,0.0,0,1,1,1,0.0,-0.6242669624218805
4837,21,38,31,80,78,0,4867.023,34,3148.175,LESS,-868,2840,1972,7,2,-2.0,-0.18748169213489754,2.0,-1.222253017596762,-0.5058227210940768,0.6966505445691415,158,80,78,0,-0.03989005496364707,0.0,-0.07803337030273506,1.4211893073778525,-0.7674605669588435,0.7674605669588435,-0.07803337030273506,0.0,1,1,0,1,0.0,-0.07803337030273506
4838,21,39,46,124,110,1,4425.743,24,1763.901,LESS,324,1886,2210,5,2,-14.0,-1.3123718449442827,14.0,0.8730378697119728,-0.9531235798360754,0.4337714595714003,234,124,110,0,1.4759320336549415,1.7167341466601715,1.170500554541026,0.3828774846360424,0.7693730136685167,0.7693730136685167,1.170500554541026,1.7167341466601715,0,1,1,2,1.7167341466601715,1.170500554541026
4839,21,40,58,92,110,0,3045.637,70,1424.638,LESS,-120,1800,1680,4,2,18.0,1.6873352292140782,18.0,1.571468165481551,1.1044603703771187,-0.3883845467735349,202,92,110,1,0.8376911542365885,0.4682002218164104,1.170500554541026,-0.13627842673486268,0.19692829068315776,0.19692829068315776,1.170500554541026,0.4682002218164104,1,0,1,2,1.170500554541026,0.4682002218164104
4840,21,41,49,110,131,1,5262.201999999998,74,2573.909,MORE,968,2264,3232,5,2,21.0,1.9685577674164243,21.0,2.0952908873087353,1.2833807138739182,0.9320663665649764,241,110,131,0,1.6155472260277064,1.170500554541026,1.9898509427197442,0.3828774846360424,1.5996757199806142,1.5996757199806142,1.9898509427197442,1.170500554541026,1,1,1,2,1.9898509427197442,1.170500554541026
4841,21,42,13,47,50,1,3953.324,14,864.53,MORE,232,1834,2066,5,1,3.0,0.28122253820234633,3.0,-1.0476454436543674,-1.4004244385780742,0.15234226618953822,97,47,50,0,-1.2565367313548828,-1.2875506099951286,-1.170500554541026,0.3828774846360424,0.6507583413382172,0.6507583413382172,-1.170500554541026,-1.2875506099951286,0,1,1,0,-1.2875506099951286,-1.170500554541026
4842,21,43,16,50,44,1,4835.736,20,1902.473,MORE,-940,3360,2420,6,1,-6.0,-0.5624450764046927,6.0,-0.5238227218271837,-1.1320439233328752,0.6780122697043746,94,50,44,1,-1.3163718138003533,-1.170500554541026,-1.4046006654492311,0.9020333960069474,-0.8602894409564692,0.8602894409564692,-1.4046006654492311,-1.170500554541026,0,1,0,0,-1.170500554541026,-1.4046006654492311
4843,21,44,7,57,50,1,4328.684,44,1448.485,MORE,484,1862,2346,5,2,-7.0,-0.6561859224721414,7.0,-0.34921514788478913,-0.05852186235207801,0.3759515241317796,107,57,50,1,-1.0570864565366473,-0.8973837584814532,-1.170500554541026,0.3828774846360424,0.9756594003299074,0.9756594003299074,-1.170500554541026,-0.8973837584814532,0,1,1,0,-0.8973837584814532,-1.170500554541026
4844,21,45,18,42,50,1,1911.698,74,1314.504,MORE,270,952,1222,2,2,8.0,0.7499267685395902,8.0,-0.17460757394239454,1.2833807138739182,-1.063894079866478,92,42,50,0,-1.3562618687640005,-1.4826340357519663,-1.170500554541026,-1.1745902494766727,0.6997513581702974,0.6997513581702974,-1.170500554541026,-1.4826340357519663,1,0,1,0,-1.4826340357519663,-1.170500554541026
4845,21,46,51,108,110,0,4664.565,54,871.492,MORE,-884,2406,1522,5,1,2.0,0.18748169213489754,2.0,-1.222253017596762,0.3887789963899207,0.5760423733615798,218,108,110,0,1.156811593945765,1.092467184238291,1.170500554541026,0.3828774846360424,-0.7880892056249825,0.7880892056249825,1.170500554541026,1.092467184238291,0,1,0,2,1.170500554541026,1.092467184238291
4846,21,47,31,78,80,1,2470.485,64,1349.9489999999996,MORE,1158,928,2086,3,2,2.0,0.18748169213489754,2.0,-1.222253017596762,0.8360798551319194,-0.7310137878327739,158,78,80,0,-0.03989005496364707,-0.07803337030273506,0.0,-0.6554343381057677,1.8446408041410156,1.8446408041410156,0.0,-0.07803337030273506,1,0,1,1,-0.07803337030273506,0.0
4847,21,48,58,110,92,0,2263.966,74,980.358,MORE,-470,1366,896,2,2,-18.0,-1.6873352292140782,18.0,1.571468165481551,1.2833807138739182,-0.8540411757829385,202,110,92,1,0.8376911542365885,1.170500554541026,0.4682002218164104,-1.1745902494766727,-0.25432318013863425,0.25432318013863425,0.4682002218164104,1.170500554541026,1,0,0,2,1.170500554541026,0.4682002218164104
4848,21,49,12,50,48,0,3684.645,64,1488.479,MORE,-940,2230,1290,3,1,-2.0,-0.18748169213489754,2.0,-1.222253017596762,0.8360798551319194,-0.0077150436321355344,98,50,48,1,-1.2365917038730592,-1.170500554541026,-1.248533924843761,-0.6554343381057677,-0.8602894409564692,0.8602894409564692,-1.248533924843761,-1.170500554541026,1,0,0,0,-1.170500554541026,-1.248533924843761
4849,21,50,54,110,101,0,4214.2829999999985,44,1213.981,MORE,-708,2338,1630,4,1,-9.0,-0.8436676146070391,9.0,0.0,-0.05852186235207801,0.3078006217504637,211,110,101,1,1.0171964015730004,1.170500554541026,0.8193503881787182,-0.13627842673486268,-0.5611741802974528,0.5611741802974528,0.8193503881787182,1.170500554541026,0,1,0,2,1.170500554541026,0.8193503881787182
4850,21,51,14,46,50,1,4624.009,84,1253.3010000000004,MORE,1148,1786,2934,7,2,4.0,0.3749633842697951,4.0,-0.8730378697119728,1.7306815726159168,0.5518823747865973,96,46,50,0,-1.2764817588367063,-1.3265672951464962,-1.170500554541026,1.4211893073778525,1.8317479049746785,1.8317479049746785,-1.170500554541026,-1.3265672951464962,1,1,1,0,-1.3265672951464962,-1.170500554541026
4851,21,52,22,80,83,1,3334.248,34,1812.776,MORE,-1234,2450,1216,3,2,3.0,0.28122253820234633,3.0,-1.0476454436543674,-0.5058227210940768,-0.21645335659885412,163,80,83,0,0.05983508244547061,0.0,0.1170500554541026,-0.6554343381057677,-1.2393406764467745,1.2393406764467745,0.1170500554541026,0.0,0,0,0,1,0.1170500554541026,0.0
4852,21,53,6,50,56,1,1743.815,74,1656.027,MORE,316,754,1070,1,2,6.0,0.5624450764046927,6.0,-0.5238227218271837,1.2833807138739182,-1.1639052506122085,106,50,56,0,-1.077031484018471,-1.170500554541026,-0.9364004436328208,-1.693746160847578,0.7590586943354473,0.7590586943354473,-0.9364004436328208,-1.170500554541026,1,0,1,0,-1.170500554541026,-0.9364004436328208
4853,21,54,13,50,47,1,4974.428,34,996.492,MORE,-670,2666,1996,6,1,-3.0,-0.28122253820234633,3.0,-1.0476454436543674,-0.5058227210940768,0.7606337935815201,97,50,47,1,-1.2565367313548828,-1.170500554541026,-1.2875506099951286,0.9020333960069474,-0.5121811634653726,0.5121811634653726,-1.2875506099951286,-1.170500554541026,0,1,0,0,-1.170500554541026,-1.2875506099951286
4854,21,55,46,110,124,1,2620.409,44,1290.81,MORE,-130,1392,1262,4,1,14.0,1.3123718449442827,14.0,0.8730378697119728,-0.05852186235207801,-0.6417011429379195,234,110,124,0,1.4759320336549415,1.170500554541026,1.7167341466601715,-0.13627842673486268,0.18403539151682086,0.18403539151682086,1.7167341466601715,1.170500554541026,0,1,0,2,1.7167341466601715,1.170500554541026
4855,21,56,27,91,80,0,3978.578,74,1134.076,MORE,-44,2190,2146,4,2,-11.0,-1.0311493067419364,11.0,0.34921514788478913,1.2833807138739182,0.16738656552903455,171,91,80,1,0.21939530230005888,0.4291835366650429,0.0,-0.13627842673486268,0.2949143243473183,0.2949143243473183,0.0,0.4291835366650429,1,1,1,1,0.4291835366650429,0.0
4856,21,57,40,64,80,1,2625.949,74,893.382,MORE,596,1014,1610,3,2,16.0,1.4998535370791803,16.0,1.222253017596762,1.2833807138739182,-0.6384008571083158,144,64,80,0,-0.3191204397091766,-0.6242669624218805,0.0,-0.6554343381057677,1.1200598709928808,1.1200598709928808,0.0,-0.6242669624218805,1,0,1,1,-0.6242669624218805,0.0
4857,21,58,22,83,80,1,3474.8,54,1573.573,MORE,-580,1944,1364,3,1,-3.0,-0.28122253820234633,3.0,-1.0476454436543674,0.3887789963899207,-0.1327237945189897,163,83,80,1,0.05983508244547061,0.1170500554541026,0.0,-0.6554343381057677,-0.3961450709683403,0.3961450709683403,0.0,0.1170500554541026,0,0,0,1,0.1170500554541026,0.0
4858,21,59,54,101,110,0,5071.145,34,1697.185,MORE,-640,2754,2114,6,2,9.0,0.8436676146070391,9.0,0.0,-0.5058227210940768,0.8182499929645121,211,101,110,0,1.0171964015730004,0.8193503881787182,1.170500554541026,0.9020333960069474,-0.47350246596636175,0.47350246596636175,1.170500554541026,0.8193503881787182,0,1,0,2,1.170500554541026,0.8193503881787182
4859,21,60,6,56,50,1,1460.254,74,1007.067,MORE,374,544,918,1,2,-6.0,-0.5624450764046927,6.0,-0.5238227218271837,1.2833807138739182,-1.332828057494561,106,56,50,1,-1.077031484018471,-0.9364004436328208,-1.170500554541026,-1.693746160847578,0.8338375095002013,0.8338375095002013,-1.170500554541026,-0.9364004436328208,1,0,1,0,-0.9364004436328208,-1.170500554541026
4860,21,61,18,50,42,0,3064.178,44,1602.358,MORE,-470,1568,1098,4,1,-8.0,-0.7499267685395902,8.0,-0.17460757394239454,-0.05852186235207801,-0.37733931219471184,92,50,42,1,-1.3562618687640005,-1.170500554541026,-1.4826340357519663,-0.13627842673486268,-0.25432318013863425,0.25432318013863425,-1.4826340357519663,-1.170500554541026,0,1,0,0,-1.170500554541026,-1.4826340357519663
4861,21,62,43,110,117,1,2287.493,54,1304.192,MORE,700,824,1524,3,2,7.0,0.6561859224721414,7.0,-0.34921514788478913,0.3887789963899207,-0.840025683957472,227,110,117,0,1.3363168412821769,1.170500554541026,1.4436173506005987,-0.6554343381057677,1.2541460223227847,1.2541460223227847,1.4436173506005987,1.170500554541026,0,0,1,2,1.4436173506005987,1.170500554541026
4862,21,63,32,77,80,1,7187.3719999999985,34,1230.559,MORE,-1234,3854,2620,7,2,3.0,0.28122253820234633,3.0,-1.0476454436543674,-0.5058227210940768,2.0789276067415132,157,77,80,0,-0.05983508244547061,-0.1170500554541026,0.0,1.4211893073778525,-1.2393406764467745,1.2393406764467745,0.0,-0.1170500554541026,0,1,0,1,-0.1170500554541026,0.0
4863,21,64,27,80,91,1,1755.19,44,1697.953,MORE,-528,1110,582,2,1,11.0,1.0311493067419364,11.0,0.34921514788478913,-0.05852186235207801,-1.157128941711172,171,80,91,0,0.21939530230005888,0.0,0.4291835366650429,-1.1745902494766727,-0.32910199530338835,0.32910199530338835,0.4291835366650429,0.0,0,0,0,1,0.4291835366650429,0.0
4864,21,65,16,44,50,1,1357.483,74,2274.615,MORE,354,490,844,1,2,6.0,0.5624450764046927,6.0,-0.5238227218271837,1.2833807138739182,-1.3940507425115634,94,44,50,0,-1.3163718138003533,-1.4046006654492311,-1.170500554541026,-1.693746160847578,0.8080517111675275,0.8080517111675275,-1.170500554541026,-1.4046006654492311,1,0,1,0,-1.4046006654492311,-1.170500554541026
4865,21,66,7,50,57,1,1727.756,54,971.972,MORE,176,666,842,1,2,7.0,0.6561859224721414,7.0,-0.34921514788478913,0.3887789963899207,-1.173471909481812,107,50,57,0,-1.0570864565366473,-1.170500554541026,-0.8973837584814532,-1.693746160847578,0.5785581060067304,0.5785581060067304,-0.8973837584814532,-1.170500554541026,1,0,1,0,-1.170500554541026,-0.8973837584814532
4866,21,67,14,50,46,0,7173.995,54,962.294,MORE,-1820,4084,2264,6,1,-4.0,-0.3749633842697951,4.0,-0.8730378697119728,0.3887789963899207,2.070958667473895,96,50,46,1,-1.2764817588367063,-1.170500554541026,-1.3265672951464962,0.9020333960069474,-1.9948645675941175,1.9948645675941175,-1.3265672951464962,-1.170500554541026,1,1,0,0,-1.170500554541026,-1.3265672951464962
4867,21,68,51,110,108,1,4887.55,4,1033.512,MORE,-392,2496,2104,5,1,-2.0,-0.18748169213489754,2.0,-1.222253017596762,-1.8477252973200728,0.708878878003126,218,110,108,1,1.156811593945765,1.170500554541026,1.092467184238291,0.3828774846360424,-0.1537585666412063,0.1537585666412063,1.092467184238291,1.170500554541026,0,1,0,2,1.170500554541026,1.092467184238291
4868,21,69,50,133,110,0,2929.147,64,1117.997,MORE,-1542,2214,672,2,1,-23.0,-2.1560394595513217,23.0,2.444506035193524,0.8360798551319194,-0.4577799071147853,243,133,110,1,1.6554372809913533,2.0678843130224793,1.170500554541026,-1.1745902494766727,-1.6364419707699513,1.6364419707699513,1.170500554541026,2.0678843130224793,1,0,0,2,2.0678843130224793,1.170500554541026
4869,21,70,49,131,110,0,2791.754000000001,54,1302.177,MORE,-892,1716,824,4,1,-21.0,-1.9685577674164243,21.0,2.0952908873087353,0.3887789963899207,-0.5396275914084184,241,131,110,1,1.6155472260277064,1.9898509427197442,1.170500554541026,-0.13627842673486268,-0.798403524958052,0.798403524958052,1.170500554541026,1.9898509427197442,1,1,0,2,1.9898509427197442,1.170500554541026
4870,21,71,47,126,110,0,3715.584,54,1319.246,MORE,-550,2118,1568,4,2,-16.0,-1.4998535370791803,16.0,1.222253017596762,0.3887789963899207,0.010715920859219349,236,126,110,1,1.5158220886185887,1.7947675169629065,1.170500554541026,-0.13627842673486268,-0.3574663734693295,0.3574663734693295,1.170500554541026,1.7947675169629065,1,1,0,2,1.7947675169629065,1.170500554541026
4871,21,72,50,110,133,1,2184.235,74,811.1489999999999,MORE,520,904,1424,3,2,23.0,2.1560394595513217,23.0,2.444506035193524,1.2833807138739182,-0.9015384843533584,243,110,133,0,1.6554372809913533,1.170500554541026,2.0678843130224793,-0.6554343381057677,1.0220738373287204,1.0220738373287204,2.0678843130224793,1.170500554541026,1,0,1,2,2.0678843130224793,1.170500554541026
4872,21,73,47,110,126,1,1333.0739999999996,74,848.148,MORE,782,432,1214,1,2,16.0,1.4998535370791803,16.0,1.222253017596762,1.2833807138739182,-1.408591658904126,236,110,126,0,1.5158220886185887,1.170500554541026,1.7947675169629065,-1.693746160847578,1.3598677954867475,1.3598677954867475,1.7947675169629065,1.170500554541026,1,0,1,2,1.7947675169629065,1.170500554541026
4873,21,74,12,48,50,1,3809.032,44,1353.929,MORE,26,1516,1542,5,2,2.0,0.18748169213489754,2.0,-1.222253017596762,-0.05852186235207801,0.06638471331495953,98,48,50,0,-1.2365917038730592,-1.248533924843761,-1.170500554541026,0.3828774846360424,0.3851646185116767,0.3851646185116767,-1.170500554541026,-1.248533924843761,0,1,1,0,-1.248533924843761,-1.170500554541026
4874,21,75,32,80,77,1,3733.481,54,1253.146,MORE,136,1558,1694,5,2,-3.0,-0.28122253820234633,3.0,-1.0476454436543674,0.3887789963899207,0.02137751210333801,157,80,77,1,-0.05983508244547061,0.0,-0.1170500554541026,0.3828774846360424,0.5269865093413828,0.5269865093413828,-0.1170500554541026,0.0,0,1,1,1,0.0,-0.1170500554541026
4875,21,76,43,117,110,1,6625.593000000002,34,1780.652,MORE,-210,3058,2848,5,2,-7.0,-0.6561859224721414,7.0,-0.34921514788478913,-0.5058227210940768,1.744264922072039,227,117,110,1,1.3363168412821769,1.4436173506005987,1.170500554541026,0.3828774846360424,0.08089219818612553,0.08089219818612553,1.170500554541026,1.4436173506005987,0,1,0,2,1.4436173506005987,1.170500554541026
4876,21,77,40,80,64,0,3065.9240000000004,64,1693.437,MORE,-534,1646,1112,4,2,-16.0,-1.4998535370791803,16.0,1.222253017596762,0.8360798551319194,-0.3762991860108689,144,80,64,1,-0.3191204397091766,0.0,-0.6242669624218805,-0.13627842673486268,-0.3368377348031905,0.3368377348031905,-0.6242669624218805,0.0,1,1,0,1,0.0,-0.6242669624218805
4877,21,78,31,80,78,1,2294.965,54,1138.054,MORE,472,818,1290,3,2,-2.0,-0.18748169213489754,2.0,-1.222253017596762,0.3887789963899207,-0.8355744681237537,158,80,78,1,-0.03989005496364707,0.0,-0.07803337030273506,-0.6554343381057677,0.9601879213303031,0.9601879213303031,-0.07803337030273506,0.0,1,0,1,1,0.0,-0.07803337030273506
4878,21,79,46,124,110,0,5545.179,34,1208.129,MORE,-400,2674,2274,6,1,-14.0,-1.3123718449442827,14.0,0.8730378697119728,-0.5058227210940768,1.100641273280455,234,124,110,1,1.4759320336549415,1.7167341466601715,1.170500554541026,0.9020333960069474,-0.16407288597427583,0.16407288597427583,1.170500554541026,1.7167341466601715,0,1,0,2,1.7167341466601715,1.170500554541026
4879,21,80,58,92,110,1,3858.118,84,3136.748,MORE,1518,2230,3748,3,2,18.0,1.6873352292140782,18.0,1.571468165481551,1.7306815726159168,0.09562619891638964,202,92,110,0,0.8376911542365885,0.4682002218164104,1.170500554541026,-0.6554343381057677,2.3087851741291443,2.3087851741291443,1.170500554541026,0.4682002218164104,1,0,1,2,1.170500554541026,0.4682002218164104
4880,21,81,48,128,110,1,2259.005,54,1652.707,LESS,476,724,1200,3,2,-18.0,-1.6873352292140782,18.0,1.571468165481551,0.3887789963899207,-0.856996540042986,238,128,110,0,1.5557121435822359,1.8728008872656416,1.170500554541026,-0.6554343381057677,0.9653450809968378,0.9653450809968378,1.170500554541026,1.8728008872656416,1,0,1,2,1.8728008872656416,1.170500554541026
4881,21,82,8,50,58,0,2876.09,74,1687.511,LESS,-474,1408,934,3,2,8.0,0.7499267685395902,8.0,-0.17460757394239454,1.2833807138739182,-0.4893869947070738,108,50,58,1,-1.0371414290548238,-1.170500554541026,-0.8583670733300858,-0.6554343381057677,-0.259480339805169,0.259480339805169,-0.8583670733300858,-1.170500554541026,1,0,1,0,-1.170500554541026,-0.8583670733300858
4882,21,83,4,54,50,1,3792.186,60,2344.205,LESS,-388,2086,1698,5,1,-4.0,-0.3749633842697951,4.0,-0.8730378697119728,0.6571595116351199,0.056349223227323664,104,54,50,0,-1.116921538982118,-1.0144338139355558,-1.170500554541026,0.3828774846360424,-0.14860140697467153,0.14860140697467153,-1.170500554541026,-1.0144338139355558,1,1,1,0,-1.0144338139355558,-1.170500554541026
4883,21,84,37,80,69,1,4953.383,64,1838.405,LESS,218,2298,2516,6,2,-11.0,-1.0311493067419364,11.0,0.34921514788478913,0.8360798551319194,0.748096877465273,149,80,69,0,-0.21939530230005888,0.0,-0.4291835366650429,0.9020333960069474,0.6327082825053455,0.6327082825053455,-0.4291835366650429,0.0,1,1,1,1,0.0,-0.4291835366650429
4884,21,85,52,105,110,0,6086.174,14,1685.691,LESS,-294,2888,2594,6,1,5.0,0.4687042303372438,5.0,-0.6984302957695783,-1.4004244385780742,1.4229225246137425,215,105,110,1,1.0969765115002945,0.9754171287841883,1.170500554541026,0.9020333960069474,-0.02740815481110455,0.02740815481110455,1.170500554541026,0.9754171287841883,0,1,1,2,1.170500554541026,0.9754171287841883
4885,21,86,5,55,50,0,1853.876,54,1613.654,LESS,10,1166,1176,2,2,-5.0,-0.4687042303372438,5.0,-0.6984302957695783,0.3887789963899207,-1.0983397707039042,105,55,50,0,-1.0969765115002945,-0.9754171287841883,-1.170500554541026,-1.1745902494766727,0.36453597984553765,0.36453597984553765,-1.170500554541026,-0.9754171287841883,1,0,1,0,-0.9754171287841883,-1.170500554541026
4886,21,87,30,96,80,1,6288.181,14,1054.817,LESS,776,2482,3258,6,1,-16.0,-1.4998535370791803,16.0,1.222253017596762,-1.4004244385780742,1.5432620263431176,176,96,80,0,0.3191204397091766,0.6242669624218805,0.0,0.9020333960069474,1.3521320559869454,1.3521320559869454,0.0,0.6242669624218805,0,1,1,1,0.6242669624218805,0.0
4887,21,88,33,80,75,1,5492.658,14,1489.46,LESS,1118,2026,3144,7,1,-5.0,-0.4687042303372438,5.0,-0.6984302957695783,-1.4004244385780742,1.0693534913207778,155,80,75,0,-0.09972513740911768,0.0,-0.19508342575683765,1.4211893073778525,1.7930692074756678,1.7930692074756678,-0.19508342575683765,0.0,0,1,1,1,0.0,-0.19508342575683765
4888,21,89,48,110,128,0,5079.273,54,1121.91,LESS,-2030,3416,1386,4,1,18.0,1.6873352292140782,18.0,1.571468165481551,0.3887789963899207,0.8230920007665007,238,110,128,1,1.5557121435822359,1.170500554541026,1.8728008872656416,-0.13627842673486268,-2.265615450087193,2.265615450087193,1.8728008872656416,1.170500554541026,1,1,0,2,1.8728008872656416,1.170500554541026
4889,21,90,9,59,50,1,7720.113,14,1387.505,LESS,464,3374,3838,9,1,-9.0,-0.8436676146070391,9.0,0.0,-1.4004244385780742,2.39629178962037,109,59,50,0,-1.0171964015730004,-0.8193503881787182,-1.170500554541026,2.4595011301196625,0.9498736019972336,0.9498736019972336,-1.170500554541026,-0.8193503881787182,0,1,1,0,-0.8193503881787182,-1.170500554541026
4890,21,91,44,110,119,0,2067.515,34,952.06,LESS,-708,1410,702,2,1,9.0,0.8436676146070391,9.0,0.0,-0.5058227210940768,-0.971070860171289,229,110,119,1,1.376206896245824,1.170500554541026,1.5216507209033339,-1.1745902494766727,-0.5611741802974528,0.5611741802974528,1.5216507209033339,1.170500554541026,0,0,0,2,1.5216507209033339,1.170500554541026
4891,21,92,2,52,50,0,3373.466,34,1187.903,LESS,-602,1942,1340,4,1,-2.0,-0.18748169213489754,2.0,-1.222253017596762,-0.5058227210940768,-0.19309043066647247,102,52,50,0,-1.156811593945765,-1.092467184238291,-1.170500554541026,-0.13627842673486268,-0.4245094491342815,0.4245094491342815,-1.170500554541026,-1.092467184238291,0,1,0,0,-1.092467184238291,-1.170500554541026
4892,21,93,8,58,50,1,4757.763,44,869.5219999999998,LESS,734,1784,2518,7,2,-8.0,-0.7499267685395902,8.0,-0.17460757394239454,-0.05852186235207801,0.6315622359513631,108,58,50,0,-1.0371414290548238,-0.8583670733300858,-1.170500554541026,1.4211893073778525,1.2979818794883302,1.2979818794883302,-1.170500554541026,-0.8583670733300858,1,1,1,0,-0.8583670733300858,-1.170500554541026
4893,21,94,44,119,110,1,2216.41,24,802.005,LESS,490,824,1314,3,2,-9.0,-0.8436676146070391,9.0,0.0,-0.9531235798360754,-0.8823712106047129,229,119,110,0,1.376206896245824,1.5216507209033339,1.170500554541026,-0.6554343381057677,0.9833951398297095,0.9833951398297095,1.170500554541026,1.5216507209033339,0,0,1,2,1.5216507209033339,1.170500554541026
4894,21,95,34,74,80,0,8953.306999999999,24,5108.927,LESS,-2906,5544,2638,8,1,6.0,0.5624450764046927,6.0,-0.5238227218271837,-0.9531235798360754,3.130929458095498,154,74,80,1,-0.11967016489094122,-0.2341001109082052,0.0,1.9403452187487575,-3.3950334170583063,3.3950334170583063,0.0,-0.2341001109082052,0,1,0,1,-0.2341001109082052,0.0
4895,21,96,24,86,80,0,5655.27,24,1517.0929999999996,LESS,-1094,3030,1936,6,1,-6.0,-0.5624450764046927,6.0,-0.5238227218271837,-0.9531235798360754,1.1662246247726742,166,86,80,0,0.11967016489094122,0.2341001109082052,0.0,0.9020333960069474,-1.0588400881180577,1.0588400881180577,0.0,0.2341001109082052,0,1,0,1,0.2341001109082052,0.0
4896,21,97,39,66,80,0,1800.5970000000002,64,1341.701,LESS,-648,1188,540,2,1,14.0,1.3123718449442827,14.0,0.8730378697119728,0.8360798551319194,-1.1300791080171626,146,66,80,1,-0.2792303847455295,-0.5462335921191455,0.0,-1.1745902494766727,-0.4838167852994313,0.4838167852994313,0.0,-0.5462335921191455,1,0,0,1,-0.5462335921191455,0.0
4897,21,98,9,50,59,0,1809.005,64,851.172,LESS,-780,1194,414,2,1,9.0,0.8436676146070391,9.0,0.0,0.8360798551319194,-1.125070298765302,109,50,59,1,-1.0171964015730004,-1.170500554541026,-0.8193503881787182,-1.1745902494766727,-0.6540030542950785,0.6540030542950785,-0.8193503881787182,-1.170500554541026,1,0,0,0,-1.170500554541026,-0.8193503881787182
4898,21,99,57,94,110,0,6087.993,54,1619.404,LESS,-860,3148,2288,8,1,16.0,1.4998535370791803,16.0,1.222253017596762,0.3887789963899207,1.4240061383184446,204,94,110,1,0.8775812092002355,0.5462335921191455,1.170500554541026,1.9403452187487575,-0.7571462476257739,0.7571462476257739,1.170500554541026,0.5462335921191455,1,1,0,2,1.170500554541026,0.5462335921191455
4899,21,100,60,110,87,1,2367.676,54,1309.566,LESS,110,1004,1114,3,2,-23.0,-2.1560394595513217,23.0,2.444506035193524,0.3887789963899207,-0.792259110189402,197,110,87,0,0.7379660168274708,1.170500554541026,0.27311679605957273,-0.6554343381057677,0.4934649715089068,0.4934649715089068,0.27311679605957273,1.170500554541026,1,0,1,2,1.170500554541026,0.27311679605957273
4900,21,101,33,75,80,0,4641.306,54,1321.182,LESS,-996,2616,1620,6,1,5.0,0.4687042303372438,5.0,-0.6984302957695783,0.3887789963899207,0.5621865343524189,155,75,80,1,-0.09972513740911768,-0.19508342575683765,0.0,0.9020333960069474,-0.9324896762879559,0.9324896762879559,0.0,-0.19508342575683765,1,1,0,1,-0.19508342575683765,0.0
4901,21,102,15,50,45,1,5208.175,14,1197.475,LESS,1134,1768,2902,7,2,-5.0,-0.4687042303372438,5.0,-0.6984302957695783,-1.4004244385780742,0.8998814310927763,95,50,45,0,-1.2964267863185297,-1.170500554541026,-1.3655839802978638,1.4211893073778525,1.813697846141807,1.813697846141807,-1.3655839802978638,-1.170500554541026,0,1,1,0,-1.170500554541026,-1.3655839802978638
4902,21,103,59,89,110,0,3285.998,44,1259.207,LESS,-748,1938,1190,4,1,21.0,1.9685577674164243,21.0,2.0952908873087353,-0.05852186235207801,-0.2451968207285247,199,89,110,1,0.7778560717911179,0.3511501663623078,1.170500554541026,-0.13627842673486268,-0.6127457769628004,0.6127457769628004,1.170500554541026,0.3511501663623078,1,0,0,2,1.170500554541026,0.3511501663623078
4903,21,104,29,80,94,0,1911.852,44,1163.009,LESS,-612,1142,530,2,1,14.0,1.3123718449442827,14.0,0.8730378697119728,-0.05852186235207801,-1.0638023390690483,174,80,94,1,0.2792303847455295,0.0,0.5462335921191455,-1.1745902494766727,-0.4374023483006184,0.4374023483006184,0.5462335921191455,0.0,1,0,0,1,0.5462335921191455,0.0
4904,21,105,55,110,98,1,4350.2,14,1079.905,LESS,280,1954,2234,5,1,-12.0,-1.124890152809385,12.0,0.5238227218271837,-1.4004244385780742,0.388769024115489,208,110,98,0,0.9573613191275298,1.170500554541026,0.7023003327246156,0.3828774846360424,0.7126442573366343,0.7126442573366343,0.7023003327246156,1.170500554541026,0,1,1,2,1.170500554541026,0.7023003327246156
4905,21,106,29,94,80,1,4407.332,34,1984.327,LESS,-106,2228,2122,3,2,-14.0,-1.3123718449442827,14.0,0.8730378697119728,-0.5058227210940768,0.4228036685228746,174,94,80,0,0.2792303847455295,0.5462335921191455,0.0,-0.6554343381057677,0.21497834951602943,0.21497834951602943,0.0,0.5462335921191455,0,0,1,1,0.5462335921191455,0.0
4906,21,107,57,110,94,1,7101.501,4,1132.947,LESS,-440,3704,3264,8,1,-16.0,-1.4998535370791803,16.0,1.222253017596762,-1.8477252973200728,2.0277725806631937,204,110,94,0,0.8775812092002355,1.170500554541026,0.5462335921191455,1.9403452187487575,-0.2156444826396235,0.2156444826396235,0.5462335921191455,1.170500554541026,0,1,1,2,1.170500554541026,0.5462335921191455
4907,21,108,39,80,66,1,3596.618,64,991.126,LESS,38,1602,1640,4,1,-14.0,-1.3123718449442827,14.0,0.8730378697119728,0.8360798551319194,-0.06015444087446738,146,80,66,0,-0.2792303847455295,0.0,-0.5462335921191455,-0.13627842673486268,0.400636097511281,0.400636097511281,-0.5462335921191455,0.0,1,0,1,1,0.0,-0.5462335921191455
4908,21,109,4,50,54,0,3515.558,44,1480.846,LESS,-792,2058,1266,4,1,4.0,0.3749633842697951,4.0,-0.8730378697119728,-0.05852186235207801,-0.10844346061231387,104,50,54,1,-1.116921538982118,-1.170500554541026,-1.0144338139355558,-0.13627842673486268,-0.6694745332946829,0.6694745332946829,-1.0144338139355558,-1.170500554541026,1,0,0,0,-1.170500554541026,-1.0144338139355558
4909,21,110,55,98,110,0,4197.757000000001,14,833.809,LESS,-1568,2914,1346,4,1,12.0,1.124890152809385,12.0,0.5238227218271837,-1.4004244385780742,0.29795576189125433,208,98,110,1,0.9573613191275298,0.7023003327246156,1.170500554541026,-0.13627842673486268,-1.6699635086024274,1.6699635086024274,1.170500554541026,0.7023003327246156,0,0,0,2,1.170500554541026,0.7023003327246156
4910,21,111,2,50,52,0,6221.123000000001,64,1661.5929999999996,LESS,-898,3296,2398,6,1,2.0,0.18748169213489754,2.0,-1.222253017596762,0.8360798551319194,1.5033142705377829,102,50,52,1,-1.156811593945765,-1.170500554541026,-1.092467184238291,0.9020333960069474,-0.8061392644578542,0.8061392644578542,-1.092467184238291,-1.170500554541026,1,1,0,0,-1.170500554541026,-1.092467184238291
4911,21,112,59,110,89,1,5153.19,44,1343.598,LESS,40,2396,2436,5,2,-21.0,-1.9685577674164243,21.0,2.0952908873087353,-0.05852186235207801,0.867125796374228,199,110,89,0,0.7778560717911179,1.170500554541026,0.3511501663623078,0.3828774846360424,0.4032146773445484,0.4032146773445484,0.3511501663623078,1.170500554541026,1,1,1,2,1.170500554541026,0.3511501663623078
4912,21,113,60,87,110,0,2283.474,14,840.182,LESS,-932,1654,722,2,1,23.0,2.1560394595513217,23.0,2.444506035193524,-1.4004244385780742,-0.8424198804825941,197,87,110,1,0.7379660168274708,0.27311679605957273,1.170500554541026,-1.1745902494766727,-0.8499751216233997,0.8499751216233997,1.170500554541026,0.27311679605957273,0,0,0,2,1.170500554541026,0.27311679605957273
4913,21,114,52,110,105,1,6055.583000000001,34,1322.0079999999996,LESS,-1086,3446,2360,7,1,-5.0,-0.4687042303372438,5.0,-0.6984302957695783,-0.5058227210940768,1.4046988704958,215,110,105,0,1.0969765115002945,1.170500554541026,0.9754171287841883,1.4211893073778525,-1.048525768784988,1.048525768784988,0.9754171287841883,1.170500554541026,0,1,0,2,1.170500554541026,0.9754171287841883
4914,21,115,30,80,96,0,1957.349,74,1338.936,LESS,-656,1204,548,2,1,16.0,1.4998535370791803,16.0,1.222253017596762,1.2833807138739182,-1.036698890623295,176,80,96,1,0.3191204397091766,0.0,0.6242669624218805,-1.1745902494766727,-0.4941311046325008,0.4941311046325008,0.6242669624218805,0.0,1,0,0,1,0.6242669624218805,0.0
4915,21,116,24,80,86,0,3033.6,54,1045.299,LESS,-308,1768,1460,5,2,6.0,0.5624450764046927,6.0,-0.5238227218271837,0.3887789963899207,-0.3955552219596251,166,80,86,1,0.11967016489094122,0.0,0.2341001109082052,0.3828774846360424,-0.045458213643976224,0.045458213643976224,0.2341001109082052,0.0,1,1,1,1,0.2341001109082052,0.0
4916,21,117,5,50,55,0,3853.18,54,897.9960000000002,LESS,-1014,2232,1218,4,1,5.0,0.4687042303372438,5.0,-0.6984302957695783,0.3887789963899207,0.09268453620401004,105,50,55,1,-1.0969765115002945,-1.170500554541026,-0.9754171287841883,-0.13627842673486268,-0.9556968947873624,0.9556968947873624,-0.9754171287841883,-1.170500554541026,1,0,0,0,-1.170500554541026,-0.9754171287841883
4917,21,118,34,80,74,1,2868.129000000001,34,816.1189999999998,LESS,696,950,1646,3,2,-6.0,-0.5624450764046927,6.0,-0.5238227218271837,-0.5058227210940768,-0.4941295173586032,154,80,74,0,-0.11967016489094122,0.0,-0.2341001109082052,-0.6554343381057677,1.24898886265625,1.24898886265625,-0.2341001109082052,0.0,0,0,1,1,0.0,-0.2341001109082052
4918,21,119,15,45,50,0,3188.486,54,1072.74,LESS,-1100,1944,844,4,1,5.0,0.4687042303372438,5.0,-0.6984302957695783,0.3887789963899207,-0.3032866170852592,95,45,50,1,-1.2964267863185297,-1.3655839802978638,-1.170500554541026,-0.13627842673486268,-1.0665758276178599,1.0665758276178599,-1.170500554541026,-1.3655839802978638,1,0,0,0,-1.3655839802978638,-1.170500554541026
4919,21,120,37,69,80,0,1792.1029999999996,54,1323.45,LESS,-126,886,760,3,2,11.0,1.0311493067419364,11.0,0.34921514788478913,0.3887789963899207,-1.1351391491429126,149,69,80,1,-0.21939530230005888,-0.4291835366650429,0.0,-0.6554343381057677,0.18919255118335562,0.18919255118335562,0.0,-0.4291835366650429,1,0,1,1,-0.4291835366650429,0.0
4920,21,121,48,128,110,0,3927.783,74,1621.094,MORE,-166,2106,1940,4,2,-18.0,-1.6873352292140782,18.0,1.571468165481551,1.2833807138739182,0.13712699536392328,238,128,110,1,1.5557121435822359,1.8728008872656416,1.170500554541026,-0.13627842673486268,0.13762095451800796,0.13762095451800796,1.170500554541026,1.8728008872656416,1,1,0,2,1.8728008872656416,1.170500554541026
4921,21,122,8,50,58,1,2346.591,54,1648.833,MORE,102,926,1028,3,2,8.0,0.7499267685395902,8.0,-0.17460757394239454,0.3887789963899207,-0.8048198550842022,108,50,58,0,-1.0371414290548238,-1.170500554541026,-0.8583670733300858,-0.6554343381057677,0.48315065217583725,0.48315065217583725,-0.8583670733300858,-1.170500554541026,1,0,1,0,-1.170500554541026,-0.8583670733300858
4922,21,123,4,54,50,1,2281.117,44,1283.836,MORE,552,764,1316,3,2,-4.0,-0.3749633842697951,4.0,-0.8730378697119728,-0.05852186235207801,-0.8438239912588351,104,54,50,1,-1.116921538982118,-1.0144338139355558,-1.170500554541026,-0.6554343381057677,1.0633311146609985,1.0633311146609985,-1.170500554541026,-1.0144338139355558,0,0,1,0,-1.0144338139355558,-1.170500554541026
4923,21,124,37,80,69,0,2012.436,24,1150.821,MORE,-346,1502,1156,4,1,-11.0,-1.0311493067419364,11.0,0.34921514788478913,-0.9531235798360754,-1.0038824925194367,149,80,69,1,-0.21939530230005888,0.0,-0.4291835366650429,-0.13627842673486268,-0.0944512304760565,0.0944512304760565,-0.4291835366650429,0.0,0,1,0,1,0.0,-0.4291835366650429
4924,21,125,52,105,110,1,4045.193,64,1673.562,MORE,812,1840,2652,5,2,5.0,0.4687042303372438,5.0,-0.6984302957695783,0.8360798551319194,0.20707041761189487,215,105,110,0,1.0969765115002945,0.9754171287841883,1.170500554541026,0.3828774846360424,1.3985464929857583,1.3985464929857583,1.170500554541026,0.9754171287841883,1,1,1,2,1.170500554541026,0.9754171287841883
4925,21,126,5,55,50,0,2741.112,54,748.666,MORE,-570,1572,1002,4,1,-5.0,-0.4687042303372438,5.0,-0.6984302957695783,0.3887789963899207,-0.5697960164955646,105,55,50,1,-1.0969765115002945,-0.9754171287841883,-1.170500554541026,-0.13627842673486268,-0.3832521718020034,0.3832521718020034,-1.170500554541026,-0.9754171287841883,1,1,0,0,-0.9754171287841883,-1.170500554541026
4926,21,127,30,96,80,0,1764.354,74,733.8539999999998,MORE,-318,1010,692,2,2,-16.0,-1.4998535370791803,16.0,1.222253017596762,1.2833807138739182,-1.151669768544658,176,96,80,1,0.3191204397091766,0.6242669624218805,0.0,-1.1745902494766727,-0.05835111281031314,0.05835111281031314,0.0,0.6242669624218805,1,0,0,1,0.6242669624218805,0.0
4927,21,128,33,80,75,0,5100.177,24,838.5219999999998,MORE,122,2300,2422,6,2,-5.0,-0.4687042303372438,5.0,-0.6984302957695783,-0.9531235798360754,0.8355449204383477,155,80,75,1,-0.09972513740911768,0.0,-0.19508342575683765,0.9020333960069474,0.5089364505085111,0.5089364505085111,-0.19508342575683765,0.0,0,1,1,1,0.0,-0.19508342575683765
4928,21,129,48,110,128,1,2564.103,74,1431.564,MORE,1232,856,2088,3,2,18.0,1.6873352292140782,18.0,1.571468165481551,1.2833807138739182,-0.6752437230681834,238,110,128,0,1.5557121435822359,1.170500554541026,1.8728008872656416,-0.6554343381057677,1.9400482579719087,1.9400482579719087,1.8728008872656416,1.170500554541026,1,0,1,2,1.8728008872656416,1.170500554541026
4929,21,130,9,59,50,0,3870.127,24,1137.972,MORE,-402,2148,1746,6,1,-9.0,-0.8436676146070391,9.0,0.0,-0.9531235798360754,0.10278019395749252,109,59,50,1,-1.0171964015730004,-0.8193503881787182,-1.170500554541026,0.9020333960069474,-0.16665146580754323,0.16665146580754323,-1.170500554541026,-0.8193503881787182,0,1,0,0,-0.8193503881787182,-1.170500554541026
4930,21,131,44,110,119,1,3701.464,64,1136.048,MORE,426,1428,1854,3,2,9.0,0.8436676146070391,9.0,0.0,0.8360798551319194,0.002304362029976963,229,110,119,0,1.376206896245824,1.170500554541026,1.5216507209033339,-0.6554343381057677,0.9008805851651532,0.9008805851651532,1.5216507209033339,1.170500554541026,1,0,1,2,1.5216507209033339,1.170500554541026
4931,21,132,2,52,50,0,8908.739,14,1812.5,MORE,-484,4074,3590,9,1,-2.0,-0.18748169213489754,2.0,-1.222253017596762,-1.4004244385780742,3.10437943303164,102,52,50,1,-1.156811593945765,-1.092467184238291,-1.170500554541026,2.4595011301196625,-0.2723732389715059,0.2723732389715059,-1.170500554541026,-1.092467184238291,0,1,0,0,-1.092467184238291,-1.170500554541026
4932,21,133,8,58,50,0,5423.255,24,1021.682,MORE,-618,2776,2158,6,1,-8.0,-0.7499267685395902,8.0,-0.17460757394239454,-0.9531235798360754,1.0280087733727667,108,58,50,1,-1.0371414290548238,-0.8583670733300858,-1.170500554541026,0.9020333960069474,-0.4451380878004206,0.4451380878004206,-1.170500554541026,-0.8583670733300858,0,1,0,0,-0.8583670733300858,-1.170500554541026
4933,21,134,44,119,110,0,3533.67,44,1185.239,MORE,-1422,2264,842,4,1,-9.0,-0.8436676146070391,9.0,0.0,-0.05852186235207801,-0.09765378968347252,229,119,110,1,1.376206896245824,1.5216507209033339,1.170500554541026,-0.13627842673486268,-1.4817271807739083,1.4817271807739083,1.170500554541026,1.5216507209033339,0,1,0,2,1.5216507209033339,1.170500554541026
4934,21,135,34,74,80,1,2659.023,54,891.301,MORE,402,970,1372,3,2,6.0,0.5624450764046927,6.0,-0.5238227218271837,0.3887789963899207,-0.6186980315616895,154,74,80,0,-0.11967016489094122,-0.2341001109082052,0.0,-0.6554343381057677,0.8699376271659447,0.8699376271659447,0.0,-0.2341001109082052,0,0,1,1,-0.2341001109082052,0.0
4935,21,136,24,86,80,0,2188.129,64,2173.324,MORE,-200,1314,1114,4,2,-6.0,-0.5624450764046927,6.0,-0.5238227218271837,0.8360798551319194,-0.8992187527612147,166,86,80,1,0.11967016489094122,0.2341001109082052,0.0,-0.13627842673486268,0.09378509735246245,0.09378509735246245,0.0,0.2341001109082052,1,1,0,1,0.2341001109082052,0.0
4936,21,137,39,66,80,1,2611.263,54,1748.203,MORE,600,1054,1654,3,2,14.0,1.3123718449442827,14.0,0.8730378697119728,0.3887789963899207,-0.6471495931540847,146,66,80,0,-0.2792303847455295,-0.5462335921191455,0.0,-0.6554343381057677,1.1252170306594156,1.1252170306594156,0.0,-0.5462335921191455,0,0,1,1,-0.5462335921191455,0.0
4937,21,138,9,50,59,1,2174.234,54,1266.346,MORE,456,708,1164,3,2,9.0,0.8436676146070391,9.0,0.0,0.3887789963899207,-0.907496274711096,109,50,59,0,-1.0171964015730004,-1.170500554541026,-0.8193503881787182,-0.6554343381057677,0.939559282664164,0.939559282664164,-0.8193503881787182,-1.170500554541026,0,0,1,0,-1.170500554541026,-0.8193503881787182
4938,21,139,57,94,110,1,2799.173,14,999.547,MORE,60,1360,1420,4,1,16.0,1.4998535370791803,16.0,1.222253017596762,-1.4004244385780742,-0.5352079487062839,204,94,110,0,0.8775812092002355,0.5462335921191455,1.170500554541026,-0.13627842673486268,0.4290004756772222,0.4290004756772222,1.170500554541026,0.5462335921191455,0,1,1,2,1.170500554541026,0.5462335921191455
4939,21,140,60,110,87,0,1889.209,64,1420.474,MORE,-318,1028,710,2,2,-23.0,-2.1560394595513217,23.0,2.444506035193524,0.8360798551319194,-1.0772912148884917,197,110,87,1,0.7379660168274708,1.170500554541026,0.27311679605957273,-1.1745902494766727,-0.05835111281031314,0.05835111281031314,0.27311679605957273,1.170500554541026,1,0,0,2,1.170500554541026,0.27311679605957273
4940,21,141,33,75,80,1,2365.461,34,1370.266,MORE,178,984,1162,3,2,5.0,0.4687042303372438,5.0,-0.6984302957695783,-0.5058227210940768,-0.7935786288017798,155,75,80,0,-0.09972513740911768,-0.19508342575683765,0.0,-0.6554343381057677,0.5811366858399978,0.5811366858399978,0.0,-0.19508342575683765,0,0,1,1,-0.19508342575683765,0.0
4941,21,142,15,50,45,0,4368.702,54,1465.8529999999996,MORE,-720,2416,1696,6,2,-5.0,-0.4687042303372438,5.0,-0.6984302957695783,0.3887789963899207,0.3997910256352232,95,50,45,1,-1.2964267863185297,-1.170500554541026,-1.3655839802978638,0.9020333960069474,-0.5766456592970571,0.5766456592970571,-1.3655839802978638,-1.170500554541026,0,1,0,0,-1.170500554541026,-1.3655839802978638
4942,21,143,59,89,110,1,2463.41,70,1373.134,MORE,1176,906,2082,3,2,21.0,1.9685577674164243,21.0,2.0952908873087353,1.1044603703771187,-0.7352285030393527,199,89,110,0,0.7778560717911179,0.3511501663623078,1.170500554541026,-0.6554343381057677,1.867848022640422,1.867848022640422,1.170500554541026,0.3511501663623078,1,0,1,2,1.170500554541026,0.3511501663623078
4943,21,144,29,80,94,1,2663.583,54,1266.593,MORE,460,1190,1650,5,2,14.0,1.3123718449442827,14.0,0.8730378697119728,0.3887789963899207,-0.6159815508066366,174,80,94,0,0.2792303847455295,0.0,0.5462335921191455,0.3828774846360424,0.9447164423306987,0.9447164423306987,0.5462335921191455,0.0,0,1,1,1,0.5462335921191455,0.0
4944,21,145,55,110,98,1,2172.213,44,1434.8370000000002,MORE,354,754,1108,3,2,-12.0,-1.124890152809385,12.0,0.5238227218271837,-0.05852186235207801,-0.9087002237474908,208,110,98,1,0.9573613191275298,1.170500554541026,0.7023003327246156,-0.6554343381057677,0.8080517111675275,0.8080517111675275,0.7023003327246156,1.170500554541026,0,0,1,2,1.170500554541026,0.7023003327246156
4945,21,146,29,94,80,0,1703.131,64,1216.825,MORE,-294,1012,718,2,2,-14.0,-1.3123718449442827,14.0,0.8730378697119728,0.8360798551319194,-1.188141501278561,174,94,80,1,0.2792303847455295,0.5462335921191455,0.0,-1.1745902494766727,-0.02740815481110455,0.02740815481110455,0.0,0.5462335921191455,1,0,0,1,0.5462335921191455,0.0
4946,21,147,57,110,94,1,4571.52,54,1307.582,MORE,74,1932,2006,5,2,-16.0,-1.4998535370791803,16.0,1.222253017596762,0.3887789963899207,0.5206136558497627,204,110,94,1,0.8775812092002355,1.170500554541026,0.5462335921191455,0.3828774846360424,0.4470505345100939,0.4470505345100939,0.5462335921191455,1.170500554541026,0,1,1,2,1.170500554541026,0.5462335921191455
4947,21,148,39,80,66,0,3521.212,44,1706.901,MORE,-978,2136,1158,4,1,-14.0,-1.3123718449442827,14.0,0.8730378697119728,-0.05852186235207801,-0.10507526276383394,146,80,66,1,-0.2792303847455295,0.0,-0.5462335921191455,-0.13627842673486268,-0.9092824577885494,0.9092824577885494,-0.5462335921191455,0.0,0,1,0,1,0.0,-0.5462335921191455
4948,21,149,4,50,54,0,3895.733,34,1578.007,MORE,-1056,2310,1254,4,2,4.0,0.3749633842697951,4.0,-0.8730378697119728,-0.5058227210940768,0.11803418654825627,104,50,54,0,-1.116921538982118,-1.170500554541026,-1.0144338139355558,-0.13627842673486268,-1.0098470712859775,1.0098470712859775,-1.0144338139355558,-1.170500554541026,0,1,0,0,-1.170500554541026,-1.0144338139355558
4949,21,150,55,98,110,1,2916.4120000000007,54,2111.211,MORE,-134,1408,1274,3,1,12.0,1.124890152809385,12.0,0.5238227218271837,0.3887789963899207,-0.4653663944866264,208,98,110,0,0.9573613191275298,0.7023003327246156,1.170500554541026,-0.6554343381057677,0.1788782318502861,0.1788782318502861,1.170500554541026,0.7023003327246156,1,0,0,2,1.170500554541026,0.7023003327246156
4950,21,151,2,50,52,1,3362.676,40,1558.4160000000004,MORE,1112,1308,2420,4,1,2.0,0.18748169213489754,2.0,-1.222253017596762,-0.2374422058488775,-0.19951824368116974,102,50,52,0,-1.156811593945765,-1.170500554541026,-1.092467184238291,-0.13627842673486268,1.7853334679758657,1.7853334679758657,-1.092467184238291,-1.170500554541026,0,1,1,0,-1.170500554541026,-1.092467184238291
4951,21,152,59,110,89,0,1545.4879999999996,74,920.161,MORE,-404,866,462,2,1,-21.0,-1.9685577674164243,21.0,2.0952908873087353,1.2833807138739182,-1.2820525047146991,199,110,89,1,0.7778560717911179,1.170500554541026,0.3511501663623078,-1.1745902494766727,-0.1692300456408106,0.1692300456408106,0.3511501663623078,1.170500554541026,1,0,0,2,1.170500554541026,0.3511501663623078
4952,21,153,60,87,110,1,2022.807,84,1155.826,MORE,574,864,1438,3,2,23.0,2.1560394595513217,23.0,2.444506035193524,1.7306815726159168,-0.997704285960083,197,87,110,0,0.7379660168274708,0.27311679605957273,1.170500554541026,-0.6554343381057677,1.0916954928269396,1.0916954928269396,1.170500554541026,0.27311679605957273,1,0,1,2,1.170500554541026,0.27311679605957273
4953,21,154,52,110,105,1,2186.946,64,2094.386,MORE,92,1002,1094,4,1,-5.0,-0.4687042303372438,5.0,-0.6984302957695783,0.8360798551319194,-0.8999234888869224,215,110,105,1,1.0969765115002945,1.170500554541026,0.9754171287841883,-0.13627842673486268,0.47025775300950035,0.47025775300950035,0.9754171287841883,1.170500554541026,1,1,1,2,1.170500554541026,0.9754171287841883
4954,21,155,30,80,96,1,1891.139,74,943.877,MORE,750,668,1418,3,2,16.0,1.4998535370791803,16.0,1.222253017596762,1.2833807138739182,-1.076141476323305,176,80,96,0,0.3191204397091766,0.0,0.6242669624218805,-0.6554343381057677,1.3186105181544694,1.3186105181544694,0.6242669624218805,0.0,1,0,1,1,0.6242669624218805,0.0
4955,21,156,24,80,86,1,8029.44,34,2882.831,MORE,948,3272,4220,6,2,6.0,0.5624450764046927,6.0,-0.5238227218271837,-0.5058227210940768,2.580563904207698,166,80,86,0,0.11967016489094122,0.0,0.2341001109082052,0.9020333960069474,1.5738899216479403,1.5738899216479403,0.2341001109082052,0.0,0,1,1,1,0.2341001109082052,0.0
4956,21,157,5,50,55,1,2919.296,14,816.681,MORE,262,1240,1502,3,1,5.0,0.4687042303372438,5.0,-0.6984302957695783,-1.4004244385780742,-0.4636483395529488,105,50,55,0,-1.0969765115002945,-1.170500554541026,-0.9754171287841883,-0.6554343381057677,0.6894370388372278,0.6894370388372278,-0.9754171287841883,-1.170500554541026,0,0,1,0,-1.170500554541026,-0.9754171287841883
4957,21,158,34,80,74,1,3110.724,24,1089.9589999999996,MORE,44,1416,1460,3,2,-6.0,-0.5624450764046927,6.0,-0.5238227218271837,-0.9531235798360754,-0.3496109540314029,154,80,74,1,-0.11967016489094122,0.0,-0.2341001109082052,-0.6554343381057677,0.40837183701108315,0.40837183701108315,-0.2341001109082052,0.0,0,0,1,1,0.0,-0.2341001109082052
4958,21,159,15,45,50,1,2221.779,54,852.76,MORE,322,852,1174,3,2,5.0,0.4687042303372438,5.0,-0.6984302957695783,0.3887789963899207,-0.8791727928034236,95,45,50,0,-1.2964267863185297,-1.3655839802978638,-1.170500554541026,-0.6554343381057677,0.7667944338352494,0.7667944338352494,-1.170500554541026,-1.3655839802978638,0,0,1,0,-1.3655839802978638,-1.170500554541026
4959,21,160,37,69,80,1,3658.028,54,954.841,MORE,-1176,2248,1072,3,2,11.0,1.0311493067419364,11.0,0.34921514788478913,0.3887789963899207,-0.02357130860082873,149,69,80,0,-0.21939530230005888,-0.4291835366650429,0.0,-0.6554343381057677,-1.1645618612820203,1.1645618612820203,0.0,-0.4291835366650429,0,0,0,1,-0.4291835366650429,0.0
4960,21,161,3,50,53,0,3194.879000000001,34,1402.296,LESS,-1668,2394,726,3,2,3.0,0.28122253820234633,3.0,-1.0476454436543674,-0.5058227210940768,-0.2994781825530103,103,50,53,1,-1.1368665664639415,-1.170500554541026,-1.0534504990869233,-0.6554343381057677,-1.7988925002657965,1.7988925002657965,-1.0534504990869233,-1.170500554541026,0,0,0,0,-1.170500554541026,-1.0534504990869233
4961,21,162,20,50,40,1,2147.085,64,1061.002,LESS,684,840,1524,3,2,-10.0,-0.9374084606744876,10.0,0.17460757394239454,0.8360798551319194,-0.9236694624345452,90,50,40,0,-1.3961519237276474,-1.170500554541026,-1.5606674060547012,-0.6554343381057677,1.2335173836566458,1.2335173836566458,-1.5606674060547012,-1.170500554541026,1,0,1,0,-1.170500554541026,-1.5606674060547012
4962,21,163,25,80,88,0,5070.572,4,1258.613,LESS,-1480,3250,1770,6,1,8.0,0.7499267685395902,8.0,-0.17460757394239454,-1.8477252973200728,0.8179086457117387,168,80,88,1,0.1595602198545883,0.0,0.31213348121094026,0.9020333960069474,-1.5565059959386625,1.5565059959386625,0.31213348121094026,0.0,0,1,0,1,0.31213348121094026,0.0
4963,21,164,42,115,110,0,5417.065,0,1002.469,LESS,-1796,3618,1822,6,1,-5.0,-0.4687042303372438,5.0,-0.6984302957695783,-2.0266456408168723,1.024321269891675,225,115,110,0,1.2964267863185297,1.3655839802978638,1.170500554541026,0.9020333960069474,-1.963921609594909,1.963921609594909,1.170500554541026,1.3655839802978638,0,1,0,2,1.3655839802978638,1.170500554541026
4964,21,165,53,103,110,0,3136.4640000000004,44,1478.7520000000004,LESS,-1064,1972,908,4,1,7.0,0.6561859224721414,7.0,-0.34921514788478913,-0.05852186235207801,-0.3342771350324863,213,103,110,1,1.0570864565366473,0.8973837584814532,1.170500554541026,-0.13627842673486268,-1.020161390619047,1.020161390619047,1.170500554541026,0.8973837584814532,1,0,0,2,1.170500554541026,0.8973837584814532
4965,21,166,26,90,80,1,5386.943,14,2184.527,LESS,-1258,3574,2316,9,1,-10.0,-0.9374084606744876,10.0,0.17460757394239454,-1.4004244385780742,1.0063770082022674,170,90,80,0,0.19945027481823535,0.3901668515136753,0.0,2.4595011301196625,-1.2702836344459831,1.2702836344459831,0.0,0.3901668515136753,0,1,0,1,0.3901668515136753,0.0
4966,21,167,35,80,72,1,7266.773,34,2451.218,LESS,-2140,4556,2416,6,1,-8.0,-0.7499267685395902,8.0,-0.17460757394239454,-0.5058227210940768,2.1262283278888705,152,80,72,0,-0.1595602198545883,0.0,-0.31213348121094026,0.9020333960069474,-2.407437340916899,2.407437340916899,-0.31213348121094026,0.0,0,1,0,1,0.0,-0.31213348121094026
4967,21,168,28,93,80,1,2320.345,64,1381.411,LESS,28,1026,1054,3,2,-13.0,-1.218630998876834,13.0,0.6984302957695783,0.8360798551319194,-0.8204551081318153,173,93,80,0,0.25928535726370594,0.5072169069677779,0.0,-0.6554343381057677,0.3877431983449441,0.3877431983449441,0.0,0.5072169069677779,1,0,1,1,0.5072169069677779,0.0
4968,21,169,26,80,90,0,2738.326,24,1833.339,LESS,-138,1264,1126,4,1,10.0,0.9374084606744876,10.0,0.17460757394239454,-0.9531235798360754,-0.5714556909217876,170,80,90,1,0.19945027481823535,0.0,0.3901668515136753,-0.13627842673486268,0.17372107218375132,0.17372107218375132,0.3901668515136753,0.0,0,0,1,1,0.3901668515136753,0.0
4969,21,170,25,88,80,1,3743.0,34,1607.588,LESS,332,1606,1938,5,2,-8.0,-0.7499267685395902,8.0,-0.17460757394239454,-0.5058227210940768,0.0270481656795106,168,88,80,0,0.1595602198545883,0.31213348121094026,0.0,0.3828774846360424,0.7796873330015863,0.7796873330015863,0.0,0.31213348121094026,0,1,1,1,0.31213348121094026,0.0
4970,21,171,36,80,70,0,6684.261,0,1229.609,LESS,-726,3738,3012,8,1,-10.0,-0.9374084606744876,10.0,0.17460757394239454,-2.0266456408168723,1.7792145915758624,150,80,70,0,-0.19945027481823535,0.0,-0.3901668515136753,1.9403452187487575,-0.5843813987968592,0.5843813987968592,-0.3901668515136753,0.0,0,1,0,1,0.0,-0.3901668515136753
4971,21,172,28,80,93,0,5069.082,54,2849.533,LESS,-2186,3512,1326,4,1,13.0,1.218630998876834,13.0,0.6984302957695783,0.3887789963899207,0.8170210237106361,173,80,93,1,0.25928535726370594,0.0,0.5072169069677779,-0.13627842673486268,-2.4667446770820485,2.4667446770820485,0.5072169069677779,0.0,1,1,0,1,0.5072169069677779,0.0
4972,21,173,21,82,80,0,4317.218,44,1047.445,LESS,-798,2338,1540,4,1,-2.0,-0.18748169213489754,2.0,-1.222253017596762,-0.05852186235207801,0.3691210047595347,162,82,80,0,0.03989005496364707,0.07803337030273506,0.0,-0.13627842673486268,-0.677210272794485,0.677210272794485,0.0,0.07803337030273506,1,1,0,1,0.07803337030273506,0.0
4973,21,174,19,50,41,1,2187.661,14,910.625,LESS,52,1048,1100,4,1,-9.0,-0.8436676146070391,9.0,0.0,-1.4004244385780742,-0.8994975494702858,91,50,41,0,-1.376206896245824,-1.170500554541026,-1.5216507209033339,-0.13627842673486268,0.4186861563441527,0.4186861563441527,-1.5216507209033339,-1.170500554541026,0,1,1,0,-1.170500554541026,-1.5216507209033339
4974,21,175,56,96,110,0,1780.706,64,1095.0410000000004,LESS,-636,1112,476,2,1,14.0,1.3123718449442827,14.0,0.8730378697119728,0.8360798551319194,-1.1419285638721528,206,96,110,1,0.9174712641638826,0.6242669624218805,1.170500554541026,-1.1745902494766727,-0.468345306299827,0.468345306299827,1.170500554541026,0.6242669624218805,1,0,0,2,1.170500554541026,0.6242669624218805
4975,21,176,23,80,85,0,4697.693,34,2338.222,LESS,-1092,2948,1856,5,2,5.0,0.4687042303372438,5.0,-0.6984302957695783,-0.5058227210940768,0.5957773677592533,165,80,85,1,0.09972513740911768,0.0,0.19508342575683765,0.3828774846360424,-1.0562615082847904,1.0562615082847904,0.19508342575683765,0.0,0,1,0,1,0.19508342575683765,0.0
4976,21,177,10,60,50,1,4615.715,24,1669.9260000000004,LESS,106,2136,2242,5,1,-10.0,-0.9374084606744876,10.0,0.17460757394239454,-0.9531235798360754,0.5469414775536131,110,60,50,0,-0.9972513740911768,-0.7803337030273506,-1.170500554541026,0.3828774846360424,0.48830781184237204,0.48830781184237204,-1.170500554541026,-0.7803337030273506,0,1,1,0,-0.7803337030273506,-1.170500554541026
4977,21,178,19,41,50,0,3213.238,44,1010.195,LESS,-1004,2176,1172,5,2,9.0,0.8436676146070391,9.0,0.0,-0.05852186235207801,-0.2885413689166042,91,41,50,1,-1.376206896245824,-1.5216507209033339,-1.170500554541026,0.3828774846360424,-0.9428039956210255,0.9428039956210255,-1.170500554541026,-1.5216507209033339,1,1,0,0,-1.5216507209033339,-1.170500554541026
4978,21,179,56,110,96,0,7377.4659999999985,0,2745.9970000000008,LESS,-1306,4270,2964,8,1,-14.0,-1.3123718449442827,14.0,0.8730378697119728,-2.0266456408168723,2.192170302498313,206,110,96,0,0.9174712641638826,1.170500554541026,0.6242669624218805,1.9403452187487575,-1.3321695504444002,1.3321695504444002,0.6242669624218805,1.170500554541026,0,1,0,2,1.170500554541026,0.6242669624218805
4979,21,180,35,72,80,0,3176.483,60,1455.059,LESS,-572,1944,1372,4,2,8.0,0.7499267685395902,8.0,-0.17460757394239454,0.6571595116351199,-0.310437037809579,152,72,80,1,-0.1595602198545883,-0.31213348121094026,0.0,-0.13627842673486268,-0.38583075163527075,0.38583075163527075,0.0,-0.31213348121094026,1,1,0,1,-0.31213348121094026,0.0
4980,21,181,11,49,50,1,3459.488,14,1730.948,LESS,-260,1608,1348,3,2,1.0,0.09374084606744876,1.0,-1.3968605915391563,-1.4004244385780742,-0.14184545094911458,99,49,50,1,-1.2166466763912356,-1.2095172396923934,-1.170500554541026,-0.6554343381057677,0.01642770235444096,0.01642770235444096,-1.170500554541026,-1.2095172396923934,0,0,1,0,-1.2095172396923934,-1.170500554541026
4981,21,182,17,43,50,0,2485.027,64,1559.095,LESS,236,1252,1488,2,2,7.0,0.6561859224721414,7.0,-0.34921514788478913,0.8360798551319194,-0.7223508353897964,93,43,50,1,-1.3363168412821769,-1.4436173506005987,-1.170500554541026,-1.1745902494766727,0.6559155010047519,0.6559155010047519,-1.170500554541026,-1.4436173506005987,1,0,1,0,-1.4436173506005987,-1.170500554541026
4982,21,183,1,51,50,0,4340.71,34,1206.124,LESS,-1744,2864,1120,4,1,-1.0,-0.09374084606744876,1.0,-1.3968605915391563,-0.5058227210940768,0.38311564640376733,101,51,50,0,-1.1767566214275886,-1.1314838693896585,-1.170500554541026,-0.13627842673486268,-1.896878533929957,1.896878533929957,-1.170500554541026,-1.1314838693896585,0,0,0,0,-1.1314838693896585,-1.170500554541026
4983,21,184,41,112,110,1,2234.861,34,1333.707,LESS,28,1160,1188,3,2,-2.0,-0.18748169213489754,2.0,-1.222253017596762,-0.5058227210940768,-0.871379590777634,222,112,110,0,1.2365917038730592,1.248533924843761,1.170500554541026,-0.6554343381057677,0.3877431983449441,0.3877431983449441,1.170500554541026,1.248533924843761,0,0,1,2,1.248533924843761,1.170500554541026
4984,21,185,20,40,50,0,1765.2620000000004,54,1158.84,LESS,-542,1064,522,2,1,10.0,0.9374084606744876,10.0,0.17460757394239454,0.3887789963899207,-1.1511288552715024,90,40,50,1,-1.3961519237276474,-1.5606674060547012,-1.170500554541026,-1.1745902494766727,-0.34715205413626005,0.34715205413626005,-1.170500554541026,-1.5606674060547012,1,0,0,0,-1.5606674060547012,-1.170500554541026
4985,21,186,1,50,51,0,2333.864,54,1409.372,LESS,-398,1434,1036,2,2,1.0,0.09374084606744876,1.0,-1.3968605915391563,0.3887789963899207,-0.8124015767003331,101,50,51,1,-1.1767566214275886,-1.170500554541026,-1.1314838693896585,-1.1745902494766727,-0.16149430614100846,0.16149430614100846,-1.1314838693896585,-1.170500554541026,1,0,1,0,-1.170500554541026,-1.1314838693896585
4986,21,187,23,85,80,0,3397.47,24,947.396,LESS,-576,1812,1236,4,1,-5.0,-0.4687042303372438,5.0,-0.6984302957695783,-0.9531235798360754,-0.17879078065676038,165,85,80,0,0.09972513740911768,0.19508342575683765,0.0,-0.13627842673486268,-0.39098791130180555,0.39098791130180555,0.0,0.19508342575683765,0,1,0,1,0.19508342575683765,0.0
4987,21,188,11,50,49,1,5579.569,54,954.002,LESS,902,1854,2756,4,2,-1.0,-0.09374084606744876,1.0,-1.3968605915391563,0.3887789963899207,1.1211280656414784,99,50,49,0,-1.2166466763912356,-1.170500554541026,-1.2095172396923934,-0.13627842673486268,1.5145825854827906,1.5145825854827906,-1.2095172396923934,-1.170500554541026,1,0,1,0,-1.170500554541026,-1.2095172396923934
4988,21,189,17,50,43,1,2468.565,54,1233.596,LESS,-76,1210,1134,3,2,-7.0,-0.6561859224721414,7.0,-0.34921514788478913,0.3887789963899207,-0.7321575692033225,93,50,43,0,-1.3363168412821769,-1.170500554541026,-1.4436173506005987,-0.6554343381057677,0.25365704701504016,0.25365704701504016,-1.4436173506005987,-1.170500554541026,1,0,1,0,-1.170500554541026,-1.4436173506005987
4989,21,190,21,80,82,0,3862.368,14,842.38,LESS,-848,2192,1344,6,1,2.0,0.18748169213489754,2.0,-1.222253017596762,-1.4004244385780742,0.09815800663765596,162,80,82,1,0.03989005496364707,0.0,0.07803337030273506,0.9020333960069474,-0.7416747686261695,0.7416747686261695,0.07803337030273506,0.0,0,1,0,1,0.07803337030273506,0.0
4990,21,191,10,50,60,0,4770.802,24,1605.0739999999996,LESS,-1602,3226,1624,7,2,10.0,0.9374084606744876,10.0,0.17460757394239454,-0.9531235798360754,0.6393298220402079,110,50,60,1,-0.9972513740911768,-1.170500554541026,-0.7803337030273506,1.4211893073778525,-1.7137993657679729,1.7137993657679729,-0.7803337030273506,-1.170500554541026,0,1,0,0,-1.170500554541026,-0.7803337030273506
4991,21,192,3,53,50,0,6413.825,54,1435.714,LESS,-828,3122,2294,6,1,-3.0,-0.28122253820234633,3.0,-1.0476454436543674,0.3887789963899207,1.6181106026562435,103,53,50,0,-1.1368665664639415,-1.0534504990869233,-1.170500554541026,0.9020333960069474,-0.7158889702934957,0.7158889702934957,-1.170500554541026,-1.0534504990869233,1,1,0,0,-1.0534504990869233,-1.170500554541026
4992,21,193,45,122,110,1,3994.448,0,1838.84,LESS,-378,2412,2034,5,1,-12.0,-1.124890152809385,12.0,0.5238227218271837,-2.0266456408168723,0.17684063341997486,232,122,110,0,1.4360419786912946,1.6387007763574364,1.170500554541026,0.3828774846360424,-0.13570850780833463,0.13570850780833463,1.170500554541026,1.6387007763574364,0,1,1,2,1.6387007763574364,1.170500554541026
4993,21,194,38,67,80,0,1734.304,34,1262.3239999999996,LESS,-724,1162,438,2,1,13.0,1.218630998876834,13.0,0.6984302957695783,-0.5058227210940768,-1.1695711384326704,147,67,80,1,-0.25928535726370594,-0.5072169069677779,0.0,-1.1745902494766727,-0.5818028189635919,0.5818028189635919,0.0,-0.5072169069677779,0,0,0,1,-0.5072169069677779,0.0
4994,21,195,38,80,67,1,4647.243,34,1889.793,LESS,644,1818,2462,5,2,-13.0,-1.218630998876834,13.0,0.6984302957695783,-0.5058227210940768,0.5657233208091625,147,80,67,0,-0.25928535726370594,0.0,-0.5072169069677779,0.3828774846360424,1.181945786991298,1.181945786991298,-0.5072169069677779,0.0,0,1,1,1,0.0,-0.5072169069677779
4995,21,196,36,70,80,0,2337.373,94,998.005,LESS,-622,1606,984,2,2,10.0,0.9374084606744876,10.0,0.17460757394239454,2.177982431357916,-0.8103111971017627,150,70,80,1,-0.19945027481823535,-0.3901668515136753,0.0,-1.1745902494766727,-0.4502952474669553,0.4502952474669553,0.0,-0.3901668515136753,1,0,0,1,-0.3901668515136753,0.0
4996,21,197,45,110,122,1,2315.217,24,1228.744,LESS,794,830,1624,3,2,12.0,1.124890152809385,12.0,0.5238227218271837,-0.9531235798360754,-0.8235099575423219,232,110,122,1,1.4360419786912946,1.170500554541026,1.6387007763574364,-0.6554343381057677,1.375339274486352,1.375339274486352,1.6387007763574364,1.170500554541026,0,0,1,2,1.6387007763574364,1.170500554541026
4997,21,198,42,110,115,0,3295.675,54,902.273,LESS,-800,1952,1152,5,2,5.0,0.4687042303372438,5.0,-0.6984302957695783,0.3887789963899207,-0.2394320434770672,225,110,115,1,1.2964267863185297,1.170500554541026,1.3655839802978638,0.3828774846360424,-0.6797888526277525,0.6797888526277525,1.3655839802978638,1.170500554541026,1,1,0,2,1.3655839802978638,1.170500554541026
4998,21,199,41,110,112,0,3930.609,54,1089.317,LESS,-170,1876,1706,7,2,2.0,0.18748169213489754,2.0,-1.222253017596762,0.3887789963899207,0.13881049856869945,222,110,112,1,1.2365917038730592,1.170500554541026,1.248533924843761,1.4211893073778525,0.1324637948514732,0.1324637948514732,1.248533924843761,1.170500554541026,1,1,1,2,1.248533924843761,1.170500554541026
4999,21,200,53,110,103,0,4819.176,74,1245.605,LESS,-1080,3162,2082,7,1,-7.0,-0.6561859224721414,7.0,-0.34921514788478913,1.2833807138739182,0.6681471553833936,213,110,103,0,1.0570864565366473,1.170500554541026,0.8973837584814532,1.4211893073778525,-1.040790029285186,1.040790029285186,0.8973837584814532,1.170500554541026,1,1,0,2,1.170500554541026,0.8973837584814532
5000,21,201,3,50,53,1,2400.215,54,1444.41,MORE,220,1054,1274,3,1,3.0,0.28122253820234633,3.0,-1.0476454436543674,0.3887789963899207,-0.7728749945559231,103,50,53,0,-1.1368665664639415,-1.170500554541026,-1.0534504990869233,-0.6554343381057677,0.6352868623386129,0.6352868623386129,-1.0534504990869233,-1.170500554541026,1,0,1,0,-1.170500554541026,-1.0534504990869233
5001,21,202,20,50,40,0,4795.18,34,1969.826,MORE,-470,2446,1976,6,1,-10.0,-0.9374084606744876,10.0,0.17460757394239454,-0.5058227210940768,0.653852271129392,90,50,40,1,-1.3961519237276474,-1.170500554541026,-1.5606674060547012,0.9020333960069474,-0.25432318013863425,0.25432318013863425,-1.5606674060547012,-1.170500554541026,0,1,0,0,-1.170500554541026,-1.5606674060547012
5002,21,203,25,80,88,1,2464.427,64,2300.42,MORE,-1500,2334,834,4,1,8.0,0.7499267685395902,8.0,-0.17460757394239454,0.8360798551319194,-0.7346226563446401,168,80,88,0,0.1595602198545883,0.0,0.31213348121094026,-0.13627842673486268,-1.5822917942713361,1.5822917942713361,0.31213348121094026,0.0,1,1,0,1,0.31213348121094026,0.0
5003,21,204,42,115,110,0,2582.984,54,912.856,MORE,-1640,2196,556,2,1,-5.0,-0.4687042303372438,5.0,-0.6984302957695783,0.3887789963899207,-0.6639959438716588,225,115,110,1,1.2964267863185297,1.3655839802978638,1.170500554541026,-1.1745902494766727,-1.762792382600053,1.762792382600053,1.170500554541026,1.3655839802978638,1,0,0,2,1.3655839802978638,1.170500554541026
5004,21,205,53,103,110,0,3333.14,14,1721.539,MORE,-1420,2736,1316,4,1,7.0,0.6561859224721414,7.0,-0.34921514788478913,-1.4004244385780742,-0.21711341376477494,213,103,110,0,1.0570864565366473,0.8973837584814532,1.170500554541026,-0.13627842673486268,-1.479148600940641,1.479148600940641,1.170500554541026,0.8973837584814532,0,1,0,2,1.170500554541026,0.8973837584814532
5005,21,206,26,90,80,0,6205.311,64,1071.3010000000004,MORE,-1008,3380,2372,8,1,-10.0,-0.9374084606744876,10.0,0.17460757394239454,0.8360798551319194,1.4938947543757437,170,90,80,1,0.19945027481823535,0.3901668515136753,0.0,1.9403452187487575,-0.9479611552875602,0.9479611552875602,0.0,0.3901668515136753,1,1,0,1,0.3901668515136753,0.0
5006,21,207,35,80,72,1,7904.323,24,2110.443,MORE,-240,3762,3522,10,2,-8.0,-0.7499267685395902,8.0,-0.17460757394239454,-0.9531235798360754,2.5060292720520096,152,80,72,1,-0.1595602198545883,0.0,-0.31213348121094026,2.9786570414905675,0.04221350068711479,0.04221350068711479,-0.31213348121094026,0.0,0,1,0,1,0.0,-0.31213348121094026
5007,21,208,28,93,80,1,3177.11,24,973.091,MORE,-554,1942,1388,6,1,-13.0,-1.218630998876834,13.0,0.6984302957695783,-0.9531235798360754,-0.31006352170575924,173,93,80,1,0.25928535726370594,0.5072169069677779,0.0,0.9020333960069474,-0.3626235331358643,0.3626235331358643,0.0,0.5072169069677779,0,1,0,1,0.5072169069677779,0.0
5008,21,209,26,80,90,1,2096.738,84,1369.626,MORE,872,752,1624,3,2,10.0,0.9374084606744876,10.0,0.17460757394239454,1.7306815726159168,-0.9536621502798618,170,80,90,0,0.19945027481823535,0.0,0.3901668515136753,-0.6554343381057677,1.4759038879837798,1.4759038879837798,0.3901668515136753,0.0,1,0,1,1,0.3901668515136753,0.0
5009,21,210,25,88,80,1,1419.017,64,861.4760000000001,MORE,-418,940,522,2,1,-8.0,-0.7499267685395902,8.0,-0.17460757394239454,0.8360798551319194,-1.3573937410244103,168,88,80,1,0.1595602198545883,0.31213348121094026,0.0,-1.1745902494766727,-0.1872801044736823,0.1872801044736823,0.0,0.31213348121094026,1,0,0,1,0.31213348121094026,0.0
5010,21,211,36,80,70,0,5425.377,64,883.084,MORE,-1090,3026,1936,6,1,-10.0,-0.9374084606744876,10.0,0.17460757394239454,0.8360798551319194,1.0292728900750086,150,80,70,1,-0.19945027481823535,0.0,-0.3901668515136753,0.9020333960069474,-1.053682928451523,1.053682928451523,-0.3901668515136753,0.0,1,1,0,1,0.0,-0.3901668515136753
5011,21,212,28,80,93,1,2963.507,64,1381.251,MORE,1372,758,2130,3,2,13.0,1.218630998876834,13.0,0.6984302957695783,0.8360798551319194,-0.4373109863376768,173,80,93,0,0.25928535726370594,0.0,0.5072169069677779,-0.6554343381057677,2.1205488463006255,2.1205488463006255,0.5072169069677779,0.0,1,0,1,1,0.5072169069677779,0.0
5012,21,213,21,82,80,1,3435.493,64,1119.754,MORE,462,1294,1756,5,2,-2.0,-0.18748169213489754,2.0,-1.222253017596762,0.8360798551319194,-0.15613973948365226,162,82,80,1,0.03989005496364707,0.07803337030273506,0.0,0.3828774846360424,0.9472950221639662,0.9472950221639662,0.0,0.07803337030273506,1,1,1,1,0.07803337030273506,0.0
5013,21,214,19,50,41,0,4322.837,44,961.12,MORE,-742,2550,1808,8,1,-9.0,-0.8436676146070391,9.0,0.0,-0.05852186235207801,0.3724683524267811,91,50,41,1,-1.376206896245824,-1.170500554541026,-1.5216507209033339,1.9403452187487575,-0.6050100374629983,0.6050100374629983,-1.5216507209033339,-1.170500554541026,0,1,0,0,-1.170500554541026,-1.5216507209033339
5014,21,215,56,96,110,1,3453.615,74,1104.734,MORE,86,1484,1570,3,2,14.0,1.3123718449442827,14.0,0.8730378697119728,1.2833807138739182,-0.14534411136017275,206,96,110,0,0.9174712641638826,0.6242669624218805,1.170500554541026,-0.6554343381057677,0.4625220135096982,0.4625220135096982,1.170500554541026,0.6242669624218805,1,0,1,2,1.170500554541026,0.6242669624218805
5015,21,216,23,80,85,1,3341.141,54,1341.168,MORE,550,1260,1810,3,2,5.0,0.4687042303372438,5.0,-0.6984302957695783,0.3887789963899207,-0.21234706233469208,165,80,85,0,0.09972513740911768,0.0,0.19508342575683765,-0.6554343381057677,1.060752534827731,1.060752534827731,0.19508342575683765,0.0,0,0,1,1,0.19508342575683765,0.0
5016,21,217,10,60,50,0,3487.366,64,1408.425,MORE,-1088,2392,1304,3,1,-10.0,-0.9374084606744876,10.0,0.17460757394239454,0.8360798551319194,-0.12523798373653508,110,60,50,1,-0.9972513740911768,-0.7803337030273506,-1.170500554541026,-0.6554343381057677,-1.0511043486182556,1.0511043486182556,-1.170500554541026,-0.7803337030273506,1,0,0,0,-0.7803337030273506,-1.170500554541026
5017,21,218,19,41,50,1,2448.685,74,1021.188,MORE,244,868,1112,3,2,9.0,0.8436676146070391,9.0,0.0,1.2833807138739182,-0.7440004721442107,91,41,50,0,-1.376206896245824,-1.5216507209033339,-1.170500554541026,-0.6554343381057677,0.6662298203378214,0.6662298203378214,-1.170500554541026,-1.5216507209033339,1,0,1,0,-1.5216507209033339,-1.170500554541026
5018,21,219,56,110,96,0,1741.28,74,1381.537,MORE,-482,1012,530,2,1,-14.0,-1.3123718449442827,14.0,0.8730378697119728,1.2833807138739182,-1.1654153994530108,206,110,96,1,0.9174712641638826,1.170500554541026,0.6242669624218805,-1.1745902494766727,-0.2697946591382385,0.2697946591382385,0.6242669624218805,1.170500554541026,1,0,0,2,1.170500554541026,0.6242669624218805
5019,21,220,35,72,80,1,2125.919,64,1122.591,MORE,570,734,1304,3,2,8.0,0.7499267685395902,8.0,-0.17460757394239454,0.8360798551319194,-0.9362784606059154,152,72,80,0,-0.1595602198545883,-0.31213348121094026,0.0,-0.6554343381057677,1.0865383331604048,1.0865383331604048,0.0,-0.31213348121094026,1,0,1,1,-0.31213348121094026,0.0
5020,21,221,11,49,50,0,2296.95,40,1954.714,MORE,-134,1426,1292,5,2,1.0,0.09374084606744876,1.0,-1.3968605915391563,-0.2374422058488775,-0.8343919649880566,99,49,50,0,-1.2166466763912356,-1.2095172396923934,-1.170500554541026,0.3828774846360424,0.1788782318502861,0.1788782318502861,-1.170500554541026,-1.2095172396923934,0,1,0,0,-1.2095172396923934,-1.170500554541026
5021,21,222,17,43,50,0,3825.649,14,1836.194,MORE,-1414,2912,1498,7,1,7.0,0.6561859224721414,7.0,-0.34921514788478913,-1.4004244385780742,0.07628378364537876,93,43,50,0,-1.3363168412821769,-1.4436173506005987,-1.170500554541026,1.4211893073778525,-1.4714128614408388,1.4714128614408388,-1.170500554541026,-1.4436173506005987,0,1,0,0,-1.4436173506005987,-1.170500554541026
5022,21,223,1,51,50,0,6548.938,14,1744.266,MORE,-1398,3766,2368,8,1,-1.0,-0.09374084606744876,1.0,-1.3968605915391563,-1.4004244385780742,1.6986000465723512,101,51,50,1,-1.1767566214275886,-1.1314838693896585,-1.170500554541026,1.9403452187487575,-1.4507842227746996,1.4507842227746996,-1.170500554541026,-1.1314838693896585,0,1,0,0,-1.1314838693896585,-1.170500554541026
5023,21,224,41,112,110,1,3613.055,74,965.925,MORE,528,1364,1892,5,2,-2.0,-0.18748169213489754,2.0,-1.222253017596762,1.2833807138739182,-0.050362600047536975,222,112,110,1,1.2365917038730592,1.248533924843761,1.170500554541026,0.3828774846360424,1.0323881566617898,1.0323881566617898,1.170500554541026,1.248533924843761,1,1,1,2,1.248533924843761,1.170500554541026
5024,21,225,20,40,50,1,1967.491,44,1007.561,MORE,288,700,988,3,2,10.0,0.9374084606744876,10.0,0.17460757394239454,-0.05852186235207801,-1.0306571038211576,90,40,50,0,-1.3961519237276474,-1.5606674060547012,-1.170500554541026,-0.6554343381057677,0.7229585766697039,0.7229585766697039,-1.170500554541026,-1.5606674060547012,0,0,1,0,-1.5606674060547012,-1.170500554541026
5025,21,226,1,50,51,1,8515.563,14,1267.44,MORE,-768,4086,3318,9,1,1.0,0.09374084606744876,1.0,-1.3968605915391563,-1.4004244385780742,2.8701568371218507,101,50,51,0,-1.1767566214275886,-1.170500554541026,-1.1314838693896585,2.4595011301196625,-0.6385315752954743,0.6385315752954743,-1.1314838693896585,-1.170500554541026,0,1,0,0,-1.170500554541026,-1.1314838693896585
5026,21,227,23,85,80,1,4615.47,64,956.997,MORE,-302,2230,1928,5,2,-5.0,-0.4687042303372438,5.0,-0.6984302957695783,0.8360798551319194,0.5467955262849755,165,85,80,1,0.09972513740911768,0.19508342575683765,0.0,0.3828774846360424,-0.03772247414417408,0.03772247414417408,0.0,0.19508342575683765,1,1,0,1,0.19508342575683765,0.0
5027,21,228,11,50,49,0,1932.855,4,1128.198,MORE,-1154,1788,634,2,1,-1.0,-0.09374084606744876,1.0,-1.3968605915391563,-1.8477252973200728,-1.0512904431702823,99,50,49,1,-1.2166466763912356,-1.170500554541026,-1.2095172396923934,-1.1745902494766727,-1.1361974831160793,1.1361974831160793,-1.2095172396923934,-1.170500554541026,0,0,0,0,-1.170500554541026,-1.2095172396923934
5028,21,229,17,50,43,1,2072.021,60,1396.505,MORE,104,796,900,3,2,-7.0,-0.6561859224721414,7.0,-0.34921514788478913,0.6571595116351199,-0.9683865482672828,93,50,43,1,-1.3363168412821769,-1.170500554541026,-1.4436173506005987,-0.6554343381057677,0.4857292320091046,0.4857292320091046,-1.4436173506005987,-1.170500554541026,1,0,1,0,-1.170500554541026,-1.4436173506005987
5029,21,230,21,80,82,1,4164.697,34,1472.274,MORE,558,1534,2092,7,2,2.0,0.18748169213489754,2.0,-1.222253017596762,-0.5058227210940768,0.27826127641712073,162,80,82,0,0.03989005496364707,0.0,0.07803337030273506,1.4211893073778525,1.0710668541608006,1.0710668541608006,0.07803337030273506,0.0,0,1,1,1,0.07803337030273506,0.0
5030,21,231,10,50,60,1,2067.636,64,901.723,MORE,460,682,1142,3,2,10.0,0.9374084606744876,10.0,0.17460757394239454,0.8360798551319194,-0.970998778116166,110,50,60,0,-0.9972513740911768,-1.170500554541026,-0.7803337030273506,-0.6554343381057677,0.9447164423306987,0.9447164423306987,-0.7803337030273506,-1.170500554541026,1,0,1,0,-1.170500554541026,-0.7803337030273506
5031,21,232,3,53,50,1,8965.785,14,1176.3,MORE,-400,4328,3928,12,1,-3.0,-0.28122253820234633,3.0,-1.0476454436543674,-1.4004244385780742,3.1383628455651364,103,53,50,1,-1.1368665664639415,-1.0534504990869233,-1.170500554541026,4.0169688642323775,-0.16407288597427583,0.16407288597427583,-1.170500554541026,-1.0534504990869233,0,1,0,0,-1.0534504990869233,-1.170500554541026
5032,21,233,45,122,110,0,1657.823,54,1038.049,MORE,-520,970,450,2,1,-12.0,-1.124890152809385,12.0,0.5238227218271837,0.3887789963899207,-1.2151323587456513,232,122,110,1,1.4360419786912946,1.6387007763574364,1.170500554541026,-1.1745902494766727,-0.3187876759703188,0.3187876759703188,1.170500554541026,1.6387007763574364,0,0,0,2,1.6387007763574364,1.170500554541026
5033,21,234,38,67,80,1,4773.458,54,1002.345,MORE,784,1756,2540,7,2,13.0,1.218630998876834,13.0,0.6984302957695783,0.3887789963899207,0.6409120529361335,147,67,80,0,-0.25928535726370594,-0.5072169069677779,0.0,1.4211893073778525,1.362446375320015,1.362446375320015,0.0,-0.5072169069677779,0,1,1,1,-0.5072169069677779,0.0
5034,21,235,38,80,67,0,1700.826,64,790.1060000000001,MORE,-492,1014,522,2,1,-13.0,-1.218630998876834,13.0,0.6984302957695783,0.8360798551319194,-1.1895146346426828,147,80,67,1,-0.25928535726370594,0.0,-0.5072169069677779,-1.1745902494766727,-0.2826875583045754,0.2826875583045754,-0.5072169069677779,0.0,1,0,0,1,0.0,-0.5072169069677779
5035,21,236,36,70,80,1,1956.149,50,1364.26,MORE,-100,1068,968,3,1,10.0,0.9374084606744876,10.0,0.17460757394239454,0.2098586528931212,-1.0374137539798878,150,70,80,0,-0.19945027481823535,-0.3901668515136753,0.0,-0.6554343381057677,0.2227140890158316,0.2227140890158316,0.0,-0.3901668515136753,0,0,0,1,-0.3901668515136753,0.0
5036,21,237,45,110,122,1,2339.862,84,852.632,MORE,642,964,1606,3,2,12.0,1.124890152809385,12.0,0.5238227218271837,1.7306815726159168,-0.8088284513562964,232,110,122,0,1.4360419786912946,1.170500554541026,1.6387007763574364,-0.6554343381057677,1.1793672071580306,1.1793672071580306,1.6387007763574364,1.170500554541026,1,0,1,2,1.6387007763574364,1.170500554541026
5037,21,238,42,110,115,1,2296.298,74,1862.313,MORE,928,1168,2096,3,1,5.0,0.4687042303372438,5.0,-0.6984302957695783,1.2833807138739182,-0.834780374078472,225,110,115,0,1.2964267863185297,1.170500554541026,1.3655839802978638,-0.6554343381057677,1.5481041233152666,1.5481041233152666,1.3655839802978638,1.170500554541026,1,0,1,2,1.3655839802978638,1.170500554541026
5038,21,239,41,110,112,1,2008.652,74,1301.031,MORE,264,750,1014,3,2,2.0,0.18748169213489754,2.0,-1.222253017596762,1.2833807138739182,-1.0061366949705592,222,110,112,0,1.2365917038730592,1.170500554541026,1.248533924843761,-0.6554343381057677,0.6920156186704952,0.6920156186704952,1.248533924843761,1.170500554541026,1,0,1,2,1.248533924843761,1.170500554541026
5039,21,240,53,110,103,0,3618.108,60,1601.589,MORE,206,1654,1860,5,2,-7.0,-0.6561859224721414,7.0,-0.34921514788478913,0.6571595116351199,-0.04735242959681708,213,110,103,1,1.0570864565366473,1.170500554541026,0.8973837584814532,0.3828774846360424,0.6172368035057412,0.6172368035057412,0.8973837584814532,1.170500554541026,1,1,1,2,1.170500554541026,0.8973837584814532
5040,22,1,49,110,131,1,4537.993,70,3246.516,MORE,1724,1238,2962,3,2,21.0,1.9685577674164243,21.0,2.0952908873087353,1.3445878475787776,0.8845570589561996,241,110,131,0,1.6155472260277064,1.170500554541026,1.9898509427197442,0.04456417666004307,1.7945048430721378,1.7945048430721378,1.9898509427197442,1.170500554541026,1,1,1,2,1.9898509427197442,1.170500554541026
5041,22,2,13,47,50,1,2586.963,80,1570.013,MORE,652,662,1314,3,2,3.0,0.28122253820234633,3.0,-1.0476454436543674,1.8990570630751809,-0.17964329646194613,97,47,50,0,-1.2565367313548828,-1.2875506099951286,-1.170500554541026,0.04456417666004307,0.6805327110005458,0.6805327110005458,-1.170500554541026,-1.2875506099951286,1,1,1,0,-1.2875506099951286,-1.170500554541026
5042,22,3,16,50,44,1,3177.974,60,1273.395,MORE,1274,906,2180,3,2,-6.0,-0.5624450764046927,6.0,-0.5238227218271837,0.7901186320823744,0.1427269983341532,94,50,44,1,-1.3163718138003533,-1.170500554541026,-1.4046006654492311,0.04456417666004307,1.3268859443480554,1.3268859443480554,-1.4046006654492311,-1.170500554541026,1,1,1,0,-1.170500554541026,-1.4046006654492311
5043,22,4,7,57,50,0,1960.35,50,1549.136,MORE,-1128,1826,698,2,1,-7.0,-0.6561859224721414,7.0,-0.34921514788478913,0.2356494165859713,-0.52143290364873,107,57,50,1,-1.0570864565366473,-0.8973837584814532,-1.170500554541026,-0.6684626499006461,-1.1691598217302694,1.1691598217302694,-1.170500554541026,-0.8973837584814532,0,0,0,0,-0.8973837584814532,-1.170500554541026
5044,22,5,18,42,50,1,1274.41,90,1106.202,MORE,692,268,960,1,2,8.0,0.7499267685395902,8.0,-0.17460757394239454,2.453526278571584,-0.8955827587486118,92,42,50,0,-1.3562618687640005,-1.4826340357519663,-1.170500554541026,-1.3814894764613352,0.7220988353315753,0.7220988353315753,-1.170500554541026,-1.4826340357519663,1,0,1,0,-1.4826340357519663,-1.170500554541026
5045,22,6,51,108,110,0,1644.567,30,1791.91,MORE,-1090,1630,540,2,1,2.0,0.18748169213489754,2.0,-1.222253017596762,-0.8732890144068349,-0.6936785281829545,218,108,110,0,1.156811593945765,1.092467184238291,1.170500554541026,-0.6684626499006461,-1.1296720036157915,1.1296720036157915,1.170500554541026,1.092467184238291,0,0,0,2,1.170500554541026,1.092467184238291
5046,22,7,31,78,80,1,3871.098,50,1624.638,MORE,304,1798,2102,4,1,2.0,0.18748169213489754,2.0,-1.222253017596762,0.2356494165859713,0.5207954068921182,158,78,80,0,-0.03989005496364707,-0.07803337030273506,0.0,0.7575910032207323,0.31890742932058863,0.31890742932058863,0.0,-0.07803337030273506,0,1,0,1,-0.07803337030273506,0.0
5047,22,8,58,110,92,0,3338.173,50,1354.688,MORE,-1780,2744,964,4,1,-18.0,-1.6873352292140782,18.0,1.571468165481551,0.2356494165859713,0.23010844953563706,202,110,92,1,0.8376911542365885,1.170500554541026,0.4682002218164104,0.7575910032207323,-1.8466876483260513,1.8466876483260513,0.4682002218164104,1.170500554541026,1,1,0,2,1.170500554541026,0.4682002218164104
5048,22,9,12,50,48,0,2504.418,60,408.624,MORE,-596,1510,914,4,1,-2.0,-0.18748169213489754,2.0,-1.222253017596762,0.7901186320823744,-0.2246679338780755,98,50,48,1,-1.2365917038730592,-1.170500554541026,-1.248533924843761,0.7575910032207323,-0.6163303681275764,0.6163303681275764,-1.248533924843761,-1.170500554541026,1,1,0,0,-1.170500554541026,-1.248533924843761
5049,22,10,54,110,101,0,2644.842,70,2774.653,MORE,-644,1552,908,2,1,-9.0,-0.8436676146070391,9.0,0.0,1.3445878475787776,-0.1480728683438512,211,110,101,1,1.0171964015730004,1.170500554541026,0.8193503881787182,-0.6684626499006461,-0.6662097173248118,0.6662097173248118,0.8193503881787182,1.170500554541026,1,0,0,2,1.170500554541026,0.8193503881787182
5050,22,11,14,46,50,1,2817.484000000001,40,1420.629,MORE,1140,818,1958,3,2,4.0,0.3749633842697951,4.0,-0.8730378697119728,-0.3188197989104318,-0.053904312370800914,96,46,50,0,-1.2764817588367063,-1.3265672951464962,-1.170500554541026,0.04456417666004307,1.1876394278391063,1.1876394278391063,-1.170500554541026,-1.3265672951464962,0,1,1,0,-1.3265672951464962,-1.170500554541026
5051,22,12,22,80,83,1,3032.704,70,1067.13,MORE,1260,904,2164,3,2,3.0,0.28122253820234633,3.0,-1.0476454436543674,1.3445878475787776,0.06348865467383326,163,80,83,0,0.05983508244547061,0.0,0.1170500554541026,0.04456417666004307,1.312337800832195,1.312337800832195,0.1170500554541026,0.0,1,1,1,1,0.1170500554541026,0.0
5052,22,13,6,50,56,1,2405.77,50,2548.558,MORE,752,730,1482,3,2,6.0,0.5624450764046927,6.0,-0.5238227218271837,0.2356494165859713,-0.2784760437796605,106,50,56,0,-1.077031484018471,-1.170500554541026,-0.9364004436328208,0.04456417666004307,0.7844480218281197,0.7844480218281197,-0.9364004436328208,-1.170500554541026,1,1,1,0,-1.170500554541026,-0.9364004436328208
5053,22,14,13,50,47,1,3382.378,40,1666.152,MORE,212,1394,1606,5,2,-3.0,-0.28122253820234633,3.0,-1.0476454436543674,-0.3188197989104318,0.2542203169652817,97,50,47,1,-1.2565367313548828,-1.170500554541026,-1.2875506099951286,1.4706178297814214,0.22330534335922067,0.22330534335922067,-1.2875506099951286,-1.170500554541026,0,1,0,0,-1.170500554541026,-1.2875506099951286
5054,22,15,46,110,124,1,2201.455,60,919.364,MORE,512,720,1232,3,2,14.0,1.3123718449442827,14.0,0.8730378697119728,0.7901186320823744,-0.3899208168570906,234,110,124,0,1.4759320336549415,1.170500554541026,1.7167341466601715,0.04456417666004307,0.5350512758419423,0.5350512758419423,1.7167341466601715,1.170500554541026,1,1,1,2,1.7167341466601715,1.170500554541026
5055,22,16,27,91,80,0,1647.6070000000002,40,3452.002,MORE,-822,1292,470,2,1,-11.0,-1.0311493067419364,11.0,0.34921514788478913,-0.3188197989104318,-0.6920203429779749,171,91,80,1,0.21939530230005888,0.4291835366650429,0.0,-0.6684626499006461,-0.8511789705978934,0.8511789705978934,0.0,0.4291835366650429,0,0,0,1,0.4291835366650429,0.0
5056,22,17,40,64,80,1,4088.601,40,2717.131,MORE,216,2182,2398,3,1,16.0,1.4998535370791803,16.0,1.222253017596762,-0.3188197989104318,0.6394336492074661,144,64,80,0,-0.3191204397091766,-0.6242669624218805,0.0,0.04456417666004307,0.22746195579232362,0.22746195579232362,0.0,-0.6242669624218805,0,0,0,1,-0.6242669624218805,0.0
5057,22,18,22,83,80,1,13138.447,60,1860.1,MORE,1802,4828,6630,8,2,-3.0,-0.28122253820234633,3.0,-1.0476454436543674,0.7901186320823744,5.57572336780712,163,83,80,1,0.05983508244547061,0.1170500554541026,0.0,3.609698309463489,1.8755587855176454,1.8755587855176454,0.0,0.1170500554541026,1,1,1,1,0.1170500554541026,0.0
5058,22,19,54,101,110,0,1937.222,70,1110.566,MORE,-584,1166,582,2,1,9.0,0.8436676146070391,9.0,0.0,1.3445878475787776,-0.5340482021424029,211,101,110,0,1.0171964015730004,0.8193503881787182,1.170500554541026,-0.6684626499006461,-0.6038605308282675,0.6038605308282675,1.170500554541026,0.8193503881787182,1,0,0,2,1.170500554541026,0.8193503881787182
5059,22,20,6,56,50,1,1213.214,90,1690.661,MORE,1138,366,1504,1,2,-6.0,-0.5624450764046927,6.0,-0.5238227218271837,2.453526278571584,-0.9289624632893768,106,56,50,1,-1.077031484018471,-0.9364004436328208,-1.170500554541026,-1.3814894764613352,1.1855611216225548,1.1855611216225548,-1.170500554541026,-0.9364004436328208,1,0,1,0,-0.9364004436328208,-1.170500554541026
5060,22,21,18,50,42,1,1389.5079999999996,50,2091.261,MORE,590,382,972,1,2,-8.0,-0.7499267685395902,8.0,-0.17460757394239454,0.2356494165859713,-0.8328019032477137,92,50,42,1,-1.3562618687640005,-1.170500554541026,-1.4826340357519663,-1.3814894764613352,0.6161052182874499,0.6161052182874499,-1.4826340357519663,-1.170500554541026,1,0,1,0,-1.170500554541026,-1.4826340357519663
5061,22,22,43,110,117,1,3259.071,50,1801.941,MORE,432,1322,1754,3,2,7.0,0.6561859224721414,7.0,-0.34921514788478913,0.2356494165859713,0.186961815955279,227,110,117,0,1.3363168412821769,1.170500554541026,1.4436173506005987,0.04456417666004307,0.4519190271798832,0.4519190271798832,1.4436173506005987,1.170500554541026,1,1,1,2,1.4436173506005987,1.170500554541026
5062,22,23,32,77,80,1,1555.1729999999998,70,1299.765,MORE,672,400,1072,1,2,3.0,0.28122253820234633,3.0,-1.0476454436543674,1.3445878475787776,-0.7424389914112236,157,77,80,0,-0.05983508244547061,-0.1170500554541026,0.0,-1.3814894764613352,0.7013157731660605,0.7013157731660605,0.0,-0.1170500554541026,1,0,1,1,-0.1170500554541026,0.0
5063,22,24,27,80,91,1,5069.976,50,1390.35,MORE,428,2036,2464,3,2,11.0,1.0311493067419364,11.0,0.34921514788478913,0.2356494165859713,1.1747301970814004,171,80,91,0,0.21939530230005888,0.0,0.4291835366650429,0.04456417666004307,0.44776241474678025,0.44776241474678025,0.4291835366650429,0.0,1,1,1,1,0.4291835366650429,0.0
5064,22,25,16,44,50,1,1336.313,50,3284.991,MORE,616,330,946,1,2,6.0,0.5624450764046927,6.0,-0.5238227218271837,0.2356494165859713,-0.8618174170565571,94,44,50,0,-1.3163718138003533,-1.4046006654492311,-1.170500554541026,-1.3814894764613352,0.6431231991026192,0.6431231991026192,-1.170500554541026,-1.4046006654492311,1,0,1,0,-1.4046006654492311,-1.170500554541026
5065,22,26,7,50,57,1,1182.444,80,2358.155,MORE,336,386,722,1,2,7.0,0.6561859224721414,7.0,-0.34921514788478913,1.8990570630751809,-0.9457461339331992,107,50,57,0,-1.0570864565366473,-1.170500554541026,-0.8973837584814532,-1.3814894764613352,0.35216032878541226,0.35216032878541226,-0.8973837584814532,-1.170500554541026,1,0,1,0,-1.170500554541026,-0.8973837584814532
5066,22,27,14,50,46,1,1338.95,90,1065.634,MORE,1082,364,1446,1,2,-4.0,-0.3749633842697951,4.0,-0.8730378697119728,2.453526278571584,-0.8603790504823693,96,50,46,1,-1.2764817588367063,-1.170500554541026,-1.3265672951464962,-1.3814894764613352,1.1273685475591135,1.1273685475591135,-1.3265672951464962,-1.170500554541026,1,0,1,0,-1.170500554541026,-1.3265672951464962
5067,22,28,51,110,108,0,1862.513,70,1229.999,MORE,-768,1350,582,2,1,-2.0,-0.18748169213489754,2.0,-1.222253017596762,1.3445878475787776,-0.5747986490104338,218,110,108,1,1.156811593945765,1.170500554541026,1.092467184238291,-0.6684626499006461,-0.7950647027510035,0.7950647027510035,1.092467184238291,1.170500554541026,1,0,0,2,1.170500554541026,1.092467184238291
5068,22,29,50,133,110,0,2617.658,60,1839.808,MORE,-576,1536,960,4,1,-23.0,-2.1560394595513217,23.0,2.444506035193524,0.7901186320823744,-0.16290053499258908,243,133,110,1,1.6554372809913533,2.0678843130224793,1.170500554541026,0.7575910032207323,-0.5955473059620616,0.5955473059620616,1.170500554541026,2.0678843130224793,1,1,0,2,2.0678843130224793,1.170500554541026
5069,22,30,49,131,110,1,4142.725,40,2182.558,MORE,-402,2520,2118,6,1,-21.0,-1.9685577674164243,21.0,2.0952908873087353,-0.3188197989104318,0.6689558913240158,241,131,110,1,1.6155472260277064,1.9898509427197442,1.170500554541026,2.1836446563421106,-0.414734665122083,0.414734665122083,1.170500554541026,1.9898509427197442,0,1,0,2,1.9898509427197442,1.170500554541026
5070,22,31,47,126,110,1,1432.219,70,1293.419,MORE,642,364,1006,1,2,-16.0,-1.4998535370791803,16.0,1.222253017596762,1.3445878475787776,-0.8095049465734109,236,126,110,1,1.5158220886185887,1.7947675169629065,1.170500554541026,-1.3814894764613352,0.6701411799177883,0.6701411799177883,1.170500554541026,1.7947675169629065,1,0,1,2,1.7947675169629065,1.170500554541026
5071,22,32,50,110,133,1,3548.336,50,1366.234,MORE,1534,810,2344,3,2,23.0,2.1560394595513217,23.0,2.444506035193524,0.2356494165859713,0.3447430473100146,243,110,133,0,1.6554372809913533,1.170500554541026,2.0678843130224793,0.04456417666004307,1.5970657524997474,1.5970657524997474,2.0678843130224793,1.170500554541026,1,1,1,2,2.0678843130224793,1.170500554541026
5072,22,33,47,110,126,1,2776.543,70,1450.821,MORE,682,1220,1902,3,2,16.0,1.4998535370791803,16.0,1.222253017596762,1.3445878475787776,-0.07623581252773087,236,110,126,0,1.5158220886185887,1.170500554541026,1.7947675169629065,0.04456417666004307,0.7117073042488179,0.7117073042488179,1.7947675169629065,1.170500554541026,1,1,1,2,1.7947675169629065,1.170500554541026
5073,22,34,12,48,50,1,4499.653,30,1680.095,MORE,686,1972,2658,4,1,2.0,0.18748169213489754,2.0,-1.222253017596762,-0.8732890144068349,0.8636442889697146,98,48,50,0,-1.2365917038730592,-1.248533924843761,-1.170500554541026,0.7575910032207323,0.7158639166819208,0.7158639166819208,-1.170500554541026,-1.248533924843761,0,1,1,0,-1.248533924843761,-1.170500554541026
5074,22,35,32,80,77,1,2747.788,60,1649.9679999999996,MORE,-262,1320,1058,3,2,-3.0,-0.28122253820234633,3.0,-1.0476454436543674,0.7901186320823744,-0.09192039001759464,157,80,77,1,-0.05983508244547061,0.0,-0.1170500554541026,0.04456417666004307,-0.2692532299634796,0.2692532299634796,-0.1170500554541026,0.0,1,1,0,1,0.0,-0.1170500554541026
5075,22,36,43,117,110,0,2167.218,80,946.009,MORE,-482,1204,722,2,1,-7.0,-0.6561859224721414,7.0,-0.34921514788478913,1.8990570630751809,-0.4085955822725128,227,117,110,1,1.3363168412821769,1.4436173506005987,1.170500554541026,-0.6684626499006461,-0.49786691378414216,0.49786691378414216,1.170500554541026,1.4436173506005987,1,0,0,2,1.4436173506005987,1.170500554541026
5076,22,37,40,80,64,0,4105.584,60,1653.956,MORE,-850,2302,1452,4,1,-16.0,-1.4998535370791803,16.0,1.222253017596762,0.7901186320823744,0.6486971226733103,144,80,64,1,-0.3191204397091766,0.0,-0.6242669624218805,0.7575910032207323,-0.880275257629614,0.880275257629614,-0.6242669624218805,0.0,1,1,0,1,0.0,-0.6242669624218805
5077,22,38,31,80,78,1,2361.564,40,1975.729,MORE,436,1082,1518,3,1,-2.0,-0.18748169213489754,2.0,-1.222253017596762,-0.3188197989104318,-0.3025884566649645,158,80,78,1,-0.03989005496364707,0.0,-0.07803337030273506,0.04456417666004307,0.45607563961298614,0.45607563961298614,-0.07803337030273506,0.0,0,1,1,1,0.0,-0.07803337030273506
5078,22,39,46,124,110,0,1730.479,80,852.6080000000002,MORE,-750,1208,458,2,1,-14.0,-1.3123718449442827,14.0,0.8730378697119728,1.8990570630751809,-0.6468173415611784,234,124,110,1,1.4759320336549415,1.7167341466601715,1.170500554541026,-0.6684626499006461,-0.7763599468020401,0.7763599468020401,1.170500554541026,1.7167341466601715,1,0,0,2,1.7167341466601715,1.170500554541026
5079,22,40,58,92,110,1,2481.226,60,1204.994,MORE,-2366,3762,1396,3,1,18.0,1.6873352292140782,18.0,1.571468165481551,0.7901186320823744,-0.2373181415339586,202,92,110,0,0.8376911542365885,0.4682002218164104,1.170500554541026,0.04456417666004307,-2.455631369775634,2.455631369775634,1.170500554541026,0.4682002218164104,1,1,0,2,1.170500554541026,0.4682002218164104
5080,22,41,49,110,131,0,2639.121,60,2346.203,LESS,-1034,1804,770,3,1,21.0,1.9685577674164243,21.0,2.0952908873087353,0.7901186320823744,-0.15119342017203793,241,110,131,1,1.6155472260277064,1.170500554541026,1.9898509427197442,0.04456417666004307,-1.07147942955235,1.07147942955235,1.9898509427197442,1.170500554541026,1,0,0,2,1.9898509427197442,1.170500554541026
5081,22,42,13,47,50,1,3490.418,40,1839.189,LESS,134,1458,1592,3,1,3.0,0.28122253820234633,3.0,-1.0476454436543674,-0.3188197989104318,0.31315134642119796,97,47,50,1,-1.2565367313548828,-1.2875506099951286,-1.170500554541026,0.04456417666004307,0.14225140091371302,0.14225140091371302,-1.170500554541026,-1.2875506099951286,1,0,1,0,-1.2875506099951286,-1.170500554541026
5082,22,43,16,50,44,1,3392.99,60,2237.885,LESS,872,1208,2080,5,2,-6.0,-0.5624450764046927,6.0,-0.5238227218271837,0.7901186320823744,0.26000869242424285,94,50,44,0,-1.3163718138003533,-1.170500554541026,-1.4046006654492311,1.4706178297814214,0.9091463948212083,0.9091463948212083,-1.4046006654492311,-1.170500554541026,1,1,1,0,-1.170500554541026,-1.4046006654492311
5083,22,44,7,57,50,1,2362.167,50,2778.9970000000008,LESS,610,830,1440,3,2,-7.0,-0.6561859224721414,7.0,-0.34921514788478913,0.2356494165859713,-0.30225954690226625,107,57,50,0,-1.0570864565366473,-0.8973837584814532,-1.170500554541026,0.04456417666004307,0.6368882804529648,0.6368882804529648,-1.170500554541026,-0.8973837584814532,1,0,1,0,-0.8973837584814532,-1.170500554541026
5084,22,45,18,42,50,0,7480.396,30,2342.487,LESS,-938,3220,2282,4,1,8.0,0.7499267685395902,8.0,-0.17460757394239454,-0.8732890144068349,2.489507427932288,92,42,50,1,-1.3562618687640005,-1.4826340357519663,-1.170500554541026,0.7575910032207323,-0.971720731157879,0.971720731157879,-1.170500554541026,-1.4826340357519663,0,1,0,0,-1.4826340357519663,-1.170500554541026
5085,22,46,51,108,110,0,4304.928,30,959.45,LESS,994,1424,2418,4,1,2.0,0.18748169213489754,2.0,-1.222253017596762,-0.8732890144068349,0.7574304356672033,218,108,110,1,1.156811593945765,1.092467184238291,1.170500554541026,0.7575910032207323,1.0359230740308485,1.0359230740308485,1.170500554541026,1.092467184238291,0,1,1,2,1.170500554541026,1.092467184238291
5086,22,47,31,78,80,0,1333.4129999999998,70,1066.696,LESS,-452,842,390,2,1,2.0,0.18748169213489754,2.0,-1.222253017596762,1.3445878475787776,-0.8633992384692022,158,78,80,1,-0.03989005496364707,-0.07803337030273506,0.0,-0.6684626499006461,-0.46669232053586995,0.46669232053586995,0.0,-0.07803337030273506,1,0,0,1,-0.07803337030273506,0.0
5087,22,48,58,110,92,1,1699.346,50,1136.87,LESS,374,540,914,3,2,-18.0,-1.6873352292140782,18.0,1.571468165481551,0.2356494165859713,-0.663799012609411,202,110,92,0,0.8376911542365885,1.170500554541026,0.4682002218164104,0.04456417666004307,0.39164814689989036,0.39164814689989036,0.4682002218164104,1.170500554541026,1,0,1,2,1.170500554541026,0.4682002218164104
5088,22,49,12,50,48,0,1330.119,40,1302.753,LESS,-460,856,396,2,1,-2.0,-0.18748169213489754,2.0,-1.222253017596762,-0.3188197989104318,-0.8651959694117031,98,50,48,0,-1.2365917038730592,-1.170500554541026,-1.248533924843761,-0.6684626499006461,-0.4750055454020759,0.4750055454020759,-1.248533924843761,-1.170500554541026,1,0,0,0,-1.170500554541026,-1.248533924843761
5089,22,50,54,110,101,1,1991.938,40,1605.6989999999996,LESS,416,644,1060,3,2,-9.0,-0.8436676146070391,9.0,0.0,-0.3188197989104318,-0.5042030502754099,211,110,101,0,1.0171964015730004,1.170500554541026,0.8193503881787182,0.04456417666004307,0.43529257744747135,0.43529257744747135,0.8193503881787182,1.170500554541026,0,0,1,2,1.170500554541026,0.8193503881787182
5090,22,51,14,46,50,0,2734.698,30,1120.65,LESS,-94,1226,1132,4,1,4.0,0.3749633842697951,4.0,-0.8730378697119728,-0.8732890144068349,-0.09906040460087816,96,46,50,1,-1.2764817588367063,-1.3265672951464962,-1.170500554541026,0.7575910032207323,-0.09467550777315545,0.09467550777315545,-1.170500554541026,-1.3265672951464962,0,1,1,0,-1.3265672951464962,-1.170500554541026
5091,22,52,22,80,83,0,5612.598000000001,60,1140.702,LESS,66,2426,2492,5,1,3.0,0.28122253820234633,3.0,-1.0476454436543674,0.7901186320823744,1.470706437968371,163,80,83,1,0.05983508244547061,0.0,0.1170500554541026,1.4706178297814214,0.07158898955096278,0.07158898955096278,0.1170500554541026,0.0,1,1,1,1,0.1170500554541026,0.0
5092,22,53,6,50,56,1,3874.569,60,1039.634,LESS,950,1240,2190,5,2,6.0,0.5624450764046927,6.0,-0.5238227218271837,0.7901186320823744,0.5226886834863563,106,50,56,1,-1.077031484018471,-1.170500554541026,-0.9364004436328208,1.4706178297814214,0.990200337266716,0.990200337266716,-0.9364004436328208,-1.170500554541026,1,1,1,0,-1.170500554541026,-0.9364004436328208
5093,22,54,13,50,47,1,5428.564,30,908.975,LESS,2224,1300,3524,5,2,-3.0,-0.28122253820234633,3.0,-1.0476454436543674,-0.8732890144068349,1.370324051121924,97,50,47,0,-1.2565367313548828,-1.170500554541026,-1.2875506099951286,1.4706178297814214,2.3140813972100074,2.3140813972100074,-1.2875506099951286,-1.170500554541026,0,1,1,0,-1.170500554541026,-1.2875506099951286
5094,22,55,46,110,124,0,2538.829,30,1212.215,LESS,-512,1476,964,4,1,14.0,1.3123718449442827,14.0,0.8730378697119728,-0.8732890144068349,-0.20589825917789464,234,110,124,1,1.4759320336549415,1.170500554541026,1.7167341466601715,0.7575910032207323,-0.5290415070324143,0.5290415070324143,1.7167341466601715,1.170500554541026,0,1,0,2,1.7167341466601715,1.170500554541026
5095,22,56,27,91,80,0,3955.248,30,3813.931,LESS,-222,1946,1724,2,1,-11.0,-1.0311493067419364,11.0,0.34921514788478913,-0.8732890144068349,0.5666955006417976,171,91,80,0,0.21939530230005888,0.4291835366650429,0.0,-0.6684626499006461,-0.22768710563245,0.22768710563245,0.0,0.4291835366650429,0,0,0,1,0.4291835366650429,0.0
5096,22,57,40,64,80,0,2049.666,50,1751.7720000000004,LESS,-554,1322,768,2,1,16.0,1.4998535370791803,16.0,1.222253017596762,0.2356494165859713,-0.4727149859619043,144,64,80,1,-0.3191204397091766,-0.6242669624218805,0.0,-0.6684626499006461,-0.5726859375799953,0.5726859375799953,0.0,-0.6242669624218805,1,0,0,1,-0.6242669624218805,0.0
5097,22,58,22,83,80,1,5041.603,50,1275.494,LESS,1830,1426,3256,5,2,-3.0,-0.28122253820234633,3.0,-1.0476454436543674,0.2356494165859713,1.1592539836534783,163,83,80,0,0.05983508244547061,0.1170500554541026,0.0,1.4706178297814214,1.904655072549366,1.904655072549366,0.0,0.1170500554541026,1,1,1,1,0.1170500554541026,0.0
5098,22,59,54,101,110,1,7011.989000000001,50,1332.408,LESS,2504,1904,4408,7,2,9.0,0.8436676146070391,9.0,0.0,0.2356494165859713,2.23401217881754,211,101,110,1,1.0171964015730004,0.8193503881787182,1.170500554541026,2.8966714829028,2.6050442675272145,2.6050442675272145,1.170500554541026,0.8193503881787182,1,1,1,2,1.170500554541026,0.8193503881787182
5099,22,60,6,56,50,0,3595.792,40,1299.503,LESS,370,1538,1908,4,1,-6.0,-0.5624450764046927,6.0,-0.5238227218271837,-0.3188197989104318,0.3706281910888,106,56,50,0,-1.077031484018471,-0.9364004436328208,-1.170500554541026,0.7575910032207323,0.38749153446678736,0.38749153446678736,-1.170500554541026,-0.9364004436328208,0,1,1,0,-0.9364004436328208,-1.170500554541026
5100,22,61,18,50,42,0,3932.313,50,1661.3729999999996,LESS,832,1222,2054,4,1,-8.0,-0.7499267685395902,8.0,-0.17460757394239454,0.2356494165859713,0.5541854750904145,92,50,42,0,-1.3562618687640005,-1.170500554541026,-1.4826340357519663,0.7575910032207323,0.8675802704901787,0.8675802704901787,-1.4826340357519663,-1.170500554541026,1,1,1,0,-1.170500554541026,-1.4826340357519663
5101,22,62,43,110,117,0,2984.226,30,911.907,LESS,220,1292,1512,4,1,7.0,0.6561859224721414,7.0,-0.34921514788478913,-0.8732890144068349,0.03704605521100545,227,110,117,1,1.3363168412821769,1.170500554541026,1.4436173506005987,0.7575910032207323,0.2316185682254266,0.2316185682254266,1.4436173506005987,1.170500554541026,0,1,1,2,1.4436173506005987,1.170500554541026
5102,22,63,32,77,80,0,8796.809000000001,40,1426.425,LESS,-1236,4620,3384,8,1,3.0,0.28122253820234633,3.0,-1.0476454436543674,-0.3188197989104318,3.20755234906475,157,77,80,1,-0.05983508244547061,-0.1170500554541026,0.0,3.609698309463489,-1.2813883574240492,1.2813883574240492,0.0,-0.1170500554541026,1,1,0,1,-0.1170500554541026,0.0
5103,22,64,27,80,91,0,3577.746,20,3608.196,LESS,-584,1870,1286,4,1,11.0,1.0311493067419364,11.0,0.34921514788478913,-1.427758229903238,0.3607848982568724,171,80,91,1,0.21939530230005888,0.0,0.4291835366650429,0.7575910032207323,-0.6038605308282675,0.6038605308282675,0.4291835366650429,0.0,0,1,0,1,0.4291835366650429,0.0
5104,22,65,16,44,50,0,3110.577,40,1635.379,LESS,-1456,2422,966,4,1,6.0,0.5624450764046927,6.0,-0.5238227218271837,-0.3188197989104318,0.1059649232486257,94,44,50,1,-1.3163718138003533,-1.4046006654492311,-1.170500554541026,0.7575910032207323,-1.5100020412447117,1.5100020412447117,-1.170500554541026,-1.4046006654492311,0,1,0,0,-1.4046006654492311,-1.170500554541026
5105,22,66,7,50,57,0,3619.106,30,1334.321,LESS,-184,1386,1202,4,1,7.0,0.6561859224721414,7.0,-0.34921514788478913,-0.8732890144068349,0.3833449443351463,107,50,57,1,-1.0570864565366473,-1.170500554541026,-0.8973837584814532,0.7575910032207323,-0.18819928751797194,0.18819928751797194,-0.8973837584814532,-1.170500554541026,0,1,1,0,-1.170500554541026,-0.8973837584814532
5106,22,67,14,50,46,0,3170.632,40,1404.34,LESS,-42,1368,1326,3,1,-4.0,-0.3749633842697951,4.0,-0.8730378697119728,-0.3188197989104318,0.13872226288186382,96,50,46,0,-1.2764817588367063,-1.170500554541026,-1.3265672951464962,0.04456417666004307,-0.04063954614281702,0.04063954614281702,-1.3265672951464962,-1.170500554541026,1,0,1,0,-1.170500554541026,-1.3265672951464962
5107,22,68,51,110,108,0,8489.945,40,1693.886,LESS,-12,3814,3802,7,1,-2.0,-0.18748169213489754,2.0,-1.222253017596762,-0.3188197989104318,3.040171643557897,218,110,108,0,1.156811593945765,1.170500554541026,1.092467184238291,2.8966714829028,-0.009464952894544855,0.009464952894544855,1.092467184238291,1.170500554541026,1,1,1,2,1.170500554541026,1.092467184238291
5108,22,69,50,133,110,0,5555.5790000000015,20,957.078,LESS,-130,2906,2776,4,1,-23.0,-2.1560394595513217,23.0,2.444506035193524,-1.427758229903238,1.439605101717475,243,133,110,0,1.6554372809913533,2.0678843130224793,1.170500554541026,0.7575910032207323,-0.13208501967108205,0.13208501967108205,1.170500554541026,2.0678843130224793,0,1,1,2,2.0678843130224793,1.170500554541026
5109,22,70,49,131,110,1,4811.767,50,1741.2879999999998,LESS,2940,836,3776,3,1,-21.0,-1.9685577674164243,21.0,2.0952908873087353,0.2356494165859713,1.0338886366891131,241,131,110,0,1.6155472260277064,1.9898509427197442,1.170500554541026,0.04456417666004307,3.0581150227354366,3.0581150227354366,1.170500554541026,1.9898509427197442,1,1,1,2,1.9898509427197442,1.170500554541026
5110,22,71,47,126,110,1,5486.553000000001,30,1343.0020000000004,LESS,2540,1242,3782,5,2,-16.0,-1.4998535370791803,16.0,1.222253017596762,-0.8732890144068349,1.4019544793625678,236,126,110,0,1.5158220886185887,1.7947675169629065,1.170500554541026,1.4706178297814214,2.642453779425141,2.642453779425141,1.170500554541026,1.7947675169629065,0,1,1,2,1.7947675169629065,1.170500554541026
5111,22,72,50,110,133,0,3947.918,20,1303.102,LESS,638,1650,2288,4,1,23.0,2.1560394595513217,23.0,2.444506035193524,-1.427758229903238,0.5626973106574228,243,110,133,1,1.6554372809913533,1.170500554541026,2.0678843130224793,0.7575910032207323,0.6659845674846854,0.6659845674846854,2.0678843130224793,1.170500554541026,0,1,1,2,2.0678843130224793,1.170500554541026
5112,22,73,47,110,126,0,3060.958,70,428.675,LESS,-420,1720,1300,4,1,16.0,1.4998535370791803,16.0,1.222253017596762,1.3445878475787776,0.07889995887827099,236,110,126,1,1.5158220886185887,1.170500554541026,1.7947675169629065,0.7575910032207323,-0.4334394210710463,0.4334394210710463,1.7947675169629065,1.170500554541026,1,1,0,2,1.7947675169629065,1.170500554541026
5113,22,74,12,48,50,0,3290.588,40,1715.911,LESS,236,1472,1708,4,1,2.0,0.18748169213489754,2.0,-1.222253017596762,-0.3188197989104318,0.20415294197677225,98,48,50,1,-1.2365917038730592,-1.248533924843761,-1.170500554541026,0.7575910032207323,0.2482450179578384,0.2482450179578384,-1.170500554541026,-1.248533924843761,1,1,1,0,-1.248533924843761,-1.170500554541026
5114,22,75,32,80,77,0,4984.029,20,1103.285,LESS,944,2112,3056,4,1,-3.0,-0.28122253820234633,3.0,-1.0476454436543674,-1.427758229903238,1.1278499195115412,157,80,77,0,-0.05983508244547061,0.0,-0.1170500554541026,0.7575910032207323,0.9839654186170615,0.9839654186170615,-0.1170500554541026,0.0,0,1,1,1,0.0,-0.1170500554541026
5115,22,76,43,117,110,0,2396.927,30,1533.746,LESS,-692,1496,804,4,1,-7.0,-0.6561859224721414,7.0,-0.34921514788478913,-0.8732890144068349,-0.28329950817690835,227,117,110,0,1.3363168412821769,1.4436173506005987,1.170500554541026,0.7575910032207323,-0.7160890665220473,0.7160890665220473,1.170500554541026,1.4436173506005987,0,1,0,2,1.4436173506005987,1.170500554541026
5116,22,77,40,80,64,0,3058.8459999999995,30,2212.065,LESS,-1078,2022,944,4,1,-16.0,-1.4998535370791803,16.0,1.222253017596762,-0.8732890144068349,0.07774795652533759,144,80,64,0,-0.3191204397091766,0.0,-0.6242669624218805,0.7575910032207323,-1.1172021663164826,1.1172021663164826,-0.6242669624218805,0.0,0,1,0,1,0.0,-0.6242669624218805
5117,22,78,31,80,78,1,1775.493,20,1708.2420000000004,LESS,516,676,1192,2,1,-2.0,-0.18748169213489754,2.0,-1.222253017596762,-1.427758229903238,-0.622264200502972,158,80,78,0,-0.03989005496364707,0.0,-0.07803337030273506,-0.6684626499006461,0.5392078882750453,0.5392078882750453,-0.07803337030273506,0.0,0,0,1,1,0.0,-0.07803337030273506
5118,22,79,46,124,110,1,1901.146,10,1293.437,LESS,-878,1628,750,2,1,-14.0,-1.3123718449442827,14.0,0.8730378697119728,-1.982227445399641,-0.5537260605157057,234,124,110,0,1.4759320336549415,1.7167341466601715,1.170500554541026,-0.6684626499006461,-0.9093715446613347,0.9093715446613347,1.170500554541026,1.7167341466601715,0,0,0,2,1.7167341466601715,1.170500554541026
5119,22,80,58,92,110,0,4069.328,20,1564.868,LESS,-1070,3396,2326,4,1,18.0,1.6873352292140782,18.0,1.571468165481551,-1.427758229903238,0.6289210822812916,202,92,110,1,0.8376911542365885,0.4682002218164104,1.170500554541026,0.7575910032207323,-1.1088889414502765,1.1088889414502765,1.170500554541026,0.4682002218164104,0,1,0,2,1.170500554541026,0.4682002218164104
5120,22,81,48,128,110,1,2832.425,20,1239.022,MORE,-1436,2356,920,3,1,-18.0,-1.6873352292140782,18.0,1.571468165481551,-1.427758229903238,-0.04575465936172272,238,128,110,1,1.5557121435822359,1.8728008872656416,1.170500554541026,0.04456417666004307,-1.489218979079197,1.489218979079197,1.170500554541026,1.8728008872656416,0,1,0,2,1.8728008872656416,1.170500554541026
5121,22,82,8,50,58,1,1245.847,80,1671.621,MORE,550,370,920,1,2,8.0,0.7499267685395902,8.0,-0.17460757394239454,1.8990570630751809,-0.9111626087518452,108,50,58,0,-1.0371414290548238,-1.170500554541026,-0.8583670733300858,-1.3814894764613352,0.5745390939564203,0.5745390939564203,-0.8583670733300858,-1.170500554541026,1,0,1,0,-1.170500554541026,-0.8583670733300858
5122,22,83,4,54,50,1,5351.723000000001,10,1092.806,MORE,1186,2024,3210,5,1,-4.0,-0.3749633842697951,4.0,-0.8730378697119728,-1.982227445399641,1.3284106927877697,104,54,50,1,-1.116921538982118,-1.0144338139355558,-1.170500554541026,1.4706178297814214,1.2354404708197904,1.2354404708197904,-1.170500554541026,-1.0144338139355558,0,1,1,0,-1.0144338139355558,-1.170500554541026
5123,22,84,37,80,69,0,2878.054,10,2027.686,MORE,-974,2036,1062,4,1,-11.0,-1.0311493067419364,11.0,0.34921514788478913,-1.982227445399641,-0.02086606307290376,149,80,69,1,-0.21939530230005888,0.0,-0.4291835366650429,0.7575910032207323,-1.0091302430558056,1.0091302430558056,-0.4291835366650429,0.0,0,1,0,1,0.0,-0.4291835366650429
5124,22,85,52,105,110,0,5010.351,10,828.1510000000002,MORE,-1446,3212,1766,4,1,5.0,0.4687042303372438,5.0,-0.6984302957695783,-1.982227445399641,1.1422074033817613,215,105,110,0,1.0969765115002945,0.9754171287841883,1.170500554541026,0.7575910032207323,-1.4996105101619543,1.4996105101619543,1.170500554541026,0.9754171287841883,0,1,0,2,1.170500554541026,0.9754171287841883
5125,22,86,5,55,50,0,1722.535,20,1205.217,MORE,-878,1284,406,2,1,-5.0,-0.4687042303372438,5.0,-0.6984302957695783,-1.427758229903238,-0.6511504413205064,105,55,50,1,-1.0969765115002945,-0.9754171287841883,-1.170500554541026,-0.6684626499006461,-0.9093715446613347,0.9093715446613347,-1.170500554541026,-0.9754171287841883,0,0,0,0,-0.9754171287841883,-1.170500554541026
5126,22,87,30,96,80,0,3481.955,50,3012.848,MORE,-1650,2756,1106,2,2,-16.0,-1.4998535370791803,16.0,1.222253017596762,0.2356494165859713,0.3085351551745724,176,96,80,1,0.3191204397091766,0.6242669624218805,0.0,-0.6684626499006461,-1.711597744250205,1.711597744250205,0.0,0.6242669624218805,1,0,0,1,0.6242669624218805,0.0
5127,22,88,33,80,75,0,3005.074,50,1203.5739999999996,MORE,1030,1136,2166,1,1,-5.0,-0.4687042303372438,5.0,-0.6984302957695783,0.2356494165859713,0.04841771480094382,155,80,75,1,-0.09972513740911768,0.0,-0.19508342575683765,-1.3814894764613352,1.073332585928775,1.073332585928775,-0.19508342575683765,0.0,1,0,1,1,0.0,-0.19508342575683765
5128,22,89,48,110,128,1,2443.694,60,1315.171,MORE,26,1146,1172,3,2,18.0,1.6873352292140782,18.0,1.571468165481551,0.7901186320823744,-0.2577901833475412,238,110,128,0,1.5557121435822359,1.170500554541026,1.8728008872656416,0.04456417666004307,0.03002286521993322,0.03002286521993322,1.8728008872656416,1.170500554541026,1,1,0,2,1.8728008872656416,1.170500554541026
5129,22,90,9,59,50,1,1336.958,50,1300.486,MORE,756,290,1046,1,2,-9.0,-0.8436676146070391,9.0,0.0,0.2356494165859713,-0.8614655981561585,109,59,50,1,-1.0171964015730004,-0.8193503881787182,-1.170500554541026,-1.3814894764613352,0.7886046342612226,0.7886046342612226,-1.170500554541026,-0.8193503881787182,1,0,1,0,-0.8193503881787182,-1.170500554541026
5130,22,91,44,110,119,1,1867.874,70,1688.1229999999996,MORE,90,864,954,1,2,9.0,0.8436676146070391,9.0,0.0,1.3445878475787776,-0.5718744612196788,229,110,119,0,1.376206896245824,1.170500554541026,1.5216507209033339,-1.3814894764613352,0.09652866414958051,0.09652866414958051,1.5216507209033339,1.170500554541026,1,0,0,2,1.5216507209033339,1.170500554541026
5131,22,92,2,52,50,0,2857.047,50,1399.059,MORE,-346,1490,1144,3,1,-2.0,-0.18748169213489754,2.0,-1.222253017596762,0.2356494165859713,-0.03232445011270789,102,52,50,1,-1.156811593945765,-1.092467184238291,-1.170500554541026,0.04456417666004307,-0.35654209105864165,0.35654209105864165,-1.170500554541026,-1.092467184238291,1,1,0,0,-1.092467184238291,-1.170500554541026
5132,22,93,8,58,50,1,1027.907,70,1590.191,MORE,328,320,648,1,2,-8.0,-0.7499267685395902,8.0,-0.17460757394239454,1.3445878475787776,-1.0300392151904092,108,58,50,1,-1.0371414290548238,-0.8583670733300858,-1.170500554541026,-1.3814894764613352,0.34384710391920636,0.34384710391920636,-1.170500554541026,-0.8583670733300858,1,0,1,0,-0.8583670733300858,-1.170500554541026
5133,22,94,44,119,110,0,2047.906,50,1366.3770000000004,MORE,-358,1118,760,2,1,-9.0,-0.8436676146070391,9.0,0.0,0.2356494165859713,-0.473674987922682,229,119,110,1,1.376206896245824,1.5216507209033339,1.170500554541026,-0.6684626499006461,-0.36901192835795055,0.36901192835795055,1.170500554541026,1.5216507209033339,0,0,0,2,1.5216507209033339,1.170500554541026
5134,22,95,34,74,80,1,2419.123,40,1667.669,MORE,1360,800,2160,1,1,6.0,0.5624450764046927,6.0,-0.5238227218271837,-0.3188197989104318,-0.2711925743579199,154,74,80,0,-0.11967016489094122,-0.2341001109082052,0.0,-1.3814894764613352,1.416253111659769,1.416253111659769,0.0,-0.2341001109082052,0,0,1,1,-0.2341001109082052,0.0
5135,22,96,24,86,80,1,1235.95,70,1497.2279999999996,MORE,740,338,1078,1,2,-6.0,-0.5624450764046927,6.0,-0.5238227218271837,1.3445878475787776,-0.9165609834142407,166,86,80,1,0.11967016489094122,0.2341001109082052,0.0,-1.3814894764613352,0.7719781845288107,0.7719781845288107,0.0,0.2341001109082052,1,0,1,1,0.2341001109082052,0.0
5136,22,97,39,66,80,1,1568.838,40,2995.934,MORE,106,914,1020,3,1,14.0,1.3123718449442827,14.0,0.8730378697119728,-0.3188197989104318,-0.7349853398237087,146,66,80,0,-0.2792303847455295,-0.5462335921191455,0.0,0.04456417666004307,0.11315511388199233,0.11315511388199233,0.0,-0.5462335921191455,0,1,0,1,-0.5462335921191455,0.0
5137,22,98,9,50,59,1,3832.769,40,1208.216,MORE,34,1694,1728,5,2,9.0,0.8436676146070391,9.0,0.0,-0.3188197989104318,0.499888636917888,109,50,59,0,-1.0171964015730004,-1.170500554541026,-0.8193503881787182,1.4706178297814214,0.038336090086139134,0.038336090086139134,-0.8193503881787182,-1.170500554541026,0,1,0,0,-1.170500554541026,-0.8193503881787182
5138,22,99,57,94,110,1,4459.989000000001,40,1516.186,MORE,842,1764,2606,3,1,16.0,1.4998535370791803,16.0,1.222253017596762,-0.3188197989104318,0.8420093356900089,204,94,110,0,0.8775812092002355,0.5462335921191455,1.170500554541026,0.04456417666004307,0.8779718015729361,0.8779718015729361,1.170500554541026,0.5462335921191455,0,1,1,2,1.170500554541026,0.5462335921191455
5139,22,100,60,110,87,0,1727.036,40,1651.41,MORE,-998,1416,418,2,1,-23.0,-2.1560394595513217,23.0,2.444506035193524,-0.3188197989104318,-0.6486953453969496,197,110,87,1,0.7379660168274708,1.170500554541026,0.27311679605957273,-0.6684626499006461,-1.0340699176544235,1.0340699176544235,0.27311679605957273,1.170500554541026,0,0,0,2,1.170500554541026,0.27311679605957273
5140,22,101,33,75,80,1,1045.908,70,1606.779,MORE,518,260,778,1,2,5.0,0.4687042303372438,5.0,-0.6984302957695783,1.3445878475787776,-1.02022046786316,155,75,80,0,-0.09972513740911768,-0.19508342575683765,0.0,-1.3814894764613352,0.5412861944915968,0.5412861944915968,0.0,-0.19508342575683765,1,0,1,1,-0.19508342575683765,0.0
5141,22,102,15,50,45,0,2923.5840000000007,40,1640.848,MORE,-424,1652,1228,4,1,-5.0,-0.4687042303372438,5.0,-0.6984302957695783,-0.3188197989104318,0.003968533105621875,95,50,45,1,-1.2964267863185297,-1.170500554541026,-1.3655839802978638,0.7575910032207323,-0.4375960335041493,0.4375960335041493,-1.3655839802978638,-1.170500554541026,0,1,0,0,-1.170500554541026,-1.3655839802978638
5142,22,103,59,89,110,0,1735.928,30,1124.592,MORE,-692,1154,462,2,1,21.0,1.9685577674164243,21.0,2.0952908873087353,-0.8732890144068349,-0.6438451536723845,199,89,110,0,0.7778560717911179,0.3511501663623078,1.170500554541026,-0.6684626499006461,-0.7160890665220473,0.7160890665220473,1.170500554541026,0.3511501663623078,0,0,0,2,1.170500554541026,0.3511501663623078
5143,22,104,29,80,94,1,1715.6229999999996,30,1625.0970000000002,MORE,308,602,910,3,2,14.0,1.3123718449442827,14.0,0.8730378697119728,-0.8732890144068349,-0.6549206308391969,174,80,94,0,0.2792303847455295,0.0,0.5462335921191455,0.04456417666004307,0.3230640417536916,0.3230640417536916,0.5462335921191455,0.0,0,1,0,1,0.5462335921191455,0.0
5144,22,105,55,110,98,0,1720.2479999999996,70,2429.166,MORE,-1208,1692,484,2,1,-12.0,-1.124890152809385,12.0,0.5238227218271837,1.3445878475787776,-0.6523978984138581,208,110,98,1,0.9573613191275298,1.170500554541026,0.7023003327246156,-0.6684626499006461,-1.2522920703923286,1.2522920703923286,0.7023003327246156,1.170500554541026,1,0,0,2,1.170500554541026,0.7023003327246156
5145,22,106,29,94,80,0,3814.193,30,1365.626,MORE,-1458,2940,1482,4,1,-14.0,-1.3123718449442827,14.0,0.8730378697119728,-0.8732890144068349,0.4897562525864082,174,94,80,1,0.2792303847455295,0.5462335921191455,0.0,0.7575910032207323,-1.5120803474612632,1.5120803474612632,0.0,0.5462335921191455,0,1,0,1,0.5462335921191455,0.0
5146,22,107,57,110,94,0,3350.17,40,1587.068,MORE,-1330,2182,852,4,1,-16.0,-1.4998535370791803,16.0,1.222253017596762,-0.3188197989104318,0.23665228108305145,204,110,94,1,0.8775812092002355,1.170500554541026,0.5462335921191455,0.7575910032207323,-1.3790687496019687,1.3790687496019687,0.5462335921191455,1.170500554541026,0,1,0,2,1.170500554541026,0.5462335921191455
5147,22,108,39,80,66,1,1875.777,50,1659.753,MORE,312,814,1126,3,2,-14.0,-1.3123718449442827,14.0,0.8730378697119728,0.2356494165859713,-0.5675637251423915,146,80,66,1,-0.2792303847455295,0.0,-0.5462335921191455,0.04456417666004307,0.3272206541867945,0.3272206541867945,-0.5462335921191455,0.0,0,1,0,1,0.0,-0.5462335921191455
5148,22,109,4,50,54,1,1258.058,50,1660.313,MORE,698,150,848,1,2,4.0,0.3749633842697951,4.0,-0.8730378697119728,0.2356494165859713,-0.9045020496932912,104,50,54,0,-1.116921538982118,-1.170500554541026,-1.0144338139355558,-1.3814894764613352,0.7283337539812297,0.7283337539812297,-1.0144338139355558,-1.170500554541026,0,0,1,0,-1.170500554541026,-1.0144338139355558
5149,22,110,55,98,110,1,3335.248,30,1242.509,MORE,440,1318,1758,5,2,12.0,1.124890152809385,12.0,0.5238227218271837,-0.8732890144068349,0.228512991731504,208,98,110,0,0.9573613191275298,0.7023003327246156,1.170500554541026,1.4706178297814214,0.4602322520460891,0.4602322520460891,1.170500554541026,0.7023003327246156,0,1,1,2,1.170500554541026,0.7023003327246156
5150,22,111,2,50,52,0,4384.725,30,1001.032,MORE,350,1890,2240,2,1,2.0,0.18748169213489754,2.0,-1.222253017596762,-0.8732890144068349,0.8009561609309369,102,50,52,0,-1.156811593945765,-1.170500554541026,-1.092467184238291,-0.6684626499006461,0.3667084723012726,0.3667084723012726,-1.092467184238291,-1.170500554541026,0,0,1,0,-1.170500554541026,-1.092467184238291
5151,22,112,59,110,89,0,1283.15,70,2335.275,MORE,-838,1132,294,2,1,-21.0,-1.9685577674164243,21.0,2.0952908873087353,1.3445878475787776,-0.8908154762842957,199,110,89,1,0.7778560717911179,1.170500554541026,0.3511501663623078,-0.6684626499006461,-0.8678054203303052,0.8678054203303052,0.3511501663623078,1.170500554541026,1,0,0,2,1.170500554541026,0.3511501663623078
5152,22,113,60,87,110,1,1904.111,50,3840.452,MORE,-546,1580,1034,3,1,23.0,2.1560394595513217,23.0,2.444506035193524,0.2356494165859713,-0.5521087844851911,197,87,110,0,0.7379660168274708,0.27311679605957273,1.170500554541026,0.04456417666004307,-0.5643727127137894,0.5643727127137894,1.170500554541026,0.27311679605957273,0,1,0,2,1.170500554541026,0.27311679605957273
5153,22,114,52,110,105,0,1966.821,50,1953.075,MORE,-938,1404,466,2,1,-5.0,-0.4687042303372438,5.0,-0.6984302957695783,0.2356494165859713,-0.5179032600758936,215,110,105,1,1.0969765115002945,1.170500554541026,0.9754171287841883,-0.6684626499006461,-0.971720731157879,0.971720731157879,0.9754171287841883,1.170500554541026,0,0,0,2,1.170500554541026,0.9754171287841883
5154,22,115,30,80,96,0,14660.622,30,2065.717,MORE,-268,6470,6202,9,1,16.0,1.4998535370791803,16.0,1.222253017596762,-0.8732890144068349,6.406002336356355,176,80,96,0,0.3191204397091766,0.0,0.6242669624218805,4.322725136024178,-0.27548814861313403,0.27548814861313403,0.6242669624218805,0.0,0,1,0,1,0.6242669624218805,0.0
5155,22,116,24,80,86,1,2734.725,60,1092.646,MORE,1102,622,1724,3,2,6.0,0.5624450764046927,6.0,-0.5238227218271837,0.7901186320823744,-0.09904567729807076,166,80,86,0,0.11967016489094122,0.0,0.2341001109082052,0.04456417666004307,1.1481516097246283,1.1481516097246283,0.2341001109082052,0.0,1,1,1,1,0.2341001109082052,0.0
5156,22,117,5,50,55,1,2675.513,50,2173.5660000000007,MORE,-206,1874,1668,3,1,5.0,0.4687042303372438,5.0,-0.6984302957695783,0.2356494165859713,-0.13134319781032286,105,50,55,0,-1.0969765115002945,-1.170500554541026,-0.9754171287841883,0.04456417666004307,-0.2110606559000382,0.2110606559000382,-0.9754171287841883,-1.170500554541026,0,1,0,0,-1.170500554541026,-0.9754171287841883
5157,22,118,34,80,74,0,3280.808,50,2032.612,MORE,-884,2100,1216,4,1,-6.0,-0.5624450764046927,6.0,-0.5238227218271837,0.2356494165859713,0.19881838562654205,154,80,74,1,-0.11967016489094122,0.0,-0.2341001109082052,0.7575910032207323,-0.9156064633109892,0.9156064633109892,-0.2341001109082052,0.0,0,1,0,1,0.0,-0.2341001109082052
5158,22,119,15,45,50,1,1183.132,70,2395.928,MORE,102,670,772,1,1,5.0,0.4687042303372438,5.0,-0.6984302957695783,1.3445878475787776,-0.9453708604394404,95,45,50,0,-1.2964267863185297,-1.3655839802978638,-1.170500554541026,-1.3814894764613352,0.10899850144888938,0.10899850144888938,-1.170500554541026,-1.3655839802978638,1,0,0,0,-1.3655839802978638,-1.170500554541026
5159,22,120,37,69,80,1,1136.765,50,1284.732,MORE,540,280,820,1,1,11.0,1.0311493067419364,11.0,0.34921514788478913,0.2356494165859713,-0.9706620030049948,149,69,80,0,-0.21939530230005888,-0.4291835366650429,0.0,-1.3814894764613352,0.564147562873663,0.564147562873663,0.0,-0.4291835366650429,0,0,1,1,-0.4291835366650429,0.0
5160,22,121,48,128,110,1,2543.718,20,1782.556,LESS,668,998,1666,3,1,-18.0,-1.6873352292140782,18.0,1.571468165481551,-1.427758229903238,-0.20323152645843928,238,128,110,0,1.5557121435822359,1.8728008872656416,1.170500554541026,0.04456417666004307,0.6971591607329576,0.6971591607329576,1.170500554541026,1.8728008872656416,0,1,1,2,1.8728008872656416,1.170500554541026
5161,22,122,8,50,58,0,1651.329,70,2023.345,LESS,-192,1160,968,2,2,8.0,0.7499267685395902,8.0,-0.17460757394239454,1.3445878475787776,-0.6899901570131942,108,50,58,1,-1.0371414290548238,-1.170500554541026,-0.8583670733300858,-0.6684626499006461,-0.19651251238417783,0.19651251238417783,-0.8583670733300858,-1.170500554541026,1,0,0,0,-1.170500554541026,-0.8583670733300858
5162,22,123,4,54,50,0,2720.7140000000004,50,1929.426,LESS,-178,1476,1298,4,1,-4.0,-0.3749633842697951,4.0,-0.8730378697119728,0.2356494165859713,-0.1066880565437836,104,54,50,0,-1.116921538982118,-1.0144338139355558,-1.170500554541026,0.7575910032207323,-0.1819643688683175,0.1819643688683175,-1.170500554541026,-1.0144338139355558,1,1,1,0,-1.0144338139355558,-1.170500554541026
5163,22,124,37,80,69,1,2237.718,60,1733.234,LESS,402,896,1298,3,2,-11.0,-1.0311493067419364,11.0,0.34921514788478913,0.7901186320823744,-0.3701409582754552,149,80,69,0,-0.21939530230005888,0.0,-0.4291835366650429,0.04456417666004307,0.42074443393161104,0.42074443393161104,-0.4291835366650429,0.0,1,1,1,1,0.0,-0.4291835366650429
5164,22,125,52,105,110,0,5937.8719999999985,40,1898.045,LESS,1132,2242,3374,6,1,5.0,0.4687042303372438,5.0,-0.6984302957695783,-0.3188197989104318,1.6481289821672196,215,105,110,1,1.0969765115002945,0.9754171287841883,1.170500554541026,2.1836446563421106,1.1793262029729004,1.1793262029729004,1.170500554541026,0.9754171287841883,1,1,1,2,1.170500554541026,0.9754171287841883
5165,22,126,5,55,50,1,2074.664,50,1605.879,LESS,432,738,1170,3,1,-5.0,-0.4687042303372438,5.0,-0.6984302957695783,0.2356494165859713,-0.459079685384905,105,55,50,0,-1.0969765115002945,-0.9754171287841883,-1.170500554541026,0.04456417666004307,0.4519190271798832,0.4519190271798832,-1.170500554541026,-0.9754171287841883,1,1,1,0,-0.9754171287841883,-1.170500554541026
5166,22,127,30,96,80,1,1913.437,60,1779.0020000000004,LESS,76,898,974,3,2,-16.0,-1.4998535370791803,16.0,1.222253017596762,0.7901186320823744,-0.547021865004389,176,96,80,0,0.3191204397091766,0.6242669624218805,0.0,0.04456417666004307,0.08198052063372016,0.08198052063372016,0.0,0.6242669624218805,1,1,1,1,0.6242669624218805,0.0
5167,22,128,33,80,75,1,6025.029,40,1888.792,LESS,926,2016,2942,5,2,-5.0,-0.4687042303372438,5.0,-0.6984302957695783,-0.3188197989104318,1.6956692610851152,155,80,75,0,-0.09972513740911768,0.0,-0.19508342575683765,1.4706178297814214,0.9652606626680982,0.9652606626680982,-0.19508342575683765,0.0,1,1,1,1,0.0,-0.19508342575683765
5168,22,129,48,110,128,0,5861.154,20,1269.105,LESS,854,2522,3376,4,1,18.0,1.6873352292140782,18.0,1.571468165481551,-1.427758229903238,1.6062827148791885,238,110,128,1,1.5557121435822359,1.170500554541026,1.8728008872656416,0.7575910032207323,0.890441638872245,0.890441638872245,1.8728008872656416,1.170500554541026,0,1,1,2,1.8728008872656416,1.170500554541026
5169,22,130,9,59,50,1,3053.9240000000004,70,2595.329,LESS,1360,702,2062,3,2,-9.0,-0.8436676146070391,9.0,0.0,1.3445878475787776,0.07506322376911796,109,59,50,0,-1.0171964015730004,-0.8193503881787182,-1.170500554541026,0.04456417666004307,1.416253111659769,1.416253111659769,-1.170500554541026,-0.8193503881787182,1,1,1,0,-0.8193503881787182,-1.170500554541026
5170,22,131,44,110,119,0,5750.981,20,2394.139,LESS,-2630,4382,1752,3,1,9.0,0.8436676146070391,9.0,0.0,-1.427758229903238,1.5461882285014883,229,110,119,1,1.376206896245824,1.170500554541026,1.5216507209033339,0.04456417666004307,-2.729967790360429,2.729967790360429,1.5216507209033339,1.170500554541026,0,1,0,2,1.5216507209033339,1.170500554541026
5171,22,132,2,52,50,0,2896.543,70,2157.0660000000007,LESS,-818,1788,970,4,1,-2.0,-0.18748169213489754,2.0,-1.222253017596762,1.3445878475787776,-0.010781133383803064,102,52,50,0,-1.156811593945765,-1.092467184238291,-1.170500554541026,0.7575910032207323,-0.8470223581647904,0.8470223581647904,-1.170500554541026,-1.092467184238291,1,1,0,0,-1.092467184238291,-1.170500554541026
5172,22,133,8,58,50,0,5574.571,30,2290.914,LESS,-102,2066,1964,4,1,-8.0,-0.7499267685395902,8.0,-0.17460757394239454,-0.8732890144068349,1.4499643956033192,108,58,50,0,-1.0371414290548238,-0.8583670733300858,-1.170500554541026,0.7575910032207323,-0.10298873263936136,0.10298873263936136,-1.170500554541026,-0.8583670733300858,0,1,1,0,-0.8583670733300858,-1.170500554541026
5173,22,134,44,119,110,1,5610.303000000001,40,2272.058,LESS,594,1492,2086,3,1,-9.0,-0.8436676146070391,9.0,0.0,-0.3188197989104318,1.4694546172297434,229,119,110,0,1.376206896245824,1.5216507209033339,1.170500554541026,0.04456417666004307,0.6202618307205529,0.6202618307205529,1.170500554541026,1.5216507209033339,1,0,1,2,1.5216507209033339,1.170500554541026
5174,22,135,34,74,80,1,5096.788,60,3407.934,LESS,762,1660,2422,4,1,6.0,0.5624450764046927,6.0,-0.5238227218271837,0.7901186320823744,1.189354954224792,154,74,80,1,-0.11967016489094122,-0.2341001109082052,0.0,0.7575910032207323,0.794839552910877,0.794839552910877,0.0,-0.2341001109082052,1,1,1,1,-0.2341001109082052,0.0
5175,22,136,24,86,80,1,7124.988,50,2078.341,LESS,1376,2570,3946,5,1,-6.0,-0.5624450764046927,6.0,-0.5238227218271837,0.2356494165859713,2.2956481228890797,166,86,80,0,0.11967016489094122,0.2341001109082052,0.0,1.4706178297814214,1.4328795613921808,1.4328795613921808,0.0,0.2341001109082052,1,1,1,1,0.2341001109082052,0.0
5176,22,137,39,66,80,0,1886.034,30,2146.221,LESS,-1214,1694,480,2,1,14.0,1.3123718449442827,14.0,0.8730378697119728,-0.8732890144068349,-0.5619689864425643,146,66,80,1,-0.2792303847455295,-0.5462335921191455,0.0,-0.6684626499006461,-1.258526989041983,1.258526989041983,0.0,-0.5462335921191455,0,0,0,1,-0.5462335921191455,0.0
5177,22,138,9,50,59,0,2175.385,20,2647.732,LESS,-408,1298,890,4,1,9.0,0.8436676146070391,9.0,0.0,-1.427758229903238,-0.4041408459011088,109,50,59,1,-1.0171964015730004,-1.170500554541026,-0.8193503881787182,0.7575910032207323,-0.4209695837717375,0.4209695837717375,-0.8193503881787182,-1.170500554541026,0,1,0,0,-1.170500554541026,-0.8193503881787182
5178,22,139,57,94,110,0,2161.453,20,1334.886,LESS,-488,1162,674,2,1,16.0,1.4998535370791803,16.0,1.222253017596762,-1.427758229903238,-0.4117401341497189,204,94,110,1,0.8775812092002355,0.5462335921191455,1.170500554541026,-0.6684626499006461,-0.5041018324337966,0.5041018324337966,1.170500554541026,0.5462335921191455,0,0,0,2,1.170500554541026,0.5462335921191455
5179,22,140,60,110,87,1,1779.399,30,2113.876,LESS,90,802,892,3,2,-23.0,-2.1560394595513217,23.0,2.444506035193524,-0.8732890144068349,-0.6201336506968372,197,110,87,0,0.7379660168274708,1.170500554541026,0.27311679605957273,0.04456417666004307,0.09652866414958051,0.09652866414958051,0.27311679605957273,1.170500554541026,0,1,1,2,1.170500554541026,0.27311679605957273
5180,22,141,33,75,80,1,2200.476,20,1024.559,LESS,-526,1506,980,5,1,5.0,0.4687042303372438,5.0,-0.6984302957695783,-1.427758229903238,-0.3904548179477729,155,75,80,1,-0.09972513740911768,-0.19508342575683765,0.0,1.4706178297814214,-0.5435896505482747,0.5435896505482747,0.0,-0.19508342575683765,0,1,0,1,-0.19508342575683765,0.0
5181,22,142,15,50,45,0,5176.143,30,1362.235,LESS,1860,1664,3524,2,1,-5.0,-0.4687042303372438,5.0,-0.6984302957695783,-0.8732890144068349,1.2326395880870122,95,50,45,0,-1.2964267863185297,-1.170500554541026,-1.3655839802978638,-0.6684626499006461,1.9358296657976384,1.9358296657976384,-1.3655839802978638,-1.170500554541026,0,0,1,0,-1.170500554541026,-1.3655839802978638
5182,22,143,59,89,110,1,6800.015,50,2607.674,LESS,-118,3292,3174,5,2,21.0,1.9685577674164243,21.0,2.0952908873087353,0.2356494165859713,2.1183897608437485,199,89,110,1,0.7778560717911179,0.3511501663623078,1.170500554541026,1.4706178297814214,-0.11961518237177318,0.11961518237177318,1.170500554541026,0.3511501663623078,1,1,1,2,1.170500554541026,0.3511501663623078
5183,22,144,29,80,94,0,3217.962,40,1642.808,LESS,-696,1966,1270,4,1,14.0,1.3123718449442827,14.0,0.8730378697119728,-0.3188197989104318,0.16453867924754798,174,80,94,1,0.2792303847455295,0.0,0.5462335921191455,0.7575910032207323,-0.7202456789551502,0.7202456789551502,0.5462335921191455,0.0,0,1,0,1,0.5462335921191455,0.0
5184,22,145,55,110,98,1,2795.17,50,1789.543,LESS,764,880,1644,3,2,-12.0,-1.124890152809385,12.0,0.5238227218271837,0.2356494165859713,-0.0660756099576147,208,110,98,0,0.9573613191275298,1.170500554541026,0.7023003327246156,0.04456417666004307,0.7969178591274285,0.7969178591274285,0.7023003327246156,1.170500554541026,1,0,1,2,1.170500554541026,0.7023003327246156
5185,22,146,29,94,80,1,2123.109,40,3455.913,LESS,128,780,908,1,1,-14.0,-1.3123718449442827,14.0,0.8730378697119728,-0.3188197989104318,-0.43265508595884206,174,94,80,0,0.2792303847455295,0.5462335921191455,0.0,-1.3814894764613352,0.1360164822640586,0.1360164822640586,0.0,0.5462335921191455,0,0,1,1,0.5462335921191455,0.0
5186,22,147,57,110,94,1,5400.809,10,1154.65,LESS,782,1978,2760,3,1,-16.0,-1.4998535370791803,16.0,1.222253017596762,-1.982227445399641,1.3551849292915932,204,110,94,0,0.8775812092002355,1.170500554541026,0.5462335921191455,0.04456417666004307,0.8156226150763918,0.8156226150763918,0.5462335921191455,1.170500554541026,0,0,1,2,1.170500554541026,0.5462335921191455
5187,22,148,39,80,66,1,3092.476,50,1855.762,LESS,916,992,1908,3,2,-14.0,-1.3123718449442827,14.0,0.8730378697119728,0.2356494165859713,0.09609163035542366,146,80,66,0,-0.2792303847455295,0.0,-0.5462335921191455,0.04456417666004307,0.9548691315853408,0.9548691315853408,-0.5462335921191455,0.0,1,0,1,1,0.0,-0.5462335921191455
5188,22,149,4,50,54,0,4144.597,50,1876.772,LESS,22,1828,1850,3,1,4.0,0.3749633842697951,4.0,-0.8730378697119728,0.2356494165859713,0.6699769843186607,104,50,54,1,-1.116921538982118,-1.170500554541026,-1.0144338139355558,0.04456417666004307,0.025866252786830267,0.025866252786830267,-1.0144338139355558,-1.170500554541026,1,0,1,0,-1.170500554541026,-1.0144338139355558
5189,22,150,55,98,110,0,3872.583,20,1604.536,LESS,-1380,2636,1256,4,1,12.0,1.124890152809385,12.0,0.5238227218271837,-1.427758229903238,0.5216054085465244,208,98,110,1,0.9573613191275298,0.7023003327246156,1.170500554541026,0.7575910032207323,-1.4310264050157557,1.4310264050157557,1.170500554541026,0.7023003327246156,0,1,0,2,1.170500554541026,0.7023003327246156
5190,22,151,2,50,52,1,2245.704,10,1382.155,LESS,-470,1792,1322,3,1,2.0,0.18748169213489754,2.0,-1.222253017596762,-1.982227445399641,-0.36578494937842665,102,50,52,1,-1.156811593945765,-1.170500554541026,-1.092467184238291,0.04456417666004307,-0.48539707648483327,0.48539707648483327,-1.092467184238291,-1.170500554541026,0,0,0,0,-1.170500554541026,-1.092467184238291
5191,22,152,59,110,89,1,1405.35,40,922.496,LESS,-1016,1426,410,2,1,-21.0,-1.9685577674164243,21.0,2.0952908873087353,-0.3188197989104318,-0.8241607946893961,199,110,89,0,0.7778560717911179,1.170500554541026,0.3511501663623078,-0.6684626499006461,-1.0527746736033867,1.0527746736033867,0.3511501663623078,1.170500554541026,0,0,0,2,1.170500554541026,0.3511501663623078
5192,22,153,60,87,110,0,3152.69,30,795.087,LESS,-100,1628,1528,2,1,23.0,2.1560394595513217,23.0,2.444506035193524,-0.8732890144068349,0.12893569743852756,197,87,110,1,0.7379660168274708,0.27311679605957273,1.170500554541026,-0.6684626499006461,-0.10091042642280988,0.10091042642280988,1.170500554541026,0.27311679605957273,0,0,1,2,1.170500554541026,0.27311679605957273
5193,22,154,52,110,105,1,2129.347,20,1450.458,LESS,-542,1594,1052,3,1,-5.0,-0.4687042303372438,5.0,-0.6984302957695783,-1.427758229903238,-0.4292525335546767,215,110,105,0,1.0969765115002945,1.170500554541026,0.9754171287841883,0.04456417666004307,-0.5602161002806865,0.5602161002806865,0.9754171287841883,1.170500554541026,0,0,0,2,1.170500554541026,0.9754171287841883
5194,22,155,30,80,96,0,1228.1989999999996,30,863.88,LESS,-1492,1838,346,2,1,16.0,1.4998535370791803,16.0,1.222253017596762,-0.8732890144068349,-0.9207888102312792,176,80,96,1,0.3191204397091766,0.0,0.6242669624218805,-0.6684626499006461,-1.5474115531426385,1.5474115531426385,0.6242669624218805,0.0,0,0,0,1,0.6242669624218805,0.0
5195,22,156,24,80,86,0,1741.894,20,1068.261,LESS,-1524,1980,456,2,1,6.0,0.5624450764046927,6.0,-0.5238227218271837,-1.427758229903238,-0.6405909652076123,166,80,86,1,0.11967016489094122,0.0,0.2341001109082052,-0.6684626499006461,-1.580664452607462,1.580664452607462,0.2341001109082052,0.0,0,0,0,1,0.2341001109082052,0.0
5196,22,157,5,50,55,0,1512.257,50,1675.755,LESS,-1628,1986,358,2,1,5.0,0.4687042303372438,5.0,-0.6984302957695783,0.2356494165859713,-0.7658477664957302,105,50,55,1,-1.0969765115002945,-1.170500554541026,-0.9754171287841883,-0.6684626499006461,-1.6887363758681389,1.6887363758681389,-0.9754171287841883,-1.170500554541026,1,0,0,0,-1.170500554541026,-0.9754171287841883
5197,22,158,34,80,74,0,6271.58,60,2225.315,LESS,-1648,2886,1238,3,1,-6.0,-0.5624450764046927,6.0,-0.5238227218271837,0.7901186320823744,1.8301518993985693,154,80,74,0,-0.11967016489094122,0.0,-0.2341001109082052,0.04456417666004307,-1.7095194380336536,1.7095194380336536,-0.2341001109082052,0.0,1,0,0,1,0.0,-0.2341001109082052
5198,22,159,15,45,50,0,1090.217,30,1535.3970000000004,LESS,-818,1128,310,2,1,5.0,0.4687042303372438,5.0,-0.6984302957695783,-0.8732890144068349,-0.9960518730449244,95,45,50,1,-1.2964267863185297,-1.3655839802978638,-1.170500554541026,-0.6684626499006461,-0.8470223581647904,0.8470223581647904,-1.170500554541026,-1.3655839802978638,0,0,0,0,-1.3655839802978638,-1.170500554541026
5199,22,160,37,69,80,0,1642.316,60,1549.764,LESS,-1706,2100,394,2,1,11.0,1.0311493067419364,11.0,0.34921514788478913,0.7901186320823744,-0.6949063488725626,149,69,80,1,-0.21939530230005888,-0.4291835366650429,0.0,-0.6684626499006461,-1.7697903183136465,1.7697903183136465,0.0,-0.4291835366650429,1,0,0,1,-0.4291835366650429,0.0
5200,22,161,3,50,53,1,2690.545,70,3126.722,MORE,-470,1340,870,3,2,3.0,0.28122253820234633,3.0,-1.0476454436543674,1.3445878475787776,-0.12314390833622675,103,50,53,0,-1.1368665664639415,-1.170500554541026,-1.0534504990869233,0.04456417666004307,-0.48539707648483327,0.48539707648483327,-1.0534504990869233,-1.170500554541026,1,1,0,0,-1.170500554541026,-1.0534504990869233
5201,22,162,20,50,40,0,2904.159,40,2092.56,MORE,-2148,3116,968,4,1,-10.0,-0.9374084606744876,10.0,0.17460757394239454,-0.3188197989104318,-0.006626943080801787,90,50,40,1,-1.3961519237276474,-1.170500554541026,-1.5606674060547012,0.7575910032207323,-2.2290959921715228,2.2290959921715228,-1.5606674060547012,-1.170500554541026,0,1,0,0,-1.170500554541026,-1.5606674060547012
5202,22,163,25,80,88,1,2020.204,70,1595.111,MORE,490,658,1148,3,2,8.0,0.7499267685395902,8.0,-0.17460757394239454,1.3445878475787776,-0.4887852006030578,168,80,88,0,0.1595602198545883,0.0,0.31213348121094026,0.04456417666004307,0.512189907459876,0.512189907459876,0.31213348121094026,0.0,1,1,1,1,0.31213348121094026,0.0
5203,22,164,42,115,110,1,5823.042,60,1278.928,MORE,2164,1552,3716,4,2,-5.0,-0.4687042303372438,5.0,-0.6984302957695783,0.7901186320823744,1.585494308783077,225,115,110,1,1.2964267863185297,1.3655839802978638,1.170500554541026,0.7575910032207323,2.251732210713463,2.251732210713463,1.170500554541026,1.3655839802978638,1,1,1,2,1.3655839802978638,1.170500554541026
5204,22,165,53,103,110,1,2364.803,50,1973.025,MORE,794,690,1484,3,1,7.0,0.6561859224721414,7.0,-0.34921514788478913,0.2356494165859713,-0.30082172578373795,213,103,110,0,1.0570864565366473,0.8973837584814532,1.170500554541026,0.04456417666004307,0.8280924523757006,0.8280924523757006,1.170500554541026,0.8973837584814532,0,1,1,2,1.170500554541026,0.8973837584814532
5205,22,166,26,90,80,1,2087.627,50,1439.0510000000004,MORE,512,684,1196,3,2,-10.0,-0.9374084606744876,10.0,0.17460757394239454,0.2356494165859713,-0.4520089436703824,170,90,80,1,0.19945027481823535,0.3901668515136753,0.0,0.04456417666004307,0.5350512758419423,0.5350512758419423,0.0,0.3901668515136753,0,1,1,1,0.3901668515136753,0.0
5206,22,167,35,80,72,1,1253.863,40,1370.354,MORE,-58,1002,944,1,1,-8.0,-0.7499267685395902,8.0,-0.17460757394239454,-0.3188197989104318,-0.9067902361850309,152,80,72,1,-0.1595602198545883,0.0,-0.31213348121094026,-1.3814894764613352,-0.05726599587522885,0.05726599587522885,-0.31213348121094026,0.0,0,0,0,1,0.0,-0.31213348121094026
5207,22,168,28,93,80,1,2354.439,50,1387.876,MORE,1198,584,1782,3,2,-13.0,-1.218630998876834,13.0,0.6984302957695783,0.2356494165859713,-0.30647482823913524,173,93,80,1,0.25928535726370594,0.5072169069677779,0.0,0.04456417666004307,1.2479103081190992,1.2479103081190992,0.0,0.5072169069677779,0,1,1,1,0.5072169069677779,0.0
5208,22,169,26,80,90,0,1642.4070000000004,30,1217.763,MORE,-2004,2314,310,2,1,10.0,0.9374084606744876,10.0,0.17460757394239454,-0.8732890144068349,-0.694856712407545,170,80,90,0,0.19945027481823535,0.0,0.3901668515136753,-0.6684626499006461,-2.0794579445798167,2.0794579445798167,0.3901668515136753,0.0,0,0,0,1,0.3901668515136753,0.0
5209,22,170,25,88,80,1,3602.054,50,1246.128,MORE,1834,576,2410,1,2,-8.0,-0.7499267685395902,8.0,-0.17460757394239454,0.2356494165859713,0.374043834428794,168,88,80,1,0.1595602198545883,0.31213348121094026,0.0,-1.3814894764613352,1.908811684982469,1.908811684982469,0.0,0.31213348121094026,0,0,1,1,0.31213348121094026,0.0
5210,22,171,36,80,70,1,1140.405,40,1440.161,MORE,-50,792,742,1,1,-10.0,-0.9374084606744876,10.0,0.17460757394239454,-0.3188197989104318,-0.9686765444042956,150,80,70,1,-0.19945027481823535,0.0,-0.3901668515136753,-1.3814894764613352,-0.048952771009022934,0.048952771009022934,-0.3901668515136753,0.0,0,0,0,1,0.0,-0.3901668515136753
5211,22,172,28,80,93,1,1132.559,60,1348.845,MORE,218,384,602,1,2,13.0,1.218630998876834,13.0,0.6984302957695783,0.7901186320823744,-0.9729561895089894,173,80,93,0,0.25928535726370594,0.0,0.5072169069677779,-1.3814894764613352,0.2295402620088751,0.2295402620088751,0.5072169069677779,0.0,1,0,0,1,0.5072169069677779,0.0
5212,22,173,21,82,80,1,1035.352,70,1115.771,MORE,400,256,656,1,2,-2.0,-0.18748169213489754,2.0,-1.222253017596762,1.3445878475787776,-1.0259782978051877,162,82,80,1,0.03989005496364707,0.07803337030273506,0.0,-1.3814894764613352,0.41866612771505957,0.41866612771505957,0.0,0.07803337030273506,1,0,1,1,0.07803337030273506,0.0
5213,22,174,19,50,41,1,3856.735,70,2095.156,MORE,490,560,1050,1,1,-9.0,-0.8436676146070391,9.0,0.0,1.3445878475787776,0.5129610272542497,91,50,41,1,-1.376206896245824,-1.170500554541026,-1.5216507209033339,-1.3814894764613352,0.512189907459876,0.512189907459876,-1.5216507209033339,-1.170500554541026,1,0,1,0,-1.170500554541026,-1.5216507209033339
5214,22,175,56,96,110,1,1972.125,60,1511.794,MORE,320,706,1026,3,2,14.0,1.3123718449442827,14.0,0.8730378697119728,0.7901186320823744,-0.515010163257732,206,96,110,0,0.9174712641638826,0.6242669624218805,1.170500554541026,0.04456417666004307,0.3355338790530004,0.3355338790530004,1.170500554541026,0.6242669624218805,1,0,1,2,1.170500554541026,0.6242669624218805
5215,22,176,23,80,85,1,1743.2179999999996,50,1460.87,MORE,54,1018,1072,3,1,5.0,0.4687042303372438,5.0,-0.6984302957695783,0.2356494165859713,-0.6398687819143912,165,80,85,0,0.09972513740911768,0.0,0.19508342575683765,0.04456417666004307,0.05911915225165391,0.05911915225165391,0.19508342575683765,0.0,0,1,0,1,0.19508342575683765,0.0
5216,22,177,10,60,50,1,1954.868,80,2611.889,MORE,968,510,1478,3,2,-10.0,-0.9374084606744876,10.0,0.17460757394239454,1.8990570630751809,-0.5244230915742883,110,60,50,1,-0.9972513740911768,-0.7803337030273506,-1.170500554541026,0.04456417666004307,1.0089050932156793,1.0089050932156793,-1.170500554541026,-0.7803337030273506,1,1,1,0,-0.7803337030273506,-1.170500554541026
5217,22,178,19,41,50,1,2041.706,70,1149.175,MORE,586,510,1096,3,2,9.0,0.8436676146070391,9.0,0.0,1.3445878475787776,-0.477056813011785,91,41,50,0,-1.376206896245824,-1.5216507209033339,-1.170500554541026,0.04456417666004307,0.611948605854347,0.611948605854347,-1.170500554541026,-1.5216507209033339,1,1,1,0,-1.5216507209033339,-1.170500554541026
5218,22,179,56,110,96,1,1993.617,30,1851.122,MORE,-684,1692,1008,3,1,-14.0,-1.3123718449442827,14.0,0.8730378697119728,-0.8732890144068349,-0.5032872302230544,206,110,96,1,0.9174712641638826,1.170500554541026,0.6242669624218805,0.04456417666004307,-0.7077758416558414,0.7077758416558414,0.6242669624218805,1.170500554541026,0,1,0,2,1.170500554541026,0.6242669624218805
5219,22,180,35,72,80,1,3404.234000000001,30,1449.38,MORE,778,1138,1916,5,2,8.0,0.7499267685395902,8.0,-0.17460757394239454,-0.8732890144068349,0.26614179586002945,152,72,80,0,-0.1595602198545883,-0.31213348121094026,0.0,1.4706178297814214,0.8114660026432888,0.8114660026432888,0.0,-0.31213348121094026,0,1,1,1,-0.31213348121094026,0.0
5220,22,181,11,49,50,1,2069.967,70,1621.963,MORE,492,752,1244,3,2,1.0,0.09374084606744876,1.0,-1.3968605915391563,1.3445878475787776,-0.4616416906177304,99,49,50,0,-1.2166466763912356,-1.2095172396923934,-1.170500554541026,0.04456417666004307,0.5142682136764275,0.5142682136764275,-1.170500554541026,-1.2095172396923934,1,1,1,0,-1.2095172396923934,-1.170500554541026
5221,22,182,17,43,50,0,2524.0460000000007,30,1120.892,MORE,-540,1430,890,4,1,7.0,0.6561859224721414,7.0,-0.34921514788478913,-0.8732890144068349,-0.2139617301927667,93,43,50,0,-1.3363168412821769,-1.4436173506005987,-1.170500554541026,0.7575910032207323,-0.558137794064135,0.558137794064135,-1.170500554541026,-1.4436173506005987,0,1,0,0,-1.4436173506005987,-1.170500554541026
5222,22,183,1,51,50,1,1021.653,40,1826.017,MORE,268,328,596,1,2,-1.0,-0.09374084606744876,1.0,-1.3968605915391563,-0.3188197989104318,-1.0334504948851266,101,51,50,1,-1.1767566214275886,-1.1314838693896585,-1.170500554541026,-1.3814894764613352,0.281497917422662,0.281497917422662,-1.170500554541026,-1.1314838693896585,0,0,0,0,-1.1314838693896585,-1.170500554541026
5223,22,184,41,112,110,1,3057.357,50,1916.877,MORE,308,426,734,1,2,-2.0,-0.18748169213489754,2.0,-1.222253017596762,0.2356494165859713,0.07693577304829358,222,112,110,1,1.2365917038730592,1.248533924843761,1.170500554541026,-1.3814894764613352,0.3230640417536916,0.3230640417536916,1.170500554541026,1.248533924843761,0,0,0,2,1.248533924843761,1.170500554541026
5224,22,185,20,40,50,1,1207.583,40,1852.776,MORE,290,656,946,1,1,10.0,0.9374084606744876,10.0,0.17460757394239454,-0.3188197989104318,-0.9320339241082056,90,40,50,0,-1.3961519237276474,-1.5606674060547012,-1.170500554541026,-1.3814894764613352,0.30435928580472826,0.30435928580472826,-1.170500554541026,-1.5606674060547012,0,0,0,0,-1.5606674060547012,-1.170500554541026
5225,22,186,1,50,51,1,1852.45,50,1421.374,MORE,502,464,966,3,2,1.0,0.09374084606744876,1.0,-1.3968605915391563,0.2356494165859713,-0.5802875693123116,101,50,51,0,-1.1767566214275886,-1.170500554541026,-1.1314838693896585,0.04456417666004307,0.5246597447591849,0.5246597447591849,-1.1314838693896585,-1.170500554541026,0,1,1,0,-1.170500554541026,-1.1314838693896585
5226,22,187,23,85,80,1,1991.661,40,1932.067,MORE,1626,202,1828,1,2,-5.0,-0.4687042303372438,5.0,-0.6984302957695783,-0.3188197989104318,-0.5043541414931004,165,85,80,1,0.09972513740911768,0.19508342575683765,0.0,-1.3814894764613352,1.6926678384611153,1.6926678384611153,0.0,0.19508342575683765,0,0,1,1,0.19508342575683765,0.0
5227,22,188,11,50,49,1,1258.405,70,1453.917,MORE,530,320,850,1,2,-1.0,-0.09374084606744876,1.0,-1.3968605915391563,1.3445878475787776,-0.9043127765794332,99,50,49,1,-1.2166466763912356,-1.170500554541026,-1.2095172396923934,-1.3814894764613352,0.5537560317909056,0.5537560317909056,-1.2095172396923934,-1.170500554541026,1,0,1,0,-1.170500554541026,-1.2095172396923934
5228,22,189,17,50,43,1,1145.536,40,1755.18,MORE,114,846,960,1,1,-7.0,-0.6561859224721414,7.0,-0.34921514788478913,-0.3188197989104318,-0.9658778114152332,93,50,43,1,-1.3363168412821769,-1.170500554541026,-1.4436173506005987,-1.3814894764613352,0.12146833874819825,0.12146833874819825,-1.4436173506005987,-1.170500554541026,0,0,0,0,-1.170500554541026,-1.4436173506005987
5229,22,190,21,80,82,1,2516.649,60,1831.02,MORE,1436,224,1660,1,2,2.0,0.18748169213489754,2.0,-1.222253017596762,0.7901186320823744,-0.2179964657063308,162,80,82,0,0.03989005496364707,0.0,0.07803337030273506,-1.3814894764613352,1.495228747888725,1.495228747888725,0.07803337030273506,0.0,1,0,1,1,0.07803337030273506,0.0
5230,22,191,10,50,60,1,1842.058,50,1568.408,MORE,758,184,942,1,2,10.0,0.9374084606744876,10.0,0.17460757394239454,0.2356494165859713,-0.5859559445261757,110,50,60,0,-0.9972513740911768,-1.170500554541026,-0.7803337030273506,-1.3814894764613352,0.7906829404777741,0.7906829404777741,-0.7803337030273506,-1.170500554541026,0,0,1,0,-1.170500554541026,-0.7803337030273506
5231,22,192,3,53,50,1,1980.187,50,1891.487,MORE,900,314,1214,1,1,-3.0,-0.28122253820234633,3.0,-1.0476454436543674,0.2356494165859713,-0.5106126997305791,103,53,50,1,-1.1368665664639415,-1.0534504990869233,-1.170500554541026,-1.3814894764613352,0.938242681852929,0.938242681852929,-1.170500554541026,-1.0534504990869233,0,0,1,0,-1.0534504990869233,-1.170500554541026
5232,22,193,45,122,110,1,1017.719,70,1685.641,MORE,592,310,902,1,2,-12.0,-1.124890152809385,12.0,0.5238227218271837,1.3445878475787776,-1.0355963174497282,232,122,110,1,1.4360419786912946,1.6387007763574364,1.170500554541026,-1.3814894764613352,0.6181835245040014,0.6181835245040014,1.170500554541026,1.6387007763574364,1,0,1,2,1.6387007763574364,1.170500554541026
5233,22,194,38,67,80,1,2228.271,30,1860.599,MORE,1754,184,1938,2,1,13.0,1.218630998876834,13.0,0.6984302957695783,-0.8732890144068349,-0.3752938778910607,147,67,80,0,-0.25928535726370594,-0.5072169069677779,0.0,-0.6684626499006461,1.82567943632041,1.82567943632041,0.0,-0.5072169069677779,0,0,1,1,-0.5072169069677779,0.0
5234,22,195,38,80,67,1,1967.784,10,1305.9489999999996,MORE,-418,1542,1124,3,2,-13.0,-1.218630998876834,13.0,0.6984302957695783,-1.982227445399641,-0.5173779862757635,147,80,67,1,-0.25928535726370594,0.0,-0.5072169069677779,0.04456417666004307,-0.43136111485449485,0.43136111485449485,-0.5072169069677779,0.0,0,1,0,1,0.0,-0.5072169069677779
5235,22,196,36,70,80,1,2396.256,70,1227.849,MORE,-140,1094,954,3,2,10.0,0.9374084606744876,10.0,0.17460757394239454,1.3445878475787776,-0.28366550892445497,150,70,80,0,-0.19945027481823535,-0.3901668515136753,0.0,0.04456417666004307,-0.14247655075383941,0.14247655075383941,0.0,-0.3901668515136753,1,1,0,1,-0.3901668515136753,0.0
5236,22,197,45,110,122,1,1232.64,60,860.8430000000002,MORE,834,292,1126,1,2,12.0,1.124890152809385,12.0,0.5238227218271837,0.7901186320823744,-0.918366441647294,232,110,122,0,1.4360419786912946,1.170500554541026,1.6387007763574364,-1.3814894764613352,0.8696585767067302,0.8696585767067302,1.6387007763574364,1.170500554541026,1,0,1,2,1.6387007763574364,1.170500554541026
5237,22,198,42,110,115,1,1559.9720000000002,40,2250.683,MORE,868,256,1124,1,2,5.0,0.4687042303372438,5.0,-0.6984302957695783,-0.3188197989104318,-0.7398213497011258,225,110,115,0,1.2964267863185297,1.170500554541026,1.3655839802978638,-1.3814894764613352,0.9049897823881053,0.9049897823881053,1.3655839802978638,1.170500554541026,0,0,1,2,1.3655839802978638,1.170500554541026
5238,22,199,41,110,112,0,1769.561,70,1130.837,MORE,-1008,1506,498,2,1,2.0,0.18748169213489754,2.0,-1.222253017596762,1.3445878475787776,-0.6254998434753203,222,110,112,0,1.2365917038730592,1.170500554541026,1.248533924843761,-0.6684626499006461,-1.0444614487371808,1.0444614487371808,1.248533924843761,1.170500554541026,1,0,0,2,1.248533924843761,1.170500554541026
5239,22,200,53,110,103,1,2482.277,50,1829.457,MORE,1014,678,1692,2,1,-7.0,-0.6561859224721414,7.0,-0.34921514788478913,0.2356494165859713,-0.2367448676357897,213,110,103,1,1.0570864565366473,1.170500554541026,0.8973837584814532,-0.6684626499006461,1.0567061361963632,1.0567061361963632,0.8973837584814532,1.170500554541026,0,0,1,2,1.170500554541026,0.8973837584814532
5240,22,201,3,50,53,0,2969.908,50,2035.508,LESS,-920,1758,838,3,1,3.0,0.28122253820234633,3.0,-1.0476454436543674,0.2356494165859713,0.02923622107781568,103,50,53,1,-1.1368665664639415,-1.170500554541026,-1.0534504990869233,0.04456417666004307,-0.9530159752089158,0.9530159752089158,-1.0534504990869233,-1.170500554541026,1,0,0,0,-1.170500554541026,-1.0534504990869233
5241,22,202,20,50,40,1,1796.985,50,3143.692,LESS,636,602,1238,3,1,-10.0,-0.9374084606744876,10.0,0.17460757394239454,0.2356494165859713,-0.6105412674682946,90,50,40,0,-1.3961519237276474,-1.170500554541026,-1.5606674060547012,0.04456417666004307,0.6639062612681339,0.6639062612681339,-1.5606674060547012,-1.170500554541026,1,0,1,0,-1.170500554541026,-1.5606674060547012
5242,22,203,25,80,88,1,1501.604,50,1745.422,LESS,380,550,930,3,2,8.0,0.7499267685395902,8.0,-0.17460757394239454,0.2356494165859713,-0.7716585056367324,168,80,88,1,0.1595602198545883,0.0,0.31213348121094026,0.04456417666004307,0.3978830655495448,0.3978830655495448,0.31213348121094026,0.0,1,0,1,1,0.31213348121094026,0.0
5243,22,204,42,115,110,0,2535.906,40,1686.461,LESS,-414,1430,1016,4,1,-5.0,-0.4687042303372438,5.0,-0.6984302957695783,-0.3188197989104318,-0.20749262607070887,225,115,110,0,1.2964267863185297,1.3655839802978638,1.170500554541026,0.7575910032207323,-0.4272045024213919,0.4272045024213919,1.170500554541026,1.3655839802978638,1,1,0,2,1.3655839802978638,1.170500554541026
5244,22,205,53,103,110,0,1280.104,50,2053.474,LESS,-682,1032,350,2,1,7.0,0.6561859224721414,7.0,-0.34921514788478913,0.2356494165859713,-0.8924769342232325,213,103,110,1,1.0570864565366473,0.8973837584814532,1.170500554541026,-0.6684626499006461,-0.7056975354392899,0.7056975354392899,1.170500554541026,0.8973837584814532,1,0,0,2,1.170500554541026,0.8973837584814532
5245,22,206,26,90,80,0,4045.242,40,1488.552,LESS,-330,2206,1876,4,1,-10.0,-0.9374084606744876,10.0,0.17460757394239454,-0.3188197989104318,0.6157832372657864,170,90,80,0,0.19945027481823535,0.3901668515136753,0.0,0.7575910032207323,-0.3399156413262298,0.3399156413262298,0.0,0.3901668515136753,1,1,0,1,0.3901668515136753,0.0
5246,22,207,35,80,72,1,1617.313,50,1487.6329999999996,LESS,284,682,966,3,2,-8.0,-0.7499267685395902,8.0,-0.17460757394239454,0.2356494165859713,-0.7085443767278595,152,80,72,0,-0.1595602198545883,0.0,-0.31213348121094026,0.04456417666004307,0.29812436715507384,0.29812436715507384,-0.31213348121094026,0.0,1,0,1,1,0.0,-0.31213348121094026
5247,22,208,28,93,80,1,2319.141,50,1687.325,LESS,-358,1522,1164,3,1,-13.0,-1.218630998876834,13.0,0.6984302957695783,0.2356494165859713,-0.32572832210932146,173,93,80,0,0.25928535726370594,0.5072169069677779,0.0,0.04456417666004307,-0.36901192835795055,0.36901192835795055,0.0,0.5072169069677779,1,0,0,1,0.5072169069677779,0.0
5248,22,209,26,80,90,0,1172.646,20,1130.655,LESS,-1198,1550,352,2,1,10.0,0.9374084606744876,10.0,0.17460757394239454,-1.427758229903238,-0.9510905084853007,170,80,90,1,0.19945027481823535,0.0,0.3901668515136753,-0.6684626499006461,-1.2419005393095712,1.2419005393095712,0.3901668515136753,0.0,0,0,0,1,0.3901668515136753,0.0
5249,22,210,25,88,80,1,2566.249,30,1661.9070000000004,LESS,750,764,1514,3,1,-8.0,-0.7499267685395902,8.0,-0.17460757394239454,-0.8732890144068349,-0.19094186499350732,168,88,80,0,0.1595602198545883,0.31213348121094026,0.0,0.04456417666004307,0.7823697156115682,0.7823697156115682,0.0,0.31213348121094026,0,0,1,1,0.31213348121094026,0.0
5250,22,211,36,80,70,1,2048.014,20,2427.385,LESS,-908,2158,1250,3,1,-10.0,-0.9374084606744876,10.0,0.17460757394239454,-1.427758229903238,-0.4736160787114524,150,80,70,0,-0.19945027481823535,0.0,-0.3901668515136753,0.04456417666004307,-0.940546137909607,0.940546137909607,-0.3901668515136753,0.0,0,0,0,1,0.0,-0.3901668515136753
5251,22,212,28,80,93,0,1116.105,30,2185.729,LESS,-868,1170,302,2,1,13.0,1.218630998876834,13.0,0.6984302957695783,-0.8732890144068349,-0.9819311169309408,173,80,93,1,0.25928535726370594,0.0,0.5072169069677779,-0.6684626499006461,-0.8989800135785774,0.8989800135785774,0.5072169069677779,0.0,0,0,0,1,0.5072169069677779,0.0
5252,22,213,21,82,80,1,8926.948,40,883.028,LESS,1552,3034,4586,6,2,-2.0,-0.18748169213489754,2.0,-1.222253017596762,-0.3188197989104318,3.27853740314068,162,82,80,0,0.03989005496364707,0.07803337030273506,0.0,2.1836446563421106,1.6157705084487108,1.6157705084487108,0.0,0.07803337030273506,1,1,1,1,0.07803337030273506,0.0
5253,22,214,19,50,41,0,2706.309,20,1883.235,LESS,-982,2352,1370,2,1,-9.0,-0.8436676146070391,9.0,0.0,-1.427758229903238,-0.11454534531935273,91,50,41,0,-1.376206896245824,-1.170500554541026,-1.5216507209033339,-0.6684626499006461,-1.0174434679220117,1.0174434679220117,-1.5216507209033339,-1.170500554541026,0,0,0,0,-1.170500554541026,-1.5216507209033339
5254,22,215,56,96,110,1,2411.239,50,1415.043,LESS,754,602,1356,3,2,14.0,1.3123718449442827,14.0,0.8730378697119728,0.2356494165859713,-0.27549294677767594,206,96,110,1,0.9174712641638826,0.6242669624218805,1.170500554541026,0.04456417666004307,0.7865263280446712,0.7865263280446712,1.170500554541026,0.6242669624218805,1,0,1,2,1.170500554541026,0.6242669624218805
5255,22,216,23,80,85,1,2289.552,40,2001.112,LESS,466,794,1260,3,2,5.0,0.4687042303372438,5.0,-0.6984302957695783,-0.3188197989104318,-0.3418678096192354,165,80,85,1,0.09972513740911768,0.0,0.19508342575683765,0.04456417666004307,0.4872502328612583,0.4872502328612583,0.19508342575683765,0.0,0,0,1,1,0.19508342575683765,0.0
5256,22,217,10,60,50,0,1407.2120000000002,30,1074.968,LESS,-778,1168,390,2,1,-10.0,-0.9374084606744876,10.0,0.17460757394239454,-0.8732890144068349,-0.8231451562513459,110,60,50,0,-0.9972513740911768,-0.7803337030273506,-1.170500554541026,-0.6684626499006461,-0.8054562338337609,0.8054562338337609,-1.170500554541026,-0.7803337030273506,0,0,0,0,-0.7803337030273506,-1.170500554541026
5257,22,218,19,41,50,0,1720.936,50,1761.559,LESS,-534,1164,630,2,1,9.0,0.8436676146070391,9.0,0.0,0.2356494165859713,-0.6520226249200993,91,41,50,1,-1.376206896245824,-1.5216507209033339,-1.170500554541026,-0.6684626499006461,-0.5519028754144806,0.5519028754144806,-1.170500554541026,-1.5216507209033339,1,0,0,0,-1.5216507209033339,-1.170500554541026
5258,22,219,56,110,96,1,1866.761,50,1394.746,LESS,92,1028,1120,4,1,-14.0,-1.3123718449442827,14.0,0.8730378697119728,0.2356494165859713,-0.5724815533687387,206,110,96,0,0.9174712641638826,1.170500554541026,0.6242669624218805,0.7575910032207323,0.09860697036613199,0.09860697036613199,0.6242669624218805,1.170500554541026,1,1,1,2,1.170500554541026,0.6242669624218805
5259,22,220,35,72,80,1,2287.665,30,1786.224,LESS,-792,2188,1396,3,1,8.0,0.7499267685395902,8.0,-0.17460757394239454,-0.8732890144068349,-0.3428970844487738,152,72,80,1,-0.1595602198545883,-0.31213348121094026,0.0,0.04456417666004307,-0.8200043773496212,0.8200043773496212,0.0,-0.31213348121094026,0,0,0,1,-0.31213348121094026,0.0
5260,22,221,11,49,50,0,1332.571,50,1530.112,LESS,-516,894,378,2,1,1.0,0.09374084606744876,1.0,-1.3968605915391563,0.2356494165859713,-0.8638585121345287,99,49,50,1,-1.2166466763912356,-1.2095172396923934,-1.170500554541026,-0.6684626499006461,-0.5331981194655173,0.5331981194655173,-1.170500554541026,-1.2095172396923934,1,0,0,0,-1.2095172396923934,-1.170500554541026
5261,22,222,17,43,50,0,2202.458,70,2034.436,LESS,-942,1520,578,2,1,7.0,0.6561859224721414,7.0,-0.34921514788478913,1.3445878475787776,-0.3893737248305792,93,43,50,1,-1.3363168412821769,-1.4436173506005987,-1.170500554541026,-0.6684626499006461,-0.975877343590982,0.975877343590982,-1.170500554541026,-1.4436173506005987,1,0,0,0,-1.4436173506005987,-1.170500554541026
5262,22,223,1,51,50,0,2878.683,40,1894.339,LESS,-646,1644,998,4,1,-1.0,-0.09374084606744876,1.0,-1.3968605915391563,-0.3188197989104318,-0.020522971463057718,101,51,50,0,-1.1767566214275886,-1.1314838693896585,-1.170500554541026,0.7575910032207323,-0.6682880235413633,0.6682880235413633,-1.170500554541026,-1.1314838693896585,1,1,0,0,-1.1314838693896585,-1.170500554541026
5263,22,224,41,112,110,1,4337.983,30,1905.419,LESS,354,1796,2150,5,1,-2.0,-0.18748169213489754,2.0,-1.222253017596762,-0.8732890144068349,0.7754604724930578,222,112,110,0,1.2365917038730592,1.248533924843761,1.170500554541026,1.4706178297814214,0.37086508473437557,0.37086508473437557,1.170500554541026,1.248533924843761,0,1,1,2,1.248533924843761,1.170500554541026
5264,22,225,20,40,50,0,2690.521,70,1956.539,LESS,-526,1658,1132,4,1,10.0,0.9374084606744876,10.0,0.17460757394239454,1.3445878475787776,-0.12315699927205548,90,40,50,1,-1.3961519237276474,-1.5606674060547012,-1.170500554541026,0.7575910032207323,-0.5435896505482747,0.5435896505482747,-1.170500554541026,-1.5606674060547012,1,1,0,0,-1.5606674060547012,-1.170500554541026
5265,22,226,1,50,51,0,1693.509,50,1699.156,LESS,-762,1292,530,2,1,1.0,0.09374084606744876,1.0,-1.3968605915391563,0.2356494165859713,-0.6669828372941036,101,50,51,1,-1.1767566214275886,-1.170500554541026,-1.1314838693896585,-0.6684626499006461,-0.7888297841013491,0.7888297841013491,-1.1314838693896585,-1.170500554541026,1,0,0,0,-1.170500554541026,-1.1314838693896585
5266,22,227,23,85,80,0,2313.065,70,2033.677,LESS,-1102,1918,816,4,1,-5.0,-0.4687042303372438,5.0,-0.6984302957695783,1.3445878475787776,-0.3290425106966424,165,85,80,0,0.09972513740911768,0.19508342575683765,0.0,0.7575910032207323,-1.1421418409151003,1.1421418409151003,0.0,0.19508342575683765,1,1,0,1,0.19508342575683765,0.0
5267,22,228,11,50,49,1,1600.281,30,1347.694,LESS,-730,1360,630,2,1,-1.0,-0.09374084606744876,1.0,-1.3968605915391563,-0.8732890144068349,-0.7178345775210211,99,50,49,0,-1.2166466763912356,-1.170500554541026,-1.2095172396923934,-0.6684626499006461,-0.7555768846365254,0.7555768846365254,-1.2095172396923934,-1.170500554541026,0,0,0,0,-1.170500554541026,-1.2095172396923934
5268,22,229,17,50,43,1,1107.641,70,2526.882,LESS,274,574,848,1,1,-7.0,-0.6561859224721414,7.0,-0.34921514788478913,1.3445878475787776,-0.9865478536332261,93,50,43,0,-1.3363168412821769,-1.170500554541026,-1.4436173506005987,-1.3814894764613352,0.2877328360723164,0.2877328360723164,-1.4436173506005987,-1.170500554541026,1,0,1,0,-1.170500554541026,-1.4436173506005987
5269,22,230,21,80,82,0,1590.669,20,1165.001,LESS,-1412,1900,488,2,1,2.0,0.18748169213489754,2.0,-1.222253017596762,-1.427758229903238,-0.7230774973204496,162,80,82,1,0.03989005496364707,0.0,0.07803337030273506,-0.6684626499006461,-1.4642793044805793,1.4642793044805793,0.07803337030273506,0.0,0,0,0,1,0.07803337030273506,0.0
5270,22,231,10,50,60,0,2748.301,10,1382.2120000000002,LESS,-1940,2814,874,4,1,10.0,0.9374084606744876,10.0,0.17460757394239454,-1.982227445399641,-0.0916405712642544,110,50,60,1,-0.9972513740911768,-1.170500554541026,-0.7803337030273506,0.7575910032207323,-2.0129521456501696,2.0129521456501696,-0.7803337030273506,-1.170500554541026,0,1,0,0,-1.170500554541026,-0.7803337030273506
5271,22,232,3,53,50,0,3963.145,30,1685.287,LESS,-1786,2994,1208,4,1,-3.0,-0.28122253820234633,3.0,-1.0476454436543674,-0.8732890144068349,0.5710029639851276,103,53,50,0,-1.1368665664639415,-1.0534504990869233,-1.170500554541026,0.7575910032207323,-1.8529225669757057,1.8529225669757057,-1.170500554541026,-1.0534504990869233,0,1,0,0,-1.0534504990869233,-1.170500554541026
5272,22,233,45,122,110,0,1594.602,10,1201.329,LESS,-1622,1926,304,2,1,-12.0,-1.124890152809385,12.0,0.5238227218271837,-1.982227445399641,-0.7209322202115074,232,122,110,0,1.4360419786912946,1.6387007763574364,1.170500554541026,-0.6684626499006461,-1.6825014572184844,1.6825014572184844,1.170500554541026,1.6387007763574364,0,0,0,2,1.6387007763574364,1.170500554541026
5273,22,234,38,67,80,0,5893.361999999999,30,1371.985,LESS,96,2518,2614,5,1,13.0,1.218630998876834,13.0,0.6984302957695783,-0.8732890144068349,1.6238507507614184,147,67,80,1,-0.25928535726370594,-0.5072169069677779,0.0,1.4706178297814214,0.10276358279923495,0.10276358279923495,0.0,-0.5072169069677779,0,1,1,1,-0.5072169069677779,0.0
5274,22,235,38,80,67,0,1303.528,80,524.396,LESS,-732,1082,350,2,1,-13.0,-1.218630998876834,13.0,0.6984302957695783,1.8990570630751809,-0.8797001808543378,147,80,67,0,-0.25928535726370594,0.0,-0.5072169069677779,-0.6684626499006461,-0.7576551908530769,0.7576551908530769,-0.5072169069677779,0.0,1,0,0,1,0.0,-0.5072169069677779
5275,22,236,36,70,80,0,1108.254,20,1342.7379999999996,LESS,-1730,2042,312,2,1,10.0,0.9374084606744876,10.0,0.17460757394239454,-1.427758229903238,-0.9862134893139324,150,70,80,1,-0.19945027481823535,-0.3901668515136753,0.0,-0.6684626499006461,-1.7947299929122642,1.7947299929122642,0.0,-0.3901668515136753,0,0,0,1,-0.3901668515136753,0.0
5276,22,237,45,110,122,0,1507.767,50,477.631,LESS,-958,1398,440,2,1,12.0,1.124890152809385,12.0,0.5238227218271837,0.2356494165859713,-0.7682968624070322,232,110,122,1,1.4360419786912946,1.170500554541026,1.6387007763574364,-0.6684626499006461,-0.9925037933233939,0.9925037933233939,1.6387007763574364,1.170500554541026,1,0,0,2,1.6387007763574364,1.170500554541026
5277,22,238,42,110,115,1,4422.5909999999985,40,1741.6129999999996,LESS,-16,1594,1578,4,1,5.0,0.4687042303372438,5.0,-0.6984302957695783,-0.3188197989104318,0.8216103849348023,225,110,115,1,1.2964267863185297,1.170500554541026,1.3655839802978638,0.7575910032207323,-0.013621565327647812,0.013621565327647812,1.3655839802978638,1.170500554541026,1,1,1,2,1.3655839802978638,1.170500554541026
5278,22,239,41,110,112,0,5432.37,20,800.453,LESS,544,2326,2870,3,1,2.0,0.18748169213489754,2.0,-1.222253017596762,-1.427758229903238,1.3724000553621054,222,110,112,1,1.2365917038730592,1.170500554541026,1.248533924843761,0.04456417666004307,0.5683041753067659,0.5683041753067659,1.248533924843761,1.170500554541026,0,0,1,2,1.248533924843761,1.170500554541026
5279,22,240,53,110,103,1,2910.324,30,1438.447,LESS,-1130,2044,914,2,1,-7.0,-0.6561859224721414,7.0,-0.34921514788478913,-0.8732890144068349,-0.003264208939782515,213,110,103,0,1.0570864565366473,1.170500554541026,0.8973837584814532,-0.6684626499006461,-1.171238127946821,1.171238127946821,0.8973837584814532,1.170500554541026,0,0,0,2,1.170500554541026,0.8973837584814532
5280,23,1,49,110,131,0,5204.121,44,2460.754,LESS,380,2294,2674,9,2,21.0,1.9685577674164243,21.0,2.0952908873087353,-0.367387780739406,0.37968238596618975,241,110,131,1,1.6155472260277064,1.170500554541026,1.9898509427197442,2.0659846763533434,0.6040290465895362,0.6040290465895362,1.9898509427197442,1.170500554541026,0,1,1,2,1.9898509427197442,1.170500554541026
5281,23,2,13,47,50,0,3055.181,64,1867.059,LESS,-410,1436,1026,4,1,3.0,0.28122253820234633,3.0,-1.0476454436543674,0.2748049896717915,-0.5908332016767359,97,47,50,1,-1.2565367313548828,-1.2875506099951286,-1.170500554541026,-0.2951406680504776,-0.1266885484373643,0.1266885484373643,-1.170500554541026,-1.2875506099951286,1,0,0,0,-1.2875506099951286,-1.170500554541026
5282,23,3,16,50,44,0,1742.2120000000002,100,1002.93,LESS,64,1094,1158,2,2,-6.0,-0.5624450764046927,6.0,-0.5238227218271837,1.4307519764119467,-1.1838031685403732,94,50,44,0,-1.3163718138003533,-1.170500554541026,-1.4046006654492311,-1.239590805812006,0.31174200857877604,0.31174200857877604,-1.4046006654492311,-1.170500554541026,1,0,1,0,-1.170500554541026,-1.4046006654492311
5283,23,4,7,57,50,0,5583.058000000001,4,1579.435,LESS,-1900,4222,2322,6,1,-7.0,-0.6561859224721414,7.0,-0.34921514788478913,-1.6517733215618011,0.5508199073649482,107,57,50,0,-1.0570864565366473,-0.8973837584814532,-1.170500554541026,0.6493094697110509,-1.5048774301969614,1.5048774301969614,-1.170500554541026,-0.8973837584814532,0,1,0,0,-0.8973837584814532,-1.170500554541026
5284,23,5,18,42,50,0,1630.8239999999996,84,1537.558,LESS,-222,1216,994,2,2,8.0,0.7499267685395902,8.0,-0.17460757394239454,0.9169977600829888,-1.234108803074781,92,42,50,1,-1.3562618687640005,-1.4826340357519663,-1.170500554541026,-1.239590805812006,0.0472037399994171,0.0472037399994171,-1.170500554541026,-1.4826340357519663,1,0,0,0,-1.4826340357519663,-1.170500554541026
5285,23,6,51,108,110,0,5647.960999999998,44,3040.811,LESS,-106,3036,2930,6,2,2.0,0.18748169213489754,2.0,-1.222253017596762,-0.367387780739406,0.58013174165757,218,108,110,1,1.156811593945765,1.092467184238291,1.170500554541026,0.6493094697110509,0.1544989818008354,0.1544989818008354,1.170500554541026,1.092467184238291,0,1,1,2,1.170500554541026,1.092467184238291
5286,23,7,31,78,80,0,10036.347,0,1136.501,LESS,-1742,5658,3916,10,1,2.0,0.18748169213489754,2.0,-1.222253017596762,-1.7802118756440406,2.5620377127847256,158,78,80,1,-0.03989005496364707,-0.07803337030273506,0.0,2.538209745234108,-1.3587339111915815,1.3587339111915815,0.0,-0.07803337030273506,0,1,0,1,-0.07803337030273506,0.0
5287,23,8,58,110,92,1,2986.934,4,1576.624,LESS,-1102,2614,1512,4,1,-18.0,-1.6873352292140782,18.0,1.571468165481551,-1.6517733215618011,-0.6216552708410061,202,110,92,0,0.8376911542365885,1.170500554541026,0.4682002218164104,-0.2951406680504776,-0.7667601633216873,0.7667601633216873,0.4682002218164104,1.170500554541026,0,0,0,2,1.170500554541026,0.4682002218164104
5288,23,9,12,50,48,0,3674.966,54,2249.5460000000007,LESS,-1274,2784,1510,2,1,-2.0,-0.18748169213489754,2.0,-1.222253017596762,-0.04629139553380726,-0.310922639498513,98,50,48,0,-1.2365917038730592,-1.170500554541026,-1.248533924843761,-1.239590805812006,-0.9258531080617214,0.9258531080617214,-1.248533924843761,-1.170500554541026,0,0,0,0,-1.170500554541026,-1.248533924843761
5289,23,10,54,110,101,1,9208.107,54,1568.031,LESS,856,3866,4722,8,1,-9.0,-0.8436676146070391,9.0,0.0,-0.04629139553380726,2.1879836068956005,211,110,101,0,1.0171964015730004,1.170500554541026,0.8193503881787182,1.5937596074725793,1.0443095215677698,1.0443095215677698,0.8193503881787182,1.170500554541026,0,1,1,2,1.170500554541026,0.8193503881787182
5290,23,11,14,46,50,0,1972.588,100,1501.914,LESS,618,1142,1760,2,2,4.0,0.3749633842697951,4.0,-0.8730378697119728,1.4307519764119467,-1.0797595474905408,96,46,50,1,-1.2764817588367063,-1.3265672951464962,-1.170500554541026,-1.239590805812006,0.824169284078653,0.824169284078653,-1.170500554541026,-1.3265672951464962,1,0,1,0,-1.3265672951464962,-1.170500554541026
5291,23,12,22,80,83,0,4958.179,84,2703.4120000000007,LESS,376,2246,2622,4,2,3.0,0.28122253820234633,3.0,-1.0476454436543674,0.9169977600829888,0.26860876610892226,163,80,83,1,0.05983508244547061,0.0,0.1170500554541026,-0.2951406680504776,0.6003292106653493,0.6003292106653493,0.1170500554541026,0.0,1,0,1,1,0.1170500554541026,0.0
5292,23,13,6,50,56,1,7160.835999999998,74,1713.808,LESS,1174,2524,3698,4,2,6.0,0.5624450764046927,6.0,-0.5238227218271837,0.5959013748773903,1.263384307878726,106,50,56,1,-1.077031484018471,-1.170500554541026,-0.9364004436328208,-0.2951406680504776,1.3384464775406235,1.3384464775406235,-0.9364004436328208,-1.170500554541026,1,0,1,0,-1.170500554541026,-0.9364004436328208
5293,23,14,13,50,47,1,5275.58,34,1963.309,LESS,-1352,3744,2392,6,1,-3.0,-0.28122253820234633,3.0,-1.0476454436543674,-0.6884841659450047,0.4119550754677001,97,50,47,0,-1.2565367313548828,-1.170500554541026,-1.2875506099951286,0.6493094697110509,-0.9979999085833647,0.9979999085833647,-1.2875506099951286,-1.170500554541026,0,1,0,0,-1.170500554541026,-1.2875506099951286
5294,23,15,46,110,124,0,3053.825,94,956.388,LESS,410,1510,1920,4,2,14.0,1.3123718449442827,14.0,0.8730378697119728,1.2380941452885876,-0.5914456055301912,234,110,124,1,1.4759320336549415,1.170500554541026,1.7167341466601715,-0.2951406680504776,0.6317778160209374,0.6317778160209374,1.7167341466601715,1.170500554541026,1,0,1,2,1.7167341466601715,1.170500554541026
5295,23,16,27,91,80,0,11543.973999999998,24,1632.406,LESS,-2158,5922,3764,11,1,-11.0,-1.0311493067419364,11.0,0.34921514788478913,-1.0095805511506035,3.242920149637937,171,91,80,0,0.21939530230005888,0.4291835366650429,0.0,3.010434814114872,-1.7435168473070126,1.7435168473070126,0.0,0.4291835366650429,0,1,0,1,0.4291835366650429,0.0
5296,23,17,40,64,80,0,1875.935,54,1616.567,LESS,-990,1414,424,2,1,16.0,1.4998535370791803,16.0,1.222253017596762,-0.04629139553380726,-1.123410483809122,144,64,80,1,-0.3191204397091766,-0.6242669624218805,0.0,-1.239590805812006,-0.6631647574444558,0.6631647574444558,0.0,-0.6242669624218805,0,0,0,1,-0.6242669624218805,0.0
5297,23,18,22,83,80,0,6832.351,24,1256.958,LESS,-1652,4420,2768,6,1,-3.0,-0.28122253820234633,3.0,-1.0476454436543674,-1.0095805511506035,1.1150321841307922,163,83,80,0,0.05983508244547061,0.1170500554541026,0.0,0.6493094697110509,-1.2754876028973776,1.2754876028973776,0.0,0.1170500554541026,0,1,0,1,0.1170500554541026,0.0
5298,23,19,54,101,110,0,3361.985,84,1005.123,LESS,138,1644,1782,4,1,9.0,0.8436676146070391,9.0,0.0,0.9169977600829888,-0.4522727652051732,211,101,110,1,1.0171964015730004,0.8193503881787182,1.170500554541026,-0.2951406680504776,0.3801889731762325,0.3801889731762325,1.170500554541026,0.8193503881787182,1,0,1,2,1.170500554541026,0.8193503881787182
5299,23,20,6,56,50,1,3958.387,84,1238.472,LESS,1426,1462,2888,3,2,-6.0,-0.5624450764046927,6.0,-0.5238227218271837,0.9169977600829888,-0.1829225564969653,106,56,50,0,-1.077031484018471,-0.9364004436328208,-1.170500554541026,-0.7673657369312419,1.5715361407643944,1.5715361407643944,-1.170500554541026,-0.9364004436328208,1,0,1,0,-0.9364004436328208,-1.170500554541026
5300,23,21,18,50,42,0,7594.009,4,1917.825,LESS,-1864,5060,3196,8,1,-8.0,-0.7499267685395902,8.0,-0.17460757394239454,-1.6517733215618011,1.4590161769146464,92,50,42,0,-1.3562618687640005,-1.170500554541026,-1.4826340357519663,1.5937596074725793,-1.47157890687928,1.47157890687928,-1.4826340357519663,-1.170500554541026,0,1,0,0,-1.170500554541026,-1.4826340357519663
5301,23,22,43,110,117,0,9315.865,44,2380.53,LESS,-1016,4566,3550,10,2,7.0,0.6561859224721414,7.0,-0.34921514788478913,-0.367387780739406,2.236649841733812,227,110,117,1,1.3363168412821769,1.170500554541026,1.4436173506005987,2.538209745234108,-0.6872136909516703,0.6872136909516703,1.4436173506005987,1.170500554541026,0,1,0,2,1.4436173506005987,1.170500554541026
5302,23,23,32,77,80,0,1826.872,74,1083.862,LESS,-582,1104,522,2,1,3.0,0.28122253820234633,3.0,-1.0476454436543674,0.5959013748773903,-1.1455685739728887,157,77,80,1,-0.05983508244547061,-0.1170500554541026,0.0,-1.239590805812006,-0.2857814931773983,0.2857814931773983,0.0,-0.1170500554541026,1,0,0,1,-0.1170500554541026,0.0
5303,23,24,27,80,91,1,2063.828,84,1314.671,LESS,578,738,1316,3,2,11.0,1.0311493067419364,11.0,0.34921514788478913,0.9169977600829888,-1.0385532587079132,171,80,91,1,0.21939530230005888,0.0,0.4291835366650429,-0.7673657369312419,0.7871709248367846,0.7871709248367846,0.4291835366650429,0.0,1,0,1,1,0.4291835366650429,0.0
5304,23,25,16,44,50,0,4442.518,44,2414.7670000000007,LESS,-1186,2468,1282,3,1,6.0,0.5624450764046927,6.0,-0.5238227218271837,-0.367387780739406,0.03572323257167186,94,44,50,1,-1.3163718138003533,-1.4046006654492311,-1.170500554541026,-0.7673657369312419,-0.844456717729611,0.844456717729611,-1.170500554541026,-1.4046006654492311,0,0,0,0,-1.4046006654492311,-1.170500554541026
5305,23,26,7,50,57,1,6184.9540000000015,14,3886.192,LESS,-518,3986,3468,6,1,7.0,0.6561859224721414,7.0,-0.34921514788478913,-1.3306769363562023,0.8226513452552231,107,50,57,1,-1.0570864565366473,-1.170500554541026,-0.8973837584814532,0.6493094697110509,-0.2265841183904089,0.2265841183904089,-0.8973837584814532,-1.170500554541026,0,1,0,0,-1.170500554541026,-0.8973837584814532
5306,23,27,14,50,46,1,5219.459,44,1070.852,LESS,1184,1818,3002,6,1,-4.0,-0.3749633842697951,4.0,-0.8730378697119728,-0.367387780739406,0.3866094142141943,96,50,46,0,-1.2764817588367063,-1.170500554541026,-1.3265672951464962,0.6493094697110509,1.3476960673510907,1.3476960673510907,-1.3265672951464962,-1.170500554541026,0,1,1,0,-1.170500554541026,-1.3265672951464962
5307,23,28,51,110,108,0,4985.085999999998,4,1869.697,LESS,-2068,3618,1550,4,1,-2.0,-0.18748169213489754,2.0,-1.222253017596762,-1.6517733215618011,0.2807606469975029,218,110,108,0,1.156811593945765,1.170500554541026,1.092467184238291,-0.2951406680504776,-1.6602705390128087,1.6602705390128087,1.092467184238291,1.170500554541026,0,0,0,2,1.170500554541026,1.092467184238291
5308,23,29,50,133,110,1,6102.594,74,1410.134,LESS,-194,2666,2472,5,2,-23.0,-2.1560394595513217,23.0,2.444506035193524,0.5959013748773903,0.7854554887872561,243,133,110,0,1.6554372809913533,2.0678843130224793,1.170500554541026,0.1770844008302866,0.07310259146872497,0.07310259146872497,1.170500554541026,2.0678843130224793,1,1,1,2,2.0678843130224793,1.170500554541026
5309,23,30,49,131,110,1,5591.604,44,1697.158,LESS,-966,3178,2212,5,1,-21.0,-1.9685577674164243,21.0,2.0952908873087353,-0.367387780739406,0.5546794968425492,241,131,110,0,1.6155472260277064,1.9898509427197442,1.170500554541026,0.1770844008302866,-0.6409657418993349,0.6409657418993349,1.170500554541026,1.9898509427197442,0,1,0,2,1.9898509427197442,1.170500554541026
5310,23,31,47,126,110,0,10455.844,34,2534.346,LESS,-52,4798,4746,7,2,-16.0,-1.4998535370791803,16.0,1.222253017596762,-0.6884841659450047,2.751493154755857,236,126,110,0,1.5158220886185887,1.7947675169629065,1.170500554541026,1.121534538591815,0.2044467667773577,0.2044467667773577,1.170500554541026,1.7947675169629065,0,1,1,2,1.7947675169629065,1.170500554541026
5311,23,32,50,110,133,0,2717.282,100,2017.276,LESS,1230,1344,2574,4,2,23.0,2.1560394595513217,23.0,2.444506035193524,1.4307519764119467,-0.7434369256285248,243,110,133,1,1.6554372809913533,1.170500554541026,2.0678843130224793,-0.2951406680504776,1.3902441804792391,1.3902441804792391,2.0678843130224793,1.170500554541026,1,0,1,2,2.0678843130224793,1.170500554541026
5312,23,33,47,110,126,0,4991.945,44,1481.045,LESS,-1592,3178,1586,6,1,16.0,1.4998535370791803,16.0,1.222253017596762,-0.367387780739406,0.2838583446603712,236,110,126,1,1.5158220886185887,1.170500554541026,1.7947675169629065,0.6493094697110509,-1.2199900640345749,1.2199900640345749,1.7947675169629065,1.170500554541026,0,1,0,2,1.7947675169629065,1.170500554541026
5313,23,34,12,48,50,0,4295.051,100,3343.382,LESS,206,2532,2738,4,2,2.0,0.18748169213489754,2.0,-1.222253017596762,1.4307519764119467,-0.030876589742091662,98,48,50,1,-1.2365917038730592,-1.248533924843761,-1.170500554541026,-0.2951406680504776,0.4430861838874088,0.4430861838874088,-1.170500554541026,-1.248533924843761,1,1,1,0,-1.248533924843761,-1.170500554541026
5314,23,35,32,80,77,0,7051.383000000002,64,2853.183,LESS,-934,3638,2704,8,1,-3.0,-0.28122253820234633,3.0,-1.0476454436543674,0.2748049896717915,1.2139525682236971,157,80,77,0,-0.05983508244547061,0.0,-0.1170500554541026,1.5937596074725793,-0.6113670545058402,0.6113670545058402,-0.1170500554541026,0.0,1,1,0,1,0.0,-0.1170500554541026
5315,23,36,43,117,110,1,7789.693,34,1738.6570000000004,LESS,-844,4054,3210,7,1,-7.0,-0.6561859224721414,7.0,-0.34921514788478913,-0.6884841659450047,1.5473920144216584,227,117,110,0,1.3363168412821769,1.4436173506005987,1.170500554541026,1.121534538591815,-0.5281207462116363,0.5281207462116363,1.170500554541026,1.4436173506005987,0,1,0,2,1.4436173506005987,1.170500554541026
5316,23,37,40,80,64,1,3845.165,64,1973.745,LESS,854,1574,2428,3,2,-16.0,-1.4998535370791803,16.0,1.222253017596762,0.2748049896717915,-0.2340564717594238,144,80,64,0,-0.3191204397091766,0.0,-0.6242669624218805,-0.7673657369312419,1.0424596036056766,1.0424596036056766,-0.6242669624218805,0.0,1,0,1,1,0.0,-0.6242669624218805
5317,23,38,31,80,78,1,3622.884,74,1005.094,LESS,368,1528,1896,5,2,-2.0,-0.18748169213489754,2.0,-1.222253017596762,0.5959013748773903,-0.3344441863242125,158,80,78,0,-0.03989005496364707,0.0,-0.07803337030273506,0.1770844008302866,0.5929295388169756,0.5929295388169756,-0.07803337030273506,0.0,1,1,1,1,0.0,-0.07803337030273506
5318,23,39,46,124,110,1,8778.517,14,3181.56,LESS,74,4538,4612,9,1,-14.0,-1.3123718449442827,14.0,0.8730378697119728,-1.3306769363562023,1.993969911168626,234,124,110,0,1.4759320336549415,1.7167341466601715,1.170500554541026,2.0659846763533434,0.3209915983892431,0.3209915983892431,1.170500554541026,1.7167341466601715,0,1,1,2,1.7167341466601715,1.170500554541026
5319,23,40,58,92,110,0,3919.144,64,1488.529,LESS,-1258,2452,1194,4,1,18.0,1.6873352292140782,18.0,1.571468165481551,0.2748049896717915,-0.20064568660105,202,92,110,1,0.8376911542365885,0.4682002218164104,1.170500554541026,-0.2951406680504776,-0.911053764364974,0.911053764364974,1.170500554541026,0.4682002218164104,1,0,0,2,1.170500554541026,0.4682002218164104
5320,23,41,49,110,131,1,2344.062,94,2837.186,MORE,776,988,1764,3,2,21.0,1.9685577674164243,21.0,2.0952908873087353,1.2380941452885876,-0.9119925054120892,241,110,131,0,1.6155472260277064,1.170500554541026,1.9898509427197442,-0.7673657369312419,0.9703128030840331,0.9703128030840331,1.9898509427197442,1.170500554541026,1,0,1,2,1.9898509427197442,1.170500554541026
5321,23,42,13,47,50,1,4627.984,34,1585.523,MORE,-252,2368,2116,6,1,3.0,0.28122253820234633,3.0,-1.0476454436543674,-0.6884841659450047,0.11948436316525905,97,47,50,0,-1.2565367313548828,-1.2875506099951286,-1.170500554541026,0.6493094697110509,0.019454970568015813,0.019454970568015813,-1.170500554541026,-1.2875506099951286,0,1,0,0,-1.2875506099951286,-1.170500554541026
5322,23,43,16,50,44,0,2976.171,64,1280.146,MORE,-828,1780,952,4,1,-6.0,-0.5624450764046927,6.0,-0.5238227218271837,0.2748049896717915,-0.6265161135214911,94,50,44,1,-1.3163718138003533,-1.170500554541026,-1.4046006654492311,-0.2951406680504776,-0.5133214025148889,0.5133214025148889,-1.4046006654492311,-1.170500554541026,0,1,0,0,-1.170500554541026,-1.4046006654492311
5323,23,44,7,57,50,0,5534.289000000002,84,2653.92,MORE,274,2686,2960,4,2,-7.0,-0.6561859224721414,7.0,-0.34921514788478913,0.9169977600829888,0.5287945950278159,107,57,50,1,-1.0570864565366473,-0.8973837584814532,-1.170500554541026,-0.2951406680504776,0.505983394598585,0.505983394598585,-1.170500554541026,-0.8973837584814532,1,1,1,0,-0.8973837584814532,-1.170500554541026
5324,23,45,18,42,50,1,6015.648,14,1258.189,MORE,-540,3366,2826,7,1,8.0,0.7499267685395902,8.0,-0.17460757394239454,-1.3306769363562023,0.7461884788739027,92,42,50,0,-1.3562618687640005,-1.4826340357519663,-1.170500554541026,1.121534538591815,-0.2469332159734365,0.2469332159734365,-1.170500554541026,-1.4826340357519663,0,1,0,0,-1.4826340357519663,-1.170500554541026
5325,23,46,51,108,110,0,5201.6590000000015,24,1793.692,MORE,-258,2632,2374,4,1,2.0,0.18748169213489754,2.0,-1.222253017596762,-1.0095805511506035,0.3785704845744452,218,108,110,0,1.156811593945765,1.092467184238291,1.170500554541026,-0.2951406680504776,0.013905216681735557,0.013905216681735557,1.170500554541026,1.092467184238291,0,1,0,2,1.170500554541026,1.092467184238291
5326,23,47,31,78,80,1,9036.964,0,3120.823,MORE,-1792,5542,3750,10,1,2.0,0.18748169213489754,2.0,-1.222253017596762,-1.7802118756440406,2.110691104910448,158,78,80,0,-0.03989005496364707,-0.07803337030273506,0.0,2.538209745234108,-1.4049818602439168,1.4049818602439168,0.0,-0.07803337030273506,0,1,0,1,-0.07803337030273506,0.0
5327,23,48,58,110,92,0,2203.778,100,2373.574,MORE,176,1568,1744,2,2,-18.0,-1.6873352292140782,18.0,1.571468165481551,1.4307519764119467,-0.9753483034785314,202,110,92,1,0.8376911542365885,1.170500554541026,0.4682002218164104,-1.239590805812006,0.41533741445600747,0.41533741445600747,0.4682002218164104,1.170500554541026,1,0,1,2,1.170500554541026,0.4682002218164104
5328,23,49,12,50,48,0,3222.26,84,2349.886,MORE,-640,1954,1314,4,2,-2.0,-0.18748169213489754,2.0,-1.222253017596762,0.9169977600829888,-0.5153761047509063,98,50,48,1,-1.2365917038730592,-1.170500554541026,-1.248533924843761,-0.2951406680504776,-0.3394291140781075,0.3394291140781075,-1.248533924843761,-1.170500554541026,1,1,0,0,-1.170500554541026,-1.248533924843761
5329,23,50,54,110,101,0,3193.828,94,2247.574,MORE,1172,1634,2806,4,2,-9.0,-0.8436676146070391,9.0,0.0,1.2380941452885876,-0.5282167141619946,211,110,101,1,1.0171964015730004,1.170500554541026,0.8193503881787182,-0.2951406680504776,1.33659655957853,1.33659655957853,0.8193503881787182,1.170500554541026,1,1,1,2,1.170500554541026,0.8193503881787182
5330,23,51,14,46,50,1,7236.065,14,2255.755,MORE,-114,3378,3264,7,1,4.0,0.3749633842697951,4.0,-0.8730378697119728,-1.3306769363562023,1.2973596246129258,96,46,50,0,-1.2764817588367063,-1.3265672951464962,-1.170500554541026,1.121534538591815,0.14709930995246173,0.14709930995246173,-1.170500554541026,-1.3265672951464962,0,1,1,0,-1.3265672951464962,-1.170500554541026
5331,23,52,22,80,83,1,4608.862,24,1382.517,MORE,-1126,3208,2082,6,1,3.0,0.28122253820234633,3.0,-1.0476454436543674,-1.0095805511506035,0.11084838493091637,163,80,83,0,0.05983508244547061,0.0,0.1170500554541026,0.6493094697110509,-0.7889591788668083,0.7889591788668083,0.1170500554541026,0.0,0,1,0,1,0.1170500554541026,0.0
5332,23,53,6,50,56,1,5553.779,24,1498.0479999999998,MORE,380,2400,2780,7,1,6.0,0.5624450764046927,6.0,-0.5238227218271837,-1.0095805511506035,0.5375967713580808,106,50,56,0,-1.077031484018471,-1.170500554541026,-0.9364004436328208,1.121534538591815,0.6040290465895362,0.6040290465895362,-0.9364004436328208,-1.170500554541026,0,1,1,0,-1.170500554541026,-0.9364004436328208
5333,23,54,13,50,47,0,1702.086,94,1640.75,MORE,-42,1176,1134,2,2,-3.0,-0.28122253820234633,3.0,-1.0476454436543674,1.2380941452885876,-1.2019250837496205,97,50,47,1,-1.2565367313548828,-1.170500554541026,-1.2875506099951286,-1.239590805812006,0.21369635658782482,0.21369635658782482,-1.2875506099951286,-1.170500554541026,1,0,1,0,-1.170500554541026,-1.2875506099951286
5334,23,55,46,110,124,0,6570.6680000000015,54,1796.595,MORE,-584,2864,2280,5,2,14.0,1.3123718449442827,14.0,0.8730378697119728,-0.04629139553380726,0.9968495310454748,234,110,124,0,1.4759320336549415,1.170500554541026,1.7167341466601715,0.1770844008302866,-0.28763141113949175,0.28763141113949175,1.7167341466601715,1.170500554541026,0,1,0,2,1.7167341466601715,1.170500554541026
5335,23,56,27,91,80,0,6377.001,54,1820.078,MORE,-2158,3898,1740,6,1,-11.0,-1.0311493067419364,11.0,0.34921514788478913,-0.04629139553380726,0.9093846216892136,171,91,80,1,0.21939530230005888,0.4291835366650429,0.0,0.6493094697110509,-1.7435168473070126,1.7435168473070126,0.0,0.4291835366650429,0,1,0,1,0.4291835366650429,0.0
5336,23,57,40,64,80,1,2698.1740000000004,74,3944.531,MORE,-384,2162,1778,3,2,16.0,1.4998535370791803,16.0,1.222253017596762,0.5959013748773903,-0.752066581109218,144,64,80,0,-0.3191204397091766,-0.6242669624218805,0.0,-0.7673657369312419,-0.10263961493014984,0.10263961493014984,0.0,-0.6242669624218805,1,0,0,1,-0.6242669624218805,0.0
5337,23,58,22,83,80,1,5340.3690000000015,14,1704.193,MORE,-700,3394,2694,6,1,-3.0,-0.28122253820234633,3.0,-1.0476454436543674,-1.3306769363562023,0.4412154244806084,163,83,80,1,0.05983508244547061,0.1170500554541026,0.0,0.6493094697110509,-0.39492665294091006,0.39492665294091006,0.0,0.1170500554541026,0,1,0,1,0.1170500554541026,0.0
5338,23,59,54,101,110,1,2953.7790000000005,100,1243.722,MORE,528,1376,1904,4,2,9.0,0.8436676146070391,9.0,0.0,1.4307519764119467,-0.6366289063581918,211,101,110,0,1.0171964015730004,0.8193503881787182,1.170500554541026,-0.2951406680504776,0.7409229757844492,0.7409229757844492,1.170500554541026,0.8193503881787182,1,1,1,2,1.170500554541026,0.8193503881787182
5339,23,60,6,56,50,0,3482.9590000000007,84,2918.841,MORE,208,1642,1850,2,1,-6.0,-0.5624450764046927,6.0,-0.5238227218271837,0.9169977600829888,-0.3976378509220774,106,56,50,1,-1.077031484018471,-0.9364004436328208,-1.170500554541026,-1.239590805812006,0.44493610184950216,0.44493610184950216,-1.170500554541026,-0.9364004436328208,1,0,1,0,-0.9364004436328208,-1.170500554541026
5340,23,61,18,50,42,0,1713.165,90,3440.048,MORE,1732,1028,2760,2,2,-8.0,-0.7499267685395902,8.0,-0.17460757394239454,1.1096555912063482,-1.1969215274867675,92,50,42,1,-1.3562618687640005,-1.170500554541026,-1.4826340357519663,-1.239590805812006,1.8545735889646875,1.8545735889646875,-1.4826340357519663,-1.170500554541026,1,0,1,0,-1.170500554541026,-1.4826340357519663
5341,23,62,43,110,117,1,4477.442,64,1650.425,MORE,184,1932,2116,5,2,7.0,0.6561859224721414,7.0,-0.34921514788478913,0.2748049896717915,0.05149579317496535,227,110,117,0,1.3363168412821769,1.170500554541026,1.4436173506005987,0.1770844008302866,0.42273708630438117,0.42273708630438117,1.4436173506005987,1.170500554541026,0,1,1,2,1.4436173506005987,1.170500554541026
5342,23,63,32,77,80,1,4010.07,54,1683.3970000000004,MORE,478,1604,2082,3,2,3.0,0.28122253820234633,3.0,-1.0476454436543674,-0.04629139553380726,-0.1595812081502691,157,77,80,0,-0.05983508244547061,-0.1170500554541026,0.0,-0.7673657369312419,0.6946750267321137,0.6946750267321137,0.0,-0.1170500554541026,0,0,1,1,-0.1170500554541026,0.0
5343,23,64,27,80,91,1,4995.276,34,2038.354,MORE,-1040,3420,2380,4,1,11.0,1.0311493067419364,11.0,0.34921514788478913,-0.6884841659450047,0.28536270840363004,171,80,91,0,0.21939530230005888,0.0,0.4291835366650429,-0.2951406680504776,-0.7094127064967913,0.7094127064967913,0.4291835366650429,0.0,0,1,0,1,0.4291835366650429,0.0
5344,23,65,16,44,50,1,6005.393,0,3479.2090000000007,MORE,-572,3548,2976,5,1,6.0,0.5624450764046927,6.0,-0.5238227218271837,-1.7802118756440406,0.7415570618258333,94,44,50,0,-1.3163718138003533,-1.4046006654492311,-1.170500554541026,0.1770844008302866,-0.27653190336693123,0.27653190336693123,-1.170500554541026,-1.4046006654492311,0,1,0,0,-1.4046006654492311,-1.170500554541026
5345,23,66,7,50,57,1,7086.972,24,1044.502,MORE,-1846,4358,2512,5,1,7.0,0.6561859224721414,7.0,-0.34921514788478913,-1.0095805511506035,1.2300254596253288,107,50,57,0,-1.0570864565366473,-1.170500554541026,-0.8973837584814532,0.1770844008302866,-1.4549296452204392,1.4549296452204392,-0.8973837584814532,-1.170500554541026,0,1,0,0,-1.170500554541026,-0.8973837584814532
5346,23,67,14,50,46,0,10712.993,24,2302.844,MORE,-4184,7054,2870,8,1,-4.0,-0.3749633842697951,4.0,-0.8730378697119728,-1.0095805511506035,2.8676281389093434,96,50,46,1,-1.2764817588367063,-1.170500554541026,-1.3265672951464962,1.5937596074725793,-3.617483742907646,3.617483742907646,-1.3265672951464962,-1.170500554541026,0,1,0,0,-1.170500554541026,-1.3265672951464962
5347,23,68,51,110,108,0,3501.092,34,1679.448,MORE,-892,2354,1462,5,1,-2.0,-0.18748169213489754,2.0,-1.222253017596762,-0.6884841659450047,-0.38944853007052793,218,110,108,1,1.156811593945765,1.170500554541026,1.092467184238291,0.1770844008302866,-0.5725187773018783,0.5725187773018783,1.092467184238291,1.170500554541026,0,1,0,2,1.170500554541026,1.092467184238291
5348,23,69,50,133,110,0,3416.171,64,1781.517,MORE,-1076,2108,1032,4,1,-23.0,-2.1560394595513217,23.0,2.444506035193524,0.2748049896717915,-0.4278009988310449,243,133,110,1,1.6554372809913533,2.0678843130224793,1.170500554541026,-0.2951406680504776,-0.7427112298144729,0.7427112298144729,1.170500554541026,2.0678843130224793,0,1,0,2,2.0678843130224793,1.170500554541026
5349,23,70,49,131,110,1,6492.763000000001,14,1041.995,MORE,-382,3384,3002,7,1,-21.0,-1.9685577674164243,21.0,2.0952908873087353,-1.3306769363562023,0.9616656651137491,241,131,110,1,1.6155472260277064,1.9898509427197442,1.170500554541026,1.121534538591815,-0.10078969696805642,0.10078969696805642,1.170500554541026,1.9898509427197442,0,1,0,2,1.9898509427197442,1.170500554541026
5350,23,71,47,126,110,0,2468.641,74,1482.792,MORE,-830,1626,796,2,1,-16.0,-1.4998535370791803,16.0,1.222253017596762,0.5959013748773903,-0.855729482064314,236,126,110,1,1.5158220886185887,1.7947675169629065,1.170500554541026,-1.239590805812006,-0.5151713204769823,0.5151713204769823,1.170500554541026,1.7947675169629065,1,0,0,2,1.7947675169629065,1.170500554541026
5351,23,72,50,110,133,1,3639.825,90,2019.218,MORE,1888,1430,3318,5,2,23.0,2.1560394595513217,23.0,2.444506035193524,1.1096555912063482,-0.3267932027833698,243,110,133,0,1.6554372809913533,1.170500554541026,2.0678843130224793,0.1770844008302866,1.9988671900079742,1.9988671900079742,2.0678843130224793,1.170500554541026,1,1,1,2,2.0678843130224793,1.170500554541026
5352,23,73,47,110,126,1,2461.623,84,1385.921,MORE,326,1070,1396,3,2,16.0,1.4998535370791803,16.0,1.222253017596762,0.9169977600829888,-0.8588989881436266,236,110,126,0,1.5158220886185887,1.170500554541026,1.7947675169629065,-0.7673657369312419,0.5540812616130139,0.5540812616130139,1.7947675169629065,1.170500554541026,1,0,1,2,1.7947675169629065,1.170500554541026
5353,23,74,12,48,50,1,5899.174,54,1685.006,MORE,-14,2780,2766,7,2,2.0,0.18748169213489754,2.0,-1.222253017596762,-0.04629139553380726,0.6935858782637776,98,48,50,0,-1.2365917038730592,-1.248533924843761,-1.170500554541026,1.121534538591815,0.23959520805713266,0.23959520805713266,-1.170500554541026,-1.248533924843761,0,1,1,0,-1.248533924843761,-1.170500554541026
5354,23,75,32,80,77,1,8113.496,14,1411.33,MORE,-898,4318,3420,10,1,-3.0,-0.28122253820234633,3.0,-1.0476454436543674,-1.3306769363562023,1.6936296286991823,157,80,77,1,-0.05983508244547061,0.0,-0.1170500554541026,2.538209745234108,-0.5780685311881586,0.5780685311881586,-0.1170500554541026,0.0,0,1,0,1,0.0,-0.1170500554541026
5355,23,76,43,117,110,0,6384.661999999998,64,1735.4720000000002,MORE,-1640,3910,2270,6,2,-7.0,-0.6561859224721414,7.0,-0.34921514788478913,0.2748049896717915,0.91284452281113,227,117,110,1,1.3363168412821769,1.4436173506005987,1.170500554541026,0.6493094697110509,-1.264388095124817,1.264388095124817,1.170500554541026,1.4436173506005987,1,1,0,2,1.4436173506005987,1.170500554541026
5356,23,77,40,80,64,0,1466.661,100,775.637,MORE,-166,1136,970,2,2,-16.0,-1.4998535370791803,16.0,1.222253017596762,1.4307519764119467,-1.308248960740526,144,80,64,1,-0.3191204397091766,0.0,-0.6242669624218805,-1.239590805812006,0.09900144293803283,0.09900144293803283,-0.6242669624218805,0.0,1,0,1,1,0.0,-0.6242669624218805
5357,23,78,31,80,78,1,3374.687,44,1703.678,MORE,60,1498,1558,5,2,-2.0,-0.18748169213489754,2.0,-1.222253017596762,-0.367387780739406,-0.4465362211442687,158,80,78,1,-0.03989005496364707,0.0,-0.07803337030273506,0.1770844008302866,0.30804217265458916,0.30804217265458916,-0.07803337030273506,0.0,0,1,1,1,0.0,-0.07803337030273506
5358,23,79,46,124,110,0,4830.295,4,2108.004,MORE,-2586,4034,1448,4,1,-14.0,-1.3123718449442827,14.0,0.8730378697119728,-1.6517733215618011,0.21085312127466535,234,124,110,1,1.4759320336549415,1.7167341466601715,1.170500554541026,-0.2951406680504776,-2.139399291195004,2.139399291195004,1.170500554541026,1.7167341466601715,0,1,0,2,1.7167341466601715,1.170500554541026
5359,23,80,58,92,110,1,2760.83,64,1437.516,MORE,174,1280,1454,4,1,18.0,1.6873352292140782,18.0,1.571468165481551,0.2748049896717915,-0.7237695487772986,202,92,110,0,0.8376911542365885,0.4682002218164104,1.170500554541026,-0.2951406680504776,0.4134874964939141,0.4134874964939141,1.170500554541026,0.4682002218164104,1,1,1,2,1.170500554541026,0.4682002218164104
5360,23,81,48,128,110,0,5203.747,0,2345.062,LESS,-2680,4244,1564,7,1,-18.0,-1.6873352292140782,18.0,1.571468165481551,-1.7802118756440406,0.37951347811870295,238,128,110,0,1.5557121435822359,1.8728008872656416,1.170500554541026,1.121534538591815,-2.226345435413395,2.226345435413395,1.170500554541026,1.8728008872656416,0,1,0,2,1.8728008872656416,1.170500554541026
5361,23,82,8,50,58,0,12041.247,34,1498.965,LESS,-1786,6564,4778,11,1,8.0,0.7499267685395902,8.0,-0.17460757394239454,-0.6884841659450047,3.4675011978821697,108,50,58,1,-1.0371414290548238,-1.170500554541026,-0.8583670733300858,3.010434814114872,-1.3994321063576367,1.3994321063576367,-0.8583670733300858,-1.170500554541026,0,1,0,0,-1.170500554541026,-0.8583670733300858
5362,23,83,4,54,50,0,4817.539000000002,34,1787.1029999999996,LESS,-1302,3110,1808,6,1,-4.0,-0.3749633842697951,4.0,-0.8730378697119728,-0.6884841659450047,0.20509218944968574,104,54,50,0,-1.116921538982118,-1.0144338139355558,-1.170500554541026,0.6493094697110509,-0.9517519595310292,0.9517519595310292,-1.170500554541026,-1.0144338139355558,0,1,0,0,-1.0144338139355558,-1.170500554541026
5363,23,84,37,80,69,1,3252.75,84,2711.4590000000007,LESS,214,1334,1548,3,2,-11.0,-1.0311493067419364,11.0,0.34921514788478913,0.9169977600829888,-0.5016060505533798,149,80,69,0,-0.21939530230005888,0.0,-0.4291835366650429,-0.7673657369312419,0.4504858557357824,0.4504858557357824,-0.4291835366650429,0.0,1,0,1,1,0.0,-0.4291835366650429
5364,23,85,52,105,110,1,5834.547,74,4098.108,LESS,474,2316,2790,5,1,5.0,0.4687042303372438,5.0,-0.6984302957695783,0.5959013748773903,0.6643986925430968,215,105,110,1,1.0969765115002945,0.9754171287841883,1.170500554541026,0.1770844008302866,0.6909751908079269,0.6909751908079269,1.170500554541026,0.9754171287841883,1,1,1,2,1.170500554541026,0.9754171287841883
5365,23,86,5,55,50,0,3037.466,94,891.166,LESS,28,1694,1722,4,2,-5.0,-0.4687042303372438,5.0,-0.6984302957695783,1.2380941452885876,-0.5988337431693299,105,55,50,0,-1.0969765115002945,-0.9754171287841883,-1.170500554541026,-0.2951406680504776,0.27844348526109447,0.27844348526109447,-1.170500554541026,-0.9754171287841883,1,0,1,0,-0.9754171287841883,-1.170500554541026
5366,23,87,30,96,80,1,2475.963,80,1747.3670000000004,LESS,978,1148,2126,3,2,-16.0,-1.4998535370791803,16.0,1.222253017596762,0.7885592060007495,-0.8524226819057606,176,96,80,0,0.3191204397091766,0.6242669624218805,0.0,-0.7673657369312419,1.1571545172554685,1.1571545172554685,0.0,0.6242669624218805,1,0,1,1,0.6242669624218805,0.0
5367,23,88,33,80,75,1,6641.422,24,1136.116,LESS,-854,3846,2992,8,1,-5.0,-0.4687042303372438,5.0,-0.6984302957695783,-1.0095805511506035,1.0288038247382192,155,80,75,0,-0.09972513740911768,0.0,-0.19508342575683765,1.5937596074725793,-0.5373703360221034,0.5373703360221034,-0.19508342575683765,0.0,0,1,0,1,0.0,-0.19508342575683765
5368,23,89,48,110,128,0,3295.507,100,1477.966,LESS,110,1950,2060,4,2,18.0,1.6873352292140782,18.0,1.571468165481551,1.4307519764119467,-0.4822959092833357,238,110,128,1,1.5557121435822359,1.170500554541026,1.8728008872656416,-0.2951406680504776,0.35429012170692464,0.35429012170692464,1.8728008872656416,1.170500554541026,1,0,1,2,1.8728008872656416,1.170500554541026
5369,23,90,9,59,50,1,2693.041,14,1110.917,LESS,-1038,2028,990,4,1,-9.0,-0.8436676146070391,9.0,0.0,-1.3306769363562023,-0.7543847735721864,109,59,50,0,-1.0171964015730004,-0.8193503881787182,-1.170500554541026,-0.2951406680504776,-0.7075627885346979,0.7075627885346979,-1.170500554541026,-0.8193503881787182,0,0,0,0,-0.8193503881787182,-1.170500554541026
5370,23,91,44,110,119,0,4536.877,64,1568.325,LESS,-152,2040,1888,6,1,9.0,0.8436676146070391,9.0,0.0,0.2748049896717915,0.07833814054229887,229,110,119,1,1.376206896245824,1.170500554541026,1.5216507209033339,0.6493094697110509,0.11195086867268676,0.11195086867268676,1.5216507209033339,1.170500554541026,1,1,1,2,1.5216507209033339,1.170500554541026
5371,23,92,2,52,50,0,4190.215,84,1587.014,LESS,-280,2356,2076,6,2,-2.0,-0.18748169213489754,2.0,-1.222253017596762,0.9169977600829888,-0.07822317556865452,102,52,50,0,-1.156811593945765,-1.092467184238291,-1.170500554541026,0.6493094697110509,-0.006443880901292051,0.006443880901292051,-1.170500554541026,-1.092467184238291,1,1,0,0,-1.092467184238291,-1.170500554541026
5372,23,93,8,58,50,1,2792.557,34,1133.102,LESS,-278,1120,842,3,2,-8.0,-0.7499267685395902,8.0,-0.17460757394239454,-0.6884841659450047,-0.7094408341323356,108,58,50,0,-1.0371414290548238,-0.8583670733300858,-1.170500554541026,-0.7673657369312419,-0.004593962939198633,0.004593962939198633,-1.170500554541026,-0.8583670733300858,0,0,0,0,-0.8583670733300858,-1.170500554541026
5373,23,94,44,119,110,0,1678.9779999999996,74,3620.428,LESS,274,1402,1676,2,1,-9.0,-0.8436676146070391,9.0,0.0,0.5959013748773903,-1.2123612402729549,229,119,110,0,1.376206896245824,1.5216507209033339,1.170500554541026,-1.239590805812006,0.505983394598585,0.505983394598585,1.170500554541026,1.5216507209033339,1,0,1,2,1.5216507209033339,1.170500554541026
5374,23,95,34,74,80,1,4975.688,14,2444.874,LESS,-2810,4824,2014,4,1,6.0,0.5624450764046927,6.0,-0.5238227218271837,-1.3306769363562023,0.27651627279782004,154,74,80,1,-0.11967016489094122,-0.2341001109082052,0.0,-0.2951406680504776,-2.346590102949467,2.346590102949467,0.0,-0.2341001109082052,0,0,0,1,-0.2341001109082052,0.0
5375,23,96,24,86,80,1,4649.152,24,1708.039,LESS,-454,2842,2388,6,1,-6.0,-0.5624450764046927,6.0,-0.5238227218271837,-1.0095805511506035,0.12904436668291194,166,86,80,0,0.11967016489094122,0.2341001109082052,0.0,0.6493094697110509,-0.1673867436034195,0.1673867436034195,0.0,0.2341001109082052,0,1,0,1,0.2341001109082052,0.0
5376,23,97,39,66,80,0,3011.419000000001,100,1878.114,LESS,-530,1996,1466,2,2,14.0,1.3123718449442827,14.0,0.8730378697119728,1.4307519764119467,-0.6105972263337432,146,66,80,1,-0.2792303847455295,-0.5462335921191455,0.0,-1.239590805812006,-0.23768362616296942,0.23768362616296942,0.0,-0.5462335921191455,1,0,0,1,-0.5462335921191455,0.0
5377,23,98,9,50,59,0,2162.661,100,1188.24,LESS,-280,1592,1312,3,2,9.0,0.8436676146070391,9.0,0.0,1.4307519764119467,-0.9939177793210928,109,50,59,1,-1.0171964015730004,-1.170500554541026,-0.8193503881787182,-0.7673657369312419,-0.006443880901292051,0.006443880901292051,-0.8193503881787182,-1.170500554541026,1,0,0,0,-1.170500554541026,-0.8193503881787182
5378,23,99,57,94,110,0,1892.987,84,3278.922,LESS,-512,2078,1566,3,2,16.0,1.4998535370791803,16.0,1.222253017596762,0.9169977600829888,-1.115709369864346,204,94,110,1,0.8775812092002355,0.5462335921191455,1.170500554541026,-0.7673657369312419,-0.22103436450412867,0.22103436450412867,1.170500554541026,0.5462335921191455,1,0,0,2,1.170500554541026,0.5462335921191455
5379,23,100,60,110,87,1,3277.054,34,2852.4040000000005,LESS,-788,2454,1666,3,1,-23.0,-2.1560394595513217,23.0,2.444506035193524,-0.6884841659450047,-0.4906297502182966,197,110,87,0,0.7379660168274708,1.170500554541026,0.27311679605957273,-0.7673657369312419,-0.47632304327302055,0.47632304327302055,0.27311679605957273,1.170500554541026,0,0,0,2,1.170500554541026,0.27311679605957273
5380,23,101,33,75,80,0,1947.047,94,1586.229,LESS,204,1168,1372,2,2,5.0,0.4687042303372438,5.0,-0.6984302957695783,1.2380941452885876,-1.0912945082730607,155,75,80,1,-0.09972513740911768,-0.19508342575683765,0.0,-1.239590805812006,0.44123626592531534,0.44123626592531534,0.0,-0.19508342575683765,1,0,1,1,-0.19508342575683765,0.0
5381,23,102,15,50,45,1,4248.472,4,3687.609,LESS,-1232,3170,1938,5,1,-5.0,-0.4687042303372438,5.0,-0.6984302957695783,-1.6517733215618011,-0.05191284275837897,95,50,45,0,-1.2964267863185297,-1.170500554541026,-1.3655839802978638,0.1770844008302866,-0.8870048308577595,0.8870048308577595,-1.3655839802978638,-1.170500554541026,0,1,0,0,-1.170500554541026,-1.3655839802978638
5382,23,103,59,89,110,0,7842.359,14,1146.492,LESS,-1932,4780,2848,6,1,21.0,1.9685577674164243,21.0,2.0952908873087353,-1.3306769363562023,1.5711773103995836,199,89,110,1,0.7778560717911179,0.3511501663623078,1.170500554541026,0.6493094697110509,-1.5344761175904562,1.5344761175904562,1.170500554541026,0.3511501663623078,0,1,0,2,1.170500554541026,0.3511501663623078
5383,23,104,29,80,94,0,5183.759,34,2171.436,LESS,-232,2424,2192,6,1,14.0,1.3123718449442827,14.0,0.8730378697119728,-0.6884841659450047,0.3704863924086287,174,80,94,1,0.2792303847455295,0.0,0.5462335921191455,0.6493094697110509,0.03795415018895001,0.03795415018895001,0.5462335921191455,0.0,0,1,0,1,0.5462335921191455,0.0
5384,23,105,55,110,98,1,5946.455,64,2050.379,LESS,376,2622,2998,7,2,-12.0,-1.124890152809385,12.0,0.5238227218271837,0.2748049896717915,0.7149391722130479,208,110,98,0,0.9573613191275298,1.170500554541026,0.7023003327246156,1.121534538591815,0.6003292106653493,0.6003292106653493,0.7023003327246156,1.170500554541026,1,1,1,2,1.170500554541026,0.7023003327246156
5385,23,106,29,94,80,1,5577.324000000001,34,1835.877,LESS,944,1942,2886,4,2,-14.0,-1.3123718449442827,14.0,0.8730378697119728,-0.6884841659450047,0.5482302881203235,174,94,80,0,0.2792303847455295,0.5462335921191455,0.0,-0.2951406680504776,1.1257059118998802,1.1257059118998802,0.0,0.5462335921191455,0,0,1,1,0.5462335921191455,0.0
5386,23,107,57,110,94,1,4187.894,64,2177.114,LESS,-144,2120,1976,3,1,-16.0,-1.4998535370791803,16.0,1.222253017596762,0.2748049896717915,-0.07927139779864659,204,110,94,0,0.8775812092002355,1.170500554541026,0.5462335921191455,-0.7673657369312419,0.11935054052106044,0.11935054052106044,0.5462335921191455,1.170500554541026,1,0,1,2,1.170500554541026,0.5462335921191455
5387,23,108,39,80,66,1,2364.475,84,1270.431,LESS,552,1090,1642,3,2,-14.0,-1.3123718449442827,14.0,0.8730378697119728,0.9169977600829888,-0.9027734789662344,146,80,66,0,-0.2792303847455295,0.0,-0.5462335921191455,-0.7673657369312419,0.7631219913295701,0.7631219913295701,-0.5462335921191455,0.0,1,0,1,1,0.0,-0.5462335921191455
5388,23,109,4,50,54,0,2721.9970000000008,90,2367.886,LESS,470,1654,2124,4,2,4.0,0.3749633842697951,4.0,-0.8730378697119728,1.1096555912063482,-0.7413075125245121,104,50,54,1,-1.116921538982118,-1.170500554541026,-1.0144338139355558,-0.2951406680504776,0.68727535488374,0.68727535488374,-1.0144338139355558,-1.170500554541026,1,0,1,0,-1.170500554541026,-1.0144338139355558
5389,23,110,55,98,110,0,3528.0170000000007,44,1649.774,LESS,-464,1698,1234,4,1,12.0,1.124890152809385,12.0,0.5238227218271837,-0.367387780739406,-0.3772885199272544,208,98,110,1,0.9573613191275298,0.7023003327246156,1.170500554541026,-0.2951406680504776,-0.1766363334138866,0.1766363334138866,1.170500554541026,0.7023003327246156,0,0,0,2,1.170500554541026,0.7023003327246156
5390,23,111,2,50,52,1,3819.64,34,1767.517,LESS,558,1450,2008,5,2,2.0,0.18748169213489754,2.0,-1.222253017596762,-0.6884841659450047,-0.24558420653777305,102,50,52,1,-1.156811593945765,-1.170500554541026,-1.092467184238291,0.1770844008302866,0.7686717452158505,0.7686717452158505,-1.092467184238291,-1.170500554541026,0,1,1,0,-1.170500554541026,-1.092467184238291
5391,23,112,59,110,89,1,6035.808000000001,4,2361.035,LESS,280,3020,3300,5,1,-21.0,-1.9685577674164243,21.0,2.0952908873087353,-1.6517733215618011,0.7552932441288107,199,110,89,0,0.7778560717911179,1.170500554541026,0.3511501663623078,0.1770844008302866,0.5115331484848652,0.5115331484848652,0.3511501663623078,1.170500554541026,0,1,1,2,1.170500554541026,0.3511501663623078
5392,23,113,60,87,110,0,1583.491,100,1744.302,LESS,-36,1168,1132,2,2,23.0,2.1560394595513217,23.0,2.444506035193524,1.4307519764119467,-1.2554855815376058,197,87,110,1,0.7379660168274708,0.27311679605957273,1.170500554541026,-1.239590805812006,0.21924611047410505,0.21924611047410505,1.170500554541026,0.27311679605957273,1,0,1,2,1.170500554541026,0.27311679605957273
5393,23,114,52,110,105,1,4636.445,14,1146.941,LESS,316,2162,2478,4,1,-5.0,-0.4687042303372438,5.0,-0.6984302957695783,-1.3306769363562023,0.12330556449570387,215,110,105,0,1.0969765115002945,1.170500554541026,0.9754171287841883,-0.2951406680504776,0.5448316718025468,0.5448316718025468,0.9754171287841883,1.170500554541026,0,0,1,2,1.170500554541026,0.9754171287841883
5394,23,115,30,80,96,0,4978.054,84,2553.233,LESS,-2552,4124,1572,5,2,16.0,1.4998535370791803,16.0,1.222253017596762,0.9169977600829888,0.27758481816454184,176,80,96,1,0.3191204397091766,0.0,0.6242669624218805,0.1770844008302866,-2.107950685839416,2.107950685839416,0.6242669624218805,0.0,1,1,0,1,0.6242669624218805,0.0
5395,23,116,24,80,86,1,5937.286,34,1922.396,LESS,414,2664,3078,5,1,6.0,0.5624450764046927,6.0,-0.5238227218271837,-0.6884841659450047,0.7107982201980555,166,80,86,1,0.11967016489094122,0.0,0.2341001109082052,0.1770844008302866,0.6354776519451243,0.6354776519451243,0.2341001109082052,0.0,0,1,1,1,0.2341001109082052,0.0
5396,23,117,5,50,55,1,4285.335,64,2392.672,LESS,-58,2018,1960,4,1,5.0,0.4687042303372438,5.0,-0.6984302957695783,0.2748049896717915,-0.0352645807746654,105,50,55,1,-1.0969765115002945,-1.170500554541026,-0.9754171287841883,-0.2951406680504776,0.19889701289107745,0.19889701289107745,-0.9754171287841883,-1.170500554541026,0,0,1,0,-1.170500554541026,-0.9754171287841883
5397,23,118,34,80,74,0,2874.753,84,2644.987,LESS,24,1718,1742,4,2,-6.0,-0.5624450764046927,6.0,-0.5238227218271837,0.9169977600829888,-0.6723190442071174,154,80,74,0,-0.11967016489094122,0.0,-0.2341001109082052,-0.2951406680504776,0.27474364933690765,0.27474364933690765,-0.2341001109082052,0.0,1,0,1,1,0.0,-0.2341001109082052
5398,23,119,15,45,50,0,2423.803,84,922.284,LESS,-876,1802,926,2,2,5.0,0.4687042303372438,5.0,-0.6984302957695783,0.9169977600829888,-0.8759794555017918,95,45,50,1,-1.2964267863185297,-1.3655839802978638,-1.170500554541026,-1.239590805812006,-0.557719433605131,0.557719433605131,-1.170500554541026,-1.3655839802978638,1,0,0,0,-1.3655839802978638,-1.170500554541026
5399,23,120,37,69,80,0,2091.791,74,3516.867,LESS,-156,1940,1784,2,2,11.0,1.0311493067419364,11.0,0.34921514788478913,0.5959013748773903,-1.0259244615440744,149,69,80,1,-0.21939530230005888,-0.4291835366650429,0.0,-1.239590805812006,0.10825103274849993,0.10825103274849993,0.0,-0.4291835366650429,1,0,1,1,-0.4291835366650429,0.0
5400,23,121,48,128,110,0,2978.324,74,2082.087,MORE,-212,1384,1172,4,1,-18.0,-1.6873352292140782,18.0,1.571468165481551,0.5959013748773903,-0.6255437643352897,238,128,110,1,1.5557121435822359,1.8728008872656416,1.170500554541026,-0.2951406680504776,0.0564533298098842,0.0564533298098842,1.170500554541026,1.8728008872656416,1,1,1,2,1.8728008872656416,1.170500554541026
5401,23,122,8,50,58,1,2394.95,84,1446.4520000000002,MORE,620,886,1506,2,2,8.0,0.7499267685395902,8.0,-0.17460757394239454,0.9169977600829888,-0.8890101991476179,108,50,58,0,-1.0371414290548238,-1.170500554541026,-0.8583670733300858,-1.239590805812006,0.8260192020407464,0.8260192020407464,-0.8583670733300858,-1.170500554541026,1,0,1,0,-1.170500554541026,-0.8583670733300858
5402,23,123,4,54,50,0,4043.489,14,1503.629,MORE,-2086,3408,1322,4,1,-4.0,-0.3749633842697951,4.0,-0.8730378697119728,-1.3306769363562023,-0.14448834356426912,104,54,50,1,-1.116921538982118,-1.0144338139355558,-1.170500554541026,-0.2951406680504776,-1.6769198006716495,1.6769198006716495,-1.170500554541026,-1.0144338139355558,0,1,0,0,-1.0144338139355558,-1.170500554541026
5403,23,124,37,80,69,0,3110.236,64,1932.583,MORE,-688,1766,1078,4,1,-11.0,-1.0311493067419364,11.0,0.34921514788478913,0.2748049896717915,-0.5659689729510939,149,80,69,1,-0.21939530230005888,0.0,-0.4291835366650429,-0.2951406680504776,-0.38382714516834954,0.38382714516834954,-0.4291835366650429,0.0,1,1,0,1,0.0,-0.4291835366650429
5404,23,125,52,105,110,1,2338.1620000000007,84,1673.042,MORE,788,934,1722,3,2,5.0,0.4687042303372438,5.0,-0.6984302957695783,0.9169977600829888,-0.9146570944499834,215,105,110,0,1.0969765115002945,0.9754171287841883,1.170500554541026,-0.7673657369312419,0.9814123108565936,0.9814123108565936,1.170500554541026,0.9754171287841883,1,0,1,2,1.170500554541026,0.9754171287841883
5405,23,126,5,55,50,0,1902.047,84,2726.256,MORE,258,976,1234,4,2,-5.0,-0.4687042303372438,5.0,-0.6984302957695783,0.9169977600829888,-1.1116176450027655,105,55,50,1,-1.0969765115002945,-0.9754171287841883,-1.170500554541026,-0.2951406680504776,0.4911840509018376,0.4911840509018376,-1.170500554541026,-0.9754171287841883,1,1,1,0,-0.9754171287841883,-1.170500554541026
5406,23,127,30,96,80,0,3217.385,34,2582.0660000000007,MORE,-338,1826,1488,4,2,-16.0,-1.4998535370791803,16.0,1.222253017596762,-0.6884841659450047,-0.5175777778966243,176,96,80,1,0.3191204397091766,0.6242669624218805,0.0,-0.2951406680504776,-0.0600915018020012,0.0600915018020012,0.0,0.6242669624218805,0,1,0,1,0.6242669624218805,0.0
5407,23,128,33,80,75,0,4795.25,4,1482.148,MORE,-2118,3668,1550,4,1,-5.0,-0.4687042303372438,5.0,-0.6984302957695783,-1.6517733215618011,0.195025914014832,155,80,75,1,-0.09972513740911768,0.0,-0.19508342575683765,-0.2951406680504776,-1.706518488065144,1.706518488065144,-0.19508342575683765,0.0,0,1,0,1,0.0,-0.19508342575683765
5408,23,129,48,110,128,1,2186.1,100,2156.826,MORE,914,844,1758,3,2,18.0,1.6873352292140782,18.0,1.571468165481551,1.4307519764119467,-0.9833321348364809,238,110,128,0,1.5557121435822359,1.170500554541026,1.8728008872656416,-0.7673657369312419,1.097957142468479,1.097957142468479,1.8728008872656416,1.170500554541026,1,0,1,2,1.8728008872656416,1.170500554541026
5409,23,130,9,59,50,0,1925.543,94,1016.491,MORE,-240,1276,1036,2,2,-9.0,-0.8436676146070391,9.0,0.0,1.2380941452885876,-1.1010062578782958,109,59,50,1,-1.0171964015730004,-0.8193503881787182,-1.170500554541026,-1.239590805812006,0.030554478340576327,0.030554478340576327,-1.170500554541026,-0.8193503881787182,1,0,0,0,-0.8193503881787182,-1.170500554541026
5410,23,131,44,110,119,0,4451.032,4,2495.323,MORE,-2910,4370,1460,6,1,9.0,0.8436676146070391,9.0,0.0,-1.6517733215618011,0.03956837004093205,229,110,119,0,1.376206896245824,1.170500554541026,1.5216507209033339,0.6493094697110509,-2.439086001054138,2.439086001054138,1.5216507209033339,1.170500554541026,0,1,0,2,1.5216507209033339,1.170500554541026
5411,23,132,2,52,50,0,3095.197,94,2429.521,MORE,86,2076,2162,4,2,-2.0,-0.18748169213489754,2.0,-1.222253017596762,1.2380941452885876,-0.5727609652461613,102,52,50,1,-1.156811593945765,-1.092467184238291,-1.170500554541026,-0.2951406680504776,0.33209110616180365,0.33209110616180365,-1.170500554541026,-1.092467184238291,1,1,1,0,-1.092467184238291,-1.170500554541026
5412,23,133,8,58,50,1,7624.385999999998,74,1234.876,MORE,-304,3680,3376,9,2,-8.0,-0.7499267685395902,8.0,-0.17460757394239454,0.5959013748773903,1.4727351974577174,108,58,50,1,-1.0371414290548238,-0.8583670733300858,-1.170500554541026,2.0659846763533434,-0.02864289644641308,0.02864289644641308,-1.170500554541026,-0.8583670733300858,1,1,0,0,-0.8583670733300858,-1.170500554541026
5413,23,134,44,119,110,0,2704.182,84,2003.679,MORE,-506,1772,1266,2,2,-9.0,-0.8436676146070391,9.0,0.0,0.9169977600829888,-0.7493532165431723,229,119,110,1,1.376206896245824,1.5216507209033339,1.170500554541026,-1.239590805812006,-0.2154846106178484,0.2154846106178484,1.170500554541026,1.5216507209033339,1,0,0,2,1.5216507209033339,1.170500554541026
5414,23,135,34,74,80,1,4213.814,0,2806.567,MORE,-1592,3530,1938,4,1,6.0,0.5624450764046927,6.0,-0.5238227218271837,-1.7802118756440406,-0.06756527104233664,154,74,80,0,-0.11967016489094122,-0.2341001109082052,0.0,-0.2951406680504776,-1.2199900640345749,1.2199900640345749,0.0,-0.2341001109082052,0,1,0,1,-0.2341001109082052,0.0
5415,23,136,24,86,80,0,3277.911,74,1290.465,MORE,-1358,2182,824,3,1,-6.0,-0.5624450764046927,6.0,-0.5238227218271837,0.5959013748773903,-0.4902427073699109,166,86,80,1,0.11967016489094122,0.2341001109082052,0.0,-0.7673657369312419,-1.003549662469645,1.003549662469645,0.0,0.2341001109082052,1,0,0,1,0.2341001109082052,0.0
5416,23,137,39,66,80,1,1742.037,74,890.34,MORE,826,662,1488,3,2,14.0,1.3123718449442827,14.0,0.8730378697119728,0.5959013748773903,-1.1838822029609888,146,66,80,0,-0.2792303847455295,-0.5462335921191455,0.0,-0.7673657369312419,1.0165607521363687,1.0165607521363687,0.0,-0.5462335921191455,1,0,1,1,-0.5462335921191455,0.0
5417,23,138,9,50,59,1,1585.672,100,2209.435,MORE,2584,404,2988,3,2,9.0,0.8436676146070391,9.0,0.0,1.4307519764119467,-1.254500586844106,109,50,59,0,-1.0171964015730004,-1.170500554541026,-0.8193503881787182,-0.7673657369312419,2.6426386408164837,2.6426386408164837,-0.8193503881787182,-1.170500554541026,1,0,1,0,-1.170500554541026,-0.8193503881787182
5418,23,139,57,94,110,1,2365.385,64,1118.202,MORE,116,962,1078,2,2,16.0,1.4998535370791803,16.0,1.222253017596762,0.2748049896717915,-0.9023624999790336,204,94,110,0,0.8775812092002355,0.5462335921191455,1.170500554541026,-1.239590805812006,0.3598398755932049,0.3598398755932049,1.170500554541026,0.5462335921191455,1,0,1,2,1.170500554541026,0.5462335921191455
5419,23,140,60,110,87,0,2278.348,84,1441.474,MORE,-362,1524,1162,4,2,-23.0,-2.1560394595513217,23.0,2.444506035193524,0.9169977600829888,-0.9416706077911072,197,110,87,1,0.7379660168274708,1.170500554541026,0.27311679605957273,-0.2951406680504776,-0.08229051734712223,0.08229051734712223,0.27311679605957273,1.170500554541026,1,1,0,2,1.170500554541026,0.27311679605957273
5420,23,141,33,75,80,1,3189.707000000001,64,1218.352,MORE,382,1398,1780,5,2,5.0,0.4687042303372438,5.0,-0.6984302957695783,0.2748049896717915,-0.5300778618611744,155,75,80,0,-0.09972513740911768,-0.19508342575683765,0.0,0.1770844008302866,0.6058789645516296,0.6058789645516296,0.0,-0.19508342575683765,1,1,1,1,-0.19508342575683765,0.0
5421,23,142,15,50,45,0,5392.648,0,1537.3010000000004,MORE,-1974,4088,2114,4,1,-5.0,-0.4687042303372438,5.0,-0.6984302957695783,-1.7802118756440406,0.4648259414826574,95,50,45,1,-1.2964267863185297,-1.170500554541026,-1.3655839802978638,-0.2951406680504776,-1.573324394794418,1.573324394794418,-1.3655839802978638,-1.170500554541026,0,0,0,0,-1.170500554541026,-1.3655839802978638
5422,23,143,59,89,110,1,2210.893,90,2447.405,MORE,2264,1044,3308,3,2,21.0,1.9685577674164243,21.0,2.0952908873087353,1.1096555912063482,-0.9721349897489346,199,89,110,0,0.7778560717911179,0.3511501663623078,1.170500554541026,-0.7673657369312419,2.346651766881537,2.346651766881537,1.170500554541026,0.3511501663623078,1,0,1,2,1.170500554541026,0.3511501663623078
5423,23,144,29,80,94,1,3352.195,74,1767.38,MORE,1834,1170,3004,3,2,14.0,1.3123718449442827,14.0,0.8730378697119728,0.5959013748773903,-0.4566941765070356,174,80,94,0,0.2792303847455295,0.0,0.5462335921191455,-0.7673657369312419,1.9489194050314518,1.9489194050314518,0.5462335921191455,0.0,1,0,1,1,0.5462335921191455,0.0
5424,23,145,55,110,98,1,4265.469,34,1116.766,MORE,-224,2084,1860,5,2,-12.0,-1.124890152809385,12.0,0.5238227218271837,-0.6884841659450047,-0.04423656820293904,208,110,98,1,0.9573613191275298,1.170500554541026,0.7023003327246156,0.1770844008302866,0.04535382203732368,0.04535382203732368,0.7023003327246156,1.170500554541026,0,1,0,2,1.170500554541026,0.7023003327246156
5425,23,146,29,94,80,0,8368.841,4,1937.292,MORE,-2100,5444,3344,8,1,-14.0,-1.3123718449442827,14.0,0.8730378697119728,-1.6517733215618011,1.8089498808824367,174,94,80,1,0.2792303847455295,0.5462335921191455,0.0,1.5937596074725793,-1.6898692264063033,1.6898692264063033,0.0,0.5462335921191455,0,1,0,1,0.5462335921191455,0.0
5426,23,147,57,110,94,0,3526.597,74,1939.834,MORE,-470,2172,1702,4,2,-16.0,-1.4998535370791803,16.0,1.222253017596762,0.5959013748773903,-0.37792982779739204,204,110,94,1,0.8775812092002355,1.170500554541026,0.5462335921191455,-0.2951406680504776,-0.18218608730016686,0.18218608730016686,0.5462335921191455,1.170500554541026,1,0,0,2,1.170500554541026,0.5462335921191455
5427,23,148,39,80,66,0,3109.193,94,1897.679,MORE,298,1708,2006,4,2,-14.0,-1.3123718449442827,14.0,0.8730378697119728,1.2380941452885876,-0.5664400180979624,146,80,66,1,-0.2792303847455295,0.0,-0.5462335921191455,-0.2951406680504776,0.528182410143706,0.528182410143706,-0.5462335921191455,0.0,1,0,1,1,0.0,-0.5462335921191455
5428,23,149,4,50,54,0,4880.3409999999985,64,1328.254,MORE,-394,2468,2074,6,1,4.0,0.3749633842697951,4.0,-0.8730378697119728,0.2748049896717915,0.2334551590696603,104,50,54,0,-1.116921538982118,-1.170500554541026,-1.0144338139355558,0.6493094697110509,-0.11188920474061693,0.11188920474061693,-1.0144338139355558,-1.170500554541026,1,1,0,0,-1.170500554541026,-1.0144338139355558
5429,23,150,55,98,110,1,1698.8010000000004,100,918.233,MORE,174,910,1084,2,2,12.0,1.124890152809385,12.0,0.5238227218271837,1.4307519764119467,-1.2034086727308893,208,98,110,0,0.9573613191275298,0.7023003327246156,1.170500554541026,-1.239590805812006,0.4134874964939141,0.4134874964939141,1.170500554541026,0.7023003327246156,1,0,1,2,1.170500554541026,0.7023003327246156
5430,23,151,2,50,52,1,3014.328,74,1306.425,MORE,1548,910,2458,3,2,2.0,0.18748169213489754,2.0,-1.222253017596762,0.5959013748773903,-0.6092834484504833,102,50,52,0,-1.156811593945765,-1.170500554541026,-1.092467184238291,-0.7673657369312419,1.6843811364520929,1.6843811364520929,-1.092467184238291,-1.170500554541026,1,0,1,0,-1.170500554541026,-1.092467184238291
5431,23,152,59,110,89,0,5611.193,4,1197.995,MORE,-1506,3574,2068,6,1,-21.0,-1.9685577674164243,21.0,2.0952908873087353,-1.6517733215618011,0.56352638407362,199,110,89,1,0.7778560717911179,1.170500554541026,0.3511501663623078,0.6493094697110509,-1.1404435916645579,1.1404435916645579,0.3511501663623078,1.170500554541026,0,1,0,2,1.170500554541026,0.3511501663623078
5432,23,153,60,87,110,1,2165.3,84,1133.948,MORE,670,830,1500,3,2,23.0,2.1560394595513217,23.0,2.444506035193524,0.9169977600829888,-0.9927259402582108,197,87,110,0,0.7379660168274708,0.27311679605957273,1.170500554541026,-0.7673657369312419,0.872267151093082,0.872267151093082,1.170500554541026,0.27311679605957273,1,0,1,2,1.170500554541026,0.27311679605957273
5433,23,154,52,110,105,0,4414.14,34,1870.029,MORE,-808,2484,1676,3,1,-5.0,-0.4687042303372438,5.0,-0.6984302957695783,-0.6884841659450047,0.022907010924659545,215,110,105,1,1.0969765115002945,1.170500554541026,0.9754171287841883,-0.7673657369312419,-0.4948222228939547,0.4948222228939547,0.9754171287841883,1.170500554541026,0,0,0,2,1.170500554541026,0.9754171287841883
5434,23,155,30,80,96,1,4289.097,74,1652.391,MORE,770,1736,2506,4,2,16.0,1.4998535370791803,16.0,1.222253017596762,0.5959013748773903,-0.03356556654406221,176,80,96,0,0.3191204397091766,0.0,0.6242669624218805,-0.2951406680504776,0.9647630491977529,0.9647630491977529,0.6242669624218805,0.0,1,0,1,1,0.6242669624218805,0.0
5435,23,156,24,80,86,1,1643.303,84,2356.2270000000008,MORE,1390,766,2156,3,2,6.0,0.5624450764046927,6.0,-0.5238227218271837,0.9169977600829888,-1.2284729714470035,166,80,86,0,0.11967016489094122,0.0,0.2341001109082052,-0.7673657369312419,1.5382376174467127,1.5382376174467127,0.2341001109082052,0.0,1,0,1,1,0.2341001109082052,0.0
5436,23,157,5,50,55,1,2858.929,84,1238.658,MORE,1244,986,2230,3,2,5.0,0.4687042303372438,5.0,-0.6984302957695783,0.9169977600829888,-0.6794655623318029,105,50,55,0,-1.0969765115002945,-1.170500554541026,-0.9754171287841883,-0.7673657369312419,1.4031936062138932,1.4031936062138932,-0.9754171287841883,-1.170500554541026,1,0,1,0,-1.170500554541026,-0.9754171287841883
5437,23,158,34,80,74,0,3979.11,34,1179.837,MORE,-322,1570,1248,4,1,-6.0,-0.5624450764046927,6.0,-0.5238227218271837,-0.6884841659450047,-0.17356352622030596,154,80,74,1,-0.11967016489094122,0.0,-0.2341001109082052,-0.2951406680504776,-0.04529215810525385,0.04529215810525385,-0.2341001109082052,0.0,0,0,0,1,0.0,-0.2341001109082052
5438,23,159,15,45,50,1,4881.373,54,1615.8729999999996,MORE,940,1740,2680,4,2,5.0,0.4687042303372438,5.0,-0.6984302957695783,-0.04629139553380726,0.233921236338662,95,45,50,0,-1.2964267863185297,-1.3655839802978638,-1.170500554541026,-0.2951406680504776,1.1220060759756936,1.1220060759756936,-1.170500554541026,-1.3655839802978638,0,0,1,0,-1.3655839802978638,-1.170500554541026
5439,23,160,37,69,80,1,2245.528,74,1575.451,MORE,1894,846,2740,3,2,11.0,1.0311493067419364,11.0,0.34921514788478913,0.5959013748773903,-0.956492948845972,149,69,80,0,-0.21939530230005888,-0.4291835366650429,0.0,-0.7673657369312419,2.0044169438942543,2.0044169438942543,0.0,-0.4291835366650429,1,0,1,1,-0.4291835366650429,0.0
5440,23,161,3,50,53,1,4417.729,10,1716.549,LESS,-642,3004,2362,7,1,3.0,0.28122253820234633,3.0,-1.0476454436543674,-1.4591154904384418,0.024527893985168636,103,50,53,1,-1.1368665664639415,-1.170500554541026,-1.0534504990869233,1.121534538591815,-0.3412790320402009,0.3412790320402009,-1.0534504990869233,-1.170500554541026,0,1,0,0,-1.170500554541026,-1.0534504990869233
5441,23,162,20,50,40,1,1847.285,94,1852.431,LESS,1642,682,2324,3,2,-10.0,-0.9374084606744876,10.0,0.17460757394239454,1.2380941452885876,-1.1363495475270342,90,50,40,0,-1.3961519237276474,-1.170500554541026,-1.5606674060547012,-0.7673657369312419,1.7713272806704836,1.7713272806704836,-1.5606674060547012,-1.170500554541026,1,0,1,0,-1.170500554541026,-1.5606674060547012
5442,23,163,25,80,88,0,4153.333,24,1514.672,LESS,-784,2474,1690,5,1,8.0,0.7499267685395902,8.0,-0.17460757394239454,-1.0095805511506035,-0.09488001843232076,168,80,88,1,0.1595602198545883,0.0,0.31213348121094026,0.1770844008302866,-0.4726232073488336,0.4726232073488336,0.31213348121094026,0.0,0,1,0,1,0.31213348121094026,0.0
5443,23,164,42,115,110,1,5662.976,14,1506.829,LESS,-662,3466,2804,7,1,-5.0,-0.4687042303372438,5.0,-0.6984302957695783,-1.3306769363562023,0.586912894946382,225,115,110,0,1.2964267863185297,1.3655839802978638,1.170500554541026,1.121534538591815,-0.3597782116611351,0.3597782116611351,1.170500554541026,1.3655839802978638,0,1,0,2,1.3655839802978638,1.170500554541026
5444,23,165,53,103,110,0,3128.357,84,2355.868,LESS,354,2340,2694,5,2,7.0,0.6561859224721414,7.0,-0.34921514788478913,0.9169977600829888,-0.5577850716026722,213,103,110,1,1.0570864565366473,0.8973837584814532,1.170500554541026,0.1770844008302866,0.5799801130823217,0.5799801130823217,1.170500554541026,0.8973837584814532,1,1,1,2,1.170500554541026,0.8973837584814532
5445,23,166,26,90,80,1,3775.908,44,2095.488,LESS,454,1534,1988,7,2,-10.0,-0.9374084606744876,10.0,0.17460757394239454,-0.367387780739406,-0.26533468243696073,170,90,80,0,0.19945027481823535,0.3901668515136753,0.0,1.121534538591815,0.6724760111869926,0.6724760111869926,0.0,0.3901668515136753,0,1,1,1,0.3901668515136753,0.0
5446,23,167,35,80,72,1,7483.732,54,1942.949,LESS,122,3404,3526,7,2,-8.0,-0.7499267685395902,8.0,-0.17460757394239454,-0.04629139553380726,1.4092122980448318,152,80,72,0,-0.1595602198545883,0.0,-0.31213348121094026,1.121534538591815,0.36538962947948517,0.36538962947948517,-0.31213348121094026,0.0,0,1,1,1,0.0,-0.31213348121094026
5447,23,168,28,93,80,0,3086.677,84,1290.466,LESS,-506,1978,1472,4,2,-13.0,-1.218630998876834,13.0,0.6984302957695783,0.9169977600829888,-0.5766088124669854,173,93,80,0,0.25928535726370594,0.5072169069677779,0.0,-0.2951406680504776,-0.2154846106178484,0.2154846106178484,0.0,0.5072169069677779,1,0,0,1,0.5072169069677779,0.0
5448,23,169,26,80,90,0,2724.531,84,1914.787,LESS,-62,1696,1634,4,2,10.0,0.9374084606744876,10.0,0.17460757394239454,0.9169977600829888,-0.7401630941139998,170,80,90,1,0.19945027481823535,0.0,0.3901668515136753,-0.2951406680504776,0.19519717696689062,0.19519717696689062,0.3901668515136753,0.0,1,0,1,1,0.3901668515136753,0.0
5449,23,170,25,88,80,1,14799.597,14,3035.993,LESS,-3410,9134,5724,14,1,-8.0,-0.7499267685395902,8.0,-0.17460757394239454,-1.3306769363562023,4.7132417356239715,168,88,80,0,0.1595602198545883,0.31213348121094026,0.0,4.427110020757165,-2.9015654915774927,2.9015654915774927,0.0,0.31213348121094026,0,1,0,1,0.31213348121094026,0.0
5450,23,171,36,80,70,0,4785.198,74,2423.931,LESS,-130,2812,2682,5,2,-10.0,-0.9374084606744876,10.0,0.17460757394239454,0.5959013748773903,0.19048617689467676,150,80,70,0,-0.19945027481823535,0.0,-0.3901668515136753,0.1770844008302866,0.13229996625571439,0.13229996625571439,-0.3901668515136753,0.0,1,1,1,1,0.0,-0.3901668515136753
5451,23,172,28,80,93,0,4683.189,64,2543.158,LESS,-716,2444,1728,3,1,13.0,1.218630998876834,13.0,0.6984302957695783,0.2748049896717915,0.1444163356800001,173,80,93,1,0.25928535726370594,0.0,0.5072169069677779,-0.7673657369312419,-0.4097259966376574,0.4097259966376574,0.5072169069677779,0.0,1,0,0,1,0.5072169069677779,0.0
5452,23,173,21,82,80,0,1716.5,90,1106.101,LESS,402,914,1316,2,2,-2.0,-0.18748169213489754,2.0,-1.222253017596762,1.1096555912063482,-1.1954153572424657,162,82,80,0,0.03989005496364707,0.07803337030273506,0.0,-1.239590805812006,0.6243781441725638,0.6243781441725638,0.0,0.07803337030273506,1,0,1,1,0.07803337030273506,0.0
5453,23,174,19,50,41,1,3201.775,84,1452.371,LESS,778,1326,2104,5,2,-9.0,-0.8436676146070391,9.0,0.0,0.9169977600829888,-0.5246276482155287,91,50,41,0,-1.376206896245824,-1.170500554541026,-1.5216507209033339,0.1770844008302866,0.9721627210461266,0.9721627210461266,-1.5216507209033339,-1.170500554541026,1,1,1,0,-1.170500554541026,-1.5216507209033339
5454,23,175,56,96,110,0,6216.3319999999985,64,967.565,LESS,-200,2666,2466,10,1,14.0,1.3123718449442827,14.0,0.8730378697119728,0.2748049896717915,0.8368224426842145,206,96,110,1,0.9174712641638826,0.6242669624218805,1.170500554541026,2.538209745234108,0.06755283758244471,0.06755283758244471,1.170500554541026,0.6242669624218805,1,1,1,2,1.170500554541026,0.6242669624218805
5455,23,176,23,80,85,1,10104.012,24,1377.493,LESS,-918,5530,4612,10,1,5.0,0.4687042303372438,5.0,-0.6984302957695783,-1.0095805511506035,2.592596936047292,165,80,85,1,0.09972513740911768,0.0,0.19508342575683765,2.538209745234108,-0.5965677108090928,0.5965677108090928,0.19508342575683765,0.0,0,1,0,1,0.19508342575683765,0.0
5456,23,177,10,60,50,1,2600.535,74,2461.754,LESS,-18,1528,1510,2,2,-10.0,-0.9374084606744876,10.0,0.17460757394239454,0.5959013748773903,-0.7961628199348102,110,60,50,0,-0.9972513740911768,-0.7803337030273506,-1.170500554541026,-1.239590805812006,0.23589537213294584,0.23589537213294584,-1.170500554541026,-0.7803337030273506,1,0,1,0,-0.7803337030273506,-1.170500554541026
5457,23,178,19,41,50,0,1775.276,100,2627.207000000001,LESS,184,1198,1382,2,2,9.0,0.8436676146070391,9.0,0.0,1.4307519764119467,-1.1688706309219077,91,41,50,1,-1.376206896245824,-1.5216507209033339,-1.170500554541026,-1.239590805812006,0.42273708630438117,0.42273708630438117,-1.170500554541026,-1.5216507209033339,1,0,1,0,-1.5216507209033339,-1.170500554541026
5458,23,179,56,110,96,1,2897.693,74,1464.661,LESS,912,1088,2000,5,2,-14.0,-1.3123718449442827,14.0,0.8730378697119728,0.5959013748773903,-0.6619587607275745,206,110,96,0,0.9174712641638826,1.170500554541026,0.6242669624218805,0.1770844008302866,1.0961072245063856,1.0961072245063856,0.6242669624218805,1.170500554541026,1,1,1,2,1.170500554541026,0.6242669624218805
5459,23,180,35,72,80,0,3046.368,64,957.15,LESS,-960,1922,962,4,1,8.0,0.7499267685395902,8.0,-0.17460757394239454,0.2748049896717915,-0.5948133750989336,152,72,80,1,-0.1595602198545883,-0.31213348121094026,0.0,-0.2951406680504776,-0.6354159880130545,0.6354159880130545,0.0,-0.31213348121094026,1,0,0,1,-0.31213348121094026,0.0
5460,23,181,11,49,50,1,3664.812,74,1199.51,LESS,1390,1230,2620,3,2,1.0,0.09374084606744876,1.0,-1.3968605915391563,0.5959013748773903,-0.3155084423952557,99,49,50,1,-1.2166466763912356,-1.2095172396923934,-1.170500554541026,-0.7673657369312419,1.5382376174467127,1.5382376174467127,-1.170500554541026,-1.2095172396923934,1,0,1,0,-1.2095172396923934,-1.170500554541026
5461,23,182,17,43,50,0,6023.569,34,2214.322,LESS,-62,2808,2746,6,1,7.0,0.6561859224721414,7.0,-0.34921514788478913,-0.6884841659450047,0.7497658025635915,93,43,50,1,-1.3363168412821769,-1.4436173506005987,-1.170500554541026,0.6493094697110509,0.19519717696689062,0.19519717696689062,-1.170500554541026,-1.4436173506005987,0,1,1,0,-1.4436173506005987,-1.170500554541026
5462,23,183,1,51,50,1,2116.203,14,2137.096,LESS,152,1292,1444,3,1,-1.0,-0.09374084606744876,1.0,-1.3968605915391563,-1.3306769363562023,-1.01489938568084,101,51,50,0,-1.1767566214275886,-1.1314838693896585,-1.170500554541026,-0.7673657369312419,0.3931383989108865,0.3931383989108865,-1.170500554541026,-1.1314838693896585,0,0,1,0,-1.1314838693896585,-1.170500554541026
5463,23,184,41,112,110,1,6664.439,24,1835.94,LESS,894,2614,3508,7,2,-2.0,-0.18748169213489754,2.0,-1.222253017596762,-1.0095805511506035,1.039198883362833,222,112,110,0,1.2365917038730592,1.248533924843761,1.170500554541026,1.121534538591815,1.079457962847545,1.079457962847545,1.170500554541026,1.248533924843761,0,1,1,2,1.248533924843761,1.170500554541026
5464,23,185,20,40,50,0,1934.764,100,2573.952,LESS,-158,1418,1260,2,2,10.0,0.9374084606744876,10.0,0.17460757394239454,1.4307519764119467,-1.0968418213497488,90,40,50,1,-1.3961519237276474,-1.5606674060547012,-1.170500554541026,-1.239590805812006,0.10640111478640651,0.10640111478640651,-1.170500554541026,-1.5606674060547012,1,0,1,0,-1.5606674060547012,-1.170500554541026
5465,23,186,1,50,51,1,2015.064,84,849.696,LESS,756,866,1622,3,2,1.0,0.09374084606744876,1.0,-1.3968605915391563,0.9169977600829888,-1.0605763129187422,101,50,51,1,-1.1767566214275886,-1.170500554541026,-1.1314838693896585,-0.7673657369312419,0.951813623463099,0.951813623463099,-1.1314838693896585,-1.170500554541026,1,0,1,0,-1.170500554541026,-1.1314838693896585
5466,23,187,23,85,80,0,1914.668,34,1526.342,LESS,-864,1388,524,2,1,-5.0,-0.4687042303372438,5.0,-0.6984302957695783,-0.6884841659450047,-1.1059176825879744,165,85,80,0,0.09972513740911768,0.19508342575683765,0.0,-1.239590805812006,-0.5466199258325705,0.5466199258325705,0.0,0.19508342575683765,0,0,0,1,0.19508342575683765,0.0
5467,23,188,11,50,49,0,3160.426,10,1479.312,LESS,-2030,2964,934,4,1,-1.0,-0.09374084606744876,1.0,-1.3968605915391563,-1.4591154904384418,-0.5433019011185634,99,50,49,0,-1.2166466763912356,-1.170500554541026,-1.2095172396923934,-0.2951406680504776,-1.6251220977330336,1.6251220977330336,-1.2095172396923934,-1.170500554541026,0,0,0,0,-1.170500554541026,-1.2095172396923934
5468,23,189,17,50,43,1,6760.5030000000015,64,2761.8340000000007,LESS,662,2780,3442,7,2,-7.0,-0.6561859224721414,7.0,-0.34921514788478913,0.2748049896717915,1.0825838124028857,93,50,43,0,-1.3363168412821769,-1.170500554541026,-1.4436173506005987,1.121534538591815,0.8648674792447082,0.8648674792447082,-1.4436173506005987,-1.170500554541026,0,1,1,0,-1.170500554541026,-1.4436173506005987
5469,23,190,21,80,82,0,3184.7140000000004,44,1373.217,LESS,-1026,2186,1160,4,1,2.0,0.18748169213489754,2.0,-1.222253017596762,-0.367387780739406,-0.5323328267876505,162,80,82,1,0.03989005496364707,0.0,0.07803337030273506,-0.2951406680504776,-0.6964632807621374,0.6964632807621374,0.07803337030273506,0.0,0,0,0,1,0.07803337030273506,0.0
5470,23,191,10,50,60,0,3722.876,84,1325.628,LESS,-366,1940,1574,6,2,10.0,0.9374084606744876,10.0,0.17460757394239454,0.9169977600829888,-0.28928527326028725,110,50,60,1,-0.9972513740911768,-1.170500554541026,-0.7803337030273506,0.6493094697110509,-0.08599035327130906,0.08599035327130906,-0.7803337030273506,-1.170500554541026,1,1,0,0,-1.170500554541026,-0.7803337030273506
5471,23,192,3,53,50,0,8232.712,44,2920.807,LESS,-1992,4952,2960,6,2,-3.0,-0.28122253820234633,3.0,-1.0476454436543674,-0.367387780739406,1.7474705857740371,103,53,50,0,-1.1368665664639415,-1.0534504990869233,-1.170500554541026,0.6493094697110509,-1.5899736564532587,1.5899736564532587,-1.170500554541026,-1.0534504990869233,0,1,0,0,-1.0534504990869233,-1.170500554541026
5472,23,193,45,122,110,1,4782.786,24,1541.691,LESS,-698,2650,1952,4,1,-12.0,-1.124890152809385,12.0,0.5238227218271837,-1.0095805511506035,0.18939685676596446,232,122,110,0,1.4360419786912946,1.6387007763574364,1.170500554541026,-0.2951406680504776,-0.3930767349788166,0.3930767349788166,1.170500554541026,1.6387007763574364,0,0,0,2,1.6387007763574364,1.170500554541026
5473,23,194,38,67,80,0,8870.76,64,1565.793,LESS,-378,4112,3734,9,2,13.0,1.218630998876834,13.0,0.6984302957695783,0.2748049896717915,2.035629180087696,147,67,80,1,-0.25928535726370594,-0.5072169069677779,0.0,2.0659846763533434,-0.09708986104386959,0.09708986104386959,0.0,-0.5072169069677779,1,1,0,1,-0.5072169069677779,0.0
5474,23,195,38,80,67,1,4927.35,24,3192.235,LESS,-372,2854,2482,5,1,-13.0,-1.218630998876834,13.0,0.6984302957695783,-1.0095805511506035,0.254685610948032,147,80,67,0,-0.25928535726370594,0.0,-0.5072169069677779,0.1770844008302866,-0.09154010715758933,0.09154010715758933,-0.5072169069677779,0.0,0,1,0,1,0.0,-0.5072169069677779
5475,23,196,36,70,80,0,4936.844,0,2053.175,LESS,-3160,4838,1678,6,1,10.0,0.9374084606744876,10.0,0.17460757394239454,-1.7802118756440406,0.2589733411727389,150,70,80,1,-0.19945027481823535,-0.3901668515136753,0.0,0.6493094697110509,-2.6703257463158154,2.6703257463158154,0.0,-0.3901668515136753,0,1,0,1,-0.3901668515136753,0.0
5476,23,197,45,110,122,1,4823.197,0,1931.83,LESS,-418,3098,2680,6,1,12.0,1.124890152809385,12.0,0.5238227218271837,-1.7802118756440406,0.2076474851745,232,110,122,1,1.4360419786912946,1.170500554541026,1.6387007763574364,0.6493094697110509,-0.13408822028573797,0.13408822028573797,1.6387007763574364,1.170500554541026,0,1,0,2,1.6387007763574364,1.170500554541026
5477,23,198,42,110,115,0,2973.842,64,1547.369,LESS,-768,1662,894,4,1,5.0,0.4687042303372438,5.0,-0.6984302957695783,0.2748049896717915,-0.6275679487535682,225,110,115,1,1.2964267863185297,1.170500554541026,1.3655839802978638,-0.2951406680504776,-0.45782386365208627,0.45782386365208627,1.3655839802978638,1.170500554541026,1,0,0,2,1.3655839802978638,1.170500554541026
5478,23,199,41,110,112,0,5737.8,74,1401.4920000000004,LESS,-478,2890,2412,5,2,2.0,0.18748169213489754,2.0,-1.222253017596762,0.5959013748773903,0.6207053034500141,222,110,112,1,1.2365917038730592,1.170500554541026,1.248533924843761,0.1770844008302866,-0.18958575914854053,0.18958575914854053,1.248533924843761,1.170500554541026,1,1,0,2,1.248533924843761,1.170500554541026
5479,23,200,53,110,103,1,4140.13,74,1235.7910000000004,LESS,948,1464,2412,5,2,-7.0,-0.6561859224721414,7.0,-0.34921514788478913,0.5959013748773903,-0.1008428267488159,213,110,103,0,1.0570864565366473,1.170500554541026,0.8973837584814532,0.1770844008302866,1.129405747824067,1.129405747824067,0.8973837584814532,1.170500554541026,1,1,1,2,1.170500554541026,0.8973837584814532
5480,23,201,3,50,53,1,1875.905,94,810.544,MORE,870,752,1622,2,2,3.0,0.28122253820234633,3.0,-1.0476454436543674,1.2380941452885876,-1.1234240325669422,103,50,53,0,-1.1368665664639415,-1.170500554541026,-1.0534504990869233,-1.239590805812006,1.0572589473024239,1.0572589473024239,-1.0534504990869233,-1.170500554541026,1,0,1,0,-1.170500554541026,-1.0534504990869233
5481,23,202,20,50,40,0,2376.242,74,1841.993,MORE,-298,1320,1022,4,1,-10.0,-0.9374084606744876,10.0,0.17460757394239454,0.5959013748773903,-0.8974592045240469,90,50,40,1,-1.3961519237276474,-1.170500554541026,-1.5606674060547012,-0.2951406680504776,-0.023093142560132823,0.023093142560132823,-1.5606674060547012,-1.170500554541026,1,0,0,0,-1.170500554541026,-1.5606674060547012
5482,23,203,25,80,88,1,1984.592,74,1314.505,MORE,730,934,1664,3,2,8.0,0.7499267685395902,8.0,-0.17460757394239454,0.5959013748773903,-1.0743382378615771,168,80,88,0,0.1595602198545883,0.0,0.31213348121094026,-0.7673657369312419,0.9277646899558845,0.9277646899558845,0.31213348121094026,0.0,1,0,1,1,0.31213348121094026,0.0
5483,23,204,42,115,110,0,4864.56,34,1483.735,MORE,-844,2696,1852,6,1,-5.0,-0.4687042303372438,5.0,-0.6984302957695783,-0.6884841659450047,0.22632806083118398,225,115,110,1,1.2964267863185297,1.3655839802978638,1.170500554541026,0.6493094697110509,-0.5281207462116363,0.5281207462116363,1.170500554541026,1.3655839802978638,0,1,0,2,1.3655839802978638,1.170500554541026
5484,23,205,53,103,110,1,3147.067,54,1221.415,MORE,490,1160,1650,3,2,7.0,0.6561859224721414,7.0,-0.34921514788478913,-0.04629139553380726,-0.5493351629757217,213,103,110,0,1.0570864565366473,0.8973837584814532,1.170500554541026,-0.7673657369312419,0.7057745345046742,0.7057745345046742,1.170500554541026,0.8973837584814532,0,0,1,2,1.170500554541026,0.8973837584814532
5485,23,206,26,90,80,1,6297.699000000001,34,1383.1660000000004,MORE,330,2466,2796,5,1,-10.0,-0.9374084606744876,10.0,0.17460757394239454,-0.6884841659450047,0.8735698352683465,170,90,80,1,0.19945027481823535,0.3901668515136753,0.0,0.1770844008302866,0.5577810975372007,0.5577810975372007,0.0,0.3901668515136753,0,1,1,1,0.3901668515136753,0.0
5486,23,207,35,80,72,0,2783.599,54,1298.55,MORE,-842,1790,948,4,1,-8.0,-0.7499267685395902,8.0,-0.17460757394239454,-0.04629139553380726,-0.7134864932173286,152,80,72,1,-0.1595602198545883,0.0,-0.31213348121094026,-0.2951406680504776,-0.5262708282495429,0.5262708282495429,-0.31213348121094026,0.0,0,0,0,1,0.0,-0.31213348121094026
5487,23,208,28,93,80,0,3529.033,84,2175.138,MORE,944,1106,2050,4,2,-13.0,-1.218630998876834,13.0,0.6984302957695783,0.9169977600829888,-0.3768296686624241,173,93,80,1,0.25928535726370594,0.5072169069677779,0.0,-0.2951406680504776,1.1257059118998802,1.1257059118998802,0.0,0.5072169069677779,1,0,1,1,0.5072169069677779,0.0
5488,23,209,26,80,90,1,5074.029,0,716.545,MORE,364,2340,2704,8,1,10.0,0.9374084606744876,10.0,0.17460757394239454,-1.7802118756440406,0.32092955255639555,170,80,90,0,0.19945027481823535,0.0,0.3901668515136753,1.5937596074725793,0.5892297028927889,0.5892297028927889,0.3901668515136753,0.0,0,1,1,1,0.3901668515136753,0.0
5489,23,210,25,88,80,0,3747.942,34,953.268,MORE,-1100,2442,1342,4,1,-8.0,-0.7499267685395902,8.0,-0.17460757394239454,-0.6884841659450047,-0.2779648344765812,168,88,80,1,0.1595602198545883,0.31213348121094026,0.0,-0.2951406680504776,-0.7649102453595938,0.7649102453595938,0.0,0.31213348121094026,0,0,0,1,0.31213348121094026,0.0
5490,23,211,36,80,70,1,3567.828,54,1701.015,MORE,556,1608,2164,5,2,-10.0,-0.9374084606744876,10.0,0.17460757394239454,-0.04629139553380726,-0.3593088666751153,150,80,70,1,-0.19945027481823535,0.0,-0.3901668515136753,0.1770844008302866,0.766821827253757,0.766821827253757,-0.3901668515136753,0.0,0,1,1,1,0.0,-0.3901668515136753
5491,23,212,28,80,93,1,2085.536,74,1113.597,MORE,584,724,1308,3,2,13.0,1.218630998876834,13.0,0.6984302957695783,0.5959013748773903,-1.0287493775495034,173,80,93,0,0.25928535726370594,0.0,0.5072169069677779,-0.7673657369312419,0.792720678723065,0.792720678723065,0.5072169069677779,0.0,1,0,1,1,0.5072169069677779,0.0
5492,23,213,21,82,80,0,3857.72,54,2477.073,MORE,-1120,2352,1232,4,1,-2.0,-0.18748169213489754,2.0,-1.222253017596762,-0.04629139553380726,-0.22838631661183625,162,82,80,1,0.03989005496364707,0.07803337030273506,0.0,-0.2951406680504776,-0.7834094249805281,0.7834094249805281,0.0,0.07803337030273506,0,0,0,1,0.07803337030273506,0.0
5493,23,214,19,50,41,0,3532.94,34,1605.817,MORE,-1326,2450,1124,4,1,-9.0,-0.8436676146070391,9.0,0.0,-0.6884841659450047,-0.37506516876902507,91,50,41,1,-1.376206896245824,-1.170500554541026,-1.5216507209033339,-0.2951406680504776,-0.9739509750761502,0.9739509750761502,-1.5216507209033339,-1.170500554541026,0,0,0,0,-1.170500554541026,-1.5216507209033339
5494,23,215,56,96,110,1,2868.798,84,2041.168,MORE,706,1294,2000,3,2,14.0,1.3123718449442827,14.0,0.8730378697119728,0.9169977600829888,-0.6750084726343485,206,96,110,0,0.9174712641638826,0.6242669624218805,1.170500554541026,-0.7673657369312419,0.9055656744107634,0.9055656744107634,1.170500554541026,0.6242669624218805,1,0,1,2,1.170500554541026,0.6242669624218805
5495,23,216,23,80,85,1,2428.069,74,1202.25,MORE,770,890,1660,3,2,5.0,0.4687042303372438,5.0,-0.6984302957695783,0.5959013748773903,-0.8740528221398158,165,80,85,0,0.09972513740911768,0.0,0.19508342575683765,-0.7673657369312419,0.9647630491977529,0.9647630491977529,0.19508342575683765,0.0,1,0,1,1,0.19508342575683765,0.0
5496,23,217,10,60,50,0,4224.684,84,1264.325,MORE,-462,2504,2042,4,2,-10.0,-0.9374084606744876,10.0,0.17460757394239454,0.9169977600829888,-0.06265610445896135,110,60,50,1,-0.9972513740911768,-0.7803337030273506,-1.170500554541026,-0.2951406680504776,-0.1747864154517932,0.1747864154517932,-1.170500554541026,-0.7803337030273506,1,0,0,0,-0.7803337030273506,-1.170500554541026
5497,23,218,19,41,50,1,2737.177,100,1926.243,MORE,1426,1150,2576,3,2,9.0,0.8436676146070391,9.0,0.0,1.4307519764119467,-0.734451841067692,91,41,50,0,-1.376206896245824,-1.5216507209033339,-1.170500554541026,-0.7673657369312419,1.5715361407643944,1.5715361407643944,-1.170500554541026,-1.5216507209033339,1,0,1,0,-1.5216507209033339,-1.170500554541026
5498,23,219,56,110,96,0,3647.591,14,1005.919,MORE,-954,2174,1220,4,1,-14.0,-1.3123718449442827,14.0,0.8730378697119728,-1.3306769363562023,-0.3232858810090834,206,110,96,1,0.9174712641638826,1.170500554541026,0.6242669624218805,-0.2951406680504776,-0.6298662341267743,0.6298662341267743,0.6242669624218805,1.170500554541026,0,0,0,2,1.170500554541026,0.6242669624218805
5499,23,220,35,72,80,1,1696.7220000000002,94,2185.935,MORE,2104,516,2620,0,2,8.0,0.7499267685395902,8.0,-0.17460757394239454,1.2380941452885876,-1.2043476016478014,152,72,80,0,-0.1595602198545883,-0.31213348121094026,0.0,-2.1840409435735344,2.198658329914063,2.198658329914063,0.0,-0.31213348121094026,1,0,1,1,-0.31213348121094026,0.0
5500,23,221,11,49,50,1,8186.463000000002,0,670.4689999999998,MORE,-1008,4076,3068,6,1,1.0,0.09374084606744876,1.0,-1.3968605915391563,-1.7802118756440406,1.7265833690937689,99,49,50,0,-1.2166466763912356,-1.2095172396923934,-1.170500554541026,0.6493094697110509,-0.6798140191032966,0.6798140191032966,-1.170500554541026,-1.2095172396923934,0,1,0,0,-1.2095172396923934,-1.170500554541026
5501,23,222,17,43,50,1,8628.347,4,1915.327,MORE,-2316,5162,2846,4,1,7.0,0.6561859224721414,7.0,-0.34921514788478913,-1.6517733215618011,1.9261493457752976,93,43,50,0,-1.3363168412821769,-1.4436173506005987,-1.170500554541026,-0.2951406680504776,-1.8896603663123928,1.8896603663123928,-1.170500554541026,-1.4436173506005987,0,0,0,0,-1.4436173506005987,-1.170500554541026
5502,23,223,1,51,50,0,4808.653,64,1870.239,MORE,-922,2752,1830,4,1,-1.0,-0.09374084606744876,1.0,-1.3968605915391563,0.2748049896717915,0.20107904738345947,101,51,50,1,-1.1767566214275886,-1.1314838693896585,-1.170500554541026,-0.2951406680504776,-0.6002675467332796,0.6002675467332796,-1.170500554541026,-1.1314838693896585,0,0,0,0,-1.1314838693896585,-1.170500554541026
5503,23,224,41,112,110,0,7458.338000000002,54,2029.325,MORE,-944,3926,2982,11,1,-2.0,-0.18748169213489754,2.0,-1.222253017596762,-0.04629139553380726,1.3977437261756298,222,112,110,1,1.2365917038730592,1.248533924843761,1.170500554541026,3.010434814114872,-0.6206166443163073,0.6206166443163073,1.170500554541026,1.248533924843761,0,1,0,2,1.248533924843761,1.170500554541026
5504,23,225,20,40,50,1,2172.229,100,1205.599,MORE,1106,934,2040,3,2,10.0,0.9374084606744876,10.0,0.17460757394239454,1.4307519764119467,-0.9895966288270972,90,40,50,0,-1.3961519237276474,-1.5606674060547012,-1.170500554541026,-0.7673657369312419,1.2755492668294472,1.2755492668294472,-1.170500554541026,-1.5606674060547012,1,0,1,0,-1.5606674060547012,-1.170500554541026
5505,23,226,1,50,51,0,4388.031,84,1184.39,MORE,638,2196,2834,4,2,1.0,0.09374084606744876,1.0,-1.3968605915391563,0.9169977600829888,0.011115526994084692,101,50,51,0,-1.1767566214275886,-1.170500554541026,-1.1314838693896585,-0.2951406680504776,0.8426684636995873,0.8426684636995873,-1.1314838693896585,-1.170500554541026,1,0,1,0,-1.170500554541026,-1.1314838693896585
5506,23,227,23,85,80,1,5195.435,34,1021.572,MORE,-4,2538,2534,6,1,-5.0,-0.4687042303372438,5.0,-0.6984302957695783,-0.6884841659450047,0.3757595689520962,165,85,80,1,0.09972513740911768,0.19508342575683765,0.0,0.6493094697110509,0.24884479786759978,0.24884479786759978,0.0,0.19508342575683765,0,1,1,1,0.19508342575683765,0.0
5507,23,228,11,50,49,0,5465.185,14,1711.945,MORE,-2076,4008,1932,7,1,-1.0,-0.09374084606744876,1.0,-1.3968605915391563,-1.3306769363562023,0.4975854830151595,99,50,49,1,-1.2166466763912356,-1.170500554541026,-1.2095172396923934,1.121534538591815,-1.6676702108611823,1.6676702108611823,-1.2095172396923934,-1.170500554541026,0,1,0,0,-1.170500554541026,-1.2095172396923934
5508,23,229,17,50,43,1,7167.638000000001,34,2724.199,MORE,-60,3328,3268,4,1,-7.0,-0.6561859224721414,7.0,-0.34921514788478913,-0.6884841659450047,1.2664562629017373,93,50,43,1,-1.3363168412821769,-1.170500554541026,-1.4436173506005987,-0.2951406680504776,0.19704709492898403,0.19704709492898403,-1.4436173506005987,-1.170500554541026,0,0,1,0,-1.170500554541026,-1.4436173506005987
5509,23,230,21,80,82,1,7094.661,84,1376.832,MORE,1358,2656,4014,6,2,2.0,0.18748169213489754,2.0,-1.222253017596762,0.9169977600829888,1.2334980062545444,162,80,82,0,0.03989005496364707,0.0,0.07803337030273506,0.6493094697110509,1.5086389300532181,1.5086389300532181,0.07803337030273506,0.0,1,1,1,1,0.07803337030273506,0.0
5510,23,231,10,50,60,1,2298.996,54,1193.958,MORE,430,818,1248,3,2,10.0,0.9374084606744876,10.0,0.17460757394239454,-0.04629139553380726,-0.9323454494089974,110,50,60,0,-0.9972513740911768,-1.170500554541026,-0.7803337030273506,-0.7673657369312419,0.6502769956418717,0.6502769956418717,-0.7803337030273506,-1.170500554541026,0,0,1,0,-1.170500554541026,-0.7803337030273506
5511,23,232,3,53,50,1,5971.541,14,2285.889,MORE,-1590,3742,2152,6,1,-3.0,-0.28122253820234633,3.0,-1.0476454436543674,-1.3306769363562023,0.7262686435019675,103,53,50,1,-1.1368665664639415,-1.0534504990869233,-1.170500554541026,0.6493094697110509,-1.2181401460724814,1.2181401460724814,-1.170500554541026,-1.0534504990869233,0,1,0,0,-1.0534504990869233,-1.170500554541026
5512,23,233,45,122,110,0,6903.541,14,2822.262,MORE,-1274,4052,2778,4,1,-12.0,-1.124890152809385,12.0,0.5238227218271837,-1.3306769363562023,1.1471833864371852,232,122,110,1,1.4360419786912946,1.6387007763574364,1.170500554541026,-0.2951406680504776,-0.9258531080617214,0.9258531080617214,1.170500554541026,1.6387007763574364,0,0,0,2,1.6387007763574364,1.170500554541026
5513,23,234,38,67,80,1,1808.105,84,1166.251,MORE,332,766,1098,1,2,13.0,1.218630998876834,13.0,0.6984302957695783,0.9169977600829888,-1.154044225239697,147,67,80,0,-0.25928535726370594,-0.5072169069677779,0.0,-1.7118158746927703,0.5596310154992941,0.5596310154992941,0.0,-0.5072169069677779,1,0,1,1,-0.5072169069677779,0.0
5514,23,235,38,80,67,0,6005.364000000001,44,1522.207,MORE,-728,2626,1898,7,1,-13.0,-1.218630998876834,13.0,0.6984302957695783,-0.367387780739406,0.7415439646932748,147,80,67,1,-0.25928535726370594,0.0,-0.5072169069677779,1.121534538591815,-0.42082550441021793,0.42082550441021793,-0.5072169069677779,0.0,0,1,0,1,0.0,-0.5072169069677779
5515,23,236,36,70,80,1,2137.484,94,1058.398,MORE,674,870,1544,3,2,10.0,0.9374084606744876,10.0,0.17460757394239454,1.2380941452885876,-1.0052883485087325,150,70,80,0,-0.19945027481823535,-0.3901668515136753,0.0,-0.7673657369312419,0.8759669870172687,0.8759669870172687,0.0,-0.3901668515136753,1,0,1,1,-0.3901668515136753,0.0
5516,23,237,45,110,122,1,2025.05,84,1402.0279999999998,MORE,1754,708,2462,3,2,12.0,1.124890152809385,12.0,0.5238227218271837,0.9169977600829888,-1.0560663830657906,232,110,122,0,1.4360419786912946,1.170500554541026,1.6387007763574364,-0.7673657369312419,1.874922686547715,1.874922686547715,1.6387007763574364,1.170500554541026,1,0,1,2,1.6387007763574364,1.170500554541026
5517,23,238,42,110,115,1,4421.108,44,1740.081,MORE,-220,2170,1950,5,1,5.0,0.4687042303372438,5.0,-0.6984302957695783,-0.367387780739406,0.02605393574093908,225,110,115,0,1.2964267863185297,1.170500554541026,1.3655839802978638,0.1770844008302866,0.04905365796151052,0.04905365796151052,1.3655839802978638,1.170500554541026,0,1,0,2,1.3655839802978638,1.170500554541026
5518,23,239,41,110,112,0,6405.426,54,2183.8920000000007,MORE,-698,3324,2626,6,2,2.0,0.18748169213489754,2.0,-1.222253017596762,-0.04629139553380726,0.9222220697234772,222,110,112,0,1.2365917038730592,1.170500554541026,1.248533924843761,0.6493094697110509,-0.3930767349788166,0.3930767349788166,1.248533924843761,1.170500554541026,0,1,0,2,1.248533924843761,1.170500554541026
5519,23,240,53,110,103,0,3406.581,4,777.712,MORE,-1424,2348,924,4,1,-7.0,-0.6561859224721414,7.0,-0.34921514788478913,-1.6517733215618011,-0.4321320850807752,213,110,103,1,1.0570864565366473,1.170500554541026,0.8973837584814532,-0.2951406680504776,-1.0645969552187278,1.0645969552187278,0.8973837584814532,1.170500554541026,0,1,0,2,1.170500554541026,0.8973837584814532
5520,24,1,49,110,131,1,13446.647,20,5350.595,MORE,-1058,6652,5594,9,2,21.0,1.9685577674164243,21.0,2.0952908873087353,-0.19985934851055792,2.960838479639588,241,110,131,0,1.6155472260277064,1.170500554541026,1.9898509427197442,2.0449634977381272,-0.34019440642062315,0.34019440642062315,1.9898509427197442,1.170500554541026,0,1,0,2,1.9898509427197442,1.170500554541026
5521,24,2,13,47,50,1,14524.851,30,3427.743,MORE,232,4474,4706,7,2,3.0,0.28122253820234633,3.0,-1.0476454436543674,0.1838706006297134,3.3272058725166613,97,47,50,0,-1.2565367313548828,-1.2875506099951286,-1.170500554541026,0.9940186595001175,0.8062537075210874,0.8062537075210874,-1.170500554541026,-1.2875506099951286,1,1,1,0,-1.2875506099951286,-1.170500554541026
5522,24,3,16,50,44,0,8482.831,20,3732.861,MORE,-3544,5476,1932,6,1,-6.0,-0.5624450764046927,6.0,-0.5238227218271837,-0.19985934851055792,1.2741629278502216,94,50,44,1,-1.3163718138003533,-1.170500554541026,-1.4046006654492311,0.46854624038111264,-2.549551004295888,2.549551004295888,-1.4046006654492311,-1.170500554541026,1,1,0,0,-1.170500554541026,-1.4046006654492311
5523,24,4,7,57,50,0,7790.2840000000015,10,3185.738,MORE,-682,3494,2812,8,1,-7.0,-0.6561859224721414,7.0,-0.34921514788478913,-0.5835892976508292,1.0388395207446663,107,57,50,1,-1.0570864565366473,-0.8973837584814532,-1.170500554541026,1.5194910786191222,-0.006035886388000574,0.006035886388000574,-1.170500554541026,-0.8973837584814532,0,1,0,0,-0.8973837584814532,-1.170500554541026
5524,24,5,18,42,50,1,8137.083,10,1793.22,MORE,-768,3498,2730,5,1,8.0,0.7499267685395902,8.0,-0.17460757394239454,-0.5835892976508292,1.1566797861140914,92,42,50,0,-1.3562618687640005,-1.4826340357519663,-1.170500554541026,-0.05692617873789222,-0.08246576065078128,0.08246576065078128,-1.170500554541026,-1.4826340357519663,0,0,0,0,-1.4826340357519663,-1.170500554541026
5525,24,6,51,108,110,1,15677.821000000002,30,2110.474,MORE,2856,4416,7272,7,2,2.0,0.18748169213489754,2.0,-1.222253017596762,0.1838706006297134,3.718978313506937,218,108,110,0,1.156811593945765,1.092467184238291,1.170500554541026,0.9940186595001175,3.138253592004071,3.138253592004071,1.170500554541026,1.092467184238291,1,1,1,2,1.170500554541026,1.092467184238291
5526,24,7,31,78,80,1,10911.268999999998,0,1468.47,MORE,2760,3014,5774,7,2,2.0,0.18748169213489754,2.0,-1.222253017596762,-0.9673192467911006,2.0993319114781928,158,78,80,0,-0.03989005496364707,-0.07803337030273506,0.0,0.9940186595001175,3.052936523059571,3.052936523059571,0.0,-0.07803337030273506,0,1,1,1,-0.07803337030273506,0.0
5527,24,8,58,110,92,0,6553.163000000001,20,3809.209,MORE,-1134,3584,2450,5,1,-18.0,-1.6873352292140782,18.0,1.571468165481551,-0.19985934851055792,0.618473063707336,202,110,92,1,0.8376911542365885,1.170500554541026,0.4682002218164104,-0.05692617873789222,-0.4077370860016852,0.4077370860016852,0.4682002218164104,1.170500554541026,1,0,0,2,1.170500554541026,0.4682002218164104
5528,24,9,12,50,48,1,2662.425,40,2407.283,MORE,400,1104,1504,3,2,-2.0,-0.18748169213489754,2.0,-1.222253017596762,0.5676005497699848,-0.7035768799283381,98,50,48,1,-1.2365917038730592,-1.170500554541026,-1.248533924843761,-1.1078710169759018,0.9555585781739614,0.9555585781739614,-1.248533924843761,-1.170500554541026,1,0,1,0,-1.170500554541026,-1.248533924843761
5529,24,10,54,110,101,0,8306.192,0,5436.2469999999985,MORE,-1448,4716,3268,6,1,-9.0,-0.8436676146070391,9.0,0.0,-0.9673192467911006,1.2141420320731573,211,110,101,1,1.0171964015730004,1.170500554541026,0.8193503881787182,0.46854624038111264,-0.686794999007652,0.686794999007652,0.8193503881787182,1.170500554541026,0,1,0,2,1.170500554541026,0.8193503881787182
5530,24,11,14,46,50,1,5601.945,50,4734.375,MORE,-68,2110,2042,5,2,4.0,0.3749633842697951,4.0,-0.8730378697119728,0.951330498910256,0.2952547685445057,96,46,50,0,-1.2764817588367063,-1.3265672951464962,-1.170500554541026,-0.05692617873789222,0.5396378670695268,0.5396378670695268,-1.170500554541026,-1.3265672951464962,1,0,1,0,-1.3265672951464962,-1.170500554541026
5531,24,12,22,80,83,1,6247.111999999999,40,1531.81,MORE,-70,2696,2626,7,2,3.0,0.28122253820234633,3.0,-1.0476454436543674,0.5676005497699848,0.5144787296504953,163,80,83,0,0.05983508244547061,0.0,0.1170500554541026,0.9940186595001175,0.537860428133183,0.537860428133183,0.1170500554541026,0.0,1,1,1,1,0.1170500554541026,0.0
5532,24,13,6,50,56,1,2528.041,60,1798.2020000000002,MORE,564,980,1544,3,2,6.0,0.5624450764046927,6.0,-0.5238227218271837,1.3350604480505277,-0.7492397746350843,106,50,56,0,-1.077031484018471,-1.170500554541026,-0.9364004436328208,-1.1078710169759018,1.101308570954148,1.101308570954148,-0.9364004436328208,-1.170500554541026,1,0,1,0,-1.170500554541026,-0.9364004436328208
5533,24,14,13,50,47,1,14967.924,0,4516.612,MORE,-3240,7636,4396,7,1,-3.0,-0.28122253820234633,3.0,-1.0476454436543674,-0.9673192467911006,3.477759478201878,97,50,47,1,-1.2565367313548828,-1.170500554541026,-1.2875506099951286,0.9940186595001175,-2.2793802859716403,2.2793802859716403,-1.2875506099951286,-1.170500554541026,0,1,0,0,-1.170500554541026,-1.2875506099951286
5534,24,15,46,110,124,1,3203.733,60,2634.894,MORE,840,1024,1864,3,2,14.0,1.3123718449442827,14.0,0.8730378697119728,1.3350604480505277,-0.5196435976334266,234,110,124,0,1.4759320336549415,1.170500554541026,1.7167341466601715,-1.1078710169759018,1.3465951441695836,1.3465951441695836,1.7167341466601715,1.170500554541026,1,0,1,2,1.7167341466601715,1.170500554541026
5535,24,16,27,91,80,0,8905.4,30,2569.943,MORE,-28,3288,3260,8,1,-11.0,-1.0311493067419364,11.0,0.34921514788478913,0.1838706006297134,1.4177493946419155,171,91,80,1,0.21939530230005888,0.4291835366650429,0.0,1.5194910786191222,0.5751866457964014,0.5751866457964014,0.0,0.4291835366650429,1,1,1,1,0.4291835366650429,0.0
5536,24,17,40,64,80,1,15783.087,20,2967.525,MORE,140,5996,6136,8,1,16.0,1.4998535370791803,16.0,1.222253017596762,-0.19985934851055792,3.754747082662493,144,64,80,0,-0.3191204397091766,-0.6242669624218805,0.0,1.5194910786191222,0.7244915164492755,0.7244915164492755,0.0,-0.6242669624218805,1,1,1,1,-0.6242669624218805,0.0
5537,24,18,22,83,80,0,8126.123,0,5612.426,MORE,-1654,5058,3404,6,1,-3.0,-0.28122253820234633,3.0,-1.0476454436543674,-0.9673192467911006,1.1529556424214944,163,83,80,1,0.05983508244547061,0.1170500554541026,0.0,0.46854624038111264,-0.8698712094510569,0.8698712094510569,0.0,0.1170500554541026,0,1,0,1,0.1170500554541026,0.0
5538,24,19,54,101,110,0,11386.066,10,4238.121,MORE,-2590,6396,3806,9,1,9.0,0.8436676146070391,9.0,0.0,-0.5835892976508292,2.2606651462239893,211,101,110,0,1.0171964015730004,0.8193503881787182,1.170500554541026,2.0449634977381272,-1.7017126316599258,1.7017126316599258,1.170500554541026,0.8193503881787182,0,1,0,2,1.170500554541026,0.8193503881787182
5539,24,20,6,56,50,0,4852.127,0,2873.128,MORE,-650,2488,1838,6,1,-6.0,-0.5624450764046927,6.0,-0.5238227218271837,-0.9673192467911006,0.04047101167446898,106,56,50,1,-1.077031484018471,-0.9364004436328208,-1.170500554541026,0.46854624038111264,0.022403136593499223,0.022403136593499223,-1.170500554541026,-0.9364004436328208,0,1,0,0,-0.9364004436328208,-1.170500554541026
5540,24,21,18,50,42,1,11320.057,10,2822.743,MORE,1624,4306,5930,5,1,-8.0,-0.7499267685395902,8.0,-0.17460757394239454,-0.5835892976508292,2.2382356753294057,92,50,42,1,-1.3562618687640005,-1.170500554541026,-1.4826340357519663,-0.05692617873789222,2.0433512072163285,2.0433512072163285,-1.4826340357519663,-1.170500554541026,0,0,1,0,-1.170500554541026,-1.4826340357519663
5541,24,22,43,110,117,1,4958.222,0,2951.687,MORE,512,1620,2132,4,1,7.0,0.6561859224721414,7.0,-0.34921514788478913,-0.9673192467911006,0.0765214701658981,227,110,117,0,1.3363168412821769,1.170500554541026,1.4436173506005987,-0.5823985978568971,1.0550951586092105,1.0550951586092105,1.4436173506005987,1.170500554541026,0,0,1,2,1.4436173506005987,1.170500554541026
5542,24,23,32,77,80,1,5720.845,10,1639.78,MORE,-1378,3252,1874,5,1,3.0,0.28122253820234633,3.0,-1.0476454436543674,-0.5835892976508292,0.33565629090306137,157,77,80,0,-0.05983508244547061,-0.1170500554541026,0.0,-0.05692617873789222,-0.6245846362356211,0.6245846362356211,0.0,-0.1170500554541026,0,1,0,1,-0.1170500554541026,0.0
5543,24,24,27,80,91,1,2867.3190000000004,40,1821.587,MORE,236,1202,1438,3,2,11.0,1.0311493067419364,11.0,0.34921514788478913,0.5676005497699848,-0.6339551009364636,171,80,91,0,0.21939530230005888,0.0,0.4291835366650429,-1.1078710169759018,0.8098085853937748,0.8098085853937748,0.4291835366650429,0.0,1,0,1,1,0.4291835366650429,0.0
5544,24,25,16,44,50,1,12566.805,0,3020.11,MORE,-1448,5884,4436,9,1,6.0,0.5624450764046927,6.0,-0.5238227218271837,-0.9673192467911006,2.6618733304806628,94,44,50,0,-1.3163718138003533,-1.4046006654492311,-1.170500554541026,2.0449634977381272,-0.686794999007652,0.686794999007652,-1.170500554541026,-1.4046006654492311,0,1,0,0,-1.4046006654492311,-1.170500554541026
5545,24,26,7,50,57,1,2622.717,40,3679.167,MORE,758,726,1484,3,2,7.0,0.6561859224721414,7.0,-0.34921514788478913,0.5676005497699848,-0.7170694253430859,107,50,57,0,-1.0570864565366473,-1.170500554541026,-0.8973837584814532,-1.1078710169759018,1.2737201477794904,1.2737201477794904,-0.8973837584814532,-1.170500554541026,1,0,1,0,-1.170500554541026,-0.8973837584814532
5546,24,27,14,50,46,1,3022.98,20,4655.8,MORE,-24,1466,1442,3,1,-4.0,-0.3749633842697951,4.0,-0.8730378697119728,-0.19985934851055792,-0.5810624064717445,96,50,46,1,-1.2764817588367063,-1.170500554541026,-1.3265672951464962,-1.1078710169759018,0.5787415236690889,0.5787415236690889,-1.3265672951464962,-1.170500554541026,0,0,1,0,-1.170500554541026,-1.3265672951464962
5547,24,28,51,110,108,0,5129.2170000000015,30,3493.351,MORE,-792,2300,1508,5,1,-2.0,-0.18748169213489754,2.0,-1.222253017596762,0.1838706006297134,0.13462456785892812,218,110,108,1,1.156811593945765,1.170500554541026,1.092467184238291,-0.05692617873789222,-0.10379502788690612,0.10379502788690612,1.092467184238291,1.170500554541026,1,1,0,2,1.170500554541026,1.092467184238291
5548,24,29,50,133,110,0,6388.74,30,2379.1910000000007,MORE,-1268,3396,2128,6,1,-23.0,-2.1560394595513217,23.0,2.444506035193524,0.1838706006297134,0.562603093053334,243,133,110,1,1.6554372809913533,2.0678843130224793,1.170500554541026,0.46854624038111264,-0.5268254947367156,0.5268254947367156,1.170500554541026,2.0678843130224793,1,1,0,2,2.0678843130224793,1.170500554541026
5549,24,30,49,131,110,0,3102.868,0,1095.955,MORE,-1102,1954,852,4,1,-21.0,-1.9685577674164243,21.0,2.0952908873087353,-0.9673192467911006,-0.5539169328116916,241,131,110,1,1.6155472260277064,1.9898509427197442,1.170500554541026,-0.5823985978568971,-0.37929806302018537,0.37929806302018537,1.170500554541026,1.9898509427197442,0,0,0,2,1.9898509427197442,1.170500554541026
5550,24,31,47,126,110,0,3448.079,40,949.159,MORE,-936,1894,958,3,1,-16.0,-1.4998535370791803,16.0,1.222253017596762,0.5676005497699848,-0.4366162605247335,236,126,110,1,1.5158220886185887,1.7947675169629065,1.170500554541026,-1.1078710169759018,-0.2317706313036552,0.2317706313036552,1.170500554541026,1.7947675169629065,1,0,0,2,1.7947675169629065,1.170500554541026
5551,24,32,50,110,133,1,2074.678,80,1518.0739999999996,MORE,886,826,1712,3,2,23.0,2.1560394595513217,23.0,2.444506035193524,2.10252034633107,-0.9032898619440988,243,110,133,0,1.6554372809913533,1.170500554541026,2.0678843130224793,-1.1078710169759018,1.3874762397054894,1.3874762397054894,2.0678843130224793,1.170500554541026,1,0,1,2,2.0678843130224793,1.170500554541026
5552,24,33,47,110,126,1,2311.138,90,1805.526,MORE,770,930,1700,3,2,16.0,1.4998535370791803,16.0,1.222253017596762,2.486250295471341,-0.8229421413645862,236,110,126,0,1.5158220886185887,1.170500554541026,1.7947675169629065,-1.1078710169759018,1.2843847813975526,1.2843847813975526,1.7947675169629065,1.170500554541026,1,0,1,2,1.7947675169629065,1.170500554541026
5553,24,34,12,48,50,0,20040.576,0,3427.42,MORE,-1306,9438,8132,15,1,2.0,0.18748169213489754,2.0,-1.222253017596762,-0.9673192467911006,5.201416864199955,98,48,50,0,-1.2365917038730592,-1.248533924843761,-1.170500554541026,5.1977980124521554,-0.5605968345272466,0.5605968345272466,-1.170500554541026,-1.248533924843761,0,1,0,0,-1.248533924843761,-1.170500554541026
5554,24,35,32,80,77,1,14313.706,0,2978.413,MORE,5534,2498,8032,7,1,-3.0,-0.28122253820234633,3.0,-1.0476454436543674,-0.9673192467911006,3.255460040402302,157,80,77,1,-0.05983508244547061,0.0,-0.1170500554541026,0.9940186595001175,5.518244327768334,5.518244327768334,-0.1170500554541026,0.0,0,1,1,1,0.0,-0.1170500554541026
5555,24,36,43,117,110,1,2068.984,50,1508.422,MORE,358,642,1000,3,2,-7.0,-0.6561859224721414,7.0,-0.34921514788478913,0.951330498910256,-0.90522464973476,227,117,110,1,1.3363168412821769,1.4436173506005987,1.170500554541026,-1.1078710169759018,0.9182323605107429,0.9182323605107429,1.170500554541026,1.4436173506005987,1,0,1,2,1.4436173506005987,1.170500554541026
5556,24,37,40,80,64,0,6688.0340000000015,20,3544.485,MORE,-888,3628,2740,5,1,-16.0,-1.4998535370791803,16.0,1.222253017596762,-0.19985934851055792,0.6643014381566275,144,80,64,1,-0.3191204397091766,0.0,-0.6242669624218805,-0.05692617873789222,-0.1891120968314055,0.1891120968314055,-0.6242669624218805,0.0,1,1,0,1,0.0,-0.6242669624218805
5557,24,38,31,80,78,1,3621.703,40,1961.768,MORE,152,1588,1740,5,2,-2.0,-0.18748169213489754,2.0,-1.222253017596762,0.5676005497699848,-0.3776198440572665,158,80,78,1,-0.03989005496364707,0.0,-0.07803337030273506,-0.05692617873789222,0.7351561500673378,0.7351561500673378,-0.07803337030273506,0.0,1,1,1,1,0.0,-0.07803337030273506
5558,24,39,46,124,110,0,4192.496,30,4244.525,MORE,-258,1780,1522,2,1,-14.0,-1.3123718449442827,14.0,0.8730378697119728,0.1838706006297134,-0.18366773176452472,234,124,110,1,1.4759320336549415,1.7167341466601715,1.170500554541026,-1.6333434360949068,0.37078116811687173,0.37078116811687173,1.170500554541026,1.7167341466601715,1,0,1,2,1.7167341466601715,1.170500554541026
5559,24,40,58,92,110,1,1830.987,60,2064.407,MORE,316,804,1120,3,2,18.0,1.6873352292140782,18.0,1.571468165481551,1.3350604480505277,-0.9860946338959806,202,92,110,0,0.8376911542365885,0.4682002218164104,1.170500554541026,-1.1078710169759018,0.8809061428475243,0.8809061428475243,1.170500554541026,0.4682002218164104,1,0,1,2,1.170500554541026,0.4682002218164104
5560,24,41,49,110,131,0,3575.375,40,2381.365,LESS,-880,1716,836,4,1,21.0,1.9685577674164243,21.0,2.0952908873087353,0.5676005497699848,-0.3933618266294041,241,110,131,1,1.6155472260277064,1.170500554541026,1.9898509427197442,-0.5823985978568971,-0.18200234108603056,0.18200234108603056,1.9898509427197442,1.170500554541026,1,0,0,2,1.9898509427197442,1.170500554541026
5561,24,42,13,47,50,0,5646.496,0,1345.055,LESS,-1358,3258,1900,6,1,3.0,0.28122253820234633,3.0,-1.0476454436543674,-0.9673192467911006,0.3103929369431265,97,47,50,1,-1.2565367313548828,-1.2875506099951286,-1.170500554541026,0.46854624038111264,-0.6068102468721838,0.6068102468721838,-1.170500554541026,-1.2875506099951286,0,1,0,0,-1.2875506099951286,-1.170500554541026
5562,24,43,16,50,44,1,3149.933,50,1569.481,LESS,210,1212,1422,4,1,-6.0,-0.5624450764046927,6.0,-0.5238227218271837,0.951330498910256,-0.5379245219638749,94,50,44,0,-1.3163718138003533,-1.170500554541026,-1.4046006654492311,-0.5823985978568971,0.7867018792213062,0.7867018792213062,-1.4046006654492311,-1.170500554541026,1,0,1,0,-1.170500554541026,-1.4046006654492311
5563,24,44,7,57,50,1,5463.962,0,2125.042,LESS,-1000,3480,2480,7,1,-7.0,-0.6561859224721414,7.0,-0.34921514788478913,-0.9673192467911006,0.24836895475476184,107,57,50,0,-1.0570864565366473,-0.8973837584814532,-1.170500554541026,0.9940186595001175,-0.2886486772666548,0.2886486772666548,-1.170500554541026,-0.8973837584814532,0,1,0,0,-0.8973837584814532,-1.170500554541026
5564,24,45,18,42,50,0,2460.966,80,1784.521,LESS,-448,1094,646,4,1,8.0,0.7499267685395902,8.0,-0.17460757394239454,2.10252034633107,-0.7720314660749508,92,42,50,1,-1.3562618687640005,-1.4826340357519663,-1.170500554541026,-0.5823985978568971,0.2019244691642167,0.2019244691642167,-1.170500554541026,-1.4826340357519663,1,0,1,0,-1.4826340357519663,-1.170500554541026
5565,24,46,51,108,110,0,5548.303000000001,10,2214.411,LESS,-1310,3316,2006,6,1,2.0,0.18748169213489754,2.0,-1.222253017596762,-0.5835892976508292,0.27702753168699856,218,108,110,1,1.156811593945765,1.092467184238291,1.170500554541026,0.46854624038111264,-0.564151712399934,0.564151712399934,1.170500554541026,1.092467184238291,0,1,0,2,1.170500554541026,1.092467184238291
5566,24,47,31,78,80,0,4746.828,0,2865.5890000000004,LESS,-2778,4230,1452,6,1,2.0,0.18748169213489754,2.0,-1.222253017596762,-0.9673192467911006,0.004691029312538473,158,78,80,1,-0.03989005496364707,-0.07803337030273506,0.0,0.46854624038111264,-1.8687918916762372,1.8687918916762372,0.0,-0.07803337030273506,0,1,0,1,-0.07803337030273506,0.0
5567,24,48,58,110,92,1,3859.959,0,863.548,LESS,80,1828,1908,5,1,-18.0,-1.6873352292140782,18.0,1.571468165481551,-0.9673192467911006,-0.2966618532157189,202,110,92,0,0.8376911542365885,1.170500554541026,0.4682002218164104,-0.05692617873789222,0.6711683483589633,0.6711683483589633,0.4682002218164104,1.170500554541026,0,1,1,2,1.170500554541026,0.4682002218164104
5568,24,49,12,50,48,1,2762.601,30,2774.9440000000004,LESS,802,762,1564,4,1,-2.0,-0.18748169213489754,2.0,-1.222253017596762,0.1838706006297134,-0.6695376629073906,98,50,48,0,-1.2365917038730592,-1.170500554541026,-1.248533924843761,-0.5823985978568971,1.3128238043790526,1.3128238043790526,-1.248533924843761,-1.170500554541026,1,0,1,0,-1.170500554541026,-1.248533924843761
5569,24,50,54,110,101,1,7154.855,0,2744.5840000000007,LESS,-1994,4138,2144,7,1,-9.0,-0.8436676146070391,9.0,0.0,-0.9673192467911006,0.8229244749013135,211,110,101,0,1.0171964015730004,1.170500554541026,0.8193503881787182,0.9940186595001175,-1.172035828629492,1.172035828629492,0.8193503881787182,1.170500554541026,0,1,0,2,1.170500554541026,0.8193503881787182
5570,24,51,14,46,50,0,2105.4410000000007,80,2973.308,LESS,-62,1152,1090,2,2,4.0,0.3749633842697951,4.0,-0.8730378697119728,2.10252034633107,-0.8928367750448871,96,46,50,1,-1.2764817588367063,-1.3265672951464962,-1.170500554541026,-1.6333434360949068,0.544970183878558,0.544970183878558,-1.170500554541026,-1.3265672951464962,1,0,1,0,-1.3265672951464962,-1.170500554541026
5571,24,52,22,80,83,0,3839.659,30,1441.33,LESS,-596,1628,1032,6,1,3.0,0.28122253820234633,3.0,-1.0476454436543674,0.1838706006297134,-0.30355967410620394,163,80,83,1,0.05983508244547061,0.0,0.1170500554541026,0.46854624038111264,0.07039398787478013,0.07039398787478013,0.1170500554541026,0.0,1,1,1,1,0.1170500554541026,0.0
5572,24,53,6,50,56,0,2483.443,100,1586.16,LESS,-112,1370,1258,5,1,6.0,0.5624450764046927,6.0,-0.5238227218271837,2.8699802446116127,-0.7643939133579343,106,50,56,1,-1.077031484018471,-1.170500554541026,-0.9364004436328208,-0.05692617873789222,0.5005342104699645,0.5005342104699645,-0.9364004436328208,-1.170500554541026,1,1,1,0,-1.170500554541026,-0.9364004436328208
5573,24,54,13,50,47,0,6981.949000000001,0,2212.989,LESS,-1394,4382,2988,8,1,-3.0,-0.28122253820234633,3.0,-1.0476454436543674,-0.9673192467911006,0.764172030621008,97,50,47,0,-1.2565367313548828,-1.170500554541026,-1.2875506099951286,1.5194910786191222,-0.6388041477263711,0.6388041477263711,-1.2875506099951286,-1.170500554541026,0,1,0,0,-1.170500554541026,-1.2875506099951286
5574,24,55,46,110,124,0,7100.686,0,1974.016,LESS,-1142,3820,2678,6,1,14.0,1.3123718449442827,14.0,0.8730378697119728,-0.9673192467911006,0.8045181665359595,234,110,124,1,1.4759320336549415,1.170500554541026,1.7167341466601715,0.46854624038111264,-0.41484684174706016,0.41484684174706016,1.7167341466601715,1.170500554541026,0,1,0,2,1.7167341466601715,1.170500554541026
5575,24,56,27,91,80,0,5496.885,0,1549.602,LESS,-1222,3326,2104,4,1,-11.0,-1.0311493067419364,11.0,0.34921514788478913,-0.9673192467911006,0.25955599698025145,171,91,80,0,0.21939530230005888,0.4291835366650429,0.0,-0.5823985978568971,-0.4859443992008096,0.4859443992008096,0.0,0.4291835366650429,0,0,0,1,0.4291835366650429,0.0
5576,24,57,40,64,80,0,3532.508,40,2531.541,LESS,-388,1760,1372,4,1,16.0,1.4998535370791803,16.0,1.222253017596762,0.5676005497699848,-0.40792778170883387,144,64,80,1,-0.3191204397091766,-0.6242669624218805,0.0,-0.5823985978568971,0.2552476372545288,0.2552476372545288,0.0,-0.6242669624218805,1,0,1,1,-0.6242669624218805,0.0
5577,24,58,22,83,80,0,2654.093,20,2880.366,LESS,-1130,2216,1086,4,1,-3.0,-0.28122253820234633,3.0,-1.0476454436543674,-0.19985934851055792,-0.7064080446406299,163,83,80,0,0.05983508244547061,0.1170500554541026,0.0,-0.5823985978568971,-0.4041822081289977,0.4041822081289977,0.0,0.1170500554541026,1,0,0,1,0.1170500554541026,0.0
5578,24,59,54,101,110,0,4357.117,10,2864.7209999999995,LESS,-2310,3814,1504,6,1,9.0,0.8436676146070391,9.0,0.0,-0.5835892976508292,-0.12773048187228106,211,101,110,1,1.0171964015730004,0.8193503881787182,1.170500554541026,0.46854624038111264,-1.4528711805718026,1.4528711805718026,1.170500554541026,0.8193503881787182,0,1,0,2,1.170500554541026,0.8193503881787182
5579,24,60,6,56,50,0,3053.903,30,2492.92,LESS,-458,1644,1186,4,1,-6.0,-0.5624450764046927,6.0,-0.5238227218271837,0.1838706006297134,-0.5705549525113273,106,56,50,0,-1.077031484018471,-0.9364004436328208,-1.170500554541026,-0.5823985978568971,0.193037274482498,0.193037274482498,-1.170500554541026,-0.9364004436328208,1,0,1,0,-0.9364004436328208,-1.170500554541026
5580,24,61,18,50,42,1,4775.43,40,2163.8160000000007,LESS,728,1816,2544,5,2,-8.0,-0.7499267685395902,8.0,-0.17460757394239454,0.5676005497699848,0.014409821091339144,92,50,42,0,-1.3562618687640005,-1.170500554541026,-1.4826340357519663,-0.05692617873789222,1.2470585637343343,1.2470585637343343,-1.4826340357519663,-1.170500554541026,1,1,1,0,-1.170500554541026,-1.4826340357519663
5581,24,62,43,110,117,0,7036.495,30,2335.836,LESS,-2458,4512,2054,6,1,7.0,0.6561859224721414,7.0,-0.34921514788478913,0.1838706006297134,0.7827064413743277,227,110,117,1,1.3363168412821769,1.170500554541026,1.4436173506005987,0.46854624038111264,-1.584401661861239,1.584401661861239,1.4436173506005987,1.170500554541026,1,1,0,2,1.4436173506005987,1.170500554541026
5582,24,63,32,77,80,0,6367.576999999998,10,1652.507,LESS,-488,3724,3236,6,1,3.0,0.28122253820234633,3.0,-1.0476454436543674,-0.5835892976508292,0.5554120298264698,157,77,80,1,-0.05983508244547061,-0.1170500554541026,0.0,0.46854624038111264,0.16637569043734193,0.16637569043734193,0.0,-0.1170500554541026,0,1,1,1,-0.1170500554541026,0.0
5583,24,64,27,80,91,0,4314.791,0,1326.3010000000004,LESS,-1054,2916,1862,4,1,11.0,1.0311493067419364,11.0,0.34921514788478913,-0.9673192467911006,-0.14211260832600875,171,80,91,1,0.21939530230005888,0.0,0.4291835366650429,-0.5823985978568971,-0.3366395285479357,0.3366395285479357,0.4291835366650429,0.0,0,0,0,1,0.4291835366650429,0.0
5584,24,65,16,44,50,0,2763.048,70,1524.106,LESS,-144,1540,1396,4,2,6.0,0.5624450764046927,6.0,-0.5238227218271837,1.7187903971907987,-0.6693857749301471,94,44,50,1,-1.3163718138003533,-1.4046006654492311,-1.170500554541026,-0.5823985978568971,0.47209518748846474,0.47209518748846474,-1.170500554541026,-1.4046006654492311,1,0,1,0,-1.4046006654492311,-1.170500554541026
5585,24,66,7,50,57,0,4439.563,20,2774.312,LESS,-1298,3102,1804,6,1,7.0,0.6561859224721414,7.0,-0.34921514788478913,-0.19985934851055792,-0.0997158148212006,107,50,57,1,-1.0570864565366473,-1.170500554541026,-0.8973837584814532,0.46854624038111264,-0.5534870787818716,0.5534870787818716,-0.8973837584814532,-1.170500554541026,1,1,0,0,-1.170500554541026,-0.8973837584814532
5586,24,67,14,50,46,0,2591.437,0,1743.595,LESS,-1358,2034,676,4,1,-4.0,-0.3749633842697951,4.0,-0.8730378697119728,-0.9673192467911006,-0.7276981858088187,96,50,46,0,-1.2764817588367063,-1.170500554541026,-1.3265672951464962,-0.5823985978568971,-0.6068102468721838,0.6068102468721838,-1.3265672951464962,-1.170500554541026,0,0,0,0,-1.170500554541026,-1.3265672951464962
5587,24,68,51,110,108,0,3184.332000000001,0,2541.249,LESS,-978,1966,988,4,1,-2.0,-0.18748169213489754,2.0,-1.222253017596762,-0.9673192467911006,-0.5262359435987615,218,110,108,0,1.156811593945765,1.170500554541026,1.092467184238291,-0.5823985978568971,-0.2690968489668737,0.2690968489668737,1.092467184238291,1.170500554541026,0,0,0,2,1.170500554541026,1.092467184238291
5588,24,69,50,133,110,1,2982.399000000001,0,3712.21,LESS,-274,1782,1508,5,1,-23.0,-2.1560394595513217,23.0,2.444506035193524,-0.9673192467911006,-0.5948515921641963,243,133,110,0,1.6554372809913533,2.0678843130224793,1.170500554541026,-0.05692617873789222,0.3565616566261218,0.3565616566261218,1.170500554541026,2.0678843130224793,0,1,1,2,2.0678843130224793,1.170500554541026
5589,24,70,49,131,110,0,4431.708,0,2967.913,LESS,-2144,3882,1738,6,1,-21.0,-1.9685577674164243,21.0,2.0952908873087353,-0.9673192467911006,-0.1023848977322727,241,131,110,0,1.6155472260277064,1.9898509427197442,1.170500554541026,0.46854624038111264,-1.3053437488552724,1.3053437488552724,1.170500554541026,1.9898509427197442,0,1,0,2,1.9898509427197442,1.170500554541026
5590,24,71,47,126,110,1,2305.433,20,867.9839999999998,LESS,470,986,1456,3,2,-16.0,-1.4998535370791803,16.0,1.222253017596762,-0.19985934851055792,-0.8248806668907053,236,126,110,0,1.5158220886185887,1.7947675169629065,1.170500554541026,-1.1078710169759018,1.0177689409459922,1.0177689409459922,1.170500554541026,1.7947675169629065,1,0,1,2,1.7947675169629065,1.170500554541026
5591,24,72,50,110,133,0,5890.691999999999,20,2719.748,LESS,-2440,4696,2256,8,1,23.0,2.1560394595513217,23.0,2.444506035193524,-0.19985934851055792,0.3933693049319388,243,110,133,1,1.6554372809913533,1.170500554541026,2.0678843130224793,1.5194910786191222,-1.5684047114341455,1.5684047114341455,2.0678843130224793,1.170500554541026,1,1,0,2,2.0678843130224793,1.170500554541026
5592,24,73,47,110,126,0,2753.98,20,1592.223,LESS,-546,1624,1078,4,1,16.0,1.4998535370791803,16.0,1.222253017596762,-0.19985934851055792,-0.6724670281239853,236,110,126,1,1.5158220886185887,1.170500554541026,1.7947675169629065,-0.5823985978568971,0.11482996128337356,0.11482996128337356,1.7947675169629065,1.170500554541026,1,0,1,2,1.7947675169629065,1.170500554541026
5593,24,74,12,48,50,0,1711.785,60,2207.891,LESS,-558,1118,560,2,1,2.0,0.18748169213489754,2.0,-1.222253017596762,1.3350604480505277,-1.0265987740825622,98,48,50,1,-1.2365917038730592,-1.248533924843761,-1.170500554541026,-1.6333434360949068,0.10416532766531113,0.10416532766531113,-1.170500554541026,-1.248533924843761,1,0,1,0,-1.248533924843761,-1.170500554541026
5594,24,75,32,80,77,0,5420.205,0,2754.042,LESS,-898,3276,2378,6,1,-3.0,-0.28122253820234633,3.0,-1.0476454436543674,-0.9673192467911006,0.23350058289737466,157,80,77,0,-0.05983508244547061,0.0,-0.1170500554541026,0.46854624038111264,-0.1979992915131242,0.1979992915131242,-0.1170500554541026,0.0,0,1,0,1,0.0,-0.1170500554541026
5595,24,76,43,117,110,0,2595.165,0,2544.66,LESS,-870,1790,920,4,1,-7.0,-0.6561859224721414,7.0,-0.34921514788478913,-0.9673192467911006,-0.7264314332827237,227,117,110,0,1.3363168412821769,1.4436173506005987,1.170500554541026,-0.5823985978568971,-0.17311514640431186,0.17311514640431186,1.170500554541026,1.4436173506005987,0,0,0,2,1.4436173506005987,1.170500554541026
5596,24,77,40,80,64,1,3789.701,0,2876.4240000000004,LESS,-774,2696,1922,5,1,-16.0,-1.4998535370791803,16.0,1.222253017596762,-0.9673192467911006,-0.320535109379448,144,80,64,0,-0.3191204397091766,0.0,-0.6242669624218805,-0.05692617873789222,-0.08779807745981248,0.08779807745981248,-0.6242669624218805,0.0,0,1,1,1,0.0,-0.6242669624218805
5597,24,78,31,80,78,0,5070.969,20,1852.177,LESS,-1286,2986,1700,6,1,-2.0,-0.18748169213489754,2.0,-1.222253017596762,-0.19985934851055792,0.1148322392269584,158,80,78,0,-0.03989005496364707,0.0,-0.07803337030273506,0.46854624038111264,-0.5428224451638092,0.5428224451638092,-0.07803337030273506,0.0,1,1,0,1,0.0,-0.07803337030273506
5598,24,79,46,124,110,0,2740.984000000001,30,1631.106,LESS,-742,1660,918,4,1,-14.0,-1.3123718449442827,14.0,0.8730378697119728,0.1838706006297134,-0.6768829926704256,234,124,110,0,1.4759320336549415,1.7167341466601715,1.170500554541026,-0.5823985978568971,-0.05935905447831269,0.05935905447831269,1.170500554541026,1.7167341466601715,1,0,1,2,1.7167341466601715,1.170500554541026
5599,24,80,58,92,110,0,2481.574,40,2935.166,LESS,-688,1550,862,4,1,18.0,1.6873352292140782,18.0,1.571468165481551,0.5676005497699848,-0.7650289885916445,202,92,110,1,0.8376911542365885,0.4682002218164104,1.170500554541026,-0.5823985978568971,-0.011368203197031785,0.011368203197031785,1.170500554541026,0.4682002218164104,1,0,1,2,1.170500554541026,0.4682002218164104
5600,24,81,48,128,110,1,4405.112,10,1888.833,MORE,-1026,2684,1658,5,1,-18.0,-1.6873352292140782,18.0,1.571468165481551,-0.5835892976508292,-0.11142206248120563,238,128,110,1,1.5557121435822359,1.8728008872656416,1.170500554541026,-0.05692617873789222,-0.31175538343912335,0.31175538343912335,1.170500554541026,1.8728008872656416,0,1,0,2,1.8728008872656416,1.170500554541026
5601,24,82,8,50,58,1,5138.55,40,3215.59,MORE,-942,2602,1660,6,1,8.0,0.7499267685395902,8.0,-0.17460757394239454,0.5676005497699848,0.13779586649788814,108,50,58,0,-1.0371414290548238,-1.170500554541026,-0.8583670733300858,0.46854624038111264,-0.23710294811268642,0.23710294811268642,-0.8583670733300858,-1.170500554541026,1,1,0,0,-1.170500554541026,-0.8583670733300858
5602,24,83,4,54,50,0,4855.218,20,2589.159,MORE,-2696,4312,1616,4,1,-4.0,-0.3749633842697951,4.0,-0.8730378697119728,-0.19985934851055792,0.04152131533813822,104,54,50,1,-1.116921538982118,-1.0144338139355558,-1.170500554541026,-0.5823985978568971,-1.7959168952861437,1.7959168952861437,-1.170500554541026,-1.0144338139355558,1,0,0,0,-1.0144338139355558,-1.170500554541026
5603,24,84,37,80,69,0,5766.951999999998,30,2169.53,MORE,-508,2820,2312,6,1,-11.0,-1.0311493067419364,11.0,0.34921514788478913,0.1838706006297134,0.35132317897190785,149,80,69,1,-0.21939530230005888,0.0,-0.4291835366650429,0.46854624038111264,0.14860130107390457,0.14860130107390457,-0.4291835366650429,0.0,1,1,0,1,0.0,-0.4291835366650429
5604,24,85,52,105,110,1,2587.378,80,1096.075,MORE,1062,898,1960,3,2,5.0,0.4687042303372438,5.0,-0.6984302957695783,2.10252034633107,-0.7290774101927832,215,105,110,0,1.0969765115002945,0.9754171287841883,1.170500554541026,-1.1078710169759018,1.5438908661037383,1.5438908661037383,1.170500554541026,0.9754171287841883,1,0,1,2,1.170500554541026,0.9754171287841883
5605,24,86,5,55,50,1,1895.944,100,846.46,MORE,810,788,1598,3,2,-5.0,-0.4687042303372438,5.0,-0.6984302957695783,2.8699802446116127,-0.9640226264288259,105,55,50,1,-1.0969765115002945,-0.9754171287841883,-1.170500554541026,-1.1078710169759018,1.3199335601244275,1.3199335601244275,-1.170500554541026,-0.9754171287841883,1,0,1,0,-0.9754171287841883,-1.170500554541026
5606,24,87,30,96,80,0,2777.171,60,1324.854,MORE,-478,1578,1100,4,1,-16.0,-1.4998535370791803,16.0,1.222253017596762,1.3350604480505277,-0.6645868623963381,176,96,80,1,0.3191204397091766,0.6242669624218805,0.0,-0.5823985978568971,0.17526288511906063,0.17526288511906063,0.0,0.6242669624218805,1,0,0,1,0.6242669624218805,0.0
5607,24,88,33,80,75,0,5402.038000000001,50,2284.527,MORE,-1142,3448,2306,8,1,-5.0,-0.4687042303372438,5.0,-0.6984302957695783,0.951330498910256,0.22732754289158985,155,80,75,1,-0.09972513740911768,0.0,-0.19508342575683765,1.5194910786191222,-0.41484684174706016,0.41484684174706016,-0.19508342575683765,0.0,1,1,0,1,0.0,-0.19508342575683765
5608,24,89,48,110,128,1,3141.014,80,2297.369,MORE,1118,1300,2418,3,2,18.0,1.6873352292140782,18.0,1.571468165481551,2.10252034633107,-0.5409551458319652,238,110,128,0,1.5557121435822359,1.170500554541026,1.8728008872656416,-1.1078710169759018,1.593659156321363,1.593659156321363,1.8728008872656416,1.170500554541026,1,0,1,2,1.8728008872656416,1.170500554541026
5609,24,90,9,59,50,0,4355.044,10,2253.746,MORE,-2158,3796,1638,6,1,-9.0,-0.8436676146070391,9.0,0.0,-0.5835892976508292,-0.12843487510902873,109,59,50,1,-1.0171964015730004,-0.8193503881787182,-1.170500554541026,0.46854624038111264,-1.3177858214096785,1.3177858214096785,-1.170500554541026,-0.8193503881787182,0,1,0,0,-0.8193503881787182,-1.170500554541026
5610,24,91,44,110,119,1,2043.082,60,1686.537,MORE,266,932,1198,3,2,9.0,0.8436676146070391,9.0,0.0,1.3350604480505277,-0.9140259973557128,229,110,119,0,1.376206896245824,1.170500554541026,1.5216507209033339,-1.1078710169759018,0.8364701694389308,0.8364701694389308,1.5216507209033339,1.170500554541026,1,0,1,2,1.5216507209033339,1.170500554541026
5611,24,92,2,52,50,0,4459.518,30,1419.662,MORE,-366,2186,1820,6,1,-2.0,-0.18748169213489754,2.0,-1.222253017596762,0.1838706006297134,-0.09293522290644053,102,52,50,1,-1.156811593945765,-1.092467184238291,-1.170500554541026,0.46854624038111264,0.2747994655543099,0.2747994655543099,-1.170500554541026,-1.092467184238291,1,1,1,0,-1.092467184238291,-1.170500554541026
5612,24,93,8,58,50,0,5189.438,20,1421.168,MORE,-1528,3200,1672,4,1,-8.0,-0.7499267685395902,8.0,-0.17460757394239454,-0.19985934851055792,0.15508731031439085,108,58,50,1,-1.0371414290548238,-0.8583670733300858,-1.170500554541026,-0.5823985978568971,-0.7578925564614014,0.7578925564614014,-1.170500554541026,-0.8583670733300858,0,0,0,0,-0.8583670733300858,-1.170500554541026
5613,24,94,44,119,110,0,4414.155,30,3190.038,MORE,32,1970,2002,4,1,-9.0,-0.8436676146070391,9.0,0.0,0.1838706006297134,-0.1083493041406808,229,119,110,1,1.376206896245824,1.5216507209033339,1.170500554541026,-0.5823985978568971,0.6285098138867136,0.6285098138867136,1.170500554541026,1.5216507209033339,1,0,1,2,1.5216507209033339,1.170500554541026
5614,24,95,34,74,80,1,3179.9,70,2419.188,MORE,30,1458,1488,5,2,6.0,0.5624450764046927,6.0,-0.5238227218271837,1.7187903971907987,-0.5277419111941621,154,74,80,0,-0.11967016489094122,-0.2341001109082052,0.0,-0.05692617873789222,0.6267323749503698,0.6267323749503698,0.0,-0.2341001109082052,1,1,1,1,-0.2341001109082052,0.0
5615,24,96,24,86,80,1,7117.9969999999985,20,1759.338,MORE,-2232,4586,2354,7,1,-6.0,-0.5624450764046927,6.0,-0.5238227218271837,-0.19985934851055792,0.8104003427642935,166,86,80,1,0.11967016489094122,0.2341001109082052,0.0,0.9940186595001175,-1.3835510620543967,1.3835510620543967,0.0,0.2341001109082052,1,1,0,1,0.2341001109082052,0.0
5616,24,97,39,66,80,1,8100.37,10,3546.035,MORE,-3106,5476,2370,6,1,14.0,1.3123718449442827,14.0,0.8730378697119728,-0.5835892976508292,1.1442049241262895,146,66,80,0,-0.2792303847455295,-0.5462335921191455,0.0,0.46854624038111264,-2.16029187723661,2.16029187723661,0.0,-0.5462335921191455,0,1,0,1,-0.5462335921191455,0.0
5617,24,98,9,50,59,1,10991.32,0,3002.3720000000008,MORE,-2536,5016,2480,8,1,9.0,0.8436676146070391,9.0,0.0,-0.9673192467911006,2.1265327715818496,109,50,59,0,-1.0171964015730004,-1.170500554541026,-0.8193503881787182,1.5194910786191222,-1.6537217803786448,1.6537217803786448,-0.8193503881787182,-1.170500554541026,0,1,0,0,-1.170500554541026,-0.8193503881787182
5618,24,99,57,94,110,1,3808.033,0,1670.156,MORE,-634,2328,1694,5,1,16.0,1.4998535370791803,16.0,1.222253017596762,-0.9673192467911006,-0.3143060033417942,204,94,110,0,0.8775812092002355,0.5462335921191455,1.170500554541026,-0.05692617873789222,0.03662264808424912,0.03662264808424912,1.170500554541026,0.5462335921191455,0,1,0,2,1.170500554541026,0.5462335921191455
5619,24,100,60,110,87,0,3128.206,20,3028.859000000001,MORE,-1406,2486,1080,4,1,-23.0,-2.1560394595513217,23.0,2.444506035193524,-0.19985934851055792,-0.5453072290814891,197,110,87,1,0.7379660168274708,1.170500554541026,0.27311679605957273,-0.5823985978568971,-0.6494687813444334,0.6494687813444334,0.27311679605957273,1.170500554541026,0,0,0,2,1.170500554541026,0.27311679605957273
5620,24,101,33,75,80,0,7991.005,0,1573.648,MORE,-2852,5106,2254,8,1,5.0,0.4687042303372438,5.0,-0.6984302957695783,-0.9673192467911006,1.1070433388214669,155,75,80,0,-0.09972513740911768,-0.19508342575683765,0.0,1.5194910786191222,-1.9345571323209554,1.9345571323209554,0.0,-0.19508342575683765,0,1,0,1,-0.19508342575683765,0.0
5621,24,102,15,50,45,0,4034.818,10,3440.187,MORE,-3142,4490,1348,4,1,-5.0,-0.4687042303372438,5.0,-0.6984302957695783,-0.5835892976508292,-0.2372457909945694,95,50,45,1,-1.2964267863185297,-1.170500554541026,-1.3655839802978638,-0.5823985978568971,-2.192285778090797,2.192285778090797,-1.3655839802978638,-1.170500554541026,0,0,0,0,-1.170500554541026,-1.3655839802978638
5622,24,103,59,89,110,1,2980.009,80,1628.3929999999998,MORE,700,1358,2058,3,2,21.0,1.9685577674164243,21.0,2.0952908873087353,2.10252034633107,-0.5956637001409579,199,89,110,0,0.7778560717911179,0.3511501663623078,1.170500554541026,-1.1078710169759018,1.222174418625522,1.222174418625522,1.170500554541026,0.3511501663623078,1,0,1,2,1.170500554541026,0.3511501663623078
5623,24,104,29,80,94,1,4047.436,60,1455.4,MORE,-278,1930,1652,5,2,14.0,1.3123718449442827,14.0,0.8730378697119728,1.3350604480505277,-0.23295826863022756,174,80,94,0,0.2792303847455295,0.0,0.5462335921191455,-0.05692617873789222,0.35300677875343434,0.35300677875343434,0.5462335921191455,0.0,1,0,1,1,0.5462335921191455,0.0
5624,24,105,55,110,98,0,5109.372,30,1859.247,MORE,-964,3006,2042,6,1,-12.0,-1.124890152809385,12.0,0.5238227218271837,0.1838706006297134,0.1278813532987466,208,110,98,1,0.9573613191275298,1.170500554541026,0.7023003327246156,0.46854624038111264,-0.25665477641246753,0.25665477641246753,0.7023003327246156,1.170500554541026,1,1,0,2,1.170500554541026,0.7023003327246156
5625,24,106,29,94,80,0,8951.546999999999,10,2415.34,MORE,-4806,6960,2154,8,1,-14.0,-1.3123718449442827,14.0,0.8730378697119728,-0.5835892976508292,1.4334298744760638,174,94,80,1,0.2792303847455295,0.5462335921191455,0.0,1.5194910786191222,-3.671114973128787,3.671114973128787,0.0,0.5462335921191455,0,1,0,1,0.5462335921191455,0.0
5626,24,107,57,110,94,0,10596.642,0,3918.82,MORE,-1514,4942,3428,10,1,-16.0,-1.4998535370791803,16.0,1.222253017596762,-0.9673192467911006,1.992423502940723,204,110,94,1,0.8775812092002355,1.170500554541026,0.5462335921191455,2.570435916857132,-0.7454504839069952,0.7454504839069952,0.5462335921191455,1.170500554541026,0,1,0,2,1.170500554541026,0.5462335921191455
5627,24,108,39,80,66,0,8235.019,20,1996.269,MORE,456,3770,4226,8,1,-14.0,-1.3123718449442827,14.0,0.8730378697119728,-0.19985934851055792,1.189957864278158,146,80,66,1,-0.2792303847455295,0.0,-0.5462335921191455,1.5194910786191222,1.005326868391586,1.005326868391586,-0.5462335921191455,0.0,0,1,1,1,0.0,-0.5462335921191455
5628,24,109,4,50,54,1,3631.516,10,2881.978,MORE,-892,2614,1722,5,1,4.0,0.3749633842697951,4.0,-0.8730378697119728,-0.5835892976508292,-0.37428544423468857,104,50,54,0,-1.116921538982118,-1.170500554541026,-1.0144338139355558,-0.05692617873789222,-0.19266697470409297,0.19266697470409297,-1.0144338139355558,-1.170500554541026,0,0,0,0,-1.170500554541026,-1.0144338139355558
5629,24,110,55,98,110,1,5048.949000000001,30,2004.592,MORE,198,2478,2676,6,1,12.0,1.124890152809385,12.0,0.5238227218271837,0.1838706006297134,0.10734997242851152,208,98,110,0,0.9573613191275298,0.7023003327246156,1.170500554541026,0.46854624038111264,0.7760372456032438,0.7760372456032438,1.170500554541026,0.7023003327246156,1,1,1,2,1.170500554541026,0.7023003327246156
5630,24,111,2,50,52,1,4187.9209999999985,30,2995.794000000001,MORE,556,1846,2402,5,1,2.0,0.18748169213489754,2.0,-1.222253017596762,0.1838706006297134,-0.18522228992087847,102,50,52,0,-1.156811593945765,-1.170500554541026,-1.092467184238291,-0.05692617873789222,1.094198815208773,1.094198815208773,-1.092467184238291,-1.170500554541026,1,0,1,0,-1.170500554541026,-1.092467184238291
5631,24,112,59,110,89,0,2787.595,40,1929.354,MORE,-618,1606,988,4,1,-21.0,-1.9685577674164243,21.0,2.0952908873087353,0.5676005497699848,-0.6610448483587806,199,110,89,1,0.7778560717911179,1.170500554541026,0.3511501663623078,-0.5823985978568971,0.05084215957499902,0.05084215957499902,0.3511501663623078,1.170500554541026,1,0,0,2,1.170500554541026,0.3511501663623078
5632,24,113,60,87,110,1,2740.276,60,1635.933,MORE,590,1138,1728,3,2,23.0,2.1560394595513217,23.0,2.444506035193524,1.3350604480505277,-0.6771235669162616,197,87,110,0,0.7379660168274708,0.27311679605957273,1.170500554541026,-1.1078710169759018,1.1244152771266165,1.1244152771266165,1.170500554541026,0.27311679605957273,1,0,1,2,1.170500554541026,0.27311679605957273
5633,24,114,52,110,105,0,2924.485,20,3397.733,MORE,-1496,2528,1032,4,1,-5.0,-0.4687042303372438,5.0,-0.6984302957695783,-0.19985934851055792,-0.6145304295558985,215,110,105,1,1.0969765115002945,1.170500554541026,0.9754171287841883,-0.5823985978568971,-0.7294535334799016,0.7294535334799016,0.9754171287841883,1.170500554541026,0,0,0,2,1.170500554541026,0.9754171287841883
5634,24,115,30,80,96,1,1756.037,70,946.207,MORE,256,774,1030,3,2,16.0,1.4998535370791803,16.0,1.222253017596762,1.7187903971907987,-1.0115622041295695,176,80,96,0,0.3191204397091766,0.0,0.6242669624218805,-1.1078710169759018,0.8275829747572122,0.8275829747572122,0.6242669624218805,0.0,1,0,1,1,0.6242669624218805,0.0
5635,24,116,24,80,86,1,2077.14,50,2986.881,MORE,504,834,1338,3,2,6.0,0.5624450764046927,6.0,-0.5238227218271837,0.951330498910256,-0.9024532887897946,166,80,86,0,0.11967016489094122,0.0,0.2341001109082052,-1.1078710169759018,1.0479854028638358,1.0479854028638358,0.2341001109082052,0.0,1,0,1,1,0.2341001109082052,0.0
5636,24,117,5,50,55,1,2617.624,50,2315.938,MORE,184,1188,1372,5,2,5.0,0.4687042303372438,5.0,-0.6984302957695783,0.951330498910256,-0.718799996860093,105,50,55,0,-1.0969765115002945,-1.170500554541026,-0.9754171287841883,-0.05692617873789222,0.7635951730488376,0.7635951730488376,-0.9754171287841883,-1.170500554541026,1,1,1,0,-1.170500554541026,-0.9754171287841883
5637,24,118,34,80,74,1,6354.7559999999985,10,1991.918,MORE,-1760,4156,2396,7,1,-6.0,-0.5624450764046927,6.0,-0.5238227218271837,-0.5835892976508292,0.551055529253223,154,80,74,1,-0.11967016489094122,0.0,-0.2341001109082052,0.9940186595001175,-0.9640754730772748,0.9640754730772748,-0.2341001109082052,0.0,0,1,0,1,0.0,-0.2341001109082052
5638,24,119,15,45,50,1,4187.163,40,2292.98,MORE,-404,2208,1804,5,2,5.0,0.4687042303372438,5.0,-0.6984302957695783,0.5676005497699848,-0.18547985387334054,95,45,50,0,-1.2964267863185297,-1.3655839802978638,-1.170500554541026,-0.05692617873789222,0.2410281257637789,0.2410281257637789,-1.170500554541026,-1.3655839802978638,1,1,1,0,-1.3655839802978638,-1.170500554541026
5639,24,120,37,69,80,1,2305.712,30,2104.922,MORE,-122,1272,1150,3,1,11.0,1.0311493067419364,11.0,0.34921514788478913,0.1838706006297134,-0.8247858643277277,149,69,80,0,-0.21939530230005888,-0.4291835366650429,0.0,-1.1078710169759018,0.4916470157882458,0.4916470157882458,0.0,-0.4291835366650429,1,0,1,1,-0.4291835366650429,0.0
5640,24,121,48,128,110,1,2367.847,20,1991.689,LESS,-782,1728,946,3,1,-18.0,-1.6873352292140782,18.0,1.571468165481551,-0.19985934851055792,-0.8036727559025901,238,128,110,0,1.5557121435822359,1.8728008872656416,1.170500554541026,-1.1078710169759018,-0.09490783320518743,0.09490783320518743,1.170500554541026,1.8728008872656416,1,0,1,2,1.8728008872656416,1.170500554541026
5641,24,122,8,50,58,0,4291.221,40,3620.598,LESS,-1170,2990,1820,6,1,8.0,0.7499267685395902,8.0,-0.17460757394239454,0.5676005497699848,-0.15012155602988744,108,50,58,1,-1.0371414290548238,-1.170500554541026,-0.8583670733300858,0.46854624038111264,-0.4397309868558725,0.4397309868558725,-0.8583670733300858,-1.170500554541026,1,1,0,0,-1.170500554541026,-0.8583670733300858
5642,24,123,4,54,50,0,2944.669000000001,0,1740.925,LESS,-1548,2562,1014,4,1,-4.0,-0.3749633842697951,4.0,-0.8730378697119728,-0.9673192467911006,-0.6076720247847874,104,54,50,0,-1.116921538982118,-1.0144338139355558,-1.170500554541026,-0.5823985978568971,-0.7756669458248387,0.7756669458248387,-1.170500554541026,-1.0144338139355558,0,1,0,0,-1.0144338139355558,-1.170500554541026
5643,24,124,37,80,69,1,5680.8780000000015,0,1758.434,LESS,336,3006,3342,8,1,-11.0,-1.0311493067419364,11.0,0.34921514788478913,-0.9673192467911006,0.322075738807987,149,80,69,0,-0.21939530230005888,0.0,-0.4291835366650429,1.5194910786191222,0.8986805322109617,0.8986805322109617,-0.4291835366650429,0.0,0,1,1,1,0.0,-0.4291835366650429
5644,24,125,52,105,110,0,7102.719,0,1935.363,LESS,-1182,4188,3006,6,1,5.0,0.4687042303372438,5.0,-0.6984302957695783,-0.9673192467911006,0.8052089680074057,215,105,110,1,1.0969765115002945,0.9754171287841883,1.170500554541026,0.46854624038111264,-0.4503956204739349,0.4503956204739349,1.170500554541026,0.9754171287841883,0,1,0,2,1.170500554541026,0.9754171287841883
5645,24,126,5,55,50,0,2670.7209999999995,10,2172.067,LESS,-1716,2614,898,4,1,-5.0,-0.4687042303372438,5.0,-0.6984302957695783,-0.5835892976508292,-0.7007579478048179,105,55,50,0,-1.0969765115002945,-0.9754171287841883,-1.170500554541026,-0.5823985978568971,-0.9249718164777126,0.9249718164777126,-1.170500554541026,-0.9754171287841883,0,0,0,0,-0.9754171287841883,-1.170500554541026
5646,24,127,30,96,80,1,5302.469,0,2930.76,LESS,-572,3426,2854,7,1,-16.0,-1.4998535370791803,16.0,1.222253017596762,-0.9673192467911006,0.19349458090909133,176,96,80,0,0.3191204397091766,0.6242669624218805,0.0,0.9940186595001175,0.09172325511090497,0.09172325511090497,0.0,0.6242669624218805,0,1,1,1,0.6242669624218805,0.0
5647,24,128,33,80,75,0,2602.201,0,3330.835,LESS,-1308,2370,1062,4,1,-5.0,-0.4687042303372438,5.0,-0.6984302957695783,-0.9673192467911006,-0.724040641766199,155,80,75,0,-0.09972513740911768,0.0,-0.19508342575683765,-0.5823985978568971,-0.5623742734635904,0.5623742734635904,-0.19508342575683765,0.0,0,0,0,1,0.0,-0.19508342575683765
5648,24,129,48,110,128,0,1755.29,40,2155.871,LESS,-606,1224,618,2,1,18.0,1.6873352292140782,18.0,1.571468165481551,0.5676005497699848,-1.0118160303465742,238,110,128,1,1.5557121435822359,1.170500554541026,1.8728008872656416,-1.6333434360949068,0.06150679319306144,0.06150679319306144,1.8728008872656416,1.170500554541026,1,0,1,2,1.8728008872656416,1.170500554541026
5649,24,130,9,59,50,1,3723.259,20,1475.09,LESS,-1280,2874,1594,4,1,-9.0,-0.8436676146070391,9.0,0.0,-0.19985934851055792,-0.3431117111334189,109,59,50,0,-1.0171964015730004,-0.8193503881787182,-1.170500554541026,-0.5823985978568971,-0.537490128354778,0.537490128354778,-1.170500554541026,-0.8193503881787182,1,0,0,0,-0.8193503881787182,-1.170500554541026
5650,24,131,44,110,119,0,2463.204,10,1505.88,LESS,-1558,2416,858,4,1,9.0,0.8436676146070391,9.0,0.0,-0.5835892976508292,-0.7712710068063346,229,110,119,1,1.376206896245824,1.170500554541026,1.5216507209033339,-0.5823985978568971,-0.7845541405065575,0.7845541405065575,1.5216507209033339,1.170500554541026,0,0,0,2,1.5216507209033339,1.170500554541026
5651,24,132,2,52,50,0,3398.0640000000008,0,1433.317,LESS,-964,2542,1578,6,1,-2.0,-0.18748169213489754,2.0,-1.222253017596762,-0.9673192467911006,-0.4536110640635319,102,52,50,0,-1.156811593945765,-1.092467184238291,-1.170500554541026,0.46854624038111264,-0.25665477641246753,0.25665477641246753,-1.170500554541026,-1.092467184238291,0,1,0,0,-1.092467184238291,-1.170500554541026
5652,24,133,8,58,50,0,5685.258000000002,0,1800.59,LESS,-652,3020,2368,5,1,-8.0,-0.7499267685395902,8.0,-0.17460757394239454,-0.9673192467911006,0.3235640371084957,108,58,50,0,-1.0371414290548238,-0.8583670733300858,-1.170500554541026,-0.05692617873789222,0.020625697657155485,0.020625697657155485,-1.170500554541026,-0.8583670733300858,0,1,1,0,-0.8583670733300858,-1.170500554541026
5653,24,134,44,119,110,0,4908.208,0,675.77,LESS,-726,2728,2002,8,1,-9.0,-0.8436676146070391,9.0,0.0,-0.9673192467911006,0.05952700642123197,229,119,110,0,1.376206896245824,1.5216507209033339,1.170500554541026,1.5194910786191222,-0.04513954298756279,0.04513954298756279,1.170500554541026,1.5216507209033339,0,1,1,2,1.5216507209033339,1.170500554541026
5654,24,135,34,74,80,0,7472.473000000001,20,1839.59,LESS,410,3616,4026,6,1,6.0,0.5624450764046927,6.0,-0.5238227218271837,-0.19985934851055792,0.9308492076892004,154,74,80,1,-0.11967016489094122,-0.2341001109082052,0.0,0.46854624038111264,0.96444577285568,0.96444577285568,0.0,-0.2341001109082052,1,1,1,1,-0.2341001109082052,0.0
5655,24,136,24,86,80,1,10282.178,0,1432.716,LESS,-3350,6572,3222,10,1,-6.0,-0.5624450764046927,6.0,-0.5238227218271837,-0.9673192467911006,1.885570480846856,166,86,80,0,0.11967016489094122,0.2341001109082052,0.0,2.570435916857132,-2.3771394274705457,2.3771394274705457,0.0,0.2341001109082052,0,1,0,1,0.2341001109082052,0.0
5656,24,137,39,66,80,0,3187.171,70,862.828,LESS,-1516,2302,786,4,1,14.0,1.3123718449442827,14.0,0.8730378697119728,1.7187903971907987,-0.5252712680564915,146,66,80,1,-0.2792303847455295,-0.5462335921191455,0.0,-0.5823985978568971,-0.7472279228433389,0.7472279228433389,0.0,-0.5462335921191455,1,0,0,1,-0.5462335921191455,0.0
5657,24,138,9,50,59,0,2787.333,60,1931.624,LESS,-1118,1848,730,4,1,9.0,0.8436676146070391,9.0,0.0,1.3350604480505277,-0.6611338744215051,109,50,59,1,-1.0171964015730004,-1.170500554541026,-0.8193503881787182,-0.5823985978568971,-0.3935175745109353,0.3935175745109353,-0.8193503881787182,-1.170500554541026,1,0,0,0,-1.170500554541026,-0.8193503881787182
5658,24,139,57,94,110,0,4138.277,20,2145.439,LESS,-1192,2812,1620,6,1,16.0,1.4998535370791803,16.0,1.222253017596762,-0.19985934851055792,-0.2020910298365056,204,94,110,1,0.8775812092002355,0.5462335921191455,1.170500554541026,0.46854624038111264,-0.45928281515565356,0.45928281515565356,1.170500554541026,0.5462335921191455,1,1,0,2,1.170500554541026,0.5462335921191455
5659,24,140,60,110,87,1,2225.688,70,1235.58,LESS,556,804,1360,3,2,-23.0,-2.1560394595513217,23.0,2.444506035193524,1.7187903971907987,-0.8519775499898055,197,110,87,0,0.7379660168274708,1.170500554541026,0.27311679605957273,-1.1078710169759018,1.094198815208773,1.094198815208773,0.27311679605957273,1.170500554541026,1,0,1,2,1.170500554541026,0.27311679605957273
5660,24,141,33,75,80,0,5286.922,0,2848.09,LESS,-2714,4136,1422,4,1,5.0,0.4687042303372438,5.0,-0.6984302957695783,-0.9673192467911006,0.1882118015305507,155,75,80,1,-0.09972513740911768,-0.19508342575683765,0.0,-0.5823985978568971,-1.8119138457132375,1.8119138457132375,0.0,-0.19508342575683765,0,0,0,1,-0.19508342575683765,0.0
5661,24,142,15,50,45,0,1671.793,70,738.74,LESS,-858,1288,430,2,1,-5.0,-0.4687042303372438,5.0,-0.6984302957695783,1.7187903971907987,-1.0401878210309503,95,50,45,0,-1.2964267863185297,-1.170500554541026,-1.3655839802978638,-1.6333434360949068,-0.16245051278624945,0.16245051278624945,-1.3655839802978638,-1.170500554541026,1,0,1,0,-1.170500554541026,-1.3655839802978638
5662,24,143,59,89,110,0,2401.3720000000008,30,1373.809,LESS,-598,1460,862,4,1,21.0,1.9685577674164243,21.0,2.0952908873087353,0.1838706006297134,-0.7922811576093135,199,89,110,1,0.7778560717911179,0.3511501663623078,1.170500554541026,-0.5823985978568971,0.06861654893843638,0.06861654893843638,1.170500554541026,0.3511501663623078,1,0,1,2,1.170500554541026,0.3511501663623078
5663,24,144,29,80,94,0,2398.838,30,1201.287,LESS,-640,1598,958,4,1,14.0,1.3123718449442827,14.0,0.8730378697119728,0.1838706006297134,-0.7931421959411604,174,80,94,1,0.2792303847455295,0.0,0.5462335921191455,-0.5823985978568971,0.03129033127521791,0.03129033127521791,0.5462335921191455,0.0,1,0,1,1,0.5462335921191455,0.0
5664,24,145,55,110,98,1,6067.071,10,1273.063,LESS,564,3040,3604,8,1,-12.0,-1.124890152809385,12.0,0.5238227218271837,-0.5835892976508292,0.4533018542345436,208,110,98,0,0.9573613191275298,1.170500554541026,0.7023003327246156,1.5194910786191222,1.101308570954148,1.101308570954148,0.7023003327246156,1.170500554541026,1,1,1,2,1.170500554541026,0.7023003327246156
5665,24,146,29,94,80,1,3546.99,0,976.897,LESS,-322,2090,1768,6,1,-14.0,-1.3123718449442827,14.0,0.8730378697119728,-0.9673192467911006,-0.4030068830814445,174,94,80,0,0.2792303847455295,0.5462335921191455,0.0,0.46854624038111264,0.3139031221538721,0.3139031221538721,0.0,0.5462335921191455,0,1,1,1,0.5462335921191455,0.0
5666,24,147,57,110,94,1,5266.732,0,2719.77,LESS,-1378,3660,2282,5,1,-16.0,-1.4998535370791803,16.0,1.222253017596762,-0.9673192467911006,0.18135135799464472,204,110,94,0,0.8775812092002355,1.170500554541026,0.5462335921191455,-0.05692617873789222,-0.6245846362356211,0.6245846362356211,0.5462335921191455,1.170500554541026,0,1,0,2,1.170500554541026,0.5462335921191455
5667,24,148,39,80,66,1,6182.813,0,1396.0970000000002,LESS,-722,3652,2930,9,1,-14.0,-1.3123718449442827,14.0,0.8730378697119728,-0.9673192467911006,0.4926303067225498,146,80,66,0,-0.2792303847455295,0.0,-0.5462335921191455,2.0449634977381272,-0.04158466511487532,0.04158466511487532,-0.5462335921191455,0.0,0,1,1,1,0.0,-0.5462335921191455
5668,24,149,4,50,54,0,7787.664000000002,30,1923.183,LESS,-1048,3718,2670,8,2,4.0,0.3749633842697951,4.0,-0.8730378697119728,0.1838706006297134,1.0379492601174216,104,50,54,1,-1.116921538982118,-1.170500554541026,-1.0144338139355558,1.5194910786191222,-0.3313072117389045,0.3313072117389045,-1.0144338139355558,-1.170500554541026,1,1,0,0,-1.170500554541026,-1.0144338139355558
5669,24,150,55,98,110,1,6293.669,0,1434.679,LESS,-2084,4320,2236,7,1,12.0,1.124890152809385,12.0,0.5238227218271837,-0.9673192467911006,0.5302985250789839,208,98,110,1,0.9573613191275298,0.7023003327246156,1.170500554541026,0.9940186595001175,-1.2520205807649603,1.2520205807649603,1.170500554541026,0.7023003327246156,0,1,0,2,1.170500554541026,0.7023003327246156
5670,24,151,2,50,52,0,2747.01,70,1593.284,LESS,-574,1536,962,3,1,2.0,0.18748169213489754,2.0,-1.222253017596762,1.7187903971907987,-0.6748353932277626,102,50,52,1,-1.156811593945765,-1.170500554541026,-1.092467184238291,-1.1078710169759018,0.08994581617456124,0.08994581617456124,-1.092467184238291,-1.170500554541026,1,0,1,0,-1.170500554541026,-1.092467184238291
5671,24,152,59,110,89,1,3819.115,20,2262.805,LESS,-1084,2956,1872,5,1,-21.0,-1.9685577674164243,21.0,2.0952908873087353,-0.19985934851055792,-0.31054040476502803,199,110,89,0,0.7778560717911179,1.170500554541026,0.3511501663623078,-0.05692617873789222,-0.3633011125930918,0.3633011125930918,0.3511501663623078,1.170500554541026,1,1,0,2,1.170500554541026,0.3511501663623078
5672,24,153,60,87,110,0,2608.959,80,1718.0929999999996,LESS,198,1710,1908,4,2,23.0,2.1560394595513217,23.0,2.444506035193524,2.10252034633107,-0.7217443130185193,197,87,110,1,0.7379660168274708,0.27311679605957273,1.170500554541026,-0.5823985978568971,0.7760372456032438,0.7760372456032438,1.170500554541026,0.27311679605957273,1,0,1,2,1.170500554541026,0.27311679605957273
5673,24,154,52,110,105,0,5789.958000000001,10,1080.975,LESS,-1246,3498,2252,4,1,-5.0,-0.4687042303372438,5.0,-0.6984302957695783,-0.5835892976508292,0.3591404827850369,215,110,105,0,1.0969765115002945,1.170500554541026,0.9754171287841883,-0.5823985978568971,-0.5072736664369345,0.5072736664369345,0.9754171287841883,1.170500554541026,0,0,0,2,1.170500554541026,0.9754171287841883
5674,24,155,30,80,96,0,3137.528,0,2229.585,LESS,-1940,2866,926,3,1,16.0,1.4998535370791803,16.0,1.222253017596762,-0.9673192467911006,-0.5421396681779866,176,80,96,1,0.3191204397091766,0.0,0.6242669624218805,-1.1078710169759018,-1.124044977348211,1.124044977348211,0.6242669624218805,0.0,0,0,0,1,0.6242669624218805,0.0
5675,24,156,24,80,86,0,11949.455,0,2019.13,LESS,-914,6262,5348,10,1,6.0,0.5624450764046927,6.0,-0.5238227218271837,-0.9673192467911006,2.4521014227594318,166,80,86,1,0.11967016489094122,0.0,0.2341001109082052,2.570435916857132,-0.21221880300387408,0.21221880300387408,0.2341001109082052,0.0,0,1,0,1,0.2341001109082052,0.0
5676,24,157,5,50,55,0,4462.793,30,1738.284,LESS,-1580,3374,1794,6,1,5.0,0.4687042303372438,5.0,-0.6984302957695783,0.1838706006297134,-0.09182239712238456,105,50,55,1,-1.0969765115002945,-1.170500554541026,-0.9754171287841883,0.46854624038111264,-0.8041059688063386,0.8041059688063386,-0.9754171287841883,-1.170500554541026,1,1,0,0,-1.170500554541026,-0.9754171287841883
5677,24,158,34,80,74,1,9508.517,0,2253.484,LESS,-1094,4808,3714,9,2,-6.0,-0.5624450764046927,6.0,-0.5238227218271837,-0.9673192467911006,1.6226850124747578,154,80,74,0,-0.11967016489094122,0.0,-0.2341001109082052,2.0449634977381272,-0.37218830727481045,0.37218830727481045,-0.2341001109082052,0.0,0,1,0,1,0.0,-0.2341001109082052
5678,24,159,15,45,50,1,2712.7090000000007,20,1505.941,LESS,-68,1660,1592,3,1,5.0,0.4687042303372438,5.0,-0.6984302957695783,-0.19985934851055792,-0.686490671767887,95,45,50,1,-1.2964267863185297,-1.3655839802978638,-1.170500554541026,-1.1078710169759018,0.5396378670695268,0.5396378670695268,-1.170500554541026,-1.3655839802978638,1,0,1,0,-1.3655839802978638,-1.170500554541026
5679,24,160,37,69,80,0,1579.458,10,1405.198,LESS,-1922,2366,444,2,1,11.0,1.0311493067419364,11.0,0.34921514788478913,-0.5835892976508292,-1.0715627122586813,149,69,80,1,-0.21939530230005888,-0.4291835366650429,0.0,-1.6333434360949068,-1.1080480269211175,1.1080480269211175,0.0,-0.4291835366650429,0,0,0,1,-0.4291835366650429,0.0
5680,24,161,3,50,53,1,4691.508,30,2644.053,MORE,986,1822,2808,5,1,3.0,0.28122253820234633,3.0,-1.0476454436543674,0.1838706006297134,-0.014106382099364947,103,50,53,0,-1.1368665664639415,-1.170500554541026,-1.0534504990869233,-0.05692617873789222,1.4763481865226764,1.4763481865226764,-1.0534504990869233,-1.170500554541026,1,0,1,0,-1.170500554541026,-1.0534504990869233
5681,24,162,20,50,40,0,4739.589,10,2608.811,MORE,-1822,3802,1980,6,1,-10.0,-0.9374084606744876,10.0,0.17460757394239454,-0.5835892976508292,0.0022312595871086735,90,50,40,1,-1.3961519237276474,-1.170500554541026,-1.5606674060547012,0.46854624038111264,-1.0191760801039307,1.0191760801039307,-1.5606674060547012,-1.170500554541026,0,1,0,0,-1.170500554541026,-1.5606674060547012
5682,24,163,25,80,88,1,1773.614,90,1747.717,MORE,1506,726,2232,3,2,8.0,0.7499267685395902,8.0,-0.17460757394239454,2.486250295471341,-1.0055896426619806,168,80,88,0,0.1595602198545883,0.0,0.31213348121094026,-1.1078710169759018,1.938482309972048,1.938482309972048,0.31213348121094026,0.0,1,0,1,1,0.31213348121094026,0.0
5683,24,164,42,115,110,1,4930.746,30,1983.04,MORE,-386,2740,2354,7,1,-5.0,-0.4687042303372438,5.0,-0.6984302957695783,0.1838706006297134,0.06718528658033328,225,115,110,1,1.2964267863185297,1.3655839802978638,1.170500554541026,0.9940186595001175,0.25702507619087256,0.25702507619087256,1.170500554541026,1.3655839802978638,1,1,1,2,1.3655839802978638,1.170500554541026
5684,24,165,53,103,110,1,3031.859000000001,10,1167.226,MORE,-314,1904,1590,5,1,7.0,0.6561859224721414,7.0,-0.34921514788478913,-0.5835892976508292,-0.5780453743689552,213,103,110,0,1.0570864565366473,0.8973837584814532,1.170500554541026,-0.05692617873789222,0.3210128778992471,0.3210128778992471,1.170500554541026,0.8973837584814532,0,0,1,2,1.170500554541026,0.8973837584814532
5685,24,166,26,90,80,0,2542.756,20,2449.91,MORE,-2184,3092,908,4,1,-10.0,-0.9374084606744876,10.0,0.17460757394239454,-0.19985934851055792,-0.7442397039748141,170,90,80,1,0.19945027481823535,0.3901668515136753,0.0,-0.5823985978568971,-1.340892527582147,1.340892527582147,0.0,0.3901668515136753,0,0,0,1,0.3901668515136753,0.0
5686,24,167,35,80,72,1,2181.946,0,1613.579,MORE,-200,1588,1388,3,1,-8.0,-0.7499267685395902,8.0,-0.17460757394239454,-0.9673192467911006,-0.8668408249352044,152,80,72,1,-0.1595602198545883,0.0,-0.31213348121094026,-1.1078710169759018,0.4223268972708401,0.4223268972708401,-0.31213348121094026,0.0,0,0,1,1,0.0,-0.31213348121094026
5687,24,168,28,93,80,0,5720.088000000002,10,2766.382,MORE,-2228,4400,2172,6,1,-13.0,-1.218630998876834,13.0,0.6984302957695783,-0.5835892976508292,0.33539906674473186,173,93,80,1,0.25928535726370594,0.5072169069677779,0.0,0.46854624038111264,-1.3799961841817094,1.3799961841817094,0.0,0.5072169069677779,0,1,0,1,0.5072169069677779,0.0
5688,24,169,26,80,90,1,2166.239,60,2306.325,MORE,412,650,1062,3,2,10.0,0.9374084606744876,10.0,0.17460757394239454,1.3350604480505277,-0.8721779713749507,170,80,90,0,0.19945027481823535,0.0,0.3901668515136753,-1.1078710169759018,0.9662232117920238,0.9662232117920238,0.3901668515136753,0.0,1,0,1,1,0.3901668515136753,0.0
5689,24,170,25,88,80,0,2670.265,0,819.055,MORE,-1052,2082,1030,4,1,-8.0,-0.7499267685395902,8.0,-0.17460757394239454,-0.9673192467911006,-0.7009128939292543,168,88,80,1,0.1595602198545883,0.31213348121094026,0.0,-0.5823985978568971,-0.334862089611592,0.334862089611592,0.0,0.31213348121094026,0,0,0,1,0.31213348121094026,0.0
5690,24,171,36,80,70,0,3263.573,0,2377.448,MORE,-1222,2616,1394,4,1,-10.0,-0.9374084606744876,10.0,0.17460757394239454,-0.9673192467911006,-0.4993103167424599,150,80,70,1,-0.19945027481823535,0.0,-0.3901668515136753,-0.5823985978568971,-0.4859443992008096,0.4859443992008096,-0.3901668515136753,0.0,0,0,0,1,0.0,-0.3901668515136753
5691,24,172,28,80,93,0,7003.096,0,2698.853,MORE,-1438,4028,2590,8,1,13.0,1.218630998876834,13.0,0.6984302957695783,-0.9673192467911006,0.7713576571417506,173,80,93,0,0.25928535726370594,0.0,0.5072169069677779,1.5194910786191222,-0.6779078043259332,0.6779078043259332,0.5072169069677779,0.0,0,1,0,1,0.5072169069677779,0.0
5692,24,173,21,82,80,1,4127.078,0,818.6569999999998,MORE,-686,2354,1668,6,1,-2.0,-0.18748169213489754,2.0,-1.222253017596762,-0.9673192467911006,-0.20589638432677848,162,82,80,1,0.03989005496364707,0.07803337030273506,0.0,0.46854624038111264,-0.00959076426068805,0.00959076426068805,0.0,0.07803337030273506,0,1,0,1,0.07803337030273506,0.0
5693,24,174,19,50,41,0,6665.635,10,1832.991,MORE,-1868,4486,2618,8,1,-9.0,-0.8436676146070391,9.0,0.0,-0.5835892976508292,0.6566903893819485,91,50,41,1,-1.376206896245824,-1.170500554541026,-1.5216507209033339,1.5194910786191222,-1.0600571756398367,1.0600571756398367,-1.5216507209033339,-1.170500554541026,0,1,0,0,-1.170500554541026,-1.5216507209033339
5694,24,175,56,96,110,1,2597.019,30,2413.565,MORE,992,746,1738,3,2,14.0,1.3123718449442827,14.0,0.8730378697119728,0.1838706006297134,-0.7258014549610017,206,96,110,0,0.9174712641638826,0.6242669624218805,1.170500554541026,-1.1078710169759018,1.4816805033317075,1.4816805033317075,1.170500554541026,0.6242669624218805,1,0,1,2,1.170500554541026,0.6242669624218805
5695,24,176,23,80,85,1,3825.918,40,1061.927,MORE,-140,1872,1732,5,2,5.0,0.4687042303372438,5.0,-0.6984302957695783,0.5676005497699848,-0.308228785281384,165,80,85,0,0.09972513740911768,0.0,0.19508342575683765,-0.05692617873789222,0.47565006536115223,0.47565006536115223,0.19508342575683765,0.0,1,0,1,1,0.19508342575683765,0.0
5696,24,177,10,60,50,1,3159.739,20,2220.94,MORE,-536,2044,1508,5,1,-10.0,-0.9374084606744876,10.0,0.17460757394239454,-0.19985934851055792,-0.5345925007002248,110,60,50,1,-0.9972513740911768,-0.7803337030273506,-1.170500554541026,-0.05692617873789222,0.12371715596509224,0.12371715596509224,-1.170500554541026,-0.7803337030273506,0,0,0,0,-0.7803337030273506,-1.170500554541026
5697,24,178,19,41,50,1,6027.076,10,1670.799,MORE,-1394,3866,2472,7,1,9.0,0.8436676146070391,9.0,0.0,-0.5835892976508292,0.4397117879037578,91,41,50,0,-1.376206896245824,-1.5216507209033339,-1.170500554541026,0.9940186595001175,-0.6388041477263711,0.6388041477263711,-1.170500554541026,-1.5216507209033339,0,1,0,0,-1.5216507209033339,-1.170500554541026
5698,24,179,56,110,96,1,7100.333000000001,0,2496.966,MORE,-314,4178,3864,7,1,-14.0,-1.3123718449442827,14.0,0.8730378697119728,-0.9673192467911006,0.8043982192071748,206,110,96,1,0.9174712641638826,1.170500554541026,0.6242669624218805,0.9940186595001175,0.3210128778992471,0.3210128778992471,0.6242669624218805,1.170500554541026,0,1,1,2,1.170500554541026,0.6242669624218805
5699,24,180,35,72,80,1,3118.869,0,1386.714,MORE,-234,1850,1616,5,1,8.0,0.7499267685395902,8.0,-0.17460757394239454,-0.9673192467911006,-0.5484798868969797,152,72,80,0,-0.1595602198545883,-0.31213348121094026,0.0,-0.05692617873789222,0.39211043535299656,0.39211043535299656,0.0,-0.31213348121094026,0,1,1,1,-0.31213348121094026,0.0
5700,24,181,11,49,50,1,3551.592,0,1876.295,MORE,-514,2534,2020,5,1,1.0,0.09374084606744876,1.0,-1.3968605915391563,-0.9673192467911006,-0.4014431504835127,99,49,50,0,-1.2166466763912356,-1.2095172396923934,-1.170500554541026,-0.05692617873789222,0.14326898426487336,0.14326898426487336,-1.170500554541026,-1.2095172396923934,0,1,0,0,-1.2095172396923934,-1.170500554541026
5701,24,182,17,43,50,1,1701.295,20,1813.95,MORE,84,880,964,3,1,7.0,0.6561859224721414,7.0,-0.34921514788478913,-0.19985934851055792,-1.030163214532867,93,43,50,0,-1.3363168412821769,-1.4436173506005987,-1.170500554541026,-1.1078710169759018,0.6747232262316508,0.6747232262316508,-1.170500554541026,-1.4436173506005987,0,0,1,0,-1.4436173506005987,-1.170500554541026
5702,24,183,1,51,50,1,11519.87,20,1919.615,MORE,-1868,6078,4210,9,1,-1.0,-0.09374084606744876,1.0,-1.3968605915391563,-0.19985934851055792,2.3061309603338644,101,51,50,1,-1.1767566214275886,-1.1314838693896585,-1.170500554541026,2.0449634977381272,-1.0600571756398367,1.0600571756398367,-1.170500554541026,-1.1314838693896585,0,1,0,0,-1.1314838693896585,-1.170500554541026
5703,24,184,41,112,110,0,2257.657,20,1810.228,MORE,-1500,2316,816,4,1,-2.0,-0.18748169213489754,2.0,-1.222253017596762,-0.19985934851055792,-0.8411146713667553,222,112,110,1,1.2365917038730592,1.248533924843761,1.170500554541026,-0.5823985978568971,-0.7330084113525891,0.7330084113525891,1.170500554541026,1.248533924843761,0,0,0,2,1.248533924843761,1.170500554541026
5704,24,185,20,40,50,1,1902.204,70,864.796,MORE,356,902,1258,3,2,10.0,0.9374084606744876,10.0,0.17460757394239454,1.7187903971907987,-0.9618955151591494,90,40,50,0,-1.3961519237276474,-1.5606674060547012,-1.170500554541026,-1.1078710169759018,0.9164549215743991,0.9164549215743991,-1.170500554541026,-1.5606674060547012,1,0,1,0,-1.5606674060547012,-1.170500554541026
5705,24,186,1,50,51,0,3278.506,10,1873.687,MORE,-1286,2684,1398,6,1,1.0,0.09374084606744876,1.0,-1.3968605915391563,-0.5835892976508292,-0.4942361709612966,101,50,51,0,-1.1767566214275886,-1.170500554541026,-1.1314838693896585,0.46854624038111264,-0.5428224451638092,0.5428224451638092,-1.1314838693896585,-1.170500554541026,0,1,0,0,-1.170500554541026,-1.1314838693896585
5706,24,187,23,85,80,1,5836.7559999999985,10,4377.487,MORE,-952,3296,2344,6,1,-5.0,-0.4687042303372438,5.0,-0.6984302957695783,-0.5835892976508292,0.3750421685994656,165,85,80,1,0.09972513740911768,0.19508342575683765,0.0,0.46854624038111264,-0.2459901427944051,0.2459901427944051,0.0,0.19508342575683765,0,1,0,1,0.19508342575683765,0.0
5707,24,188,11,50,49,0,6428.1280000000015,0,2492.695,MORE,-922,3744,2822,8,1,-1.0,-0.09374084606744876,1.0,-1.3968605915391563,-0.9673192467911006,0.5759869043456709,99,50,49,1,-1.2166466763912356,-1.170500554541026,-1.2095172396923934,1.5194910786191222,-0.21932855874924903,0.21932855874924903,-1.2095172396923934,-1.170500554541026,0,1,0,0,-1.170500554541026,-1.2095172396923934
5708,24,189,17,50,43,1,3240.047,10,1579.052,MORE,-1008,2368,1360,4,1,-7.0,-0.6561859224721414,7.0,-0.34921514788478913,-0.5835892976508292,-0.5073043135045067,93,50,43,1,-1.3363168412821769,-1.170500554541026,-1.4436173506005987,-0.5823985978568971,-0.29575843301202975,0.29575843301202975,-1.4436173506005987,-1.170500554541026,0,0,0,0,-1.170500554541026,-1.4436173506005987
5709,24,190,21,80,82,1,2056.268,60,1417.259,MORE,406,810,1216,2,2,2.0,0.18748169213489754,2.0,-1.222253017596762,1.3350604480505277,-0.9095454719240904,162,80,82,0,0.03989005496364707,0.0,0.07803337030273506,-1.6333434360949068,0.9608908949829925,0.9608908949829925,0.07803337030273506,0.0,1,0,1,1,0.07803337030273506,0.0
5710,24,191,10,50,60,1,2066.19,40,2015.443,MORE,-206,1310,1104,3,1,10.0,0.9374084606744876,10.0,0.17460757394239454,0.5676005497699848,-0.906174034541066,110,50,60,0,-0.9972513740911768,-1.170500554541026,-0.7803337030273506,-1.1078710169759018,0.4169945804618089,0.4169945804618089,-0.7803337030273506,-1.170500554541026,1,0,1,0,-1.170500554541026,-0.7803337030273506
5711,24,192,3,53,50,0,6681.316,20,1637.29,MORE,-2442,4304,1862,6,1,-3.0,-0.28122253820234633,3.0,-1.0476454436543674,-0.19985934851055792,0.6620187011742487,103,53,50,1,-1.1368665664639415,-1.0534504990869233,-1.170500554541026,0.46854624038111264,-1.5701821503704891,1.5701821503704891,-1.170500554541026,-1.0534504990869233,0,1,0,0,-1.0534504990869233,-1.170500554541026
5712,24,193,45,122,110,0,9861.942,0,1893.07,MORE,716,4310,5026,8,1,-12.0,-1.124890152809385,12.0,0.5238227218271837,-0.9673192467911006,1.742776753766368,232,122,110,1,1.4360419786912946,1.6387007763574364,1.170500554541026,1.5194910786191222,1.2363939301162719,1.2363939301162719,1.170500554541026,1.6387007763574364,0,1,1,2,1.6387007763574364,1.170500554541026
5713,24,194,38,67,80,1,2324.637,70,962.059,MORE,310,986,1296,3,2,13.0,1.218630998876834,13.0,0.6984302957695783,1.7187903971907987,-0.8183552603694798,147,67,80,0,-0.25928535726370594,-0.5072169069677779,0.0,-1.1078710169759018,0.8755738260384931,0.8755738260384931,0.0,-0.5072169069677779,1,0,1,1,-0.5072169069677779,0.0
5714,24,195,38,80,67,0,6921.754,20,1649.917,MORE,-822,3434,2612,6,1,-13.0,-1.218630998876834,13.0,0.6984302957695783,-0.19985934851055792,0.7437181228129902,147,80,67,1,-0.25928535726370594,0.0,-0.5072169069677779,0.46854624038111264,-0.13045661193206218,0.13045661193206218,-0.5072169069677779,0.0,0,1,0,1,0.0,-0.5072169069677779
5715,24,196,36,70,80,1,2406.314,20,1629.79,MORE,190,1008,1198,3,2,10.0,0.9374084606744876,10.0,0.17460757394239454,-0.19985934851055792,-0.7906018950063198,150,70,80,0,-0.19945027481823535,-0.3901668515136753,0.0,-1.1078710169759018,0.7689274898578689,0.7689274898578689,0.0,-0.3901668515136753,0,0,1,1,-0.3901668515136753,0.0
5716,24,197,45,110,122,1,2452.491,50,2233.167,MORE,262,1140,1402,3,2,12.0,1.124890152809385,12.0,0.5238227218271837,0.951330498910256,-0.7749112213481951,232,110,122,0,1.4360419786912946,1.170500554541026,1.6387007763574364,-1.1078710169759018,0.8329152915662433,0.8329152915662433,1.6387007763574364,1.170500554541026,1,0,1,2,1.6387007763574364,1.170500554541026
5717,24,198,42,110,115,1,2897.344,50,2296.802,MORE,40,1198,1238,5,2,5.0,0.4687042303372438,5.0,-0.6984302957695783,0.951330498910256,-0.6237527821070639,225,110,115,0,1.2964267863185297,1.170500554541026,1.3655839802978638,-0.05692617873789222,0.6356195696320885,0.6356195696320885,1.3655839802978638,1.170500554541026,1,0,1,2,1.3655839802978638,1.170500554541026
5718,24,199,41,110,112,1,3221.2790000000005,10,1811.547,MORE,162,1594,1756,4,1,2.0,0.18748169213489754,2.0,-1.222253017596762,-0.5835892976508292,-0.5136815697839462,222,110,112,0,1.2365917038730592,1.170500554541026,1.248533924843761,-0.5823985978568971,0.7440433447490565,0.7440433447490565,1.248533924843761,1.170500554541026,0,0,1,2,1.248533924843761,1.170500554541026
5719,24,200,53,110,103,1,6580.304,0,3142.961,MORE,-1070,3438,2368,6,2,-7.0,-0.6561859224721414,7.0,-0.34921514788478913,-0.9673192467911006,0.6276954162585009,213,110,103,1,1.0570864565366473,1.170500554541026,0.8973837584814532,0.46854624038111264,-0.35085904003868557,0.35085904003868557,0.8973837584814532,1.170500554541026,0,1,0,2,1.170500554541026,0.8973837584814532
5720,24,201,3,50,53,0,2888.724,10,1041.789,LESS,-1178,2186,1008,3,1,3.0,0.28122253820234633,3.0,-1.0476454436543674,-0.5835892976508292,-0.626681807529526,103,50,53,1,-1.1368665664639415,-1.170500554541026,-1.0534504990869233,-1.1078710169759018,-0.4468407426012474,0.4468407426012474,-1.0534504990869233,-1.170500554541026,0,0,0,0,-1.170500554541026,-1.0534504990869233
5721,24,202,20,50,40,1,4297.435,0,2077.628,LESS,-378,2452,2074,5,1,-10.0,-0.9374084606744876,10.0,0.17460757394239454,-0.9673192467911006,-0.14801007529030716,90,50,40,0,-1.3961519237276474,-1.170500554541026,-1.5606674060547012,-0.05692617873789222,0.2641348319362475,0.2641348319362475,-1.5606674060547012,-1.170500554541026,0,1,1,0,-1.170500554541026,-1.5606674060547012
5722,24,203,25,80,88,0,2260.145,0,1643.565,LESS,-1240,2078,838,4,1,8.0,0.7499267685395902,8.0,-0.17460757394239454,-0.9673192467911006,-0.8402692635650052,168,80,88,1,0.1595602198545883,0.0,0.31213348121094026,-0.5823985978568971,-0.5019413496279033,0.5019413496279033,0.31213348121094026,0.0,0,0,0,1,0.31213348121094026,0.0
5723,24,204,42,115,110,1,1960.698,0,2234.769,LESS,-446,1926,1480,3,1,-5.0,-0.4687042303372438,5.0,-0.6984302957695783,-0.9673192467911006,-0.9420195971705758,225,115,110,0,1.2964267863185297,1.3655839802978638,1.170500554541026,-1.1078710169759018,0.2037019081005604,0.2037019081005604,1.170500554541026,1.3655839802978638,0,0,1,2,1.3655839802978638,1.170500554541026
5724,24,205,53,103,110,1,3239.019,0,1046.6989999999996,LESS,-8,1866,1858,5,1,7.0,0.6561859224721414,7.0,-0.34921514788478913,-0.9673192467911006,-0.507653621872754,213,103,110,1,1.0570864565366473,0.8973837584814532,1.170500554541026,-0.05692617873789222,0.5929610351598389,0.5929610351598389,1.170500554541026,0.8973837584814532,0,1,1,2,1.170500554541026,0.8973837584814532
5725,24,206,26,90,80,1,2213.529,40,1340.78,LESS,418,794,1212,4,1,-10.0,-0.9374084606744876,10.0,0.17460757394239454,0.5676005497699848,-0.8561091068473132,170,90,80,0,0.19945027481823535,0.3901668515136753,0.0,-0.5823985978568971,0.971555528601055,0.971555528601055,0.0,0.3901668515136753,1,0,1,1,0.3901668515136753,0.0
5726,24,207,35,80,72,0,2944.044000000001,0,2125.16,LESS,-1426,2558,1132,4,1,-8.0,-0.7499267685395902,8.0,-0.17460757394239454,-0.9673192467911006,-0.6078843961176226,152,80,72,0,-0.1595602198545883,0.0,-0.31213348121094026,-0.5823985978568971,-0.6672431707078709,0.6672431707078709,-0.31213348121094026,0.0,0,0,0,1,0.0,-0.31213348121094026
5727,24,208,28,93,80,0,5211.769,0,1507.384,LESS,-1230,3274,2044,6,1,-13.0,-1.218630998876834,13.0,0.6984302957695783,-0.9673192467911006,0.16267525308805705,173,93,80,0,0.25928535726370594,0.5072169069677779,0.0,0.46854624038111264,-0.49305415494618454,0.49305415494618454,0.0,0.5072169069677779,0,1,0,1,0.5072169069677779,0.0
5728,24,209,26,80,90,0,3964.665,0,1701.608,LESS,-944,2910,1966,6,1,10.0,0.9374084606744876,10.0,0.17460757394239454,-0.9673192467911006,-0.2610833687743823,170,80,90,1,0.19945027481823535,0.0,0.3901668515136753,0.46854624038111264,-0.23888038704903014,0.23888038704903014,0.3901668515136753,0.0,0,1,0,1,0.3901668515136753,0.0
5729,24,210,25,88,80,1,3423.163,20,1396.146,LESS,22,1766,1788,6,1,-8.0,-0.7499267685395902,8.0,-0.17460757394239454,-0.19985934851055792,-0.4450825711310058,168,88,80,0,0.1595602198545883,0.31213348121094026,0.0,0.46854624038111264,0.619622619204995,0.619622619204995,0.0,0.31213348121094026,1,1,1,1,0.31213348121094026,0.0
5730,24,211,36,80,70,1,2643.2790000000005,60,1180.299,LESS,342,1068,1410,5,2,-10.0,-0.9374084606744876,10.0,0.17460757394239454,1.3350604480505277,-0.7100825783898763,150,80,70,0,-0.19945027481823535,0.0,-0.3901668515136753,-0.05692617873789222,0.9040128490199929,0.9040128490199929,-0.3901668515136753,0.0,1,1,1,1,0.0,-0.3901668515136753
5731,24,212,28,80,93,0,4970.891,20,1667.656,LESS,-1390,3020,1630,6,1,13.0,1.218630998876834,13.0,0.6984302957695783,-0.19985934851055792,0.08082632203099932,173,80,93,1,0.25928535726370594,0.0,0.5072169069677779,0.46854624038111264,-0.6352492698536836,0.6352492698536836,0.5072169069677779,0.0,1,1,0,1,0.5072169069677779,0.0
5732,24,213,21,82,80,1,3342.673,10,1915.926,LESS,-240,2246,2006,5,1,-2.0,-0.18748169213489754,2.0,-1.222253017596762,-0.5835892976508292,-0.4724326008588455,162,82,80,0,0.03989005496364707,0.07803337030273506,0.0,-0.05692617873789222,0.3867781185439653,0.3867781185439653,0.0,0.07803337030273506,0,1,1,1,0.07803337030273506,0.0
5733,24,214,19,50,41,1,1978.514,60,1126.782,LESS,172,924,1096,3,2,-9.0,-0.8436676146070391,9.0,0.0,1.3350604480505277,-0.9359658249053108,91,50,41,0,-1.376206896245824,-1.170500554541026,-1.5216507209033339,-1.1078710169759018,0.7529305394307753,0.7529305394307753,-1.5216507209033339,-1.170500554541026,1,0,1,0,-1.170500554541026,-1.5216507209033339
5734,24,215,56,96,110,0,6042.265,60,1716.679,LESS,-1054,3346,2292,8,1,14.0,1.3123718449442827,14.0,0.8730378697119728,1.3350604480505277,0.4448729209828504,206,96,110,1,0.9174712641638826,0.6242669624218805,1.170500554541026,1.5194910786191222,-0.3366395285479357,0.3366395285479357,1.170500554541026,0.6242669624218805,1,1,0,2,1.170500554541026,0.6242669624218805
5735,24,216,23,80,85,0,2930.168,0,2132.242,LESS,-1388,2426,1038,4,1,5.0,0.4687042303372438,5.0,-0.6984302957695783,-0.9673192467911006,-0.6125993795006953,165,80,85,1,0.09972513740911768,0.0,0.19508342575683765,-0.5823985978568971,-0.6334718309173398,0.6334718309173398,0.19508342575683765,0.0,0,0,0,1,0.19508342575683765,0.0
5736,24,217,10,60,50,0,6251.257,10,2752.489,LESS,-3316,4950,1634,6,1,-10.0,-0.9374084606744876,10.0,0.17460757394239454,-0.5835892976508292,0.515887176329858,110,60,50,0,-0.9972513740911768,-0.7803337030273506,-1.170500554541026,0.46854624038111264,-2.3469229655527024,2.3469229655527024,-1.170500554541026,-0.7803337030273506,0,1,0,0,-0.7803337030273506,-1.170500554541026
5737,24,218,19,41,50,0,1759.21,70,1853.746,LESS,-406,1122,716,2,1,9.0,0.8436676146070391,9.0,0.0,1.7187903971907987,-1.0104840373470323,91,41,50,1,-1.376206896245824,-1.5216507209033339,-1.170500554541026,-1.6333434360949068,0.23925068682743517,0.23925068682743517,-1.170500554541026,-1.5216507209033339,1,0,1,0,-1.5216507209033339,-1.170500554541026
5738,24,219,56,110,96,1,4677.634,0,1588.027,LESS,-128,2566,2438,7,1,-14.0,-1.3123718449442827,14.0,0.8730378697119728,-0.9673192467911006,-0.018820685894172275,206,110,96,0,0.9174712641638826,1.170500554541026,0.6242669624218805,0.9940186595001175,0.48631469897921464,0.48631469897921464,0.6242669624218805,1.170500554541026,0,1,1,2,1.170500554541026,0.6242669624218805
5739,24,220,35,72,80,0,2788.571,30,1994.351,LESS,-1374,2510,1136,4,1,8.0,0.7499267685395902,8.0,-0.17460757394239454,0.1838706006297134,-0.6607132092854253,152,72,80,1,-0.1595602198545883,-0.31213348121094026,0.0,-0.5823985978568971,-0.6210297583629336,0.6210297583629336,0.0,-0.31213348121094026,1,0,0,1,-0.31213348121094026,0.0
5740,24,221,11,49,50,0,2701.609000000001,70,718.12,LESS,-254,1554,1300,4,2,1.0,0.09374084606744876,1.0,-1.3968605915391563,1.7187903971907987,-0.6902623866390389,99,49,50,1,-1.2166466763912356,-1.2095172396923934,-1.170500554541026,-0.5823985978568971,0.37433604598955916,0.37433604598955916,-1.170500554541026,-1.2095172396923934,1,0,1,0,-1.2095172396923934,-1.170500554541026
5741,24,222,17,43,50,0,2059.749,90,716.688,LESS,-104,1312,1208,4,2,7.0,0.6561859224721414,7.0,-0.34921514788478913,2.486250295471341,-0.908362648548732,93,43,50,1,-1.3363168412821769,-1.4436173506005987,-1.170500554541026,-0.5823985978568971,0.5076439662153395,0.5076439662153395,-1.170500554541026,-1.4436173506005987,1,0,1,0,-1.4436173506005987,-1.170500554541026
5742,24,223,1,51,50,0,2985.155,20,1186.114,LESS,-1640,2614,974,4,1,-1.0,-0.09374084606744876,1.0,-1.3968605915391563,-0.19985934851055792,-0.5939151195349266,101,51,50,0,-1.1767566214275886,-1.1314838693896585,-1.170500554541026,-0.5823985978568971,-0.8574291368966507,0.8574291368966507,-1.170500554541026,-1.1314838693896585,1,0,0,0,-1.1314838693896585,-1.170500554541026
5743,24,224,41,112,110,0,3842.488,0,1369.382,LESS,-1270,2652,1382,5,1,-2.0,-0.18748169213489754,2.0,-1.222253017596762,-0.9673192467911006,-0.30259839650525905,222,112,110,0,1.2365917038730592,1.248533924843761,1.170500554541026,-0.05692617873789222,-0.5286029336730593,0.5286029336730593,1.170500554541026,1.248533924843761,0,1,0,2,1.248533924843761,1.170500554541026
5744,24,225,20,40,50,0,1674.875,100,606.025,LESS,12,1030,1042,2,2,10.0,0.9374084606744876,10.0,0.17460757394239454,2.8699802446116127,-1.0391405755144736,90,40,50,1,-1.3961519237276474,-1.5606674060547012,-1.170500554541026,-1.6333434360949068,0.6107354245232762,0.6107354245232762,-1.170500554541026,-1.5606674060547012,1,0,1,0,-1.5606674060547012,-1.170500554541026
5745,24,226,1,50,51,1,3977.509,30,1528.599,LESS,534,1438,1972,5,2,1.0,0.09374084606744876,1.0,-1.3968605915391563,0.1838706006297134,-0.2567190529360872,101,50,51,1,-1.1767566214275886,-1.170500554541026,-1.1314838693896585,-0.05692617873789222,1.0746469869089919,1.0746469869089919,-1.1314838693896585,-1.170500554541026,1,1,1,0,-1.170500554541026,-1.1314838693896585
5746,24,227,23,85,80,0,6565.472,0,1111.009,LESS,-694,3402,2708,8,1,-5.0,-0.4687042303372438,5.0,-0.6984302957695783,-0.9673192467911006,0.6226555896847238,165,85,80,0,0.09972513740911768,0.19508342575683765,0.0,1.5194910786191222,-0.016700520006062997,0.016700520006062997,0.0,0.19508342575683765,0,1,1,1,0.19508342575683765,0.0
5747,24,228,11,50,49,0,2701.208,80,780.1560000000002,LESS,74,1510,1584,4,2,-1.0,-0.09374084606744876,1.0,-1.3968605915391563,2.10252034633107,-0.6903986440861862,99,50,49,0,-1.2166466763912356,-1.170500554541026,-1.2095172396923934,-0.5823985978568971,0.6658360315499321,0.6658360315499321,-1.2095172396923934,-1.170500554541026,1,0,1,0,-1.170500554541026,-1.2095172396923934
5748,24,229,17,50,43,0,4268.8,20,1476.894,LESS,182,1818,2000,4,1,-7.0,-0.6561859224721414,7.0,-0.34921514788478913,-0.19985934851055792,-0.15774008027548164,93,50,43,0,-1.3363168412821769,-1.170500554541026,-1.4436173506005987,-0.5823985978568971,0.7618177341124939,0.7618177341124939,-1.4436173506005987,-1.170500554541026,1,0,1,0,-1.170500554541026,-1.4436173506005987
5749,24,230,21,80,82,0,4315.806,0,3020.35,LESS,-1456,3192,1736,6,1,2.0,0.18748169213489754,2.0,-1.222253017596762,-0.9673192467911006,-0.14176771728148468,162,80,82,1,0.03989005496364707,0.0,0.07803337030273506,0.46854624038111264,-0.6939047547530268,0.6939047547530268,0.07803337030273506,0.0,0,1,0,1,0.07803337030273506,0.0
5750,24,231,10,50,60,0,3440.885,60,1796.761,LESS,-730,2074,1344,4,1,10.0,0.9374084606744876,10.0,0.17460757394239454,1.3350604480505277,-0.439060739514199,110,50,60,1,-0.9972513740911768,-1.170500554541026,-0.7803337030273506,-0.5823985978568971,-0.04869442086025027,0.04869442086025027,-0.7803337030273506,-1.170500554541026,1,0,1,0,-1.170500554541026,-0.7803337030273506
5751,24,232,3,53,50,0,3279.55,60,1414.808,LESS,-50,1556,1506,4,2,-3.0,-0.28122253820234633,3.0,-1.0476454436543674,1.3350604480505277,-0.4938814258869287,103,53,50,0,-1.1368665664639415,-1.0534504990869233,-1.170500554541026,-0.5823985978568971,0.5556348174966204,0.5556348174966204,-1.170500554541026,-1.0534504990869233,1,0,1,0,-1.0534504990869233,-1.170500554541026
5752,24,233,45,122,110,1,4856.0920000000015,0,900.742,LESS,450,1762,2212,7,2,-12.0,-1.124890152809385,12.0,0.5238227218271837,-0.9673192467911006,0.04181829540997542,232,122,110,0,1.4360419786912946,1.6387007763574364,1.170500554541026,0.9940186595001175,0.9999945515825548,0.9999945515825548,1.170500554541026,1.6387007763574364,0,1,1,2,1.6387007763574364,1.170500554541026
5753,24,234,38,67,80,0,2480.809,30,2844.72,LESS,-702,1578,876,4,1,13.0,1.218630998876834,13.0,0.6984302957695783,0.1838706006297134,-0.7652889311030346,147,67,80,1,-0.25928535726370594,-0.5072169069677779,0.0,-0.5823985978568971,-0.023810275751437945,0.023810275751437945,0.0,-0.5072169069677779,1,0,1,1,-0.5072169069677779,0.0
5754,24,235,38,80,67,0,6157.77,10,1910.24,LESS,-1106,3382,2276,8,1,-13.0,-1.218630998876834,13.0,0.6984302957695783,-0.5835892976508292,0.4841208422614455,147,80,67,0,-0.25928535726370594,0.0,-0.5072169069677779,1.5194910786191222,-0.38285294089287286,0.38285294089287286,-0.5072169069677779,0.0,0,1,0,1,0.0,-0.5072169069677779
5755,24,236,36,70,80,0,2544.731,80,2092.882,LESS,282,1556,1838,4,2,10.0,0.9374084606744876,10.0,0.17460757394239454,2.10252034633107,-0.7435686105630549,150,70,80,1,-0.19945027481823535,-0.3901668515136753,0.0,-0.5823985978568971,0.8506896809296808,0.8506896809296808,0.0,-0.3901668515136753,1,0,1,1,-0.3901668515136753,0.0
5756,24,237,45,110,122,0,2351.11,20,1296.011,LESS,-684,1492,808,4,1,12.0,1.124890152809385,12.0,0.5238227218271837,-0.19985934851055792,-0.8093598902988487,232,110,122,1,1.4360419786912946,1.170500554541026,1.6387007763574364,-0.5823985978568971,-0.007813325324344311,0.007813325324344311,1.6387007763574364,1.170500554541026,1,0,1,2,1.6387007763574364,1.170500554541026
5757,24,238,42,110,115,0,2895.454,0,2457.08,LESS,-1532,2382,850,4,1,5.0,0.4687042303372438,5.0,-0.6984302957695783,-0.9673192467911006,-0.6243949930175573,225,110,115,1,1.2964267863185297,1.170500554541026,1.3655839802978638,-0.5823985978568971,-0.7614474343340889,0.7614474343340889,1.3655839802978638,1.170500554541026,0,0,0,2,1.3655839802978638,1.170500554541026
5758,24,239,41,110,112,0,3671.883,0,1060.336,LESS,-1196,2806,1610,6,1,2.0,0.18748169213489754,2.0,-1.222253017596762,-0.9673192467911006,-0.3605689744865994,222,110,112,1,1.2365917038730592,1.170500554541026,1.248533924843761,0.46854624038111264,-0.46283769302834105,0.46283769302834105,1.248533924843761,1.170500554541026,0,1,0,2,1.248533924843761,1.170500554541026
5759,24,240,53,110,103,1,5307.49,0,1882.147,LESS,704,2152,2856,4,1,-7.0,-0.6561859224721414,7.0,-0.34921514788478913,-0.9673192467911006,0.19520068724855555,213,110,103,0,1.0570864565366473,1.170500554541026,0.8973837584814532,-0.5823985978568971,1.2257292964982094,1.2257292964982094,0.8973837584814532,1.170500554541026,0,0,1,2,1.170500554541026,0.8973837584814532
5760,25,1,49,110,131,0,10605.34,4,2316.401,LESS,-4108,7376,3268,6,1,21.0,1.9685577674164243,21.0,2.0952908873087353,-1.2593710757015233,0.9875769078373876,241,110,131,1,1.6155472260277064,1.170500554541026,1.9898509427197442,1.1471584260115046,-1.8431033284359093,1.8431033284359093,1.9898509427197442,1.170500554541026,0,1,0,2,1.9898509427197442,1.170500554541026
5761,25,2,13,47,50,0,6873.107,14,2518.451,LESS,-1730,4706,2976,4,1,3.0,0.28122253820234633,3.0,-1.0476454436543674,-0.4895059249924924,0.02059433746466052,97,47,50,1,-1.2565367313548828,-1.2875506099951286,-1.170500554541026,0.014162449703845685,-0.3940911075844034,0.3940911075844034,-1.170500554541026,-1.2875506099951286,1,0,0,0,-1.2875506099951286,-1.170500554541026
5762,25,3,16,50,44,0,9148.281,4,3420.894,LESS,-3480,6388,2908,6,1,-6.0,-0.5624450764046927,6.0,-0.5238227218271837,-1.2593710757015233,0.6100681464592221,94,50,44,0,-1.3163718138003533,-1.170500554541026,-1.4046006654492311,1.1471584260115046,-1.4604373592623408,1.4604373592623408,-1.4046006654492311,-1.170500554541026,0,1,0,0,-1.170500554541026,-1.4046006654492311
5763,25,4,7,57,50,1,9435.773,14,2636.511,LESS,-1670,5696,4026,5,1,-7.0,-0.6561859224721414,7.0,-0.34921514788478913,-0.4895059249924924,0.6845543195147614,107,57,50,0,-1.0570864565366473,-0.8973837584814532,-1.170500554541026,0.5806604378576751,-0.35753066466973127,0.35753066466973127,-1.170500554541026,-0.8973837584814532,1,1,0,0,-0.8973837584814532,-1.170500554541026
5764,25,5,18,42,50,0,5681.3780000000015,14,1826.936,LESS,-3688,4538,850,2,1,8.0,0.7499267685395902,8.0,-0.17460757394239454,-0.4895059249924924,-0.2881701934763923,92,42,50,1,-1.3562618687640005,-1.4826340357519663,-1.170500554541026,-1.1188335266038132,-1.5871802280332041,1.5871802280332041,-1.170500554541026,-1.4826340357519663,1,0,0,0,-1.4826340357519663,-1.170500554541026
5765,25,6,51,108,110,0,14484.907,4,2868.844,LESS,-5850,10522,4672,5,1,2.0,0.18748169213489754,2.0,-1.222253017596762,-1.2593710757015233,1.9927321780451184,218,108,110,1,1.156811593945765,1.092467184238291,1.170500554541026,0.5806604378576751,-2.9045748543918903,2.9045748543918903,1.170500554541026,1.092467184238291,0,1,0,2,1.170500554541026,1.092467184238291
5766,25,7,31,78,80,1,20821.753,4,3094.095,LESS,-2456,10058,7602,7,1,2.0,0.18748169213489754,2.0,-1.222253017596762,-1.2593710757015233,3.634542759843236,158,78,80,1,-0.03989005496364707,-0.07803337030273506,0.0,1.7136564141653339,-0.8364724668519363,0.8364724668519363,0.0,-0.07803337030273506,0,1,0,1,-0.07803337030273506,0.0
5767,25,8,58,110,92,1,5124.241,24,4217.061,LESS,-1712,3552,1840,3,1,-18.0,-1.6873352292140782,18.0,1.571468165481551,0.2803592257165388,-0.43251856837950026,202,110,92,0,0.8376911542365885,1.170500554541026,0.4682002218164104,-0.5523355384499837,-0.3831229747100018,0.3831229747100018,0.4682002218164104,1.170500554541026,1,0,0,2,1.170500554541026,0.4682002218164104
5768,25,9,12,50,48,1,4464.752,14,2806.906,LESS,-1878,3758,1880,4,1,-2.0,-0.18748169213489754,2.0,-1.222253017596762,-0.4895059249924924,-0.6033852769565208,98,50,48,0,-1.2365917038730592,-1.170500554541026,-1.248533924843761,0.014162449703845685,-0.4842735334405947,0.4842735334405947,-1.248533924843761,-1.170500554541026,0,0,0,0,-1.170500554541026,-1.248533924843761
5769,25,10,54,110,101,0,12785.335,4,2251.0,LESS,-4066,8028,3962,2,1,-9.0,-0.8436676146070391,9.0,0.0,-1.2593710757015233,1.552390832503852,211,110,101,0,1.0171964015730004,1.170500554541026,0.8193503881787182,-1.1188335266038132,-1.8175110183956387,1.8175110183956387,0.8193503881787182,1.170500554541026,0,0,0,2,1.170500554541026,0.8193503881787182
5770,25,11,14,46,50,0,11620.869,14,1150.332,LESS,-5824,8714,2890,6,1,4.0,0.3749633842697951,4.0,-0.8730378697119728,-0.4895059249924924,1.2506898599783836,96,46,50,1,-1.2764817588367063,-1.3265672951464962,-1.170500554541026,1.1471584260115046,-2.888731995795532,2.888731995795532,-1.170500554541026,-1.3265672951464962,0,1,0,0,-1.3265672951464962,-1.170500554541026
5771,25,12,22,80,83,0,6066.0340000000015,14,2004.16,LESS,-1582,3612,2030,6,1,3.0,0.28122253820234633,3.0,-1.0476454436543674,-0.4895059249924924,-0.1885098433349912,163,80,83,1,0.05983508244547061,0.0,0.1170500554541026,1.1471584260115046,-0.30390868172821217,0.30390868172821217,0.1170500554541026,0.0,0,1,0,1,0.1170500554541026,0.0
5772,25,13,6,50,56,0,14469.857,4,1295.322,LESS,-4254,9140,4886,10,1,6.0,0.5624450764046927,6.0,-0.5238227218271837,-1.2593710757015233,1.9888328803099264,106,50,56,1,-1.077031484018471,-1.170500554541026,-0.9364004436328208,3.4131503786268227,-1.9320670728616114,1.9320670728616114,-0.9364004436328208,-1.170500554541026,0,1,0,0,-1.170500554541026,-0.9364004436328208
5773,25,14,13,50,47,0,14354.673,4,3287.061,LESS,98,6988,7086,7,1,-3.0,-0.28122253820234633,3.0,-1.0476454436543674,-1.2593710757015233,1.9589899095238548,97,50,47,0,-1.2565367313548828,-1.170500554541026,-1.2875506099951286,1.7136564141653339,0.7197837198826077,0.7197837198826077,-1.2875506099951286,-1.170500554541026,0,1,1,0,-1.170500554541026,-1.2875506099951286
5774,25,15,46,110,124,0,8853.375,14,2963.717,LESS,-762,5084,4322,3,1,14.0,1.3123718449442827,14.0,0.8730378697119728,-0.4895059249924924,0.5336610834761929,234,110,124,1,1.4759320336549415,1.170500554541026,1.7167341466601715,-0.5523355384499837,0.19575070477230708,0.19575070477230708,1.7167341466601715,1.170500554541026,0,0,1,2,1.7167341466601715,1.170500554541026
5775,25,16,27,91,80,1,8577.71,14,2093.802,LESS,1112,3448,4560,5,1,-11.0,-1.0311493067419364,11.0,0.34921514788478913,-0.4895059249924924,0.4622391625345479,171,91,80,0,0.21939530230005888,0.4291835366650429,0.0,0.5806604378576751,1.3376552051405668,1.3376552051405668,0.0,0.4291835366650429,0,1,1,1,0.4291835366650429,0.0
5776,25,17,40,64,80,0,22884.768,14,1360.861,LESS,3882,7340,11222,7,1,16.0,1.4998535370791803,16.0,1.222253017596762,-0.4895059249924924,4.169048388890912,144,64,80,1,-0.3191204397091766,-0.6242669624218805,0.0,1.7136564141653339,3.0255289863679304,3.0255289863679304,0.0,-0.6242669624218805,0,1,1,1,-0.6242669624218805,0.0
5777,25,18,22,83,80,1,18738.581,4,1103.152,LESS,-5984,10218,4234,8,1,-3.0,-0.28122253820234633,3.0,-1.0476454436543674,-1.2593710757015233,3.0948146627259083,163,83,80,0,0.05983508244547061,0.1170500554541026,0.0,2.2801544023191638,-2.986226510234658,2.986226510234658,0.0,0.1170500554541026,0,1,0,1,0.1170500554541026,0.0
5778,25,19,54,101,110,0,7137.299,14,1845.347,LESS,-1700,4270,2570,3,1,9.0,0.8436676146070391,9.0,0.0,-0.4895059249924924,0.08904372399329137,211,101,110,1,1.0171964015730004,0.8193503881787182,1.170500554541026,-0.5523355384499837,-0.37581088612706737,0.37581088612706737,1.170500554541026,0.8193503881787182,0,0,0,2,1.170500554541026,0.8193503881787182
5779,25,20,6,56,50,1,7638.14,24,1541.85,LESS,1724,2488,4212,3,1,-6.0,-0.5624450764046927,6.0,-0.5238227218271837,0.2803592257165388,0.2188063935608257,106,56,50,0,-1.077031484018471,-0.9364004436328208,-1.170500554541026,-0.5523355384499837,1.7105717228702226,1.7105717228702226,-1.170500554541026,-0.9364004436328208,1,0,1,0,-0.9364004436328208,-1.170500554541026
5780,25,21,18,50,42,1,5032.886,24,2205.1220000000008,LESS,1976,1440,3416,3,2,-8.0,-0.7499267685395902,8.0,-0.17460757394239454,0.2803592257165388,-0.4561876942664425,92,50,42,0,-1.3562618687640005,-1.170500554541026,-1.4826340357519663,-0.5523355384499837,1.8641255831118457,1.8641255831118457,-1.4826340357519663,-1.170500554541026,1,0,1,0,-1.170500554541026,-1.4826340357519663
5781,25,22,43,110,117,0,5773.3409999999985,14,1338.019,LESS,-3516,4860,1344,4,1,7.0,0.6561859224721414,7.0,-0.34921514788478913,-0.4895059249924924,-0.26434354114273995,227,110,117,1,1.3363168412821769,1.170500554541026,1.4436173506005987,0.014162449703845685,-1.4823736250111441,1.4823736250111441,1.4436173506005987,1.170500554541026,0,0,0,2,1.4436173506005987,1.170500554541026
5782,25,23,32,77,80,1,18916.334,10,1193.419,LESS,1348,7150,8498,7,1,3.0,0.28122253820234633,3.0,-1.0476454436543674,-0.7974519852761047,3.140868607597909,157,77,80,1,-0.05983508244547061,-0.1170500554541026,0.0,1.7136564141653339,1.4814596139382774,1.4814596139382774,0.0,-0.1170500554541026,0,1,1,1,-0.1170500554541026,0.0
5783,25,24,27,80,91,0,3767.677,24,3399.9590000000007,LESS,-3066,4092,1026,4,1,11.0,1.0311493067419364,11.0,0.34921514788478913,0.2803592257165388,-0.783990125379052,171,80,91,1,0.21939530230005888,0.0,0.4291835366650429,0.014162449703845685,-1.208170303151103,1.208170303151103,0.4291835366650429,0.0,1,0,0,1,0.4291835366650429,0.0
5784,25,25,16,44,50,0,8356.347,4,1279.957,LESS,-1060,4728,3668,4,1,6.0,0.5624450764046927,6.0,-0.5238227218271837,-1.2593710757015233,0.4048863223647575,94,44,50,1,-1.3163718138003533,-1.4046006654492311,-1.170500554541026,0.014162449703845685,0.014167171629435454,0.014167171629435454,-1.170500554541026,-1.4046006654492311,0,1,1,0,-1.4046006654492311,-1.170500554541026
5785,25,26,7,50,57,0,10362.932,14,1684.601,LESS,-2470,6272,3802,6,1,7.0,0.6561859224721414,7.0,-0.34921514788478913,-0.4895059249924924,0.924771528077091,107,50,57,1,-1.0570864565366473,-1.170500554541026,-0.8973837584814532,1.1471584260115046,-0.8450032368653598,0.8450032368653598,-0.8973837584814532,-1.170500554541026,1,1,0,0,-1.170500554541026,-0.8973837584814532
5786,25,27,14,50,46,1,18878.189,4,798.0830000000002,LESS,-774,7924,7150,10,1,-4.0,-0.3749633842697951,4.0,-0.8730378697119728,-1.2593710757015233,3.130985636693663,96,50,46,0,-1.2764817588367063,-1.170500554541026,-1.3265672951464962,3.4131503786268227,0.18843861618937266,0.18843861618937266,-1.3265672951464962,-1.170500554541026,0,1,1,0,-1.170500554541026,-1.3265672951464962
5787,25,28,51,110,108,0,16446.413,0,2903.0290000000005,LESS,-7400,11778,4378,9,1,-2.0,-0.18748169213489754,2.0,-1.222253017596762,-1.5673171359851361,2.5009378859099614,218,110,108,0,1.156811593945765,1.170500554541026,1.092467184238291,2.8466523904729932,-3.8490529630209207,3.8490529630209207,1.092467184238291,1.170500554541026,0,1,0,2,1.170500554541026,1.092467184238291
5788,25,29,50,133,110,1,6331.5030000000015,24,1739.592,LESS,-2298,4498,2200,4,1,-23.0,-2.1560394595513217,23.0,2.444506035193524,0.2803592257165388,-0.11972959945035765,243,133,110,0,1.6554372809913533,2.0678843130224793,1.170500554541026,0.014162449703845685,-0.7401966338432997,0.7401966338432997,1.170500554541026,2.0678843130224793,1,1,0,2,2.0678843130224793,1.170500554541026
5789,25,30,49,131,110,1,4537.676,24,3742.15,LESS,-3108,4778,1670,5,1,-21.0,-1.9685577674164243,21.0,2.0952908873087353,0.2803592257165388,-0.5844914305750487,241,131,110,0,1.6155472260277064,1.9898509427197442,1.170500554541026,0.5806604378576751,-1.2337626131913735,1.2337626131913735,1.170500554541026,1.9898509427197442,1,1,0,2,1.9898509427197442,1.170500554541026
5790,25,31,47,126,110,1,4827.674,14,2619.109,LESS,-616,2652,2036,5,1,-16.0,-1.4998535370791803,16.0,1.222253017596762,-0.4895059249924924,-0.5093559791059282,236,126,110,0,1.5158220886185887,1.7947675169629065,1.170500554541026,0.5806604378576751,0.28471444919800926,0.28471444919800926,1.170500554541026,1.7947675169629065,0,1,1,2,1.7947675169629065,1.170500554541026
5791,25,32,50,110,133,0,4442.857,14,2701.952,LESS,-1530,3574,2044,4,1,23.0,2.1560394595513217,23.0,2.444506035193524,-0.4895059249924924,-0.6090580426649617,243,110,133,1,1.6554372809913533,1.170500554541026,2.0678843130224793,0.014162449703845685,-0.2722229645354963,0.2722229645354963,2.0678843130224793,1.170500554541026,0,1,0,2,2.0678843130224793,1.170500554541026
5792,25,33,47,110,126,0,4583.469,24,2165.923,LESS,-3478,4906,1428,4,1,16.0,1.4998535370791803,16.0,1.222253017596762,0.2803592257165388,-0.5726269427884936,236,110,126,1,1.5158220886185887,1.170500554541026,1.7947675169629065,0.014162449703845685,-1.4592186778318517,1.4592186778318517,1.7947675169629065,1.170500554541026,1,1,0,2,1.7947675169629065,1.170500554541026
5793,25,34,12,48,50,0,6211.153,24,1769.4589999999996,LESS,-188,2950,2762,4,1,2.0,0.18748169213489754,2.0,-1.222253017596762,0.2803592257165388,-0.1509110268543699,98,48,50,1,-1.2365917038730592,-1.248533924843761,-1.170500554541026,0.014162449703845685,0.5455122753226705,0.5455122753226705,-1.170500554541026,-1.248533924843761,1,1,1,0,-1.248533924843761,-1.170500554541026
5794,25,35,32,80,77,1,11220.262,4,982.316,LESS,460,4900,5360,7,1,-3.0,-0.28122253820234633,3.0,-1.0476454436543674,-1.2593710757015233,1.1468967724167798,157,80,77,0,-0.05983508244547061,0.0,-0.1170500554541026,1.7136564141653339,0.9403650588011296,0.9403650588011296,-0.1170500554541026,0.0,0,1,1,1,0.0,-0.1170500554541026
5795,25,36,43,117,110,1,9336.648,14,2396.665,LESS,-1086,4386,3300,4,1,-7.0,-0.6561859224721414,7.0,-0.34921514788478913,-0.4895059249924924,0.6588720678203478,227,117,110,0,1.3363168412821769,1.4436173506005987,1.170500554541026,0.014162449703845685,-0.001675686966922473,0.001675686966922473,1.170500554541026,1.4436173506005987,1,1,1,2,1.4436173506005987,1.170500554541026
5796,25,37,40,80,64,1,8353.089,24,1603.546,LESS,-1630,4494,2864,5,1,-16.0,-1.4998535370791803,16.0,1.222253017596762,0.2803592257165388,0.4040422086091923,144,80,64,0,-0.3191204397091766,0.0,-0.6242669624218805,0.5806604378576751,-0.33315703605994984,0.33315703605994984,-0.6242669624218805,0.0,1,1,0,1,0.0,-0.6242669624218805
5797,25,38,31,80,78,1,10986.937,24,3083.335,LESS,-1388,5656,4268,6,1,-2.0,-0.18748169213489754,2.0,-1.222253017596762,0.2803592257165388,1.0864447030437752,158,80,78,0,-0.03989005496364707,0.0,-0.07803337030273506,1.1471584260115046,-0.18569658297077224,0.18569658297077224,-0.07803337030273506,0.0,1,1,1,1,0.0,-0.07803337030273506
5798,25,39,46,124,110,1,3494.054,34,2710.315,LESS,-704,2282,1578,4,1,-14.0,-1.3123718449442827,14.0,0.8730378697119728,1.05022437642557,-0.8548829854585531,234,124,110,0,1.4759320336549415,1.7167341466601715,1.170500554541026,0.014162449703845685,0.23109246625649016,0.23109246625649016,1.170500554541026,1.7167341466601715,1,1,1,2,1.7167341466601715,1.170500554541026
5799,25,40,58,92,110,0,5148.55,44,2518.615,LESS,-2470,3524,1054,3,1,18.0,1.6873352292140782,18.0,1.571468165481551,1.820089527134601,-0.4262203604961257,202,92,110,1,0.8376911542365885,0.4682002218164104,1.170500554541026,-0.5523355384499837,-0.8450032368653598,0.8450032368653598,1.170500554541026,0.4682002218164104,1,0,0,2,1.170500554541026,0.4682002218164104
5800,25,41,49,110,131,1,2573.855,34,1426.429,MORE,8,1078,1086,3,1,21.0,1.9685577674164243,21.0,2.0952908873087353,1.05022437642557,-1.0932969307493248,241,110,131,0,1.6155472260277064,1.170500554541026,1.9898509427197442,-0.5523355384499837,0.6649430555105995,0.6649430555105995,1.9898509427197442,1.170500554541026,1,0,1,2,1.9898509427197442,1.170500554541026
5801,25,42,13,47,50,1,2276.933,34,1358.422,MORE,94,968,1062,3,2,3.0,0.28122253820234633,3.0,-1.0476454436543674,1.05022437642557,-1.1702263182661845,97,47,50,0,-1.2565367313548828,-1.2875506099951286,-1.170500554541026,-0.5523355384499837,0.7173463570216296,0.7173463570216296,-1.170500554541026,-1.2875506099951286,1,0,1,0,-1.2875506099951286,-1.170500554541026
5802,25,43,16,50,44,0,6313.423000000002,24,2465.487,MORE,-3014,4864,1850,5,1,-6.0,-0.5624450764046927,6.0,-0.5238227218271837,0.2803592257165388,-0.12441393852359847,94,50,44,1,-1.3163718138003533,-1.170500554541026,-1.4046006654492311,0.5806604378576751,-1.1764845859583872,1.1764845859583872,-1.4046006654492311,-1.170500554541026,1,1,0,0,-1.170500554541026,-1.4046006654492311
5803,25,44,7,57,50,0,4063.28,24,1591.708,MORE,-1646,2682,1036,4,1,-7.0,-0.6561859224721414,7.0,-0.34921514788478913,0.2803592257165388,-0.7074024769793167,107,57,50,1,-1.0570864565366473,-0.8973837584814532,-1.170500554541026,0.014162449703845685,-0.34290648750386243,0.34290648750386243,-1.170500554541026,-0.8973837584814532,1,1,0,0,-0.8973837584814532,-1.170500554541026
5804,25,45,18,42,50,1,2272.777,24,3530.791,MORE,184,926,1110,3,2,8.0,0.7499267685395902,8.0,-0.17460757394239454,0.2803592257165388,-1.1713030944381086,92,42,50,0,-1.3562618687640005,-1.4826340357519663,-1.170500554541026,-0.5523355384499837,0.7721870213936378,0.7721870213936378,-1.170500554541026,-1.4826340357519663,1,0,1,0,-1.4826340357519663,-1.170500554541026
5805,25,46,51,108,110,1,7273.913,34,1492.131,MORE,418,3094,3512,5,2,2.0,0.18748169213489754,2.0,-1.222253017596762,1.05022437642557,0.12443898384681587,218,108,110,0,1.156811593945765,1.092467184238291,1.170500554541026,0.5806604378576751,0.9147727487608591,0.9147727487608591,1.170500554541026,1.092467184238291,1,1,1,2,1.170500554541026,1.092467184238291
5806,25,47,31,78,80,0,7112.3290000000015,24,1337.695,MORE,-3632,4984,1352,4,1,2.0,0.18748169213489754,2.0,-1.222253017596762,0.2803592257165388,0.0825742579170294,158,78,80,0,-0.03989005496364707,-0.07803337030273506,0.0,0.014162449703845685,-1.5530571479795103,1.5530571479795103,0.0,-0.07803337030273506,0,1,0,1,-0.07803337030273506,0.0
5807,25,48,58,110,92,0,4954.129,34,1501.5870000000002,MORE,416,1594,2010,3,1,-18.0,-1.6873352292140782,18.0,1.571468165481551,1.05022437642557,-0.476592809996046,202,110,92,1,0.8376911542365885,1.170500554541026,0.4682002218164104,-0.5523355384499837,0.91355406733037,0.91355406733037,0.4682002218164104,1.170500554541026,1,0,1,2,1.170500554541026,0.4682002218164104
5808,25,49,12,50,48,0,7277.991999999998,14,1677.0929999999996,MORE,-1418,3812,2394,6,1,-2.0,-0.18748169213489754,2.0,-1.222253017596762,-0.4895059249924924,0.1254958101233504,98,50,48,1,-1.2365917038730592,-1.170500554541026,-1.248533924843761,1.1471584260115046,-0.2039768044281083,0.2039768044281083,-1.248533924843761,-1.170500554541026,0,1,0,0,-1.170500554541026,-1.248533924843761
5809,25,50,54,110,101,1,10290.151,24,2059.916,MORE,-22,3892,3870,6,2,-9.0,-0.8436676146070391,9.0,0.0,0.2803592257165388,0.9059147315013416,211,110,101,1,1.0171964015730004,1.170500554541026,0.8193503881787182,1.1471584260115046,0.6466628340532634,0.6466628340532634,0.8193503881787182,1.170500554541026,1,1,1,2,1.170500554541026,0.8193503881787182
5810,25,51,14,46,50,1,2719.824,34,2030.219,MORE,242,1012,1254,3,2,4.0,0.3749633842697951,4.0,-0.8730378697119728,1.05022437642557,-1.055477888150769,96,46,50,0,-1.2764817588367063,-1.3265672951464962,-1.170500554541026,-0.5523355384499837,0.8075287828778208,0.8075287828778208,-1.170500554541026,-1.3265672951464962,1,0,1,0,-1.3265672951464962,-1.170500554541026
5811,25,52,22,80,83,0,4433.277,34,1159.777,MORE,-630,2454,1824,4,1,3.0,0.28122253820234633,3.0,-1.0476454436543674,1.05022437642557,-0.6115401205588579,163,80,83,0,0.05983508244547061,0.0,0.1170500554541026,0.014162449703845685,0.2761836791845858,0.2761836791845858,0.1170500554541026,0.0,1,1,0,1,0.1170500554541026,0.0
5812,25,53,6,50,56,1,2834.5370000000007,24,1222.892,MORE,-474,1514,1040,3,2,6.0,0.5624450764046927,6.0,-0.5238227218271837,0.2803592257165388,-1.0257569485429878,106,50,56,0,-1.077031484018471,-1.170500554541026,-0.9364004436328208,-0.5523355384499837,0.37124083076273334,0.37124083076273334,-0.9364004436328208,-1.170500554541026,0,0,1,0,-1.170500554541026,-0.9364004436328208
5813,25,54,13,50,47,1,3205.1620000000007,34,2266.878,MORE,614,1092,1706,3,2,-3.0,-0.28122253820234633,3.0,-1.0476454436543674,1.05022437642557,-0.9297318838848082,97,50,47,1,-1.2565367313548828,-1.170500554541026,-1.2875506099951286,-0.5523355384499837,1.034203528948788,1.034203528948788,-1.2875506099951286,-1.170500554541026,1,0,1,0,-1.170500554541026,-1.2875506099951286
5814,25,55,46,110,124,1,7905.951,20,1787.94,MORE,-3608,4912,1304,3,1,14.0,1.3123718449442827,14.0,0.8730378697119728,-0.027586834567073684,0.2881934251727562,234,110,124,0,1.4759320336549415,1.170500554541026,1.7167341466601715,-0.5523355384499837,-1.5384329708136413,1.5384329708136413,1.7167341466601715,1.170500554541026,0,0,0,2,1.7167341466601715,1.170500554541026
5815,25,56,27,91,80,0,9726.995,34,1987.922,MORE,1748,3436,5184,4,1,-11.0,-1.0311493067419364,11.0,0.34921514788478913,1.05022437642557,0.7600068965937079,171,91,80,1,0.21939530230005888,0.4291835366650429,0.0,0.014162449703845685,1.7251959000360915,1.7251959000360915,0.0,0.4291835366650429,1,1,1,1,0.4291835366650429,0.0
5816,25,57,40,64,80,1,5668.465,24,2603.55,MORE,-438,2758,2320,5,2,16.0,1.4998535370791803,16.0,1.222253017596762,0.2803592257165388,-0.29151581684214256,144,64,80,0,-0.3191204397091766,-0.6242669624218805,0.0,0.5806604378576751,0.39317709651153665,0.39317709651153665,0.0,-0.6242669624218805,0,1,1,1,-0.6242669624218805,0.0
5817,25,58,22,83,80,1,6087.764,24,1042.571,MORE,-306,2786,2480,4,2,-3.0,-0.28122253820234633,3.0,-1.0476454436543674,0.2803592257165388,-0.18287982740238515,163,83,80,1,0.05983508244547061,0.1170500554541026,0.0,0.014162449703845685,0.47361007092381535,0.47361007092381535,0.0,0.1170500554541026,0,1,1,1,0.1170500554541026,0.0
5818,25,59,54,101,110,1,5074.383,14,1146.652,MORE,-1440,2614,1174,3,2,9.0,0.8436676146070391,9.0,0.0,-0.4895059249924924,-0.4454362551888832,211,101,110,0,1.0171964015730004,0.8193503881787182,1.170500554541026,-0.5523355384499837,-0.21738230016348808,0.21738230016348808,1.170500554541026,0.8193503881787182,0,0,0,2,1.170500554541026,0.8193503881787182
5819,25,60,6,56,50,0,5837.491,24,1189.985,MORE,-1886,3652,1766,4,1,-6.0,-0.5624450764046927,6.0,-0.5238227218271837,0.2803592257165388,-0.2477229464774519,106,56,50,1,-1.077031484018471,-0.9364004436328208,-1.170500554541026,0.014162449703845685,-0.489148259162551,0.489148259162551,-1.170500554541026,-0.9364004436328208,0,1,0,0,-0.9364004436328208,-1.170500554541026
5820,25,61,18,50,42,0,10204.94,14,1141.0510000000004,MORE,-1392,5132,3740,4,1,-8.0,-0.7499267685395902,8.0,-0.17460757394239454,-0.4895059249924924,0.8838374518127398,92,50,42,1,-1.3562618687640005,-1.170500554541026,-1.4826340357519663,0.014162449703845685,-0.1881339458317504,0.1881339458317504,-1.4826340357519663,-1.170500554541026,0,1,0,0,-1.170500554541026,-1.4826340357519663
5821,25,62,43,110,117,1,4410.447,34,2333.203,MORE,124,1824,1948,2,2,7.0,0.6561859224721414,7.0,-0.34921514788478913,1.05022437642557,-0.6174551349970266,227,110,117,0,1.3363168412821769,1.170500554541026,1.4436173506005987,-1.1188335266038132,0.7356265784789656,0.7356265784789656,1.4436173506005987,1.170500554541026,1,0,1,2,1.4436173506005987,1.170500554541026
5822,25,63,32,77,80,1,3228.403,14,2035.005,MORE,-436,1550,1114,2,1,3.0,0.28122253820234633,3.0,-1.0476454436543674,-0.4895059249924924,-0.9237103836413798,157,77,80,0,-0.05983508244547061,-0.1170500554541026,0.0,-1.1188335266038132,0.3943957779420257,0.3943957779420257,0.0,-0.1170500554541026,0,0,1,1,-0.1170500554541026,0.0
5823,25,64,27,80,91,1,3140.789,24,1115.687,MORE,-836,1976,1140,3,2,11.0,1.0311493067419364,11.0,0.34921514788478913,0.2803592257165388,-0.9464102555198599,171,80,91,0,0.21939530230005888,0.0,0.4291835366650429,-0.5523355384499837,0.15065949184421143,0.15065949184421143,0.4291835366650429,0.0,0,0,0,1,0.4291835366650429,0.0
5824,25,65,16,44,50,1,5966.109,34,1391.48,MORE,-172,2594,2422,5,2,6.0,0.5624450764046927,6.0,-0.5238227218271837,1.05022437642557,-0.214399366669814,94,44,50,0,-1.3163718138003533,-1.4046006654492311,-1.170500554541026,0.5806604378576751,0.5552617267665831,0.5552617267665831,-1.170500554541026,-1.4046006654492311,1,1,1,0,-1.4046006654492311,-1.170500554541026
5825,25,66,7,50,57,1,2245.362,34,1066.58,MORE,-334,1380,1046,3,1,7.0,0.6561859224721414,7.0,-0.34921514788478913,1.05022437642557,-1.1784060344653706,107,50,57,0,-1.0570864565366473,-1.170500554541026,-0.8973837584814532,-0.5523355384499837,0.45654853089696834,0.45654853089696834,-0.8973837584814532,-1.170500554541026,1,1,1,0,-1.170500554541026,-0.8973837584814532
5826,25,67,14,50,46,1,5074.143,4,2324.733,MORE,-716,3040,2324,5,1,-4.0,-0.3749633842697951,4.0,-0.8730378697119728,-1.2593710757015233,-0.4454984366810058,96,50,46,1,-1.2764817588367063,-1.170500554541026,-1.3265672951464962,0.5806604378576751,0.2237803776735557,0.2237803776735557,-1.3265672951464962,-1.170500554541026,0,1,0,0,-1.170500554541026,-1.3265672951464962
5827,25,68,51,110,108,0,3602.406,34,796.659,MORE,-718,2020,1302,2,1,-2.0,-0.18748169213489754,2.0,-1.222253017596762,1.05022437642557,-0.8268101144815735,218,110,108,1,1.156811593945765,1.170500554541026,1.092467184238291,-1.1188335266038132,0.22256169624306665,0.22256169624306665,1.092467184238291,1.170500554541026,1,0,0,2,1.170500554541026,1.092467184238291
5828,25,69,50,133,110,0,6713.8809999999985,34,1253.795,MORE,-844,3146,2302,3,1,-23.0,-2.1560394595513217,23.0,2.444506035193524,1.05022437642557,-0.020659455305021675,243,133,110,1,1.6554372809913533,2.0678843130224793,1.170500554541026,-0.5523355384499837,0.14578476612225516,0.14578476612225516,1.170500554541026,2.0678843130224793,1,0,0,2,2.0678843130224793,1.170500554541026
5829,25,70,49,131,110,0,8546.707,14,1677.506,MORE,-616,3454,2838,2,1,-21.0,-1.9685577674164243,21.0,2.0952908873087353,-0.4895059249924924,0.4542066092000523,241,131,110,1,1.6155472260277064,1.9898509427197442,1.170500554541026,-1.1188335266038132,0.28471444919800926,0.28471444919800926,1.170500554541026,1.9898509427197442,0,0,0,2,1.9898509427197442,1.170500554541026
5830,25,71,47,126,110,1,8338.258,14,1856.842,MORE,2544,1768,4312,3,1,-16.0,-1.4998535370791803,16.0,1.222253017596762,-0.4895059249924924,0.400199651485562,236,126,110,1,1.5158220886185887,1.7947675169629065,1.170500554541026,-0.5523355384499837,2.210231109370742,2.210231109370742,1.170500554541026,1.7947675169629065,0,0,1,2,1.7947675169629065,1.170500554541026
5831,25,72,50,110,133,1,2436.319,24,1777.136,MORE,-128,1284,1156,3,1,23.0,2.1560394595513217,23.0,2.444506035193524,0.2803592257165388,-1.1289310711684208,243,110,133,0,1.6554372809913533,1.170500554541026,2.0678843130224793,-0.5523355384499837,0.5820727182373426,0.5820727182373426,2.0678843130224793,1.170500554541026,1,1,1,2,2.0678843130224793,1.170500554541026
5832,25,73,47,110,126,1,4491.683,34,1345.583,MORE,-80,1894,1814,2,2,16.0,1.4998535370791803,16.0,1.222253017596762,1.05022437642557,-0.5964077362717062,236,110,126,0,1.5158220886185887,1.170500554541026,1.7947675169629065,-1.1188335266038132,0.6113210725690804,0.6113210725690804,1.7947675169629065,1.170500554541026,1,0,1,2,1.7947675169629065,1.170500554541026
5833,25,74,12,48,50,1,6058.228,24,1096.328,MORE,-624,2828,2204,4,2,2.0,0.18748169213489754,2.0,-1.222253017596762,0.2803592257165388,-0.19053229636628127,98,48,50,0,-1.2365917038730592,-1.248533924843761,-1.170500554541026,0.014162449703845685,0.279839723476053,0.279839723476053,-1.170500554541026,-1.248533924843761,1,1,0,0,-1.248533924843761,-1.170500554541026
5834,25,75,32,80,77,0,9096.82,4,2734.943,MORE,-3948,7076,3128,6,1,-3.0,-0.28122253820234633,3.0,-1.0476454436543674,-1.2593710757015233,0.5967351391003697,157,80,77,1,-0.05983508244547061,0.0,-0.1170500554541026,1.1471584260115046,-1.7456088139967836,1.7456088139967836,-0.1170500554541026,0.0,0,1,0,1,0.0,-0.1170500554541026
5835,25,76,43,117,110,1,8202.511,14,1461.689,MORE,-1684,4012,2328,3,1,-7.0,-0.6561859224721414,7.0,-0.34921514788478913,-0.4895059249924924,0.3650290222723307,227,117,110,1,1.3363168412821769,1.4436173506005987,1.170500554541026,-0.5523355384499837,-0.3660614346831548,0.3660614346831548,1.170500554541026,1.4436173506005987,0,0,0,2,1.4436173506005987,1.170500554541026
5836,25,77,40,80,64,0,4408.043,24,1101.58,MORE,-1000,2686,1686,4,1,-16.0,-1.4998535370791803,16.0,1.222253017596762,0.2803592257165388,-0.6180779862764555,144,80,64,1,-0.3191204397091766,0.0,-0.6242669624218805,0.014162449703845685,0.05072761454410759,0.05072761454410759,-0.6242669624218805,0.0,1,1,0,1,0.0,-0.6242669624218805
5837,25,78,31,80,78,1,8096.268,24,1479.6070000000002,MORE,774,2646,3420,3,2,-2.0,-0.18748169213489754,2.0,-1.222253017596762,0.2803592257165388,0.3375025711573789,158,80,78,1,-0.03989005496364707,0.0,-0.07803337030273506,-0.5523355384499837,1.1316980433879138,1.1316980433879138,-0.07803337030273506,0.0,1,0,1,1,0.0,-0.07803337030273506
5838,25,79,46,124,110,0,9448.103,14,3251.85,MORE,-476,4432,3956,6,1,-14.0,-1.3123718449442827,14.0,0.8730378697119728,-0.4895059249924924,0.6877488936725634,234,124,110,1,1.4759320336549415,1.7167341466601715,1.170500554541026,1.1471584260115046,0.37002214933224425,0.37002214933224425,1.170500554541026,1.7167341466601715,0,1,1,2,1.7167341466601715,1.170500554541026
5839,25,80,58,92,110,1,2913.902,34,1859.341,MORE,-404,1600,1196,3,2,18.0,1.6873352292140782,18.0,1.571468165481551,1.05022437642557,-1.005194306366674,202,92,110,0,0.8376911542365885,0.4682002218164104,1.170500554541026,-0.5523355384499837,0.4138946808298508,0.4138946808298508,1.170500554541026,0.4682002218164104,1,0,1,2,1.170500554541026,0.4682002218164104
5840,25,81,48,128,110,1,5272.922,14,984.661,LESS,-1418,3064,1646,3,1,-18.0,-1.6873352292140782,18.0,1.571468165481551,-0.4895059249924924,-0.3939968749199582,238,128,110,0,1.5557121435822359,1.8728008872656416,1.170500554541026,-0.5523355384499837,-0.2039768044281083,0.2039768044281083,1.170500554541026,1.8728008872656416,1,0,0,2,1.8728008872656416,1.170500554541026
5841,25,82,8,50,58,0,3494.4990000000007,14,940.273,LESS,-1686,2668,982,4,1,8.0,0.7499267685395902,8.0,-0.17460757394239454,-0.4895059249924924,-0.8547676906085756,108,50,58,1,-1.0371414290548238,-1.170500554541026,-0.8583670733300858,0.014162449703845685,-0.36728011611364386,0.36728011611364386,-0.8583670733300858,-1.170500554541026,1,1,0,0,-1.170500554541026,-0.8583670733300858
5842,25,83,4,54,50,0,1748.989,14,1128.545,LESS,-1320,1790,470,2,1,-4.0,-0.3749633842697951,4.0,-0.8730378697119728,-0.4895059249924924,-1.3070110919212212,104,54,50,0,-1.116921538982118,-1.0144338139355558,-1.170500554541026,-1.1188335266038132,-0.14426141433414383,0.14426141433414383,-1.170500554541026,-1.0144338139355558,1,0,1,0,-1.0144338139355558,-1.170500554541026
5843,25,84,37,80,69,1,5231.227,24,1593.3270000000002,LESS,-678,3106,2428,5,1,-11.0,-1.0311493067419364,11.0,0.34921514788478913,0.2803592257165388,-0.4047996137285188,149,80,69,0,-0.21939530230005888,0.0,-0.4291835366650429,0.5806604378576751,0.24693532485284808,0.24693532485284808,-0.4291835366650429,0.0,1,1,1,1,0.0,-0.4291835366650429
5844,25,85,52,105,110,1,5080.765,0,1763.715,LESS,-750,3238,2488,5,1,5.0,0.4687042303372438,5.0,-0.6984302957695783,-1.5673171359851361,-0.4437827456775211,215,105,110,1,1.0969765115002945,0.9754171287841883,1.170500554541026,0.5806604378576751,0.2030627933552415,0.2030627933552415,1.170500554541026,0.9754171287841883,0,1,1,2,1.170500554541026,0.9754171287841883
5845,25,86,5,55,50,1,4836.0790000000015,34,1603.9979999999996,LESS,458,2164,2622,5,1,-5.0,-0.4687042303372438,5.0,-0.6984302957695783,1.05022437642557,-0.507178331433882,105,55,50,0,-1.0969765115002945,-0.9754171287841883,-1.170500554541026,0.5806604378576751,0.9391463773706406,0.9391463773706406,-1.170500554541026,-0.9754171287841883,1,1,1,0,-0.9754171287841883,-1.170500554541026
5846,25,87,30,96,80,1,4108.556,4,1052.647,LESS,-1306,2706,1400,3,1,-16.0,-1.4998535370791803,16.0,1.222253017596762,-1.2593710757015233,-0.6956719384903759,176,96,80,0,0.3191204397091766,0.6242669624218805,0.0,-0.5523355384499837,-0.13573064432072032,0.13573064432072032,0.0,0.6242669624218805,0,0,1,1,0.6242669624218805,0.0
5847,25,88,33,80,75,1,3867.341,24,1887.49,LESS,-708,2180,1472,5,1,-5.0,-0.4687042303372438,5.0,-0.6984302957695783,0.2803592257165388,-0.7581682244169129,155,80,75,0,-0.09972513740911768,0.0,-0.19508342575683765,0.5806604378576751,0.228655103395512,0.228655103395512,-0.19508342575683765,0.0,1,1,1,1,0.0,-0.19508342575683765
5848,25,89,48,110,128,0,4352.233,0,2435.416,LESS,-2406,3482,1076,4,1,18.0,1.6873352292140782,18.0,1.571468165481551,-1.5673171359851361,-0.6325377740904803,238,110,128,1,1.5557121435822359,1.170500554541026,1.8728008872656416,0.014162449703845685,-0.8060054310897096,0.8060054310897096,1.8728008872656416,1.170500554541026,0,1,0,2,1.8728008872656416,1.170500554541026
5849,25,90,9,59,50,1,6863.626,24,3318.672,LESS,-22,3726,3704,7,1,-9.0,-0.8436676146070391,9.0,0.0,0.2803592257165388,0.018137909436264758,109,59,50,0,-1.0171964015730004,-0.8193503881787182,-1.170500554541026,1.7136564141653339,0.6466628340532634,0.6466628340532634,-1.170500554541026,-0.8193503881787182,1,1,1,0,-0.8193503881787182,-1.170500554541026
5850,25,91,44,110,119,0,1729.7579999999996,14,2124.627,LESS,-1118,1476,358,2,1,9.0,0.8436676146070391,9.0,0.0,-0.4895059249924924,-1.3119936430671004,229,110,119,1,1.376206896245824,1.170500554541026,1.5216507209033339,-1.1188335266038132,-0.021174589854747614,0.021174589854747614,1.5216507209033339,1.170500554541026,1,0,1,2,1.5216507209033339,1.170500554541026
5851,25,92,2,52,50,1,10487.373,54,1960.654,LESS,-6710,8288,1578,3,2,-2.0,-0.18748169213489754,2.0,-1.222253017596762,2.589954677843632,0.9570128908322436,102,52,50,0,-1.156811593945765,-1.092467184238291,-1.170500554541026,-0.5523355384499837,-3.428607869502191,3.428607869502191,-1.170500554541026,-1.092467184238291,1,0,0,0,-1.092467184238291,-1.170500554541026
5852,25,93,8,58,50,1,9844.776,24,1707.2220000000002,LESS,1846,3188,5034,5,2,-8.0,-0.7499267685395902,8.0,-0.17460757394239454,0.2803592257165388,0.7905227229424566,108,58,50,0,-1.0371414290548238,-0.8583670733300858,-1.170500554541026,0.5806604378576751,1.7849112901300561,1.7849112901300561,-1.170500554541026,-0.8583670733300858,1,1,1,0,-0.8583670733300858,-1.170500554541026
5853,25,94,44,119,110,0,2258.015,0,1299.563,LESS,-2012,2484,472,2,1,-9.0,-0.8436676146070391,9.0,0.0,-1.5673171359851361,-1.1751277743827535,229,119,110,0,1.376206896245824,1.5216507209033339,1.170500554541026,-1.1188335266038132,-0.5659251892833624,0.5659251892833624,1.170500554541026,1.5216507209033339,0,0,0,2,1.5216507209033339,1.170500554541026
5854,25,95,34,74,80,0,7393.847,24,1526.868,LESS,-3890,5680,1790,4,1,6.0,0.5624450764046927,6.0,-0.5238227218271837,0.2803592257165388,0.15551262999781526,154,74,80,1,-0.11967016489094122,-0.2341001109082052,0.0,0.014162449703845685,-1.7102670525126005,1.7102670525126005,0.0,-0.2341001109082052,1,0,0,1,-0.2341001109082052,0.0
5855,25,96,24,86,80,0,4631.108,34,2791.27,LESS,-2822,3504,682,2,1,-6.0,-0.5624450764046927,6.0,-0.5238227218271837,1.05022437642557,-0.5602841756916949,166,86,80,0,0.11967016489094122,0.2341001109082052,0.0,-1.1188335266038132,-1.0594911686314363,1.0594911686314363,0.0,0.2341001109082052,1,0,0,1,0.2341001109082052,0.0
5856,25,97,39,66,80,0,6976.254,44,1668.703,LESS,-244,3462,3218,2,1,14.0,1.3123718449442827,14.0,0.8730378697119728,1.820089527134601,0.04731864733122984,146,66,80,1,-0.2792303847455295,-0.5462335921191455,0.0,-1.1188335266038132,0.5113891952689765,0.5113891952689765,0.0,-0.5462335921191455,1,0,1,1,-0.5462335921191455,0.0
5857,25,98,9,50,59,0,3445.728,44,1352.54,LESS,-1570,2310,740,2,1,9.0,0.8436676146070391,9.0,0.0,1.820089527134601,-0.867403747076553,109,50,59,1,-1.0171964015730004,-1.170500554541026,-0.8193503881787182,-1.1188335266038132,-0.29659659314527775,0.29659659314527775,-0.8193503881787182,-1.170500554541026,1,0,0,0,-1.170500554541026,-0.8193503881787182
5858,25,99,57,94,110,0,14442.578,24,1612.4129999999998,LESS,-3114,8082,4968,10,1,16.0,1.4998535370791803,16.0,1.222253017596762,0.2803592257165388,1.9817651764615336,204,94,110,1,0.8775812092002355,0.5462335921191455,1.170500554541026,3.4131503786268227,-1.2374186574828407,1.2374186574828407,1.170500554541026,0.5462335921191455,1,1,0,2,1.170500554541026,0.5462335921191455
5859,25,100,60,110,87,1,7163.538000000001,14,1199.874,LESS,1474,2612,4086,5,2,-23.0,-2.1560394595513217,23.0,2.444506035193524,-0.4895059249924924,0.09584197470915272,197,110,87,0,0.7379660168274708,1.170500554541026,0.27311679605957273,0.5806604378576751,1.5582365440590888,1.5582365440590888,0.27311679605957273,1.170500554541026,1,1,1,2,1.170500554541026,0.27311679605957273
5860,25,101,33,75,80,0,17352.241,14,2555.515,LESS,-3144,8478,5334,6,1,5.0,0.4687042303372438,5.0,-0.6984302957695783,-0.4895059249924924,2.7356284552703385,155,75,80,1,-0.09972513740911768,-0.19508342575683765,0.0,1.1471584260115046,-1.2556988789401768,1.2556988789401768,0.0,-0.19508342575683765,1,1,0,1,-0.19508342575683765,0.0
5861,25,102,15,50,45,1,12157.872,44,1685.624,LESS,-3274,6240,2966,4,2,-5.0,-0.4687042303372438,5.0,-0.6984302957695783,1.820089527134601,1.3898217258715002,95,50,45,0,-1.2964267863185297,-1.170500554541026,-1.3655839802978638,0.014162449703845685,-1.3349131719219665,1.3349131719219665,-1.3655839802978638,-1.170500554541026,1,0,0,0,-1.170500554541026,-1.3655839802978638
5862,25,103,59,89,110,0,6527.306,14,1395.246,LESS,-880,3510,2630,4,1,21.0,1.9685577674164243,21.0,2.0952908873087353,-0.4895059249924924,-0.06899908819163153,199,89,110,1,0.7778560717911179,0.3511501663623078,1.170500554541026,0.014162449703845685,0.12384850037345187,0.12384850037345187,1.170500554541026,0.3511501663623078,1,0,1,2,1.170500554541026,0.3511501663623078
5863,25,104,29,80,94,0,10886.82,24,2275.221,LESS,-2690,5952,3262,5,1,14.0,1.3123718449442827,14.0,0.8730378697119728,0.2803592257165388,1.0605054345152545,174,80,94,1,0.2792303847455295,0.0,0.5462335921191455,0.5806604378576751,-0.9790581942191576,0.9790581942191576,0.5462335921191455,0.0,1,1,0,1,0.5462335921191455,0.0
5864,25,105,55,110,98,1,4584.629,24,1873.459,LESS,-1244,2800,1556,2,1,-12.0,-1.124890152809385,12.0,0.5238227218271837,0.2803592257165388,-0.5723263989099008,208,110,98,0,0.9573613191275298,1.170500554541026,0.7023003327246156,-1.1188335266038132,-0.0979515199755591,0.0979515199755591,0.7023003327246156,1.170500554541026,1,0,1,2,1.170500554541026,0.7023003327246156
5865,25,106,29,94,80,1,4392.289000000002,34,4422.0329999999985,LESS,1728,990,2718,3,2,-14.0,-1.3123718449442827,14.0,0.8730378697119728,1.05022437642557,-0.6221596830552071,174,94,80,0,0.2792303847455295,0.5462335921191455,0.0,-0.5523355384499837,1.7130090857312008,1.7130090857312008,0.0,0.5462335921191455,1,0,1,1,0.5462335921191455,0.0
5866,25,107,57,110,94,1,3026.2209999999995,34,1172.2,LESS,486,1222,1708,3,2,-16.0,-1.4998535370791803,16.0,1.222253017596762,1.05022437642557,-0.9760936271428168,204,110,94,0,0.8775812092002355,1.170500554541026,0.5462335921191455,-0.5523355384499837,0.9562079173974876,0.9562079173974876,0.5462335921191455,1.170500554541026,1,0,1,2,1.170500554541026,0.5462335921191455
5867,25,108,39,80,66,1,2553.148,24,1519.703,LESS,464,1024,1488,3,2,-14.0,-1.3123718449442827,14.0,0.8730378697119728,0.2803592257165388,-1.0986618980717584,146,80,66,0,-0.2792303847455295,0.0,-0.5462335921191455,-0.5523355384499837,0.9428024216621078,0.9428024216621078,-0.5462335921191455,0.0,1,0,1,1,0.0,-0.5462335921191455
5868,25,109,4,50,54,0,12648.333,34,1541.418,LESS,-1436,6294,4858,6,1,4.0,0.3749633842697951,4.0,-0.8730378697119728,1.05022437642557,1.5168950459047297,104,50,54,1,-1.116921538982118,-1.170500554541026,-1.0144338139355558,1.1471584260115046,-0.21494493730250996,0.21494493730250996,-1.0144338139355558,-1.170500554541026,1,1,0,0,-1.170500554541026,-1.0144338139355558
5869,25,110,55,98,110,0,14784.401000000002,0,1745.071,LESS,-3716,8974,5258,6,1,12.0,1.124890152809385,12.0,0.5238227218271837,-1.5673171359851361,2.070327943885893,208,98,110,1,0.9573613191275298,0.7023003327246156,1.170500554541026,1.1471584260115046,-1.6042417680600511,1.6042417680600511,1.170500554541026,0.7023003327246156,0,1,0,2,1.170500554541026,0.7023003327246156
5870,25,111,2,50,52,1,9254.688,4,1264.751,LESS,-1948,5216,3268,6,1,2.0,0.18748169213489754,2.0,-1.222253017596762,-1.2593710757015233,0.6376370882604575,102,50,52,1,-1.156811593945765,-1.170500554541026,-1.092467184238291,1.1471584260115046,-0.5269273835077122,0.5269273835077122,-1.092467184238291,-1.170500554541026,0,1,0,0,-1.170500554541026,-1.092467184238291
5871,25,112,59,110,89,1,6988.265,24,1875.113,LESS,-156,3196,3040,5,2,-21.0,-1.9685577674164243,21.0,2.0952908873087353,0.2803592257165388,0.05043057192241888,199,110,89,0,0.7778560717911179,1.170500554541026,0.3511501663623078,0.5806604378576751,0.5650111782104957,0.5650111782104957,0.3511501663623078,1.170500554541026,1,1,1,2,1.170500554541026,0.3511501663623078
5872,25,113,60,87,110,0,4438.115,24,2114.827,LESS,-462,2242,1780,1,1,23.0,2.1560394595513217,23.0,2.444506035193524,0.2803592257165388,-0.6102866453134853,197,87,110,1,0.7379660168274708,0.27311679605957273,1.170500554541026,-1.6853315147576426,0.37855291934566776,0.37855291934566776,1.170500554541026,0.27311679605957273,1,0,1,2,1.170500554541026,0.27311679605957273
5873,25,114,52,110,105,0,13030.08,4,2403.75,LESS,-2792,7296,4504,6,1,-5.0,-0.4687042303372438,5.0,-0.6984302957695783,-1.2593710757015233,1.6158017045436937,215,110,105,0,1.0969765115002945,1.170500554541026,0.9754171287841883,1.1471584260115046,-1.0412109471741002,1.0412109471741002,0.9754171287841883,1.170500554541026,0,1,0,2,1.170500554541026,0.9754171287841883
5874,25,115,30,80,96,0,4169.67,24,4132.7829999999985,LESS,-3372,4248,876,2,1,16.0,1.4998535370791803,16.0,1.222253017596762,0.2803592257165388,-0.6798379397004399,176,80,96,1,0.3191204397091766,0.0,0.6242669624218805,-1.1188335266038132,-1.3946285620159309,1.3946285620159309,0.6242669624218805,0.0,1,0,0,1,0.6242669624218805,0.0
5875,25,116,24,80,86,1,14829.522,14,2490.427,LESS,670,5880,6550,8,1,6.0,0.5624450764046927,6.0,-0.5238227218271837,-0.4895059249924924,2.082018323494504,166,80,86,1,0.11967016489094122,0.0,0.2341001109082052,2.2801544023191638,1.068326609002482,1.068326609002482,0.2341001109082052,0.0,1,1,1,1,0.2341001109082052,0.0
5876,25,117,5,50,55,0,4997.609,24,1149.592,LESS,-72,2196,2124,4,1,5.0,0.4687042303372438,5.0,-0.6984302957695783,0.2803592257165388,-0.4653275963398229,105,50,55,1,-1.0969765115002945,-1.170500554541026,-0.9754171287841883,0.014162449703845685,0.6161957982910367,0.6161957982910367,-0.9754171287841883,-1.170500554541026,1,1,1,0,-1.170500554541026,-0.9754171287841883
5877,25,118,34,80,74,1,12149.061000000003,0,1045.568,LESS,-1758,5734,3976,8,1,-6.0,-0.5624450764046927,6.0,-0.5238227218271837,-1.5673171359851361,1.387538887841948,154,80,74,0,-0.11967016489094122,0.0,-0.2341001109082052,2.2801544023191638,-0.4111526476112504,0.4111526476112504,-0.2341001109082052,0.0,0,1,0,1,0.0,-0.2341001109082052
5878,25,119,15,45,50,1,9155.211,24,2075.681,LESS,-244,4364,4120,7,2,5.0,0.4687042303372438,5.0,-0.6984302957695783,0.2803592257165388,0.6118636370442638,95,45,50,1,-1.2964267863185297,-1.3655839802978638,-1.170500554541026,1.7136564141653339,0.5113891952689765,0.5113891952689765,-1.170500554541026,-1.3655839802978638,1,1,1,0,-1.3655839802978638,-1.170500554541026
5879,25,120,37,69,80,0,7639.21,4,2263.74,LESS,-3266,5704,2438,6,1,11.0,1.0311493067419364,11.0,0.34921514788478913,-1.2593710757015233,0.2190836193798725,149,69,80,1,-0.21939530230005888,-0.4291835366650429,0.0,1.1471584260115046,-1.33003844620001,1.33003844620001,0.0,-0.4291835366650429,0,1,0,1,-0.4291835366650429,0.0
5880,25,121,48,128,110,0,6615.136,24,1679.148,MORE,-1864,3748,1884,4,1,-18.0,-1.6873352292140782,18.0,1.571468165481551,0.2803592257165388,-0.046243252970240616,238,128,110,1,1.5557121435822359,1.8728008872656416,1.170500554541026,0.014162449703845685,-0.4757427634271712,0.4757427634271712,1.170500554541026,1.8728008872656416,0,1,0,2,1.8728008872656416,1.170500554541026
5881,25,122,8,50,58,1,5430.728,24,1258.232,MORE,2166,1266,3432,3,2,8.0,0.7499267685395902,8.0,-0.17460757394239454,0.2803592257165388,-0.35311098931200197,108,50,58,0,-1.0371414290548238,-1.170500554541026,-0.8583670733300858,-0.5523355384499837,1.9799003190083075,1.9799003190083075,-0.8583670733300858,-1.170500554541026,1,1,1,0,-1.170500554541026,-0.8583670733300858
5882,25,123,4,54,50,0,7244.234,34,2447.712,MORE,-2532,4742,2210,7,2,-4.0,-0.3749633842697951,4.0,-0.8730378697119728,1.05022437642557,0.1167494650771969,104,54,50,1,-1.116921538982118,-1.0144338139355558,-1.170500554541026,1.7136564141653339,-0.882782361210521,0.882782361210521,-1.170500554541026,-1.0144338139355558,1,1,0,0,-1.0144338139355558,-1.170500554541026
5883,25,124,37,80,69,0,9260.72,14,1195.417,MORE,-1420,4370,2950,6,1,-11.0,-1.0311493067419364,11.0,0.34921514788478913,-0.4895059249924924,0.6391999164291403,149,80,69,1,-0.21939530230005888,0.0,-0.4291835366650429,1.1471584260115046,-0.20519548585859737,0.20519548585859737,-0.4291835366650429,0.0,0,1,0,1,0.0,-0.4291835366650429
5884,25,125,52,105,110,1,6270.738,24,2253.867,MORE,-54,2596,2542,3,2,5.0,0.4687042303372438,5.0,-0.6984302957695783,0.2803592257165388,-0.1354731759871655,215,105,110,0,1.0969765115002945,0.9754171287841883,1.170500554541026,-0.5523355384499837,0.6271639311654383,0.6271639311654383,1.170500554541026,0.9754171287841883,1,0,1,2,1.170500554541026,0.9754171287841883
5885,25,126,5,55,50,0,9983.241,4,1230.641,MORE,-1748,5248,3500,6,1,-5.0,-0.4687042303372438,5.0,-0.6984302957695783,-1.2593710757015233,0.8263975575539774,105,55,50,1,-1.0969765115002945,-0.9754171287841883,-1.170500554541026,1.1471584260115046,-0.4050592404588051,0.4050592404588051,-1.170500554541026,-0.9754171287841883,0,1,0,0,-0.9754171287841883,-1.170500554541026
5886,25,127,30,96,80,0,6964.184,24,1683.3770000000004,MORE,530,2716,3246,3,1,-16.0,-1.4998535370791803,16.0,1.222253017596762,0.2803592257165388,0.04419143645656083,176,96,80,1,0.3191204397091766,0.6242669624218805,0.0,-0.5523355384499837,0.9830189088682472,0.9830189088682472,0.0,0.6242669624218805,1,0,1,1,0.6242669624218805,0.0
5887,25,128,33,80,75,0,2931.4709999999995,24,1169.441,MORE,-392,1644,1252,2,1,-5.0,-0.4687042303372438,5.0,-0.6984302957695783,0.2803592257165388,-1.0006423620537443,155,80,75,1,-0.09972513740911768,0.0,-0.19508342575683765,-1.1188335266038132,0.4212067694127853,0.4212067694127853,-0.19508342575683765,0.0,1,0,1,1,0.0,-0.19508342575683765
5888,25,129,48,110,128,1,5759.629,24,1341.828,MORE,356,2562,2918,3,2,18.0,1.6873352292140782,18.0,1.571468165481551,0.2803592257165388,-0.2678961770593479,238,110,128,0,1.5557121435822359,1.170500554541026,1.8728008872656416,-0.5523355384499837,0.876993624415698,0.876993624415698,1.8728008872656416,1.170500554541026,0,1,1,2,1.8728008872656416,1.170500554541026
5889,25,130,9,59,50,0,3920.8,44,1735.616,MORE,122,1816,1938,4,1,-9.0,-0.8436676146070391,9.0,0.0,1.820089527134601,-0.7443175561361395,109,59,50,1,-1.0171964015730004,-0.8193503881787182,-1.170500554541026,0.014162449703845685,0.7344078970484766,0.7344078970484766,-1.170500554541026,-0.8193503881787182,1,1,1,0,-0.8193503881787182,-1.170500554541026
5890,25,131,44,110,119,1,10235.104,24,1274.908,MORE,158,4458,4616,4,2,9.0,0.8436676146070391,9.0,0.0,0.2803592257165388,0.8916526290143566,229,110,119,0,1.376206896245824,1.170500554541026,1.5216507209033339,0.014162449703845685,0.7563441627972799,0.7563441627972799,1.5216507209033339,1.170500554541026,0,1,1,2,1.5216507209033339,1.170500554541026
5891,25,132,2,52,50,1,7471.273,0,2802.17,MORE,-1684,5190,3506,3,1,-2.0,-0.18748169213489754,2.0,-1.222253017596762,-1.5673171359851361,0.17557289753568847,102,52,50,1,-1.156811593945765,-1.092467184238291,-1.170500554541026,-0.5523355384499837,-0.3660614346831548,0.3660614346831548,-1.170500554541026,-1.092467184238291,0,1,0,0,-1.092467184238291,-1.170500554541026
5892,25,133,8,58,50,0,4530.887,24,1076.717,MORE,-1116,2504,1388,4,1,-8.0,-0.7499267685395902,8.0,-0.17460757394239454,0.2803592257165388,-0.5862503895334688,108,58,50,1,-1.0371414290548238,-0.8583670733300858,-1.170500554541026,0.014162449703845685,-0.019955908424258543,0.019955908424258543,-1.170500554541026,-0.8583670733300858,0,1,0,0,-0.8583670733300858,-1.170500554541026
5893,25,134,44,119,110,0,4484.656,44,1049.6660000000004,MORE,-2348,3460,1112,2,1,-9.0,-0.8436676146070391,9.0,0.0,1.820089527134601,-0.5982283585431478,229,119,110,1,1.376206896245824,1.5216507209033339,1.170500554541026,-1.1188335266038132,-0.7706636696055265,0.7706636696055265,1.170500554541026,1.5216507209033339,1,0,0,2,1.5216507209033339,1.170500554541026
5894,25,135,34,74,80,1,9936.325,34,2466.375,MORE,1412,3994,5406,7,2,6.0,0.5624450764046927,6.0,-0.5238227218271837,1.05022437642557,0.8142421122021983,154,74,80,0,-0.11967016489094122,-0.2341001109082052,0.0,1.7136564141653339,1.5204574197139276,1.5204574197139276,0.0,-0.2341001109082052,1,1,1,1,-0.2341001109082052,0.0
5895,25,136,24,86,80,0,16153.568,44,2413.943,MORE,4728,4864,9592,6,1,-6.0,-0.5624450764046927,6.0,-0.5238227218271837,1.820089527134601,2.425064806490535,166,86,80,1,0.11967016489094122,0.2341001109082052,0.0,1.1471584260115046,3.5410312314648076,3.5410312314648076,0.0,0.2341001109082052,1,1,1,1,0.2341001109082052,0.0
5896,25,137,39,66,80,1,3876.481,34,1392.611,MORE,504,1434,1938,2,2,14.0,1.3123718449442827,14.0,0.8730378697119728,1.05022437642557,-0.7558001459252414,146,66,80,0,-0.2792303847455295,-0.5462335921191455,0.0,-1.1188335266038132,0.9671760502718892,0.9671760502718892,0.0,-0.5462335921191455,1,0,1,1,-0.5462335921191455,0.0
5897,25,138,9,50,59,1,5081.794,24,1174.178,MORE,1024,1918,2942,4,1,9.0,0.8436676146070391,9.0,0.0,0.2803592257165388,-0.4435161425300453,109,50,59,0,-1.0171964015730004,-1.170500554541026,-0.8193503881787182,0.014162449703845685,1.2840332221990478,1.2840332221990478,-0.8193503881787182,-1.170500554541026,0,1,1,0,-1.170500554541026,-0.8193503881787182
5898,25,139,57,94,110,1,7911.395,24,1390.965,MORE,-856,3558,2702,3,1,16.0,1.4998535370791803,16.0,1.222253017596762,0.2803592257165388,0.2896039086857388,204,94,110,0,0.8775812092002355,0.5462335921191455,1.170500554541026,-0.5523355384499837,0.13847267753932072,0.13847267753932072,1.170500554541026,0.5462335921191455,0,0,0,2,1.170500554541026,0.5462335921191455
5899,25,140,60,110,87,0,3683.951,44,1821.658,MORE,-518,1980,1462,2,1,-23.0,-2.1560394595513217,23.0,2.444506035193524,1.820089527134601,-0.8056826570851452,197,110,87,1,0.7379660168274708,1.170500554541026,0.27311679605957273,-1.1188335266038132,0.3444298392919738,0.3444298392919738,0.27311679605957273,1.170500554541026,1,0,1,2,1.170500554541026,0.27311679605957273
5900,25,141,33,75,80,1,10024.49,14,1966.396,MORE,322,4580,4902,4,1,5.0,0.4687042303372438,5.0,-0.6984302957695783,-0.4895059249924924,0.83708474242301,155,75,80,0,-0.09972513740911768,-0.19508342575683765,0.0,0.014162449703845685,0.8562760400973837,0.8562760400973837,0.0,-0.19508342575683765,0,1,1,1,-0.19508342575683765,0.0
5901,25,142,15,50,45,0,6029.848000000001,24,2180.159,MORE,-2740,4268,1528,2,1,-5.0,-0.4687042303372438,5.0,-0.6984302957695783,0.2803592257165388,-0.19788525780978636,95,50,45,1,-1.2964267863185297,-1.170500554541026,-1.3655839802978638,-1.1188335266038132,-1.0095252299813844,1.0095252299813844,-1.3655839802978638,-1.170500554541026,0,0,0,0,-1.170500554541026,-1.3655839802978638
5902,25,143,59,89,110,1,4898.047000000001,54,1327.06,MORE,-246,2276,2030,3,1,21.0,1.9685577674164243,21.0,2.0952908873087353,2.589954677843632,-0.4911230701678097,199,89,110,0,0.7778560717911179,0.3511501663623078,1.170500554541026,-0.5523355384499837,0.5101705138384874,0.5101705138384874,1.170500554541026,0.3511501663623078,1,0,1,2,1.170500554541026,0.3511501663623078
5903,25,144,29,80,94,1,10050.236,24,2505.5460000000007,MORE,1308,4300,5608,3,1,14.0,1.3123718449442827,14.0,0.8730378697119728,0.2803592257165388,0.8437552619904694,174,80,94,0,0.2792303847455295,0.0,0.5462335921191455,-0.5523355384499837,1.4570859853284959,1.4570859853284959,0.5462335921191455,0.0,0,0,1,1,0.5462335921191455,0.0
5904,25,145,55,110,98,0,9459.282,4,1957.317,MORE,-3238,6356,3118,4,1,-12.0,-1.124890152809385,12.0,0.5238227218271837,-1.2593710757015233,0.6906452557577271,208,110,98,1,0.9573613191275298,1.170500554541026,0.7023003327246156,0.014162449703845685,-1.312976906173163,1.312976906173163,0.7023003327246156,1.170500554541026,0,1,0,2,1.170500554541026,0.7023003327246156
5905,25,146,29,94,80,0,6726.8780000000015,34,1612.679,MORE,-1502,3986,2484,4,1,-14.0,-1.3123718449442827,14.0,0.8730378697119728,1.05022437642557,-0.01729206841702801,174,94,80,1,0.2792303847455295,0.5462335921191455,0.0,0.014162449703845685,-0.2551614245086493,0.2551614245086493,0.0,0.5462335921191455,1,1,0,1,0.5462335921191455,0.0
5906,25,147,57,110,94,0,4227.071,34,1281.269,MORE,-2338,3162,824,2,1,-16.0,-1.4998535370791803,16.0,1.222253017596762,1.05022437642557,-0.6649659404115518,204,110,94,1,0.8775812092002355,1.170500554541026,0.5462335921191455,-1.1188335266038132,-0.7645702624530811,0.7645702624530811,0.5462335921191455,1.170500554541026,1,0,0,2,1.170500554541026,0.5462335921191455
5907,25,148,39,80,66,0,2647.691,34,1360.89,MORE,-690,1624,934,2,1,-14.0,-1.3123718449442827,14.0,0.8730378697119728,1.05022437642557,-1.0741667946977869,146,80,66,1,-0.2792303847455295,0.0,-0.5462335921191455,-1.1188335266038132,0.23962323626991364,0.23962323626991364,-0.5462335921191455,0.0,1,0,0,1,0.0,-0.5462335921191455
5908,25,149,4,50,54,1,4261.383,34,2449.007,MORE,38,1700,1738,2,2,4.0,0.3749633842697951,4.0,-0.8730378697119728,1.05022437642557,-0.6560760597544146,104,50,54,0,-1.116921538982118,-1.170500554541026,-1.0144338139355558,-1.1188335266038132,0.6832232769679356,0.6832232769679356,-1.0144338139355558,-1.170500554541026,1,0,1,0,-1.170500554541026,-1.0144338139355558
5909,25,150,55,98,110,0,8863.916,14,1582.855,MORE,-1950,5016,3066,4,1,12.0,1.124890152809385,12.0,0.5238227218271837,-0.4895059249924924,0.5363921464281303,208,98,110,0,0.9573613191275298,0.7023003327246156,1.170500554541026,0.014162449703845685,-0.5281460649382013,0.5281460649382013,1.170500554541026,0.7023003327246156,0,1,0,2,1.170500554541026,0.7023003327246156
5910,25,151,2,50,52,1,9317.731,4,3026.483,MORE,-802,5780,4978,7,1,2.0,0.18748169213489754,2.0,-1.222253017596762,-1.2593710757015233,0.6539708707933293,102,50,52,0,-1.156811593945765,-1.170500554541026,-1.092467184238291,1.7136564141653339,0.17137707616252565,0.17137707616252565,-1.092467184238291,-1.170500554541026,0,1,0,0,-1.170500554541026,-1.092467184238291
5911,25,152,59,110,89,0,5333.2040000000015,34,2807.195,MORE,-488,2890,2402,2,1,-21.0,-1.9685577674164243,21.0,2.0952908873087353,1.05022437642557,-0.37837843863604703,199,110,89,1,0.7778560717911179,1.170500554541026,0.3511501663623078,-1.1188335266038132,0.36271006074930984,0.36271006074930984,0.3511501663623078,1.170500554541026,1,0,1,2,1.170500554541026,0.3511501663623078
5912,25,153,60,87,110,1,2054.79,24,1901.1,MORE,-1038,2112,1074,2,1,23.0,2.1560394595513217,23.0,2.444506035193524,0.2803592257165388,-1.2277812482853736,197,87,110,0,0.7379660168274708,0.27311679605957273,1.170500554541026,-1.1188335266038132,0.02757266736481524,0.02757266736481524,1.170500554541026,0.27311679605957273,0,0,0,2,1.170500554541026,0.27311679605957273
5913,25,154,52,110,105,0,4031.124,24,1259.272,MORE,-1854,2956,1102,2,1,-5.0,-0.4687042303372438,5.0,-0.6984302957695783,0.2803592257165388,-0.7157337605655519,215,110,105,1,1.0969765115002945,1.170500554541026,0.9754171287841883,-1.1188335266038132,-0.46964935627472587,0.46964935627472587,0.9754171287841883,1.170500554541026,0,0,0,2,1.170500554541026,0.9754171287841883
5914,25,155,30,80,96,1,4050.984,24,1830.995,MORE,-1688,3084,1396,2,1,16.0,1.4998535370791803,16.0,1.222253017596762,0.2803592257165388,-0.7105882420924013,176,80,96,0,0.3191204397091766,0.0,0.6242669624218805,-1.1188335266038132,-0.36849879754413295,0.36849879754413295,0.6242669624218805,0.0,0,0,0,1,0.6242669624218805,0.0
5915,25,156,24,80,86,1,2207.765,4,796.279,MORE,-448,1460,1012,4,1,6.0,0.5624450764046927,6.0,-0.5238227218271837,-1.2593710757015233,-1.1881470242959369,166,80,86,0,0.11967016489094122,0.0,0.2341001109082052,0.014162449703845685,0.38708368935909127,0.38708368935909127,0.2341001109082052,0.0,0,1,1,1,0.2341001109082052,0.0
5916,25,157,5,50,55,1,9500.898,14,2644.792,MORE,366,4490,4856,7,1,5.0,0.4687042303372438,5.0,-0.6984302957695783,-0.4895059249924924,0.7014275264917974,105,50,55,0,-1.0969765115002945,-1.170500554541026,-0.9754171287841883,1.7136564141653339,0.8830870315681433,0.8830870315681433,-0.9754171287841883,-1.170500554541026,0,1,1,0,-1.170500554541026,-0.9754171287841883
5917,25,158,34,80,74,0,3232.877,34,1496.717,MORE,-504,1856,1352,2,1,-6.0,-0.5624450764046927,6.0,-0.5238227218271837,1.05022437642557,-0.9225512169923932,154,80,74,1,-0.11967016489094122,0.0,-0.2341001109082052,-1.1188335266038132,0.3529606093053973,0.3529606093053973,-0.2341001109082052,0.0,1,0,1,1,0.0,-0.2341001109082052
5918,25,159,15,45,50,1,2478.6,14,2125.772,MORE,-752,2074,1322,3,1,5.0,0.4687042303372438,5.0,-0.6984302957695783,-0.4895059249924924,-1.1179765058832607,95,45,50,0,-1.2964267863185297,-1.3655839802978638,-1.170500554541026,-0.5523355384499837,0.20184411192475243,0.20184411192475243,-1.170500554541026,-1.3655839802978638,0,0,0,0,-1.3655839802978638,-1.170500554541026
5919,25,160,37,69,80,1,2495.215,34,2361.678,MORE,-1404,2200,796,2,1,11.0,1.0311493067419364,11.0,0.34921514788478913,1.05022437642557,-1.1136717330015184,149,69,80,0,-0.21939530230005888,-0.4291835366650429,0.0,-1.1188335266038132,-0.1954460344146848,0.1954460344146848,0.0,-0.4291835366650429,1,0,0,1,-0.4291835366650429,0.0
5920,25,161,3,50,53,1,10451.447,4,1526.366,LESS,-990,5078,4088,9,1,3.0,0.28122253820234633,3.0,-1.0476454436543674,-1.2593710757015233,0.9477048396405816,103,50,53,1,-1.1368665664639415,-1.170500554541026,-1.0534504990869233,2.8466523904729932,0.05682102169655295,0.05682102169655295,-1.0534504990869233,-1.170500554541026,0,1,1,0,-1.170500554541026,-1.0534504990869233
5921,25,162,20,50,40,1,3062.126,14,2563.9210000000007,LESS,-1002,2254,1252,3,1,-10.0,-0.9374084606744876,10.0,0.17460757394239454,-0.4895059249924924,-0.9667910168317152,90,50,40,0,-1.3961519237276474,-1.170500554541026,-1.5606674060547012,-0.5523355384499837,0.04950893311361852,0.04950893311361852,-1.5606674060547012,-1.170500554541026,0,0,1,0,-1.170500554541026,-1.5606674060547012
5922,25,163,25,80,88,0,2317.785,24,2049.9,LESS,-1514,2140,626,2,1,8.0,0.7499267685395902,8.0,-0.17460757394239454,0.2803592257165388,-1.1596419919487049,168,80,88,1,0.1595602198545883,0.0,0.31213348121094026,-1.1188335266038132,-0.26247351309158373,0.26247351309158373,0.31213348121094026,0.0,1,0,0,1,0.31213348121094026,0.0
5923,25,164,42,115,110,1,3715.88,14,1749.755,LESS,32,1852,1884,3,1,-5.0,-0.4687042303372438,5.0,-0.6984302957695783,-0.4895059249924924,-0.7974101868268759,225,115,110,0,1.2964267863185297,1.3655839802978638,1.170500554541026,-0.5523355384499837,0.6795672326764683,0.6795672326764683,1.170500554541026,1.3655839802978638,0,0,1,2,1.3655839802978638,1.170500554541026
5924,25,165,53,103,110,1,5518.65,0,2278.78,LESS,-1328,3550,2222,3,1,7.0,0.6561859224721414,7.0,-0.34921514788478913,-1.5673171359851361,-0.3303313178519645,213,103,110,1,1.0570864565366473,0.8973837584814532,1.170500554541026,-0.5523355384499837,-0.1491361400561001,0.1491361400561001,1.170500554541026,0.8973837584814532,0,0,1,2,1.170500554541026,0.8973837584814532
5925,25,166,26,90,80,1,3033.609000000001,14,1959.976,LESS,-464,2018,1554,3,1,-10.0,-0.9374084606744876,10.0,0.17460757394239454,-0.4895059249924924,-0.9741794735436404,170,90,80,0,0.19945027481823535,0.3901668515136753,0.0,-0.5523355384499837,0.3773342379151787,0.3773342379151787,0.0,0.3901668515136753,0,0,1,1,0.3901668515136753,0.0
5926,25,167,35,80,72,0,6281.081,0,2127.768,LESS,-2120,4664,2544,4,1,-8.0,-0.7499267685395902,8.0,-0.17460757394239454,-1.5673171359851361,-0.13279341276622916,152,80,72,0,-0.1595602198545883,0.0,-0.31213348121094026,0.014162449703845685,-0.6317339865297723,0.6317339865297723,-0.31213348121094026,0.0,0,0,0,1,0.0,-0.31213348121094026
5927,25,168,28,93,80,1,5961.882,24,2023.202,LESS,-632,2884,2252,3,1,-13.0,-1.218630998876834,13.0,0.6984302957695783,0.2803592257165388,-0.2154945381998247,173,93,80,0,0.25928535726370594,0.5072169069677779,0.0,-0.5523355384499837,0.2749649977540967,0.2749649977540967,0.0,0.5072169069677779,1,0,1,1,0.5072169069677779,0.0
5928,25,169,26,80,90,0,3211.206,4,1080.095,LESS,-2340,2958,618,2,1,10.0,0.9374084606744876,10.0,0.17460757394239454,-1.2593710757015233,-0.9281659466415192,170,80,90,1,0.19945027481823535,0.0,0.3901668515136753,-1.1188335266038132,-0.7657889438835702,0.7657889438835702,0.3901668515136753,0.0,0,0,0,1,0.3901668515136753,0.0
5929,25,170,25,88,80,1,3237.87,14,1221.817,LESS,-1198,2322,1124,3,1,-8.0,-0.7499267685395902,8.0,-0.17460757394239454,-0.4895059249924924,-0.9212575828666912,168,88,80,0,0.1595602198545883,0.31213348121094026,0.0,-0.5523355384499837,-0.06992184707431047,0.06992184707431047,0.0,0.31213348121094026,0,0,1,1,0.31213348121094026,0.0
5930,25,171,36,80,70,1,6432.154,24,1827.685,LESS,-456,3328,2872,4,2,-10.0,-0.9374084606744876,10.0,0.17460757394239454,0.2803592257165388,-0.09365197710186432,150,80,70,0,-0.19945027481823535,0.0,-0.3901668515136753,0.014162449703845685,0.38220896363713497,0.38220896363713497,-0.3901668515136753,0.0,1,0,1,1,0.0,-0.3901668515136753
5931,25,172,28,80,93,0,10040.522,10,1844.342,LESS,-1504,5874,4370,6,1,13.0,1.218630998876834,13.0,0.6984302957695783,-0.7974519852761047,0.8412384660968044,173,80,93,1,0.25928535726370594,0.0,0.5072169069677779,1.1471584260115046,-0.25638010593913835,0.25638010593913835,0.5072169069677779,0.0,0,1,0,1,0.5072169069677779,0.0
5932,25,173,21,82,80,0,2498.547,14,2327.613,LESS,-2274,2938,664,2,1,-2.0,-0.18748169213489754,2.0,-1.222253017596762,-0.4895059249924924,-1.1128084466192156,162,82,80,0,0.03989005496364707,0.07803337030273506,0.0,-1.1188335266038132,-0.7255724566774309,0.7255724566774309,0.0,0.07803337030273506,1,0,0,1,0.07803337030273506,0.0
5933,25,174,19,50,41,1,3623.451,34,1638.756,LESS,-202,1846,1644,3,2,-9.0,-0.8436676146070391,9.0,0.0,1.05022437642557,-0.8213575748910672,91,50,41,0,-1.376206896245824,-1.170500554541026,-1.5216507209033339,-0.5523355384499837,0.536981505309247,0.536981505309247,-1.5216507209033339,-1.170500554541026,1,0,1,0,-1.170500554541026,-1.5216507209033339
5934,25,175,56,96,110,0,3671.973,14,1126.954,LESS,-2808,3524,716,2,1,14.0,1.3123718449442827,14.0,0.8730378697119728,-0.4895059249924924,-0.8087860317211673,206,96,110,1,0.9174712641638826,0.6242669624218805,1.170500554541026,-1.1188335266038132,-1.050960398618013,1.050960398618013,1.170500554541026,0.6242669624218805,0,0,0,2,1.170500554541026,0.6242669624218805
5935,25,176,23,80,85,1,11918.43,4,2308.041,LESS,416,5210,5626,5,1,5.0,0.4687042303372438,5.0,-0.6984302957695783,-1.2593710757015233,1.3277848057180195,165,80,85,1,0.09972513740911768,0.0,0.19508342575683765,0.5806604378576751,0.91355406733037,0.91355406733037,0.19508342575683765,0.0,0,1,1,1,0.19508342575683765,0.0
5936,25,177,10,60,50,1,3124.5959999999995,34,1970.055,LESS,-84,1916,1832,4,1,-10.0,-0.9374084606744876,10.0,0.17460757394239454,1.05022437642557,-0.9506056926112866,110,60,50,0,-0.9972513740911768,-0.7803337030273506,-1.170500554541026,0.014162449703845685,0.6088837097081022,0.6088837097081022,-1.170500554541026,-0.7803337030273506,1,1,1,0,-0.7803337030273506,-1.170500554541026
5937,25,178,19,41,50,0,2185.444,54,1330.852,LESS,-1388,1950,562,2,1,9.0,0.8436676146070391,9.0,0.0,2.589954677843632,-1.193930162152895,91,41,50,1,-1.376206896245824,-1.5216507209033339,-1.170500554541026,-1.1188335266038132,-0.18569658297077224,0.18569658297077224,-1.170500554541026,-1.5216507209033339,1,0,1,0,-1.5216507209033339,-1.170500554541026
5938,25,179,56,110,96,1,5332.1,34,1360.503,LESS,1082,1500,2582,2,2,-14.0,-1.3123718449442827,14.0,0.8730378697119728,1.05022437642557,-0.3786644734998116,206,110,96,0,0.9174712641638826,1.170500554541026,0.6242669624218805,-1.1188335266038132,1.319374983683231,1.319374983683231,0.6242669624218805,1.170500554541026,1,0,1,2,1.170500554541026,0.6242669624218805
5939,25,180,35,72,80,1,9531.317,14,1650.3770000000004,LESS,1200,3242,4442,4,1,8.0,0.7499267685395902,8.0,-0.17460757394239454,-0.4895059249924924,0.7093087715287948,152,72,80,1,-0.1595602198545883,-0.31213348121094026,0.0,0.014162449703845685,1.391277188082086,1.391277188082086,0.0,-0.31213348121094026,1,1,1,1,-0.31213348121094026,0.0
5940,25,181,11,49,50,1,7351.036999999998,14,1533.54,LESS,-448,2912,2464,2,1,1.0,0.09374084606744876,1.0,-1.3968605915391563,-0.4895059249924924,0.14442100634043434,99,49,50,1,-1.2166466763912356,-1.2095172396923934,-1.170500554541026,-1.1188335266038132,0.38708368935909127,0.38708368935909127,-1.170500554541026,-1.2095172396923934,0,0,1,0,-1.2095172396923934,-1.170500554541026
5941,25,182,17,43,50,0,11476.7,0,2171.3160000000007,LESS,-3496,6894,3398,3,1,7.0,0.6561859224721414,7.0,-0.34921514788478913,-1.5673171359851361,1.2133371785707476,93,43,50,1,-1.3363168412821769,-1.4436173506005987,-1.170500554541026,-0.5523355384499837,-1.4701868107062535,1.4701868107062535,-1.170500554541026,-1.4436173506005987,0,0,0,0,-1.4436173506005987,-1.170500554541026
5942,25,183,1,51,50,1,7324.7,14,2688.127,LESS,-1336,4278,2942,4,2,-1.0,-0.09374084606744876,1.0,-1.3968605915391563,-0.4895059249924924,0.13759736484862364,101,51,50,0,-1.1767566214275886,-1.1314838693896585,-1.170500554541026,0.014162449703845685,-0.1540108657780564,0.1540108657780564,-1.170500554541026,-1.1314838693896585,0,1,1,0,-1.1314838693896585,-1.170500554541026
5943,25,184,41,112,110,1,8582.713,0,3551.193,LESS,-1982,4960,2978,3,1,-2.0,-0.18748169213489754,2.0,-1.222253017596762,-1.5673171359851361,0.4635353875557551,222,112,110,0,1.2365917038730592,1.248533924843761,1.170500554541026,-0.5523355384499837,-0.5476449678260265,0.5476449678260265,1.170500554541026,1.248533924843761,0,0,0,2,1.248533924843761,1.170500554541026
5944,25,185,20,40,50,0,1807.66,34,1610.1,LESS,-886,1334,448,2,1,10.0,0.9374084606744876,10.0,0.17460757394239454,1.05022437642557,-1.291810048903184,90,40,50,1,-1.3961519237276474,-1.5606674060547012,-1.170500554541026,-1.1188335266038132,0.12019245608198466,0.12019245608198466,-1.170500554541026,-1.5606674060547012,1,0,1,0,-1.5606674060547012,-1.170500554541026
5945,25,186,1,50,51,1,7903.485,14,2070.411,LESS,-858,3778,2920,3,1,1.0,0.09374084606744876,1.0,-1.3968605915391563,-0.4895059249924924,0.2875545103411957,101,50,51,1,-1.1767566214275886,-1.170500554541026,-1.1314838693896585,-0.5523355384499837,0.13725399610883166,0.13725399610883166,-1.1314838693896585,-1.170500554541026,0,0,1,0,-1.170500554541026,-1.1314838693896585
5946,25,187,23,85,80,1,9877.773,0,1234.477,LESS,1332,3940,5272,6,1,-5.0,-0.4687042303372438,5.0,-0.6984302957695783,-1.5673171359851361,0.7990719008406716,165,85,80,0,0.09972513740911768,0.19508342575683765,0.0,1.1471584260115046,1.4717101624943647,1.4717101624943647,0.0,0.19508342575683765,0,1,1,1,0.19508342575683765,0.0
5947,25,188,11,50,49,0,6297.153,24,1388.408,LESS,192,2542,2734,2,1,-1.0,-0.09374084606744876,1.0,-1.3968605915391563,0.2803592257165388,-0.12862932551041456,99,50,49,0,-1.2166466763912356,-1.170500554541026,-1.2095172396923934,-1.1188335266038132,0.7770617471155941,0.7770617471155941,-1.2095172396923934,-1.170500554541026,1,0,1,0,-1.170500554541026,-1.2095172396923934
5948,25,189,17,50,43,0,8252.668,4,2452.514,LESS,-1746,5074,3328,4,1,-7.0,-0.6561859224721414,7.0,-0.34921514788478913,-1.2593710757015233,0.3780241768573162,93,50,43,0,-1.3363168412821769,-1.170500554541026,-1.4436173506005987,0.014162449703845685,-0.403840559028316,0.403840559028316,-1.4436173506005987,-1.170500554541026,0,0,0,0,-1.170500554541026,-1.4436173506005987
5949,25,190,21,80,82,0,6010.176,0,1742.5,LESS,-1534,3990,2456,6,1,2.0,0.18748169213489754,2.0,-1.222253017596762,-1.5673171359851361,-0.202982067447441,162,80,82,1,0.03989005496364707,0.0,0.07803337030273506,1.1471584260115046,-0.27466032739647445,0.27466032739647445,0.07803337030273506,0.0,0,1,0,1,0.07803337030273506,0.0
5950,25,191,10,50,60,0,3384.7270000000008,14,2378.46,LESS,-1974,2936,962,4,1,10.0,0.9374084606744876,10.0,0.17460757394239454,-0.4895059249924924,-0.8832084687472809,110,50,60,1,-0.9972513740911768,-1.170500554541026,-0.7803337030273506,0.014162449703845685,-0.5427702421040701,0.5427702421040701,-0.7803337030273506,-1.170500554541026,1,0,0,0,-1.170500554541026,-0.7803337030273506
5951,25,192,3,53,50,0,7329.265,0,1785.7379999999996,LESS,-2028,4910,2882,4,1,-3.0,-0.28122253820234633,3.0,-1.0476454436543674,-1.5673171359851361,0.13878010864670698,103,53,50,0,-1.1368665664639415,-1.0534504990869233,-1.170500554541026,0.014162449703845685,-0.575674640727275,0.575674640727275,-1.170500554541026,-1.0534504990869233,0,0,0,0,-1.0534504990869233,-1.170500554541026
5952,25,193,45,122,110,1,7596.478,4,972.983,LESS,-2462,4574,2112,3,1,-12.0,-1.124890152809385,12.0,0.5238227218271837,-1.2593710757015233,0.2080122047074318,232,122,110,0,1.4360419786912946,1.6387007763574364,1.170500554541026,-0.5523355384499837,-0.8401285111434035,0.8401285111434035,1.170500554541026,1.6387007763574364,0,0,0,2,1.6387007763574364,1.170500554541026
5953,25,194,38,67,80,0,6557.638000000001,4,1291.393,LESS,-624,3804,3180,4,1,13.0,1.218630998876834,13.0,0.6984302957695783,-1.2593710757015233,-0.06114038394552824,147,67,80,1,-0.25928535726370594,-0.5072169069677779,0.0,0.014162449703845685,0.279839723476053,0.279839723476053,0.0,-0.5072169069677779,0,0,1,1,-0.5072169069677779,0.0
5954,25,195,38,80,67,0,9484.053,0,1698.083,LESS,1888,3826,5714,2,1,-13.0,-1.218630998876834,13.0,0.6984302957695783,-1.5673171359851361,0.697063163013438,147,80,67,0,-0.25928535726370594,0.0,-0.5072169069677779,-1.1188335266038132,1.8105036001703265,1.8105036001703265,-0.5072169069677779,0.0,0,0,1,1,0.0,-0.5072169069677779
5955,25,196,36,70,80,0,14925.51,0,1692.135,LESS,-1278,7584,6306,6,1,10.0,0.9374084606744876,10.0,0.17460757394239454,-1.5673171359851361,2.1068878112689644,150,70,80,1,-0.19945027481823535,-0.3901668515136753,0.0,1.1471584260115046,-0.11866910429387331,0.11866910429387331,0.0,-0.3901668515136753,0,1,1,1,-0.3901668515136753,0.0
5956,25,197,45,110,122,0,11435.305,0,2310.527,LESS,-3988,7582,3594,5,1,12.0,1.124890152809385,12.0,0.5238227218271837,-1.5673171359851361,1.2026121666273402,232,110,122,1,1.4360419786912946,1.170500554541026,1.6387007763574364,0.5806604378576751,-1.769982442606565,1.769982442606565,1.6387007763574364,1.170500554541026,0,1,0,2,1.6387007763574364,1.170500554541026
5957,25,198,42,110,115,0,8143.982,4,1774.34,LESS,-268,4470,4202,2,1,5.0,0.4687042303372438,5.0,-0.6984302957695783,-1.2593710757015233,0.3498647699704659,225,110,115,1,1.2964267863185297,1.170500554541026,1.3655839802978638,-1.1188335266038132,0.4967650181031077,0.4967650181031077,1.3655839802978638,1.170500554541026,0,0,1,2,1.3655839802978638,1.170500554541026
5958,25,199,41,110,112,1,13629.316,4,1541.629,LESS,-2234,6912,4678,4,1,2.0,0.18748169213489754,2.0,-1.222253017596762,-1.2593710757015233,1.7710574904337686,222,110,112,1,1.2365917038730592,1.170500554541026,1.248533924843761,0.014162449703845685,-0.7011988280676494,0.7011988280676494,1.248533924843761,1.170500554541026,0,0,0,2,1.248533924843761,1.170500554541026
5959,25,200,53,110,103,0,11410.918,4,2623.418,LESS,-3690,7290,3600,4,1,-7.0,-0.6561859224721414,7.0,-0.34921514788478913,-1.2593710757015233,1.1962937497590256,213,110,103,0,1.0570864565366473,1.170500554541026,0.8973837584814532,0.014162449703845685,-1.5883989094636932,1.5883989094636932,0.8973837584814532,1.170500554541026,0,0,0,2,1.170500554541026,0.8973837584814532
5960,25,201,3,50,53,1,4797.221,24,1400.3370000000002,MORE,-1226,2854,1628,3,1,3.0,0.28122253820234633,3.0,-1.0476454436543674,0.2803592257165388,-0.5172460331876432,103,50,53,0,-1.1368665664639415,-1.170500554541026,-1.0534504990869233,-0.5523355384499837,-0.08698338710115747,0.08698338710115747,-1.0534504990869233,-1.170500554541026,0,0,0,0,-1.170500554541026,-1.0534504990869233
5961,25,202,20,50,40,0,4452.768,34,1102.008,MORE,-1558,2998,1440,4,1,-10.0,-0.9374084606744876,10.0,0.17460757394239454,1.05022437642557,-0.606490206129846,90,50,40,1,-1.3961519237276474,-1.170500554541026,-1.5606674060547012,0.014162449703845685,-0.2892845045623433,0.2892845045623433,-1.5606674060547012,-1.170500554541026,1,1,0,0,-1.170500554541026,-1.5606674060547012
5962,25,203,25,80,88,1,2917.58,24,1721.116,MORE,-1662,2686,1024,2,1,8.0,0.7499267685395902,8.0,-0.17460757394239454,0.2803592257165388,-1.0042413749998942,168,80,88,0,0.1595602198545883,0.0,0.31213348121094026,-1.1188335266038132,-0.352655938947775,0.352655938947775,0.31213348121094026,0.0,0,0,0,1,0.31213348121094026,0.0
5963,25,204,42,115,110,0,7974.616999999998,24,1297.596,MORE,-2626,4542,1916,2,1,-5.0,-0.4687042303372438,5.0,-0.6984302957695783,0.2803592257165388,0.30598406824815155,225,115,110,1,1.2964267863185297,1.3655839802978638,1.170500554541026,-1.1188335266038132,-0.9400603884435074,0.9400603884435074,1.170500554541026,1.3655839802978638,0,0,0,2,1.3655839802978638,1.170500554541026
5964,25,205,53,103,110,1,6034.191999999999,14,2830.419000000001,MORE,1178,2358,3536,2,1,7.0,0.6561859224721414,7.0,-0.34921514788478913,-0.4895059249924924,-0.19675977280236653,213,103,110,0,1.0570864565366473,0.8973837584814532,1.170500554541026,-1.1188335266038132,1.3778716923467063,1.3778716923467063,1.170500554541026,0.8973837584814532,0,0,1,2,1.170500554541026,0.8973837584814532
5965,25,206,26,90,80,0,4698.9,24,1758.559,MORE,-1108,2530,1422,4,1,-10.0,-0.9374084606744876,10.0,0.17460757394239454,0.2803592257165388,-0.5427199768834459,170,90,80,1,0.19945027481823535,0.3901668515136753,0.0,0.014162449703845685,-0.015081182702302257,0.015081182702302257,0.0,0.3901668515136753,0,1,0,1,0.3901668515136753,0.0
5966,25,207,35,80,72,0,10533.239,34,1854.522,MORE,740,4296,5036,8,1,-8.0,-0.7499267685395902,8.0,-0.17460757394239454,1.05022437642557,0.9688962921559859,152,80,72,1,-0.1595602198545883,0.0,-0.31213348121094026,2.2801544023191638,1.1109804590695995,1.1109804590695995,-0.31213348121094026,0.0,1,1,1,1,0.0,-0.31213348121094026
5967,25,208,28,93,80,0,5401.655,34,3020.769,MORE,-576,2726,2150,6,1,-13.0,-1.218630998876834,13.0,0.6984302957695783,1.05022437642557,-0.3606434998140116,173,93,80,1,0.25928535726370594,0.5072169069677779,0.0,1.1471584260115046,0.3090880778077907,0.3090880778077907,0.0,0.5072169069677779,1,1,1,1,0.5072169069677779,0.0
5968,25,209,26,80,90,1,2049.338,44,2007.279,MORE,222,880,1102,3,2,10.0,0.9374084606744876,10.0,0.17460757394239454,1.820089527134601,-1.22919380451476,170,80,90,0,0.19945027481823535,0.0,0.3901668515136753,-0.5523355384499837,0.7953419685729302,0.7953419685729302,0.3901668515136753,0.0,1,0,1,1,0.3901668515136753,0.0
5969,25,210,25,88,80,0,6868.522,4,2253.474,MORE,-3424,5308,1884,5,1,-8.0,-0.7499267685395902,8.0,-0.17460757394239454,-1.2593710757015233,0.019406411875567083,168,88,80,1,0.1595602198545883,0.31213348121094026,0.0,0.5806604378576751,-1.4263142792086467,1.4263142792086467,0.0,0.31213348121094026,0,1,0,1,0.31213348121094026,0.0
5970,25,211,36,80,70,0,8182.444,14,2417.556,MORE,-2422,5482,3060,6,1,-10.0,-0.9374084606744876,10.0,0.17460757394239454,-0.4895059249924924,0.3598298722622243,150,80,70,1,-0.19945027481823535,0.0,-0.3901668515136753,1.1471584260115046,-0.815754882533622,0.815754882533622,-0.3901668515136753,0.0,0,1,0,1,0.0,-0.3901668515136753
5971,25,212,28,80,93,1,2063.279,24,1465.408,MORE,-828,1690,862,4,1,13.0,1.218630998876834,13.0,0.6984302957695783,0.2803592257165388,-1.225581837091085,173,80,93,0,0.25928535726370594,0.0,0.5072169069677779,0.014162449703845685,0.15553421756616773,0.15553421756616773,0.5072169069677779,0.0,0,1,0,1,0.5072169069677779,0.0
5972,25,213,21,82,80,0,3914.681,34,1447.1629999999998,MORE,-1166,2436,1270,4,1,-2.0,-0.18748169213489754,2.0,-1.222253017596762,1.05022437642557,-0.745902925095717,162,82,80,1,0.03989005496364707,0.07803337030273506,0.0,0.014162449703845685,-0.050422944186485325,0.050422944186485325,0.0,0.07803337030273506,1,1,0,1,0.07803337030273506,0.0
5973,25,214,19,50,41,0,2949.97,4,2594.524,MORE,-1514,2498,984,4,1,-9.0,-0.8436676146070391,9.0,0.0,-1.2593710757015233,-0.9958494644588394,91,50,41,1,-1.376206896245824,-1.170500554541026,-1.5216507209033339,0.014162449703845685,-0.26247351309158373,0.26247351309158373,-1.5216507209033339,-1.170500554541026,0,1,0,0,-1.170500554541026,-1.5216507209033339
5974,25,215,56,96,110,1,1976.353,24,1190.715,MORE,-12,1032,1020,2,1,14.0,1.3123718449442827,14.0,0.8730378697119728,0.2803592257165388,-1.2481034553588135,206,96,110,0,0.9174712641638826,0.6242669624218805,1.170500554541026,-1.1188335266038132,0.6527562412057089,0.6527562412057089,1.170500554541026,0.6242669624218805,1,0,1,2,1.170500554541026,0.6242669624218805
5975,25,216,23,80,85,1,1498.183,14,2150.75,MORE,-1410,2396,986,2,1,5.0,0.4687042303372438,5.0,-0.6984302957695783,-0.4895059249924924,-1.3719923057267105,165,80,85,0,0.09972513740911768,0.0,0.19508342575683765,-1.1188335266038132,-0.199102078706152,0.199102078706152,0.19508342575683765,0.0,0,0,0,1,0.19508342575683765,0.0
5976,25,217,10,60,50,0,4731.632000000001,34,1369.319,MORE,-1058,2640,1582,4,1,-10.0,-0.9374084606744876,10.0,0.17460757394239454,1.05022437642557,-0.5342394577161158,110,60,50,1,-0.9972513740911768,-0.7803337030273506,-1.170500554541026,0.014162449703845685,0.015385853059924525,0.015385853059924525,-1.170500554541026,-0.7803337030273506,1,1,0,0,-0.7803337030273506,-1.170500554541026
5977,25,218,19,41,50,1,2406.173,24,1376.069,MORE,-54,1160,1106,3,2,9.0,0.8436676146070391,9.0,0.0,0.2803592257165388,-1.1367415847581288,91,41,50,0,-1.376206896245824,-1.5216507209033339,-1.170500554541026,-0.5523355384499837,0.6271639311654383,0.6271639311654383,-1.170500554541026,-1.5216507209033339,0,0,1,0,-1.5216507209033339,-1.170500554541026
5978,25,219,56,110,96,0,3846.133,44,3448.913,MORE,-1000,2398,1398,2,1,-14.0,-1.3123718449442827,14.0,0.8730378697119728,1.820089527134601,-0.7636629956041525,206,110,96,1,0.9174712641638826,1.170500554541026,0.6242669624218805,-1.1188335266038132,0.05072761454410759,0.05072761454410759,0.6242669624218805,1.170500554541026,1,0,0,2,1.170500554541026,0.6242669624218805
5979,25,220,35,72,80,1,5041.701,44,1228.694,MORE,220,2270,2490,5,1,8.0,0.7499267685395902,8.0,-0.17460757394239454,1.820089527134601,-0.4539038198786872,152,72,80,0,-0.1595602198545883,-0.31213348121094026,0.0,0.5806604378576751,0.7941232871424411,0.7941232871424411,0.0,-0.31213348121094026,1,1,1,1,-0.31213348121094026,0.0
5980,25,221,11,49,50,1,3976.439,14,955.235,MORE,-690,2182,1492,3,2,1.0,0.09374084606744876,1.0,-1.3968605915391563,-0.4895059249924924,-0.729902072635252,99,49,50,0,-1.2166466763912356,-1.2095172396923934,-1.170500554541026,-0.5523355384499837,0.23962323626991364,0.23962323626991364,-1.170500554541026,-1.2095172396923934,0,0,0,0,-1.2095172396923934,-1.170500554541026
5981,25,222,17,43,50,1,6041.11,4,1143.798,MORE,-3308,4754,1446,5,1,7.0,0.6561859224721414,7.0,-0.34921514788478913,-1.2593710757015233,-0.19496739129193053,93,43,50,0,-1.3363168412821769,-1.4436173506005987,-1.170500554541026,0.5806604378576751,-1.3556307562402807,1.3556307562402807,-1.170500554541026,-1.4436173506005987,0,1,0,0,-1.4436173506005987,-1.170500554541026
5982,25,223,1,51,50,1,10959.667,0,1288.284,MORE,-2564,6536,3972,7,1,-1.0,-0.09374084606744876,1.0,-1.3968605915391563,-1.5673171359851361,1.079379331001337,101,51,50,1,-1.1767566214275886,-1.1314838693896585,-1.170500554541026,1.7136564141653339,-0.9022812640983462,0.9022812640983462,-1.170500554541026,-1.1314838693896585,0,1,0,0,-1.1314838693896585,-1.170500554541026
5983,25,224,41,112,110,0,2929.594,34,1071.999,MORE,-1418,2248,830,2,1,-2.0,-0.18748169213489754,2.0,-1.222253017596762,1.05022437642557,-1.0011286731400535,222,112,110,1,1.2365917038730592,1.248533924843761,1.170500554541026,-1.1188335266038132,-0.2039768044281083,0.2039768044281083,1.170500554541026,1.248533924843761,1,0,0,2,1.248533924843761,1.170500554541026
5984,25,225,20,40,50,1,1842.801,14,1284.839,MORE,-608,1532,924,1,1,10.0,0.9374084606744876,10.0,0.17460757394239454,-0.4895059249924924,-1.282705383008673,90,40,50,0,-1.3961519237276474,-1.5606674060547012,-1.170500554541026,-1.6853315147576426,0.28958917491996555,0.28958917491996555,-1.170500554541026,-1.5606674060547012,0,0,1,0,-1.5606674060547012,-1.170500554541026
5985,25,226,1,50,51,0,9067.473,34,1473.257,MORE,1028,3528,4556,5,1,1.0,0.09374084606744876,1.0,-1.3968605915391563,1.05022437642557,0.5891316380615202,101,50,51,0,-1.1767566214275886,-1.170500554541026,-1.1314838693896585,0.5806604378576751,1.286470585060026,1.286470585060026,-1.1314838693896585,-1.170500554541026,1,1,1,0,-1.170500554541026,-1.1314838693896585
5986,25,227,23,85,80,0,9167.467,44,1522.638,MORE,578,3772,4350,6,1,-5.0,-0.4687042303372438,5.0,-0.6984302957695783,1.820089527134601,0.6150390385753283,165,85,80,1,0.09972513740911768,0.19508342575683765,0.0,1.1471584260115046,1.012267263199985,1.012267263199985,0.0,0.19508342575683765,1,1,1,1,0.19508342575683765,0.0
5987,25,228,11,50,49,0,12136.964,4,959.934,MORE,-514,5978,5464,6,1,-1.0,-0.09374084606744876,1.0,-1.3968605915391563,-1.2593710757015233,1.3844046815494142,99,50,49,1,-1.2166466763912356,-1.170500554541026,-1.2095172396923934,1.1471584260115046,0.3468672021529519,0.3468672021529519,-1.2095172396923934,-1.170500554541026,0,1,1,0,-1.170500554541026,-1.2095172396923934
5988,25,229,17,50,43,1,2698.169000000001,24,808.255,MORE,100,1274,1374,1,2,-7.0,-0.6561859224721414,7.0,-0.34921514788478913,0.2803592257165388,-1.0610884723670868,93,50,43,1,-1.3363168412821769,-1.170500554541026,-1.4436173506005987,-1.6853315147576426,0.7210024013130968,0.7210024013130968,-1.4436173506005987,-1.170500554541026,0,0,1,0,-1.170500554541026,-1.4436173506005987
5989,25,230,21,80,82,1,4628.875,34,917.993,MORE,92,2188,2280,3,2,2.0,0.18748169213489754,2.0,-1.222253017596762,1.05022437642557,-0.5608627226579862,162,80,82,0,0.03989005496364707,0.0,0.07803337030273506,-0.5523355384499837,0.7161276755911405,0.7161276755911405,0.07803337030273506,0.0,1,0,1,1,0.07803337030273506,0.0
5990,25,231,10,50,60,1,3754.417,4,2527.058,MORE,-1204,3090,1886,3,1,10.0,0.9374084606744876,10.0,0.17460757394239454,-1.2593710757015233,-0.7874256528188294,110,50,60,0,-0.9972513740911768,-1.170500554541026,-0.7803337030273506,-0.5523355384499837,-0.07357789136577768,0.07357789136577768,-0.7803337030273506,-1.170500554541026,0,0,0,0,-1.170500554541026,-0.7803337030273506
5991,25,232,3,53,50,0,4177.62,24,1047.933,MORE,-1788,2882,1094,4,1,-3.0,-0.28122253820234633,3.0,-1.0476454436543674,0.2803592257165388,-0.6777781777738766,103,53,50,1,-1.1368665664639415,-1.0534504990869233,-1.170500554541026,0.014162449703845685,-0.4294328690685865,0.4294328690685865,-1.170500554541026,-1.0534504990869233,0,1,0,0,-1.0534504990869233,-1.170500554541026
5992,25,233,45,122,110,0,3395.043,44,1948.428,MORE,-350,1824,1474,2,1,-12.0,-1.124890152809385,12.0,0.5238227218271837,1.820089527134601,-0.8805357009442085,232,122,110,1,1.4360419786912946,1.6387007763574364,1.170500554541026,-1.1188335266038132,0.44679907945305575,0.44679907945305575,1.170500554541026,1.6387007763574364,1,0,1,2,1.6387007763574364,1.170500554541026
5993,25,234,38,67,80,1,4928.446,14,1218.23,MORE,364,2240,2604,3,1,13.0,1.218630998876834,13.0,0.6984302957695783,-0.4895059249924924,-0.4832470069218228,147,67,80,0,-0.25928535726370594,-0.5072169069677779,0.0,-0.5523355384499837,0.8818683501376542,0.8818683501376542,0.0,-0.5072169069677779,0,0,1,1,-0.5072169069677779,0.0
5994,25,235,38,80,67,0,2868.349,44,1196.653,MORE,-1094,1902,808,2,1,-13.0,-1.218630998876834,13.0,0.6984302957695783,1.820089527134601,-1.0169966126611063,147,80,67,1,-0.25928535726370594,0.0,-0.5072169069677779,-1.1188335266038132,-0.006550412688878758,0.006550412688878758,-0.5072169069677779,0.0,1,0,0,1,0.0,-0.5072169069677779
5995,25,236,36,70,80,1,9406.728,24,2230.634,MORE,-578,4436,3858,4,1,10.0,0.9374084606744876,10.0,0.17460757394239454,0.2803592257165388,0.6770290635201662,150,70,80,0,-0.19945027481823535,-0.3901668515136753,0.0,0.014162449703845685,0.30786939637730165,0.30786939637730165,0.0,-0.3901668515136753,0,1,1,1,-0.3901668515136753,0.0
5996,25,237,45,110,122,0,7354.094,4,1660.745,MORE,-364,4150,3786,4,1,12.0,1.124890152809385,12.0,0.5238227218271837,-1.2593710757015233,0.14521304309634722,232,110,122,0,1.4360419786912946,1.170500554541026,1.6387007763574364,0.014162449703845685,0.43826830943963224,0.43826830943963224,1.6387007763574364,1.170500554541026,0,1,1,2,1.6387007763574364,1.170500554541026
5997,25,238,42,110,115,1,7369.732,34,1733.737,MORE,-910,3748,2838,5,2,5.0,0.4687042303372438,5.0,-0.6984302957695783,1.05022437642557,0.14926468548723992,225,110,115,0,1.2964267863185297,1.170500554541026,1.3655839802978638,0.5806604378576751,0.1055682789161158,0.1055682789161158,1.3655839802978638,1.170500554541026,1,1,0,2,1.3655839802978638,1.170500554541026
5998,25,239,41,110,112,1,4304.453,34,1504.214,MORE,-24,2168,2144,3,1,2.0,0.18748169213489754,2.0,-1.222253017596762,1.05022437642557,-0.644917072813901,222,110,112,0,1.2365917038730592,1.170500554541026,1.248533924843761,-0.5523355384499837,0.6454441526227744,0.6454441526227744,1.248533924843761,1.170500554541026,1,0,1,2,1.248533924843761,1.170500554541026
5999,25,240,53,110,103,0,3459.006,44,1596.2910000000004,MORE,-1486,2580,1094,2,1,-7.0,-0.6561859224721414,7.0,-0.34921514788478913,1.820089527134601,-0.8639635560248665,213,110,103,1,1.0570864565366473,1.170500554541026,0.8973837584814532,-1.1188335266038132,-0.24541197306473672,0.24541197306473672,0.8973837584814532,1.170500554541026,1,0,0,2,1.170500554541026,0.8973837584814532
6000,26,1,49,110,131,1,3954.36,50,1478.2479999999996,MORE,316,1516,1832,2,2,21.0,1.9685577674164243,21.0,2.0952908873087353,-0.07173135367908642,0.03847808069123816,241,110,131,0,1.6155472260277064,1.170500554541026,1.9898509427197442,-0.8276444527499438,0.3323855069071951,0.3323855069071951,1.9898509427197442,1.170500554541026,0,0,1,2,1.9898509427197442,1.170500554541026
6001,26,2,13,47,50,1,3430.1040000000007,40,1201.641,MORE,38,1610,1648,3,1,3.0,0.28122253820234633,3.0,-1.0476454436543674,-0.4720923974693368,-0.243520965501356,97,47,50,0,-1.2565367313548828,-1.2875506099951286,-1.170500554541026,0.11823492182142054,0.07190533329672673,0.07190533329672673,-1.170500554541026,-1.2875506099951286,0,0,0,0,-1.2875506099951286,-1.170500554541026
6002,26,3,16,50,44,0,4790.332,0,925.194,MORE,-600,2832,2232,4,1,-6.0,-0.5624450764046927,6.0,-0.5238227218271837,-2.073536572630338,0.4881502001208978,94,50,44,1,-1.3163718138003533,-1.170500554541026,-1.4046006654492311,1.0641142963927848,-0.5258872953488806,0.5258872953488806,-1.4046006654492311,-1.170500554541026,0,1,0,0,-1.170500554541026,-1.4046006654492311
6003,26,4,7,57,50,0,2293.717,70,990.236,MORE,-662,1424,762,2,1,-7.0,-0.6561859224721414,7.0,-0.34921514788478913,0.7289907339014143,-0.8547873126784301,107,57,50,1,-1.0570864565366473,-0.8973837584814532,-1.170500554541026,-0.8276444527499438,-0.5839799959382656,0.5839799959382656,-1.170500554541026,-0.8973837584814532,1,0,0,0,-0.8973837584814532,-1.170500554541026
6004,26,5,18,42,50,1,1600.204,40,1085.661,MORE,474,636,1110,1,2,8.0,0.7499267685395902,8.0,-0.17460757394239454,-0.4720923974693368,-1.2278302621576251,92,42,50,0,-1.3562618687640005,-1.4826340357519663,-1.170500554541026,-1.773523827321308,0.4804281955059505,0.4804281955059505,-1.170500554541026,-1.4826340357519663,0,0,1,0,-1.4826340357519663,-1.170500554541026
6005,26,6,51,108,110,1,3382.276,60,1567.66,MORE,1482,1014,2496,2,2,2.0,0.18748169213489754,2.0,-1.222253017596762,0.32862969011116394,-0.2692478057879711,218,108,110,0,1.156811593945765,1.092467184238291,1.170500554541026,-0.8276444527499438,1.4249030696043394,1.4249030696043394,1.170500554541026,1.092467184238291,1,0,1,2,1.170500554541026,1.092467184238291
6006,26,7,31,78,80,0,5924.823,60,1836.241,MORE,-20,2602,2582,5,2,2.0,0.18748169213489754,2.0,-1.222253017596762,0.32862969011116394,1.0983966825914515,158,78,80,0,-0.03989005496364707,-0.07803337030273506,0.0,2.0099936709641493,0.01756054887439878,0.01756054887439878,0.0,-0.07803337030273506,1,1,0,1,-0.07803337030273506,0.0
6007,26,8,58,110,92,1,3778.703,20,1899.364,MORE,62,1654,1716,3,2,-18.0,-1.6873352292140782,18.0,1.571468165481551,-1.2728144850498375,-0.05600840388319231,202,110,92,1,0.8376911542365885,1.170500554541026,0.4682002218164104,0.11823492182142054,0.09439283029906932,0.09439283029906932,0.4682002218164104,1.170500554541026,0,0,0,2,1.170500554541026,0.4682002218164104
6008,26,9,12,50,48,0,5725.531999999998,30,2061.277,MORE,-1882,3660,1778,4,1,-2.0,-0.18748169213489754,2.0,-1.222253017596762,-0.8724534412595871,0.9911973908050556,98,50,48,1,-1.2365917038730592,-1.170500554541026,-1.248533924843761,1.0641142963927848,-1.727094426890681,1.727094426890681,-1.248533924843761,-1.170500554541026,0,1,0,0,-1.170500554541026,-1.248533924843761
6009,26,10,54,110,101,1,5110.1579999999985,70,2431.172,MORE,776,1892,2668,4,2,-9.0,-0.8436676146070391,9.0,0.0,0.7289907339014143,0.660185669333634,211,110,101,1,1.0171964015730004,1.170500554541026,0.8193503881787182,1.0641142963927848,0.7633958661187614,0.7633958661187614,0.8193503881787182,1.170500554541026,1,1,1,2,1.170500554541026,0.8193503881787182
6010,26,11,14,46,50,1,2845.0640000000008,90,2266.151,MORE,1384,1072,2456,3,2,4.0,0.3749633842697951,4.0,-0.8730378697119728,1.5297128214819151,-0.558215927475116,96,46,50,0,-1.2764817588367063,-1.3265672951464962,-1.170500554541026,0.11823492182142054,1.3330791235114403,1.3330791235114403,-1.170500554541026,-1.3265672951464962,1,0,1,0,-1.3265672951464962,-1.170500554541026
6011,26,12,22,80,83,0,4896.907,50,1754.362,MORE,-1436,3174,1738,4,1,3.0,0.28122253820234633,3.0,-1.0476454436543674,-0.07173135367908642,0.5454772471131606,163,80,83,0,0.05983508244547061,0.0,0.1170500554541026,1.0641142963927848,-1.3092017742638142,1.3092017742638142,0.1170500554541026,0.0,0,1,0,1,0.1170500554541026,0.0
6012,26,13,6,50,56,1,3161.734000000001,60,1018.496,MORE,478,1154,1632,3,2,6.0,0.5624450764046927,6.0,-0.5238227218271837,0.32862969011116394,-0.38787808115994,106,50,56,0,-1.077031484018471,-1.170500554541026,-0.9364004436328208,0.11823492182142054,0.4841761116730076,0.4841761116730076,-0.9364004436328208,-1.170500554541026,1,0,1,0,-1.170500554541026,-0.9364004436328208
6013,26,14,13,50,47,1,4104.913,70,951.241,MORE,-34,1896,1862,3,2,-3.0,-0.28122253820234633,3.0,-1.0476454436543674,0.7289907339014143,0.11946104016415506,97,50,47,1,-1.2565367313548828,-1.170500554541026,-1.2875506099951286,0.11823492182142054,0.0044428422896989365,0.0044428422896989365,-1.2875506099951286,-1.170500554541026,1,1,0,0,-1.170500554541026,-1.2875506099951286
6014,26,15,46,110,124,1,3033.454,50,1274.325,MORE,682,1018,1700,3,2,14.0,1.3123718449442827,14.0,0.8730378697119728,-0.07173135367908642,-0.4568803198478829,234,110,124,0,1.4759320336549415,1.170500554541026,1.7167341466601715,0.11823492182142054,0.6753198361929197,0.6753198361929197,1.7167341466601715,1.170500554541026,0,1,1,2,1.7167341466601715,1.170500554541026
6015,26,16,27,91,80,0,3098.95,50,1123.656,MORE,-584,1652,1068,2,1,-11.0,-1.0311493067419364,11.0,0.34921514788478913,-0.07173135367908642,-0.4216498035935528,171,91,80,1,0.21939530230005888,0.4291835366650429,0.0,-0.8276444527499438,-0.5108956306806521,0.5108956306806521,0.0,0.4291835366650429,0,0,0,1,0.4291835366650429,0.0
6016,26,17,40,64,80,1,3006.867,70,1797.835,MORE,898,1102,2000,3,2,16.0,1.4998535370791803,16.0,1.222253017596762,0.7289907339014143,-0.4711815555821854,144,64,80,0,-0.3191204397091766,-0.6242669624218805,0.0,0.11823492182142054,0.877707309214003,0.877707309214003,0.0,-0.6242669624218805,1,1,1,1,-0.6242669624218805,0.0
6017,26,18,22,83,80,1,2611.25,60,1090.873,MORE,-126,1012,886,1,2,-3.0,-0.28122253820234633,3.0,-1.0476454436543674,0.32862969011116394,-0.6839852557927232,163,83,80,1,0.05983508244547061,0.1170500554541026,0.0,-1.773523827321308,-0.08175922955261433,0.08175922955261433,0.0,0.1170500554541026,1,0,0,1,0.1170500554541026,0.0
6018,26,19,54,101,110,0,5021.21,60,1014.321,MORE,-90,2144,2054,4,1,9.0,0.8436676146070391,9.0,0.0,0.32862969011116394,0.6123402442727125,211,101,110,0,1.0171964015730004,0.8193503881787182,1.170500554541026,1.0641142963927848,-0.04802798404910045,0.04802798404910045,1.170500554541026,0.8193503881787182,1,1,0,2,1.170500554541026,0.8193503881787182
6019,26,20,6,56,50,0,5364.196999999999,70,1821.563,MORE,270,2404,2674,4,1,-6.0,-0.5624450764046927,6.0,-0.5238227218271837,0.7289907339014143,0.7968340924241103,106,56,50,1,-1.077031484018471,-0.9364004436328208,-1.170500554541026,1.0641142963927848,0.2892844709860385,0.2892844709860385,-1.170500554541026,-0.9364004436328208,1,1,1,0,-0.9364004436328208,-1.170500554541026
6020,26,21,18,50,42,0,15268.943,60,1117.601,MORE,-8534,10476,1942,2,1,-8.0,-0.7499267685395902,8.0,-0.17460757394239454,0.32862969011116394,6.1246299112223985,92,50,42,1,-1.3562618687640005,-1.170500554541026,-1.4826340357519663,-0.8276444527499438,-7.959879012706637,7.959879012706637,-1.4826340357519663,-1.170500554541026,1,0,0,0,-1.170500554541026,-1.4826340357519663
6021,26,22,43,110,117,0,3485.132,0,2106.605,MORE,-832,2156,1324,2,1,7.0,0.6561859224721414,7.0,-0.34921514788478913,-2.073536572630338,-0.21392122126593305,227,110,117,0,1.3363168412821769,1.170500554541026,1.4436173506005987,-0.8276444527499438,-0.7432664330381923,0.7432664330381923,1.4436173506005987,1.170500554541026,0,0,0,2,1.4436173506005987,1.170500554541026
6022,26,23,32,77,80,0,7177.3290000000015,50,1513.503,MORE,-1516,4280,2764,4,1,3.0,0.28122253820234633,3.0,-1.0476454436543674,-0.07173135367908642,1.7721238261062653,157,77,80,0,-0.05983508244547061,-0.1170500554541026,0.0,1.0641142963927848,-1.3841600976049564,1.3841600976049564,0.0,-0.1170500554541026,0,1,0,1,-0.1170500554541026,0.0
6023,26,24,27,80,91,1,3908.625,50,1569.461,MORE,-458,2008,1550,3,1,11.0,1.0311493067419364,11.0,0.34921514788478913,-0.07173135367908642,0.013877072066409169,171,80,91,0,0.21939530230005888,0.0,0.4291835366650429,0.11823492182142054,-0.39283627141835353,0.39283627141835353,0.4291835366650429,0.0,0,1,0,1,0.4291835366650429,0.0
6024,26,25,16,44,50,1,2896.952,100,1230.408,MORE,1088,978,2066,2,2,6.0,0.5624450764046927,6.0,-0.5238227218271837,1.9300738652721652,-0.5303051996840346,94,44,50,0,-1.3163718138003533,-1.4046006654492311,-1.170500554541026,-0.8276444527499438,1.055733327149215,1.055733327149215,-1.170500554541026,-1.4046006654492311,1,0,1,0,-1.4046006654492311,-1.170500554541026
6025,26,26,7,50,57,0,7720.648,40,1249.017,MORE,470,2616,3086,4,1,7.0,0.6561859224721414,7.0,-0.34921514788478913,-0.4720923974693368,2.0643769234066567,107,50,57,0,-1.0570864565366473,-1.170500554541026,-0.8973837584814532,1.0641142963927848,0.4766802793388934,0.4766802793388934,-0.8973837584814532,-1.170500554541026,0,1,1,0,-1.170500554541026,-0.8973837584814532
6026,26,27,14,50,46,0,2694.369,50,1407.612,MORE,-1072,1930,858,2,1,-4.0,-0.3749633842697951,4.0,-0.8730378697119728,-0.07173135367908642,-0.6392752692203572,96,50,46,1,-1.2764817588367063,-1.170500554541026,-1.3265672951464962,-0.8276444527499438,-0.9681414030616183,0.9681414030616183,-1.3265672951464962,-1.170500554541026,0,0,0,0,-1.170500554541026,-1.3265672951464962
6027,26,28,51,110,108,1,5572.055,40,893.743,MORE,1936,1370,3306,2,2,-2.0,-0.18748169213489754,2.0,-1.222253017596762,-0.4720923974693368,0.908641602006262,218,110,108,1,1.156811593945765,1.170500554541026,1.092467184238291,-0.8276444527499438,1.85029155456532,1.85029155456532,1.092467184238291,1.170500554541026,0,0,1,2,1.170500554541026,1.092467184238291
6028,26,29,50,133,110,0,10583.331,70,1380.3,MORE,-574,5078,4504,3,1,-23.0,-2.1560394595513217,23.0,2.444506035193524,0.7289907339014143,3.604223631029946,243,133,110,1,1.6554372809913533,2.0678843130224793,1.170500554541026,0.11823492182142054,-0.5015258402630094,0.5015258402630094,1.170500554541026,2.0678843130224793,1,0,0,2,2.0678843130224793,1.170500554541026
6029,26,30,49,131,110,0,9587.822,90,3052.149000000001,MORE,462,4472,4934,4,2,-21.0,-1.9685577674164243,21.0,2.0952908873087353,1.5297128214819151,3.0687360286445773,241,131,110,1,1.6155472260277064,1.9898509427197442,1.170500554541026,1.0641142963927848,0.46918444700477924,0.46918444700477924,1.170500554541026,1.9898509427197442,1,1,1,2,1.9898509427197442,1.170500554541026
6030,26,31,47,126,110,0,3651.797,50,1587.11,MORE,-918,1790,872,2,1,-16.0,-1.4998535370791803,16.0,1.222253017596762,-0.07173135367908642,-0.12427156340090385,236,126,110,1,1.5158220886185887,1.7947675169629065,1.170500554541026,-0.8276444527499438,-0.8238466306299199,0.8238466306299199,1.170500554541026,1.7947675169629065,0,0,0,2,1.7947675169629065,1.170500554541026
6031,26,32,50,110,133,1,4992.643,60,1218.723,MORE,-52,2038,1986,2,2,23.0,2.1560394595513217,23.0,2.444506035193524,0.32862969011116394,0.5969739599524876,243,110,133,0,1.6554372809913533,1.170500554541026,2.0678843130224793,-0.8276444527499438,-0.01242278046205801,0.01242278046205801,2.0678843130224793,1.170500554541026,1,0,0,2,2.0678843130224793,1.170500554541026
6032,26,33,47,110,126,0,4595.107,60,1190.033,MORE,310,2104,2414,2,1,16.0,1.4998535370791803,16.0,1.222253017596762,0.32862969011116394,0.38313802325892704,236,110,126,0,1.5158220886185887,1.170500554541026,1.7947675169629065,-0.8276444527499438,0.32676363265660946,0.32676363265660946,1.7947675169629065,1.170500554541026,1,0,1,2,1.7947675169629065,1.170500554541026
6033,26,34,12,48,50,1,4694.762,70,1092.213,MORE,1354,1680,3034,3,2,2.0,0.18748169213489754,2.0,-1.222253017596762,0.7289907339014143,0.4367427792337236,98,48,50,0,-1.2365917038730592,-1.248533924843761,-1.170500554541026,0.11823492182142054,1.3049697522585122,1.3049697522585122,-1.170500554541026,-1.248533924843761,1,1,1,0,-1.248533924843761,-1.170500554541026
6034,26,35,32,80,77,1,7557.36,50,1609.441,MORE,502,2818,3320,5,2,-3.0,-0.28122253820234633,3.0,-1.0476454436543674,-0.07173135367908642,1.976543765074284,157,80,77,1,-0.05983508244547061,0.0,-0.1170500554541026,2.0099936709641493,0.5066636086753502,0.5066636086753502,-0.1170500554541026,0.0,0,1,1,1,0.0,-0.1170500554541026
6035,26,36,43,117,110,0,2468.382,60,1163.309,MORE,-396,1634,1238,3,2,-7.0,-0.6561859224721414,7.0,-0.34921514788478913,0.32862969011116394,-0.7608344282036132,227,117,110,1,1.3363168412821769,1.4436173506005987,1.170500554541026,0.11823492182142054,-0.3347435708289685,0.3347435708289685,1.170500554541026,1.4436173506005987,1,1,0,2,1.4436173506005987,1.170500554541026
6036,26,37,40,80,64,0,3474.492,20,1643.6229999999996,MORE,-1284,2238,954,1,1,-16.0,-1.4998535370791803,16.0,1.222253017596762,-1.2728144850498375,-0.2196445126569504,144,80,64,1,-0.3191204397091766,0.0,-0.6242669624218805,-1.773523827321308,-1.1667809599156447,1.1667809599156447,-0.6242669624218805,0.0,0,0,0,1,0.0,-0.6242669624218805
6037,26,38,31,80,78,0,2846.675,70,1303.329,MORE,-986,1882,896,2,1,-2.0,-0.18748169213489754,2.0,-1.222253017596762,0.7289907339014143,-0.5573493652165703,158,80,78,1,-0.03989005496364707,0.0,-0.07803337030273506,-0.8276444527499438,-0.8875612054698906,0.8875612054698906,-0.07803337030273506,0.0,1,0,0,1,0.0,-0.07803337030273506
6038,26,39,46,124,110,0,2255.533,40,1117.065,MORE,-862,1660,798,2,1,-14.0,-1.3123718449442827,14.0,0.8730378697119728,-0.4720923974693368,-0.8753266132869458,234,124,110,1,1.4759320336549415,1.7167341466601715,1.170500554541026,-0.8276444527499438,-0.7713758042911205,0.7713758042911205,1.170500554541026,1.7167341466601715,0,0,0,2,1.7167341466601715,1.170500554541026
6039,26,40,58,92,110,0,3640.418,60,1172.529,MORE,-766,2026,1260,1,1,18.0,1.6873352292140782,18.0,1.571468165481551,0.32862969011116394,-0.1303923653500003,202,92,110,0,0.8376911542365885,0.4682002218164104,1.170500554541026,-1.773523827321308,-0.6814258162817501,0.6814258162817501,1.170500554541026,0.4682002218164104,1,0,0,2,1.170500554541026,0.4682002218164104
6040,26,41,49,110,131,0,2493.757,80,2022.452,LESS,-588,1476,888,2,2,21.0,1.9685577674164243,21.0,2.0952908873087353,1.1293517776916646,-0.7471851313006935,241,110,131,1,1.6155472260277064,1.170500554541026,1.9898509427197442,-0.8276444527499438,-0.5146435468477093,0.5146435468477093,1.9898509427197442,1.170500554541026,1,0,0,2,1.9898509427197442,1.170500554541026
6041,26,42,13,47,50,0,2694.086,60,866.424,LESS,-490,1466,976,2,1,3.0,0.28122253820234633,3.0,-1.0476454436543674,0.32862969011116394,-0.6394274958616787,97,47,50,1,-1.2565367313548828,-1.2875506099951286,-1.170500554541026,-0.8276444527499438,-0.42281960075481034,0.42281960075481034,-1.170500554541026,-1.2875506099951286,1,0,0,0,-1.2875506099951286,-1.170500554541026
6042,26,43,16,50,44,1,3082.664,50,1063.218,LESS,48,1462,1510,3,2,-6.0,-0.5624450764046927,6.0,-0.5238227218271837,-0.07173135367908642,-0.43041009716442746,94,50,44,0,-1.3163718138003533,-1.170500554541026,-1.4046006654492311,0.11823492182142054,0.08127512371436947,0.08127512371436947,-1.4046006654492311,-1.170500554541026,0,1,1,0,-1.170500554541026,-1.4046006654492311
6043,26,44,7,57,50,0,2189.881,0,1932.297,LESS,-688,1556,868,2,1,-7.0,-0.6561859224721414,7.0,-0.34921514788478913,-2.073536572630338,-0.910641042460167,107,57,50,0,-1.0570864565366473,-0.8973837584814532,-1.170500554541026,-0.8276444527499438,-0.6083414510241367,0.6083414510241367,-1.170500554541026,-0.8973837584814532,0,0,0,0,-0.8973837584814532,-1.170500554541026
6044,26,45,18,42,50,0,2006.645,60,1041.604,LESS,-382,1134,752,2,1,8.0,0.7499267685395902,8.0,-0.17460757394239454,0.32862969011116394,-1.0092042963440446,92,42,50,1,-1.3562618687640005,-1.4826340357519663,-1.170500554541026,-0.8276444527499438,-0.32162586424426864,0.32162586424426864,-1.170500554541026,-1.4826340357519663,1,0,0,0,-1.4826340357519663,-1.170500554541026
6045,26,46,51,108,110,0,2061.51,40,1497.221,LESS,-504,1238,734,2,1,2.0,0.18748169213489754,2.0,-1.222253017596762,-0.4720923974693368,-0.9796922303507956,218,108,110,1,1.156811593945765,1.092467184238291,1.170500554541026,-0.8276444527499438,-0.4359373073395102,0.4359373073395102,1.170500554541026,1.092467184238291,0,0,0,2,1.170500554541026,1.092467184238291
6046,26,47,31,78,80,1,3270.151,0,1807.722,LESS,-516,2524,2008,3,1,2.0,0.18748169213489754,2.0,-1.222253017596762,-2.073536572630338,-0.32956021624077403,158,78,80,1,-0.03989005496364707,-0.07803337030273506,0.0,0.11823492182142054,-0.44718105584068146,0.44718105584068146,0.0,-0.07803337030273506,0,1,0,1,-0.07803337030273506,0.0
6047,26,48,58,110,92,1,2749.182,10,1301.3010000000004,LESS,176,1316,1492,3,1,-18.0,-1.6873352292140782,18.0,1.571468165481551,-1.6731755288400882,-0.6097911742000721,202,110,92,0,0.8376911542365885,1.170500554541026,0.4682002218164104,0.11823492182142054,0.20120844106019664,0.20120844106019664,0.4682002218164104,1.170500554541026,0,1,1,2,1.170500554541026,0.4682002218164104
6048,26,49,12,50,48,0,1961.831,80,1504.866,LESS,68,1002,1070,2,2,-2.0,-0.18748169213489754,2.0,-1.222253017596762,1.1293517776916646,-1.0333098960054221,98,50,48,0,-1.2365917038730592,-1.170500554541026,-1.248533924843761,-0.8276444527499438,0.10001470454965497,0.10001470454965497,-1.248533924843761,-1.170500554541026,1,0,1,0,-1.170500554541026,-1.248533924843761
6049,26,50,54,110,101,1,2567.314,40,1336.588,LESS,348,1292,1640,4,1,-9.0,-0.8436676146070391,9.0,0.0,-0.4720923974693368,-0.7076185763336762,211,110,101,0,1.0171964015730004,1.170500554541026,0.8193503881787182,1.0641142963927848,0.3623688362436519,0.3623688362436519,0.8193503881787182,1.170500554541026,0,1,1,2,1.170500554541026,0.8193503881787182
6050,26,51,14,46,50,0,2440.868,10,1342.604,LESS,-728,1694,966,2,1,4.0,0.3749633842697951,4.0,-0.8730378697119728,-1.6731755288400882,-0.775634300321325,96,46,50,1,-1.2764817588367063,-1.3265672951464962,-1.170500554541026,-0.8276444527499438,-0.6458206126947077,0.6458206126947077,-1.170500554541026,-1.3265672951464962,0,0,0,0,-1.3265672951464962,-1.170500554541026
6051,26,52,22,80,83,0,2501.371,70,1120.348,LESS,-680,1570,890,2,2,3.0,0.28122253820234633,3.0,-1.0476454436543674,0.7289907339014143,-0.7430895353748282,163,80,83,1,0.05983508244547061,0.0,0.1170500554541026,-0.8276444527499438,-0.6008456186900225,0.6008456186900225,0.1170500554541026,0.0,1,0,0,1,0.1170500554541026,0.0
6052,26,53,6,50,56,0,2034.693,70,1333.583,LESS,524,1096,1620,2,2,6.0,0.5624450764046927,6.0,-0.5238227218271837,0.7289907339014143,-0.9941171838501296,106,50,56,1,-1.077031484018471,-1.170500554541026,-0.9364004436328208,-0.8276444527499438,0.5272771475941642,0.5272771475941642,-0.9364004436328208,-1.170500554541026,1,0,1,0,-1.170500554541026,-0.9364004436328208
6053,26,54,13,50,47,0,2186.896,40,1446.418,LESS,-284,1170,886,2,1,-3.0,-0.28122253820234633,3.0,-1.0476454436543674,-0.4720923974693368,-0.9122466838889436,97,50,47,0,-1.2565367313548828,-1.170500554541026,-1.2875506099951286,-0.8276444527499438,-0.22980191815136974,0.22980191815136974,-1.2875506099951286,-1.170500554541026,0,0,0,0,-1.170500554541026,-1.2875506099951286
6054,26,55,46,110,124,0,3497.84,50,1861.231,LESS,-274,1808,1534,1,1,14.0,1.3123718449442827,14.0,0.8730378697119728,-0.07173135367908642,-0.2070855457962856,234,110,124,1,1.4759320336549415,1.170500554541026,1.7167341466601715,-1.773523827321308,-0.220432127733727,0.220432127733727,1.7167341466601715,1.170500554541026,0,0,0,2,1.7167341466601715,1.170500554541026
6055,26,56,27,91,80,0,4301.24,30,1319.106,LESS,76,2080,2156,3,1,-11.0,-1.0311493067419364,11.0,0.34921514788478913,-0.8724534412595871,0.225065986491624,171,91,80,0,0.21939530230005888,0.4291835366650429,0.0,0.11823492182142054,0.10751053688376916,0.10751053688376916,0.0,0.4291835366650429,0,1,1,1,0.4291835366650429,0.0
6056,26,57,40,64,80,0,2002.954,80,1883.718,LESS,442,1220,1662,2,2,16.0,1.4998535370791803,16.0,1.222253017596762,1.1293517776916646,-1.0111896975211354,144,64,80,1,-0.3191204397091766,-0.6242669624218805,0.0,-0.8276444527499438,0.4504448661694937,0.4504448661694937,0.0,-0.6242669624218805,1,0,1,1,-0.6242669624218805,0.0
6057,26,58,22,83,80,1,4178.732,60,1509.806,LESS,838,1678,2516,3,2,-3.0,-0.28122253820234633,3.0,-1.0476454436543674,0.32862969011116394,0.1591685258026432,163,83,80,0,0.05983508244547061,0.1170500554541026,0.0,0.11823492182142054,0.8214885667081465,0.8214885667081465,0.0,0.1170500554541026,1,1,1,1,0.1170500554541026,0.0
6058,26,59,54,101,110,0,2498.799,40,1285.335,LESS,-658,1466,808,2,1,9.0,0.8436676146070391,9.0,0.0,-0.4720923974693368,-0.744473022729875,211,101,110,1,1.0171964015730004,0.8193503881787182,1.170500554541026,-0.8276444527499438,-0.5802320797712085,0.5802320797712085,1.170500554541026,0.8193503881787182,0,0,0,2,1.170500554541026,0.8193503881787182
6059,26,60,6,56,50,0,4576.566,50,1409.1329999999996,LESS,-286,2234,1948,4,1,-6.0,-0.5624450764046927,6.0,-0.5238227218271837,-0.07173135367908642,0.3731647576874182,106,56,50,0,-1.077031484018471,-0.9364004436328208,-1.170500554541026,1.0641142963927848,-0.2316758762348983,0.2316758762348983,-1.170500554541026,-0.9364004436328208,1,1,0,0,-0.9364004436328208,-1.170500554541026
6060,26,61,18,50,42,1,3470.541,50,1208.667,LESS,502,1326,1828,3,2,-8.0,-0.7499267685395902,8.0,-0.17460757394239454,-0.07173135367908642,-0.2217697686988592,92,50,42,0,-1.3562618687640005,-1.170500554541026,-1.4826340357519663,0.11823492182142054,0.5066636086753502,0.5066636086753502,-1.4826340357519663,-1.170500554541026,1,1,1,0,-1.170500554541026,-1.4826340357519663
6061,26,62,43,110,117,1,3723.311,60,1150.079,LESS,1374,1078,2452,3,2,7.0,0.6561859224721414,7.0,-0.34921514788478913,0.32862969011116394,-0.08580394492936087,227,110,117,1,1.3363168412821769,1.170500554541026,1.4436173506005987,0.11823492182142054,1.3237093330937977,1.3237093330937977,1.4436173506005987,1.170500554541026,1,1,1,2,1.4436173506005987,1.170500554541026
6062,26,63,32,77,80,1,3684.998,30,1175.747,LESS,180,1614,1794,3,2,3.0,0.28122253820234633,3.0,-1.0476454436543674,-0.8724534412595871,-0.10641263506695947,157,77,80,1,-0.05983508244547061,-0.1170500554541026,0.0,0.11823492182142054,0.20495635722725375,0.20495635722725375,0.0,-0.1170500554541026,0,1,1,1,-0.1170500554541026,0.0
6063,26,64,27,80,91,1,4086.338,60,1037.062,LESS,518,1432,1950,3,2,11.0,1.0311493067419364,11.0,0.34921514788478913,0.32862969011116394,0.10946948587955503,171,80,91,1,0.21939530230005888,0.0,0.4291835366650429,0.11823492182142054,0.5216552733435786,0.5216552733435786,0.4291835366650429,0.0,1,1,1,1,0.4291835366650429,0.0
6064,26,65,16,44,50,1,5223.016,40,791.0419999999998,LESS,708,2002,2710,3,2,6.0,0.5624450764046927,6.0,-0.5238227218271837,-0.4720923974693368,0.7208923629245594,94,44,50,1,-1.3163718138003533,-1.4046006654492311,-1.170500554541026,0.11823492182142054,0.6996812912787908,0.6996812912787908,-1.170500554541026,-1.4046006654492311,0,1,1,0,-1.4046006654492311,-1.170500554541026
6065,26,66,7,50,57,1,4457.953,10,2392.258,LESS,-958,3192,2234,3,1,7.0,0.6561859224721414,7.0,-0.34921514788478913,-1.6731755288400882,0.3093624304540779,107,50,57,1,-1.0570864565366473,-1.170500554541026,-0.8973837584814532,0.11823492182142054,-0.8613257923004909,0.8613257923004909,-0.8973837584814532,-1.170500554541026,0,1,0,0,-1.170500554541026,-0.8973837584814532
6066,26,67,14,50,46,0,7896.099,20,1630.267,LESS,822,3138,3960,4,1,-4.0,-0.3749633842697951,4.0,-0.8730378697119728,-1.2728144850498375,2.1587525998958847,96,50,46,0,-1.2764817588367063,-1.170500554541026,-1.3265672951464962,1.0641142963927848,0.8064969020399181,0.8064969020399181,-1.3265672951464962,-1.170500554541026,0,1,1,0,-1.170500554541026,-1.3265672951464962
6067,26,68,51,110,108,1,5371.976,40,1621.485,LESS,530,2248,2778,3,1,-2.0,-0.18748169213489754,2.0,-1.222253017596762,-0.4720923974693368,0.8010184423988026,218,110,108,0,1.156811593945765,1.170500554541026,1.092467184238291,0.11823492182142054,0.5328990218447499,0.5328990218447499,1.092467184238291,1.170500554541026,0,1,1,2,1.170500554541026,1.092467184238291
6068,26,69,50,133,110,1,4946.858,50,1613.0739999999996,LESS,1832,1106,2938,2,2,-23.0,-2.1560394595513217,23.0,2.444506035193524,-0.07173135367908642,0.5723460561613476,243,133,110,0,1.6554372809913533,2.0678843130224793,1.170500554541026,-0.8276444527499438,1.7528457342218355,1.7528457342218355,1.170500554541026,2.0678843130224793,1,0,1,2,2.0678843130224793,1.170500554541026
6069,26,70,49,131,110,1,3588.377,70,1261.025,LESS,834,1502,2336,3,2,-21.0,-1.9685577674164243,21.0,2.0952908873087353,0.7289907339014143,-0.1583853923499943,241,131,110,0,1.6155472260277064,1.9898509427197442,1.170500554541026,0.11823492182142054,0.8177406505410895,0.8177406505410895,1.170500554541026,1.9898509427197442,1,1,1,2,1.9898509427197442,1.170500554541026
6070,26,71,47,126,110,0,3142.813,50,1348.0,LESS,-262,1646,1384,2,1,-16.0,-1.4998535370791803,16.0,1.222253017596762,-0.07173135367908642,-0.39805574999541404,236,126,110,0,1.5158220886185887,1.7947675169629065,1.170500554541026,-0.8276444527499438,-0.2091883792325557,0.2091883792325557,1.170500554541026,1.7947675169629065,1,0,1,2,1.7947675169629065,1.170500554541026
6071,26,72,50,110,133,0,4487.395,30,1692.601,LESS,-1164,2796,1632,2,1,23.0,2.1560394595513217,23.0,2.444506035193524,-0.8724534412595871,0.3251993801847484,243,110,133,1,1.6554372809913533,1.170500554541026,2.0678843130224793,-0.8276444527499438,-1.0543434749039315,1.0543434749039315,2.0678843130224793,1.170500554541026,0,0,0,2,2.0678843130224793,1.170500554541026
6072,26,73,47,110,126,0,2063.181,80,1477.402,LESS,412,966,1378,2,2,16.0,1.4998535370791803,16.0,1.222253017596762,1.1293517776916646,-0.9787933938926764,236,110,126,1,1.5158220886185887,1.170500554541026,1.7947675169629065,-0.8276444527499438,0.42233549491656547,0.42233549491656547,1.7947675169629065,1.170500554541026,1,0,1,2,1.7947675169629065,1.170500554541026
6073,26,74,12,48,50,0,2060.215,90,2060.994,LESS,678,1108,1786,1,2,2.0,0.18748169213489754,2.0,-1.222253017596762,1.5297128214819151,-0.9803888151582549,98,48,50,1,-1.2365917038730592,-1.248533924843761,-1.170500554541026,-1.773523827321308,0.6715719200258625,0.6715719200258625,-1.170500554541026,-1.248533924843761,1,0,1,0,-1.248533924843761,-1.170500554541026
6074,26,75,32,80,77,0,2384.944,100,1660.481,LESS,900,1200,2100,2,2,-3.0,-0.28122253820234633,3.0,-1.0476454436543674,1.9300738652721652,-0.8057160059370445,157,80,77,0,-0.05983508244547061,0.0,-0.1170500554541026,-0.8276444527499438,0.8795812672975315,0.8795812672975315,-0.1170500554541026,0.0,1,0,1,1,0.0,-0.1170500554541026
6075,26,76,43,117,110,1,2822.85,70,988.937,LESS,806,1074,1880,3,2,-7.0,-0.6561859224721414,7.0,-0.34921514788478913,0.7289907339014143,-0.5701649119638439,227,117,110,0,1.3363168412821769,1.4436173506005987,1.170500554541026,0.11823492182142054,0.7915052373716898,0.7915052373716898,1.170500554541026,1.4436173506005987,1,1,1,2,1.4436173506005987,1.170500554541026
6076,26,77,40,80,64,0,2110.343,80,1401.195,LESS,562,974,1536,2,2,-16.0,-1.4998535370791803,16.0,1.222253017596762,1.1293517776916646,-0.9534247972213268,144,80,64,0,-0.3191204397091766,0.0,-0.6242669624218805,-0.8276444527499438,0.5628823511812067,0.5628823511812067,-0.6242669624218805,0.0,1,0,1,1,0.0,-0.6242669624218805
6077,26,78,31,80,78,0,2032.518,60,1920.414,LESS,-94,908,814,2,1,-2.0,-0.18748169213489754,2.0,-1.222253017596762,0.32862969011116394,-0.9952871235846656,158,80,78,0,-0.03989005496364707,0.0,-0.07803337030273506,-0.8276444527499438,-0.05177590021615755,0.05177590021615755,-0.07803337030273506,0.0,1,0,1,1,0.0,-0.07803337030273506
6078,26,79,46,124,110,0,4916.4209999999985,40,1365.6029999999996,LESS,-520,2662,2142,4,1,-14.0,-1.3123718449442827,14.0,0.8730378697119728,-0.4720923974693368,0.5559738926210839,234,124,110,0,1.4759320336549415,1.7167341466601715,1.170500554541026,1.0641142963927848,-0.45092897200773857,0.45092897200773857,1.170500554541026,1.7167341466601715,0,1,0,2,1.7167341466601715,1.170500554541026
6079,26,80,58,92,110,0,3463.87,30,1676.7579999999996,LESS,-542,1970,1428,2,1,18.0,1.6873352292140782,18.0,1.571468165481551,-0.8724534412595871,-0.2253581217880959,202,92,110,1,0.8376911542365885,0.4682002218164104,1.170500554541026,-0.8276444527499438,-0.47154251092655264,0.47154251092655264,1.170500554541026,0.4682002218164104,0,0,0,2,1.170500554541026,0.4682002218164104
6080,26,81,48,128,110,0,6962.221,80,1780.233,MORE,-426,3066,2640,3,2,-18.0,-1.6873352292140782,18.0,1.571468165481551,1.1293517776916646,1.6564165174089933,238,128,110,1,1.5557121435822359,1.8728008872656416,1.170500554541026,0.11823492182142054,-0.3628529420818968,0.3628529420818968,1.170500554541026,1.8728008872656416,1,1,0,2,1.8728008872656416,1.170500554541026
6081,26,82,8,50,58,1,3006.345,100,2588.931,MORE,1554,1290,2844,3,2,8.0,0.7499267685395902,8.0,-0.17460757394239454,1.9300738652721652,-0.4714623411184742,108,50,58,0,-1.0371414290548238,-1.170500554541026,-0.8583670733300858,0.11823492182142054,1.492365560611367,1.492365560611367,-0.8583670733300858,-1.170500554541026,1,1,1,0,-1.170500554541026,-0.8583670733300858
6082,26,83,4,54,50,1,4687.366,70,961.486,MORE,668,2200,2868,3,2,-4.0,-0.3749633842697951,4.0,-0.8730378697119728,0.7289907339014143,0.4327644462329752,104,54,50,1,-1.116921538982118,-1.0144338139355558,-1.170500554541026,0.11823492182142054,0.6622021296082198,0.6622021296082198,-1.170500554541026,-1.0144338139355558,1,1,1,0,-1.0144338139355558,-1.170500554541026
6083,26,84,37,80,69,0,2758.795,50,1147.372,MORE,232,1196,1428,4,1,-11.0,-1.0311493067419364,11.0,0.34921514788478913,-0.07173135367908642,-0.604620309525086,149,80,69,1,-0.21939530230005888,0.0,-0.4291835366650429,1.0641142963927848,0.25367926739899604,0.25367926739899604,-0.4291835366650429,0.0,0,1,1,1,0.0,-0.4291835366650429
6084,26,85,52,105,110,1,2739.147,80,1874.052,MORE,890,1190,2080,3,2,5.0,0.4687042303372438,5.0,-0.6984302957695783,1.1293517776916646,-0.6151890340787243,215,105,110,0,1.0969765115002945,0.9754171287841883,1.170500554541026,0.11823492182142054,0.8702114768798888,0.8702114768798888,1.170500554541026,0.9754171287841883,1,1,1,2,1.170500554541026,0.9754171287841883
6085,26,86,5,55,50,0,3927.039,50,1124.224,MORE,-360,1928,1568,4,1,-5.0,-0.4687042303372438,5.0,-0.6984302957695783,-0.07173135367908642,0.023782023915487664,105,55,50,1,-1.0969765115002945,-0.9754171287841883,-1.170500554541026,1.0641142963927848,-0.30101232532545463,0.30101232532545463,-1.170500554541026,-0.9754171287841883,0,1,0,0,-0.9754171287841883,-1.170500554541026
6086,26,87,30,96,80,0,4294.75,30,3094.475,MORE,-366,2068,1702,5,1,-16.0,-1.4998535370791803,16.0,1.222253017596762,-0.8724534412595871,0.22157499390443405,176,96,80,1,0.3191204397091766,0.6242669624218805,0.0,2.0099936709641493,-0.30663419957604027,0.30663419957604027,0.0,0.6242669624218805,0,1,0,1,0.6242669624218805,0.0
6087,26,88,33,80,75,1,2454.979,90,1177.911,MORE,820,894,1714,3,2,-5.0,-0.4687042303372438,5.0,-0.6984302957695783,1.5297128214819151,-0.7680439464849861,155,80,75,1,-0.09972513740911768,0.0,-0.19508342575683765,0.11823492182142054,0.8046229439563896,0.8046229439563896,-0.19508342575683765,0.0,1,1,1,1,0.0,-0.19508342575683765
6088,26,89,48,110,128,1,2496.827,70,2690.24,MORE,1566,842,2408,3,2,18.0,1.6873352292140782,18.0,1.571468165481551,0.7289907339014143,-0.7455337680891875,238,110,128,0,1.5557121435822359,1.170500554541026,1.8728008872656416,0.11823492182142054,1.5036093091125384,1.5036093091125384,1.8728008872656416,1.170500554541026,1,1,1,2,1.8728008872656416,1.170500554541026
6089,26,90,9,59,50,1,6324.076,30,1832.97,MORE,290,2648,2938,5,2,-9.0,-0.8436676146070391,9.0,0.0,-0.8724534412595871,1.3131561992961378,109,59,50,1,-1.0171964015730004,-0.8193503881787182,-1.170500554541026,2.0099936709641493,0.308024051821324,0.308024051821324,-1.170500554541026,-0.8193503881787182,0,1,1,0,-0.8193503881787182,-1.170500554541026
6090,26,91,44,110,119,1,11780.841,50,1112.164,MORE,3230,2716,5946,5,2,9.0,0.8436676146070391,9.0,0.0,-0.07173135367908642,4.248368243215775,229,110,119,0,1.376206896245824,1.170500554541026,1.5216507209033339,2.0099936709641493,3.0627424346082917,3.0627424346082917,1.5216507209033339,1.170500554541026,0,1,1,2,1.5216507209033339,1.170500554541026
6091,26,92,2,52,50,0,9034.696,0,2082.326,MORE,-636,3968,3332,4,1,-2.0,-0.18748169213489754,2.0,-1.222253017596762,-2.073536572630338,2.7712077134239124,102,52,50,1,-1.156811593945765,-1.092467184238291,-1.170500554541026,1.0641142963927848,-0.5596185408523945,0.5596185408523945,-1.170500554541026,-1.092467184238291,0,1,0,0,-1.092467184238291,-1.170500554541026
6092,26,93,8,58,50,0,2735.087,10,1696.283,MORE,-1036,2006,970,2,1,-8.0,-0.7499267685395902,8.0,-0.17460757394239454,-1.6731755288400882,-0.6173729215831913,108,58,50,1,-1.0371414290548238,-0.8583670733300858,-1.170500554541026,-0.8276444527499438,-0.9344101575581043,0.9344101575581043,-1.170500554541026,-0.8583670733300858,0,0,0,0,-0.8583670733300858,-1.170500554541026
6093,26,94,44,119,110,0,4886.065,30,1771.77,MORE,-274,2356,2082,4,1,-9.0,-0.8436676146070391,9.0,0.0,-0.8724534412595871,0.5396452992502458,229,119,110,1,1.376206896245824,1.5216507209033339,1.170500554541026,1.0641142963927848,-0.220432127733727,0.220432127733727,1.170500554541026,1.5216507209033339,0,1,0,2,1.5216507209033339,1.170500554541026
6094,26,95,34,74,80,1,8591.544,40,1690.784,MORE,982,3346,4328,4,1,6.0,0.5624450764046927,6.0,-0.5238227218271837,-0.4720923974693368,2.532834778601343,154,74,80,0,-0.11967016489094122,-0.2341001109082052,0.0,1.0641142963927848,0.9564135487222021,0.9564135487222021,0.0,-0.2341001109082052,0,1,1,1,-0.2341001109082052,0.0
6095,26,96,24,86,80,1,5016.858,60,2928.079,MORE,-148,2482,2334,4,1,-6.0,-0.5624450764046927,6.0,-0.5238227218271837,0.32862969011116394,0.6099992889969882,166,86,80,1,0.11967016489094122,0.2341001109082052,0.0,1.0641142963927848,-0.10237276847142837,0.10237276847142837,0.0,0.2341001109082052,1,1,0,1,0.2341001109082052,0.0
6096,26,97,39,66,80,0,3983.471,50,1340.879,MORE,118,1700,1818,3,2,14.0,1.3123718449442827,14.0,0.8730378697119728,-0.07173135367908642,0.05413698442092858,146,66,80,0,-0.2792303847455295,-0.5462335921191455,0.0,0.11823492182142054,0.1468636566378687,0.1468636566378687,0.0,-0.5462335921191455,0,1,0,1,-0.5462335921191455,0.0
6097,26,98,9,50,59,1,3944.317,20,2202.493,MORE,-582,2110,1528,4,1,9.0,0.8436676146070391,9.0,0.0,-1.2728144850498375,0.033075917585976104,109,50,59,0,-1.0171964015730004,-1.170500554541026,-0.8193503881787182,1.0641142963927848,-0.5090216725971236,0.5090216725971236,-0.8193503881787182,-1.170500554541026,0,1,0,0,-1.170500554541026,-0.8193503881787182
6098,26,99,57,94,110,1,3322.85,60,1053.581,MORE,348,1314,1662,3,2,16.0,1.4998535370791803,16.0,1.222253017596762,0.32862969011116394,-0.30121324885212497,204,94,110,0,0.8775812092002355,0.5462335921191455,1.170500554541026,0.11823492182142054,0.3623688362436519,0.3623688362436519,1.170500554541026,0.5462335921191455,1,1,1,2,1.170500554541026,0.5462335921191455
6099,26,100,60,110,87,0,5648.852,20,1156.532,MORE,-740,2898,2158,2,1,-23.0,-2.1560394595513217,23.0,2.444506035193524,-1.2728144850498375,0.9499509637502432,197,110,87,1,0.7379660168274708,1.170500554541026,0.27311679605957273,-0.8276444527499438,-0.657064361195879,0.657064361195879,0.27311679605957273,1.170500554541026,0,0,0,2,1.170500554541026,0.27311679605957273
6100,26,101,33,75,80,1,3192.225,90,1965.136,MORE,830,1196,2026,3,2,5.0,0.4687042303372438,5.0,-0.6984302957695783,1.5297128214819151,-0.3714768708400616,155,75,80,0,-0.09972513740911768,-0.19508342575683765,0.0,0.11823492182142054,0.8139927343740323,0.8139927343740323,0.0,-0.19508342575683765,1,1,1,1,-0.19508342575683765,0.0
6101,26,102,15,50,45,1,5584.85,70,1404.162,MORE,26,2532,2558,5,2,-5.0,-0.4687042303372438,5.0,-0.6984302957695783,0.7289907339014143,0.9155240750652912,95,50,45,1,-1.2964267863185297,-1.170500554541026,-1.3655839802978638,2.0099936709641493,0.060661584795555425,0.060661584795555425,-1.3655839802978638,-1.170500554541026,1,1,0,0,-1.170500554541026,-1.3655839802978638
6102,26,103,59,89,110,0,3800.955,50,1899.69,MORE,-1586,2742,1156,2,1,21.0,1.9685577674164243,21.0,2.0952908873087353,-0.07173135367908642,-0.0440389790680684,199,89,110,0,0.7778560717911179,0.3511501663623078,1.170500554541026,-0.8276444527499438,-1.4497486305284555,1.4497486305284555,1.170500554541026,0.3511501663623078,0,0,0,2,1.170500554541026,0.3511501663623078
6103,26,104,29,80,94,1,2762.286,90,1937.265,MORE,1154,1144,2298,3,2,14.0,1.3123718449442827,14.0,0.8730378697119728,1.5297128214819151,-0.60274248901324,174,80,94,0,0.2792303847455295,0.0,0.5462335921191455,0.11823492182142054,1.1175739439056571,1.1175739439056571,0.5462335921191455,0.0,1,1,1,1,0.5462335921191455,0.0
6104,26,105,55,110,98,0,2369.886,60,1419.4779999999996,MORE,-608,1388,780,2,1,-12.0,-1.124890152809385,12.0,0.5238227218271837,0.32862969011116394,-0.8138157542233171,208,110,98,1,0.9573613191275298,1.170500554541026,0.7023003327246156,-0.8276444527499438,-0.5333831276829948,0.5333831276829948,0.7023003327246156,1.170500554541026,1,0,0,2,1.170500554541026,0.7023003327246156
6105,26,106,29,94,80,0,4778.094,50,1271.559,MORE,-476,2414,1938,4,1,-14.0,-1.3123718449442827,14.0,0.8730378697119728,-0.07173135367908642,0.4815673392145753,174,94,80,1,0.2792303847455295,0.5462335921191455,0.0,1.0641142963927848,-0.4097018941701105,0.4097018941701105,0.0,0.5462335921191455,0,1,0,1,0.5462335921191455,0.0
6106,26,107,57,110,94,0,3005.013,60,955.334,MORE,-444,1572,1128,2,1,-16.0,-1.4998535370791803,16.0,1.222253017596762,0.32862969011116394,-0.4721788283490038,204,110,94,1,0.8775812092002355,1.170500554541026,0.5462335921191455,-0.8276444527499438,-0.3797185648336537,0.3797185648336537,0.5462335921191455,1.170500554541026,1,0,0,2,1.170500554541026,0.5462335921191455
6107,26,108,39,80,66,0,3246.13,20,1108.887,MORE,-764,1850,1086,2,1,-14.0,-1.3123718449442827,14.0,0.8730378697119728,-1.2728144850498375,-0.34248119203998706,146,80,66,1,-0.2792303847455295,0.0,-0.5462335921191455,-0.8276444527499438,-0.6795518581982216,0.6795518581982216,-0.5462335921191455,0.0,0,0,0,1,0.0,-0.5462335921191455
6108,26,109,4,50,54,1,2716.2090000000007,50,1659.859,MORE,36,1212,1248,3,2,4.0,0.3749633842697951,4.0,-0.8730378697119728,-0.07173135367908642,-0.627527460575637,104,50,54,0,-1.116921538982118,-1.170500554541026,-1.0144338139355558,0.11823492182142054,0.07003137521319817,0.07003137521319817,-1.0144338139355558,-1.170500554541026,0,1,0,0,-1.170500554541026,-1.0144338139355558
6109,26,110,55,98,110,0,5576.069,20,1706.0320000000004,MORE,-1004,2714,1710,3,1,12.0,1.124890152809385,12.0,0.5238227218271837,-1.2728144850498375,0.9108007459577232,208,98,110,0,0.9573613191275298,0.7023003327246156,1.170500554541026,0.11823492182142054,-0.9044268282216475,0.9044268282216475,1.170500554541026,0.7023003327246156,0,1,0,2,1.170500554541026,0.7023003327246156
6110,26,111,2,50,52,1,2473.1420000000007,100,2048.577,MORE,1142,936,2078,3,2,2.0,0.18748169213489754,2.0,-1.222253017596762,1.9300738652721652,-0.7582740083707893,102,50,52,0,-1.156811593945765,-1.170500554541026,-1.092467184238291,0.11823492182142054,1.106330195404486,1.106330195404486,-1.092467184238291,-1.170500554541026,1,1,1,0,-1.170500554541026,-1.092467184238291
6111,26,112,59,110,89,0,3912.157,80,1067.85,MORE,28,1776,1804,3,2,-21.0,-1.9685577674164243,21.0,2.0952908873087353,1.1293517776916646,0.01577694661463043,199,110,89,1,0.7778560717911179,1.170500554541026,0.3511501663623078,0.11823492182142054,0.06253554287908397,0.06253554287908397,0.3511501663623078,1.170500554541026,1,0,0,2,1.170500554541026,0.3511501663623078
6112,26,113,60,87,110,1,3462.278,60,2014.497,MORE,440,1324,1764,3,2,23.0,2.1560394595513217,23.0,2.444506035193524,0.32862969011116394,-0.2262144638834437,197,87,110,0,0.7379660168274708,0.27311679605957273,1.170500554541026,0.11823492182142054,0.44857090808596517,0.44857090808596517,1.170500554541026,0.27311679605957273,1,0,1,2,1.170500554541026,0.27311679605957273
6113,26,114,52,110,105,0,6806.876,50,1101.565,MORE,-1128,2914,1786,4,1,-5.0,-0.4687042303372438,5.0,-0.6984302957695783,-0.07173135367908642,1.5728559251968135,215,110,105,1,1.0969765115002945,1.170500554541026,0.9754171287841883,1.0641142963927848,-1.0206122294004176,1.0206122294004176,0.9754171287841883,1.170500554541026,0,1,0,2,1.170500554541026,0.9754171287841883
6114,26,115,30,80,96,1,3689.885,90,2523.943,MORE,614,1968,2582,3,2,16.0,1.4998535370791803,16.0,1.222253017596762,1.5297128214819151,-0.10378390151170544,176,80,96,0,0.3191204397091766,0.0,0.6242669624218805,0.11823492182142054,0.611605261352949,0.611605261352949,0.6242669624218805,0.0,1,0,1,1,0.6242669624218805,0.0
6115,26,116,24,80,86,1,4854.366,0,1733.9,MORE,-1744,3346,1602,3,1,6.0,0.5624450764046927,6.0,-0.5238227218271837,-2.073536572630338,0.5225943017122893,166,80,86,0,0.11967016489094122,0.0,0.2341001109082052,0.11823492182142054,-1.597791319127211,1.597791319127211,0.2341001109082052,0.0,0,0,0,1,0.2341001109082052,0.0
6116,26,117,5,50,55,1,2165.553,100,2087.501,MORE,928,780,1708,3,2,5.0,0.4687042303372438,5.0,-0.6984302957695783,1.9300738652721652,-0.9237271545805308,105,50,55,0,-1.0969765115002945,-1.170500554541026,-0.9754171287841883,0.11823492182142054,0.9058166804669312,0.9058166804669312,-0.9754171287841883,-1.170500554541026,1,0,1,0,-1.170500554541026,-0.9754171287841883
6117,26,118,34,80,74,0,2967.995,10,1641.3429999999996,MORE,-806,2250,1444,4,1,-6.0,-0.5624450764046927,6.0,-0.5238227218271837,-1.6731755288400882,-0.49209093367914297,154,80,74,1,-0.11967016489094122,0.0,-0.2341001109082052,1.0641142963927848,-0.7189049779523211,0.7189049779523211,-0.2341001109082052,0.0,0,1,0,1,0.0,-0.2341001109082052
6118,26,119,15,45,50,1,2533.616,90,1668.756,MORE,1456,1172,2628,3,2,5.0,0.4687042303372438,5.0,-0.6984302957695783,1.5297128214819151,-0.7257448426207536,95,45,50,0,-1.2964267863185297,-1.3655839802978638,-1.170500554541026,0.11823492182142054,1.4005416145184681,1.4005416145184681,-1.170500554541026,-1.3655839802978638,1,0,1,0,-1.3655839802978638,-1.170500554541026
6119,26,120,37,69,80,0,2814.158,50,949.61,MORE,-772,1630,858,2,1,11.0,1.0311493067419364,11.0,0.34921514788478913,-0.07173135367908642,-0.5748403676753779,149,69,80,0,-0.21939530230005888,-0.4291835366650429,0.0,-0.8276444527499438,-0.6870476905323358,0.6870476905323358,0.0,-0.4291835366650429,0,0,0,1,-0.4291835366650429,0.0
6120,26,121,48,128,110,1,6310.8780000000015,20,1023.08,LESS,-658,3194,2536,5,1,-18.0,-1.6873352292140782,18.0,1.571468165481551,-1.2728144850498375,1.3060569511966416,238,128,110,0,1.5557121435822359,1.8728008872656416,1.170500554541026,2.0099936709641493,-0.5802320797712085,0.5802320797712085,1.170500554541026,1.8728008872656416,0,1,0,2,1.8728008872656416,1.170500554541026
6121,26,122,8,50,58,0,2225.929,100,1334.813,LESS,360,1480,1840,3,2,8.0,0.7499267685395902,8.0,-0.17460757394239454,1.9300738652721652,-0.8912507033564644,108,50,58,1,-1.0371414290548238,-1.170500554541026,-0.8583670733300858,0.11823492182142054,0.3736125847448232,0.3736125847448232,-0.8583670733300858,-1.170500554541026,1,1,1,0,-1.170500554541026,-0.8583670733300858
6122,26,123,4,54,50,1,5577.786,50,1431.944,LESS,408,2286,2694,5,2,-4.0,-0.3749633842697951,4.0,-0.8730378697119728,-0.07173135367908642,0.9117243259688486,104,54,50,0,-1.116921538982118,-1.0144338139355558,-1.170500554541026,2.0099936709641493,0.41858757874950836,0.41858757874950836,-1.170500554541026,-1.0144338139355558,1,1,1,0,-1.0144338139355558,-1.170500554541026
6123,26,124,37,80,69,1,3762.645,40,1164.27,LESS,588,1432,2020,3,2,-11.0,-1.0311493067419364,11.0,0.34921514788478913,-0.4720923974693368,-0.06464605549568826,149,80,69,0,-0.21939530230005888,0.0,-0.4291835366650429,0.11823492182142054,0.5872438062670778,0.5872438062670778,-0.4291835366650429,0.0,0,1,1,1,0.0,-0.4291835366650429
6124,26,125,52,105,110,0,6337.387,70,2636.757,LESS,-1720,3458,1738,4,1,5.0,0.4687042303372438,5.0,-0.6984302957695783,0.7289907339014143,1.3203162304714977,215,105,110,1,1.0969765115002945,0.9754171287841883,1.170500554541026,1.0641142963927848,-1.5753038221248683,1.5753038221248683,1.170500554541026,0.9754171287841883,1,1,0,2,1.170500554541026,0.9754171287841883
6125,26,126,5,55,50,0,5171.295,20,1798.196,LESS,-422,2624,2202,4,1,-5.0,-0.4687042303372438,5.0,-0.6984302957695783,-1.2728144850498375,0.6930714649889572,105,55,50,0,-1.0969765115002945,-0.9754171287841883,-1.170500554541026,1.0641142963927848,-0.35910502591483967,0.35910502591483967,-1.170500554541026,-0.9754171287841883,0,1,0,0,-0.9754171287841883,-1.170500554541026
6126,26,127,30,96,80,1,3259.466,20,1565.677,LESS,608,1210,1818,3,2,-16.0,-1.4998535370791803,16.0,1.222253017596762,-1.2728144850498375,-0.3353077132814714,176,96,80,0,0.3191204397091766,0.6242669624218805,0.0,0.11823492182142054,0.6059833871023633,0.6059833871023633,0.0,0.6242669624218805,0,1,1,1,0.6242669624218805,0.0
6127,26,128,33,80,75,0,5783.933000000001,0,2750.435,LESS,-2340,4446,2106,4,1,-5.0,-0.4687042303372438,5.0,-0.6984302957695783,-2.073536572630338,1.022611482959832,155,80,75,0,-0.09972513740911768,0.0,-0.19508342575683765,1.0641142963927848,-2.1562308280187183,2.1562308280187183,-0.19508342575683765,0.0,0,1,0,1,0.0,-0.19508342575683765
6128,26,129,48,110,128,0,2434.332000000001,90,1937.524,LESS,978,1334,2312,2,2,18.0,1.6873352292140782,18.0,1.571468165481551,1.5297128214819151,-0.7791500364615209,238,110,128,1,1.5557121435822359,1.170500554541026,1.8728008872656416,-0.8276444527499438,0.952665632555145,0.952665632555145,1.8728008872656416,1.170500554541026,1,0,1,2,1.8728008872656416,1.170500554541026
6129,26,130,9,59,50,1,4499.962,10,1376.049,LESS,-426,2682,2256,5,1,-9.0,-0.8436676146070391,9.0,0.0,-1.6731755288400882,0.33195921128539835,109,59,50,0,-1.0171964015730004,-0.8193503881787182,-1.170500554541026,2.0099936709641493,-0.3628529420818968,0.3628529420818968,-1.170500554541026,-0.8193503881787182,0,1,0,0,-0.8193503881787182,-1.170500554541026
6130,26,131,44,110,119,0,6346.889,30,1460.3570000000002,LESS,-620,2832,2212,4,1,9.0,0.8436676146070391,9.0,0.0,-0.8724534412595871,1.3254273878772729,229,110,119,1,1.376206896245824,1.170500554541026,1.5216507209033339,1.0641142963927848,-0.544626876184166,0.544626876184166,1.5216507209033339,1.170500554541026,0,1,0,2,1.5216507209033339,1.170500554541026
6131,26,132,2,52,50,0,10257.774,20,1523.695,LESS,3226,2970,6196,6,1,-2.0,-0.18748169213489754,2.0,-1.222253017596762,-1.2728144850498375,3.4291054378546217,102,52,50,0,-1.156811593945765,-1.092467184238291,-1.170500554541026,2.9558730455355136,3.0589945184412346,3.0589945184412346,-1.170500554541026,-1.092467184238291,0,1,1,0,-1.092467184238291,-1.170500554541026
6132,26,133,8,58,50,0,3939.51,40,1534.336,LESS,144,1816,1960,4,1,-8.0,-0.7499267685395902,8.0,-0.17460757394239454,-0.4720923974693368,0.030490216296820163,108,58,50,0,-1.0371414290548238,-0.8583670733300858,-1.170500554541026,1.0641142963927848,0.17122511172373986,0.17122511172373986,-1.170500554541026,-0.8583670733300858,0,1,1,0,-0.8583670733300858,-1.170500554541026
6133,26,134,44,119,110,1,5972.627,60,2473.812,LESS,1420,2054,3474,6,1,-9.0,-0.8436676146070391,9.0,0.0,0.32862969011116394,1.124110613198237,229,119,110,0,1.376206896245824,1.5216507209033339,1.170500554541026,2.9558730455355136,1.3668103690149542,1.3668103690149542,1.170500554541026,1.5216507209033339,1,1,1,2,1.5216507209033339,1.170500554541026
6134,26,135,34,74,80,0,2583.198,50,1676.813,LESS,-864,1738,874,2,1,6.0,0.5624450764046927,6.0,-0.5238227218271837,-0.07173135367908642,-0.6990745198999432,154,74,80,1,-0.11967016489094122,-0.2341001109082052,0.0,-0.8276444527499438,-0.773249762374649,0.773249762374649,0.0,-0.2341001109082052,0,0,0,1,-0.2341001109082052,0.0
6135,26,136,24,86,80,1,5884.523,50,1433.756,LESS,1882,1588,3470,3,2,-6.0,-0.5624450764046927,6.0,-0.5238227218271837,-0.07173135367908642,1.0767191785446473,166,86,80,0,0.11967016489094122,0.2341001109082052,0.0,0.11823492182142054,1.7996946863100491,1.7996946863100491,0.0,0.2341001109082052,1,1,1,1,0.2341001109082052,0.0
6136,26,137,39,66,80,0,2442.05,60,1367.224,LESS,-966,1694,728,2,1,14.0,1.3123718449442827,14.0,0.8730378697119728,0.32862969011116394,-0.7749984985897287,146,66,80,1,-0.2792303847455295,-0.5462335921191455,0.0,-0.8276444527499438,-0.8688216246346051,0.8688216246346051,0.0,-0.5462335921191455,1,0,0,1,-0.5462335921191455,0.0
6137,26,138,9,50,59,0,2534.487,20,1149.8,LESS,-1226,2014,788,2,1,9.0,0.8436676146070391,9.0,0.0,-1.2728144850498375,-0.7252763288236129,109,50,59,1,-1.0171964015730004,-1.170500554541026,-0.8193503881787182,-0.8276444527499438,-1.1124361754933167,1.1124361754933167,-0.8193503881787182,-1.170500554541026,0,0,0,0,-1.170500554541026,-0.8193503881787182
6138,26,139,57,94,110,0,2364.845,60,1803.31,LESS,-900,1688,788,2,1,16.0,1.4998535370791803,16.0,1.222253017596762,0.32862969011116394,-0.8165273248908095,204,94,110,1,0.8775812092002355,0.5462335921191455,1.170500554541026,-0.8276444527499438,-0.806981007878163,0.806981007878163,1.170500554541026,0.5462335921191455,1,0,0,2,1.170500554541026,0.5462335921191455
6139,26,140,60,110,87,1,4377.315,60,1535.485,LESS,-306,1656,1350,3,2,-23.0,-2.1560394595513217,23.0,2.444506035193524,0.32862969011116394,0.26598698203407195,197,110,87,0,0.7379660168274708,1.170500554541026,0.27311679605957273,0.11823492182142054,-0.2504154570701838,0.2504154570701838,0.27311679605957273,1.170500554541026,1,1,0,2,1.170500554541026,0.27311679605957273
6140,26,141,33,75,80,1,5945.525,80,2302.447,LESS,982,2554,3536,5,2,5.0,0.4687042303372438,5.0,-0.6984302957695783,1.1293517776916646,1.109532357250929,155,75,80,1,-0.09972513740911768,-0.19508342575683765,0.0,2.0099936709641493,0.9564135487222021,0.9564135487222021,0.0,-0.19508342575683765,1,1,1,1,-0.19508342575683765,0.0
6141,26,142,15,50,45,0,3650.664,30,1107.5739999999996,LESS,-1702,2510,808,2,1,-5.0,-0.4687042303372438,5.0,-0.6984302957695783,-0.8724534412595871,-0.1248810078695149,95,50,45,0,-1.2964267863185297,-1.170500554541026,-1.3655839802978638,-0.8276444527499438,-1.5584381993731113,1.5584381993731113,-1.3655839802978638,-1.170500554541026,0,0,0,0,-1.170500554541026,-1.3655839802978638
6142,26,143,59,89,110,0,2038.65,80,2586.992,LESS,-158,1406,1248,2,2,21.0,1.9685577674164243,21.0,2.0952908873087353,1.1293517776916646,-0.9919887003882636,199,89,110,1,0.7778560717911179,0.3511501663623078,1.170500554541026,-0.8276444527499438,-0.11174255888907113,0.11174255888907113,1.170500554541026,0.3511501663623078,1,0,1,2,1.170500554541026,0.3511501663623078
6143,26,144,29,80,94,0,2173.383,40,1038.604,LESS,-464,1202,738,2,1,14.0,1.3123718449442827,14.0,0.8730378697119728,-0.4720923974693368,-0.9195153715362012,174,80,94,1,0.2792303847455295,0.0,0.5462335921191455,-0.8276444527499438,-0.39845814566893917,0.39845814566893917,0.5462335921191455,0.0,0,0,0,1,0.5462335921191455,0.0
6144,26,145,55,110,98,1,5711.783,40,1279.779,LESS,324,2572,2896,3,2,-12.0,-1.124890152809385,12.0,0.5238227218271837,-0.4720923974693368,0.9838017579728108,208,110,98,0,0.9573613191275298,1.170500554541026,0.7023003327246156,0.11823492182142054,0.3398813392413093,0.3398813392413093,0.7023003327246156,1.170500554541026,0,1,1,2,1.170500554541026,0.7023003327246156
6145,26,146,29,94,80,1,6388.109,50,972.174,LESS,1892,1554,3446,2,2,-14.0,-1.3123718449442827,14.0,0.8730378697119728,-0.07173135367908642,1.3475997629842034,174,94,80,0,0.2792303847455295,0.5462335921191455,0.0,-0.8276444527499438,1.809064476727692,1.809064476727692,0.0,0.5462335921191455,0,0,1,1,0.5462335921191455,0.0
6146,26,147,57,110,94,1,4760.737,40,1583.069,LESS,-484,2546,2062,4,1,-16.0,-1.4998535370791803,16.0,1.222253017596762,-0.4720923974693368,0.4722309511813151,204,110,94,0,0.8775812092002355,1.170500554541026,0.5462335921191455,1.0641142963927848,-0.4171977265042247,0.4171977265042247,0.5462335921191455,1.170500554541026,0,1,0,2,1.170500554541026,0.5462335921191455
6147,26,148,39,80,66,1,4125.136,50,1072.228,LESS,596,1600,2196,3,2,-14.0,-1.3123718449442827,14.0,0.8730378697119728,-0.07173135367908642,0.13033905913037208,146,80,66,0,-0.2792303847455295,0.0,-0.5462335921191455,0.11823492182142054,0.594739638601192,0.594739638601192,-0.5462335921191455,0.0,0,1,1,1,0.0,-0.5462335921191455
6148,26,149,4,50,54,0,4116.57,60,1849.159,LESS,-654,2156,1502,4,1,4.0,0.3749633842697951,4.0,-0.8730378697119728,0.32862969011116394,0.12573137923794175,104,50,54,1,-1.116921538982118,-1.170500554541026,-1.0144338139355558,1.0641142963927848,-0.5764841636041514,0.5764841636041514,-1.0144338139355558,-1.170500554541026,1,1,0,0,-1.170500554541026,-1.0144338139355558
6149,26,150,55,98,110,0,2502.618,90,1413.109,LESS,162,1504,1666,1,2,12.0,1.124890152809385,12.0,0.5238227218271837,1.5297128214819151,-0.7424187699270277,208,98,110,1,0.9573613191275298,0.7023003327246156,1.170500554541026,-1.773523827321308,0.1880907344754968,0.1880907344754968,1.170500554541026,0.7023003327246156,1,0,1,2,1.170500554541026,0.7023003327246156
6150,26,151,2,50,52,0,1974.829,100,2515.818,LESS,942,1084,2026,2,2,2.0,0.18748169213489754,2.0,-1.222253017596762,1.9300738652721652,-1.0263182285711696,102,50,52,1,-1.156811593945765,-1.170500554541026,-1.092467184238291,-0.8276444527499438,0.9189343870516311,0.9189343870516311,-1.092467184238291,-1.170500554541026,1,0,1,0,-1.170500554541026,-1.092467184238291
6151,26,152,59,110,89,0,2485.7670000000007,40,1582.7520000000004,LESS,-772,1498,726,2,1,-21.0,-1.9685577674164243,21.0,2.0952908873087353,-0.4720923974693368,-0.7514829788772184,199,110,89,0,0.7778560717911179,1.170500554541026,0.3511501663623078,-0.8276444527499438,-0.6870476905323358,0.6870476905323358,0.3511501663623078,1.170500554541026,0,0,0,2,1.170500554541026,0.3511501663623078
6152,26,153,60,87,110,0,2519.234,80,958.899,LESS,-196,1598,1402,2,2,23.0,2.1560394595513217,23.0,2.444506035193524,1.1293517776916646,-0.7334809682584991,197,87,110,1,0.7379660168274708,0.27311679605957273,1.170500554541026,-0.8276444527499438,-0.14734776247611356,0.14734776247611356,1.170500554541026,0.27311679605957273,1,0,1,2,1.170500554541026,0.27311679605957273
6153,26,154,52,110,105,0,5623.303000000001,50,1332.3770000000004,LESS,-242,2122,1880,4,1,-5.0,-0.4687042303372438,5.0,-0.6984302957695783,-0.07173135367908642,0.9362080716685612,215,110,105,0,1.0969765115002945,1.170500554541026,0.9754171287841883,1.0641142963927848,-0.1904487983972702,0.1904487983972702,0.9754171287841883,1.170500554541026,0,1,1,2,1.170500554541026,0.9754171287841883
6154,26,155,30,80,96,0,4310.302,60,2318.21,LESS,-1072,2254,1182,1,1,16.0,1.4998535370791803,16.0,1.222253017596762,0.32862969011116394,0.22994046643386076,176,80,96,1,0.3191204397091766,0.0,0.6242669624218805,-1.773523827321308,-0.9681414030616183,0.9681414030616183,0.6242669624218805,0.0,1,0,0,1,0.6242669624218805,0.0
6155,26,156,24,80,86,0,10034.304,40,1373.784,LESS,-1666,5522,3856,3,1,6.0,0.5624450764046927,6.0,-0.5238227218271837,-0.4720923974693368,3.3089001815434704,166,80,86,1,0.11967016489094122,0.0,0.2341001109082052,0.11823492182142054,-1.5247069538695974,1.5247069538695974,0.2341001109082052,0.0,0,1,0,1,0.2341001109082052,0.0
6156,26,157,5,50,55,0,3917.847,30,2128.134,LESS,-1192,2082,890,2,1,5.0,0.4687042303372438,5.0,-0.6984302957695783,-0.8724534412595871,0.018837616540841817,105,50,55,1,-1.0969765115002945,-1.170500554541026,-0.9754171287841883,-0.8276444527499438,-1.0805788880733314,1.0805788880733314,-0.9754171287841883,-1.170500554541026,0,0,0,0,-1.170500554541026,-0.9754171287841883
6157,26,158,34,80,74,0,3621.119,0,1717.731,LESS,-1296,2738,1442,2,1,-6.0,-0.5624450764046927,6.0,-0.5238227218271837,-2.073536572630338,-0.14077336164278642,154,80,74,0,-0.11967016489094122,0.0,-0.2341001109082052,-0.8276444527499438,-1.1780247084168158,1.1780247084168158,-0.2341001109082052,0.0,0,0,0,1,0.0,-0.2341001109082052
6158,26,159,15,45,50,0,5296.541,70,1816.307,LESS,-888,2886,1998,2,2,5.0,0.4687042303372438,5.0,-0.6984302957695783,0.7289907339014143,0.7604417049851379,95,45,50,1,-1.2964267863185297,-1.3655839802978638,-1.170500554541026,-0.8276444527499438,-0.7957372593769917,0.7957372593769917,-1.170500554541026,-1.3655839802978638,1,0,0,0,-1.3655839802978638,-1.170500554541026
6159,26,160,37,69,80,0,2968.8520000000008,70,1566.947,LESS,-1608,2338,730,2,1,11.0,1.0311493067419364,11.0,0.34921514788478913,0.7289907339014143,-0.491629950528569,149,69,80,1,-0.21939530230005888,-0.4291835366650429,0.0,-0.8276444527499438,-1.4703621694472695,1.4703621694472695,0.0,-0.4291835366650429,1,0,0,1,-0.4291835366650429,0.0
6160,26,161,3,50,53,1,2681.53,60,1756.965,MORE,98,1410,1508,4,1,3.0,0.28122253820234633,3.0,-1.0476454436543674,0.32862969011116394,-0.6461814100257399,103,50,53,0,-1.1368665664639415,-1.170500554541026,-1.0534504990869233,1.0641142963927848,0.1281240758025832,0.1281240758025832,-1.0534504990869233,-1.170500554541026,0,1,0,0,-1.170500554541026,-1.0534504990869233
6161,26,162,20,50,40,0,6612.498000000001,80,1483.983,MORE,-1546,3720,2174,5,2,-10.0,-0.9374084606744876,10.0,0.17460757394239454,1.1293517776916646,1.4682993524521548,90,50,40,1,-1.3961519237276474,-1.170500554541026,-1.5606674060547012,2.0099936709641493,-1.4122694688578845,1.4122694688578845,-1.5606674060547012,-1.170500554541026,1,1,0,0,-1.170500554541026,-1.5606674060547012
6162,26,163,25,80,88,1,2543.025,100,1724.544,MORE,1428,1154,2582,3,2,8.0,0.7499267685395902,8.0,-0.17460757394239454,1.9300738652721652,-0.7206837102243172,168,80,88,0,0.1595602198545883,0.0,0.31213348121094026,0.11823492182142054,1.3743062013490686,1.3743062013490686,0.31213348121094026,0.0,1,0,1,1,0.31213348121094026,0.0
6163,26,164,42,115,110,1,3110.467,30,1173.266,MORE,822,1172,1994,4,1,-5.0,-0.4687042303372438,5.0,-0.6984302957695783,-0.8724534412595871,-0.4154547709854373,225,115,110,1,1.2964267863185297,1.3655839802978638,1.170500554541026,1.0641142963927848,0.8064969020399181,0.8064969020399181,1.170500554541026,1.3655839802978638,0,1,1,2,1.3655839802978638,1.170500554541026
6164,26,165,53,103,110,1,2827.555,80,1677.1329999999996,MORE,652,1108,1760,3,2,7.0,0.6561859224721414,7.0,-0.34921514788478913,1.1293517776916646,-0.5676340768139626,213,103,110,0,1.0570864565366473,0.8973837584814532,1.170500554541026,0.11823492182142054,0.6472104649399915,0.6472104649399915,1.170500554541026,0.8973837584814532,1,0,1,2,1.170500554541026,0.8973837584814532
6165,26,166,26,90,80,1,2676.807,50,1081.702,MORE,550,984,1534,3,2,-10.0,-0.9374084606744876,10.0,0.17460757394239454,-0.07173135367908642,-0.6487219274354934,170,90,80,1,0.19945027481823535,0.3901668515136753,0.0,0.11823492182142054,0.5516386026800354,0.5516386026800354,0.0,0.3901668515136753,0,0,1,1,0.3901668515136753,0.0
6166,26,167,35,80,72,0,4946.576,50,1235.623,MORE,-710,2628,1918,4,1,-8.0,-0.7499267685395902,8.0,-0.17460757394239454,-0.07173135367908642,0.5721943674233525,152,80,72,1,-0.1595602198545883,0.0,-0.31213348121094026,1.0641142963927848,-0.6289549899429507,0.6289549899429507,-0.31213348121094026,0.0,0,1,0,1,0.0,-0.31213348121094026
6167,26,168,28,93,80,0,3069.226,30,1173.518,MORE,-738,1932,1194,2,1,-13.0,-1.218630998876834,13.0,0.6984302957695783,-0.8724534412595871,-0.4376384420622181,173,93,80,1,0.25928535726370594,0.5072169069677779,0.0,-0.8276444527499438,-0.6551904031123504,0.6551904031123504,0.0,0.5072169069677779,0,0,0,1,0.5072169069677779,0.0
6168,26,169,26,80,90,1,2909.776,50,1725.444,MORE,350,1216,1566,3,2,10.0,0.9374084606744876,10.0,0.17460757394239454,-0.07173135367908642,-0.5234071274285453,170,80,90,0,0.19945027481823535,0.0,0.3901668515136753,0.11823492182142054,0.36424279432718043,0.36424279432718043,0.3901668515136753,0.0,0,0,1,1,0.3901668515136753,0.0
6169,26,170,25,88,80,0,2467.004,80,806.591,MORE,-90,1450,1360,2,2,-8.0,-0.7499267685395902,8.0,-0.17460757394239454,1.1293517776916646,-0.7615756589871492,168,88,80,1,0.1595602198545883,0.31213348121094026,0.0,-0.8276444527499438,-0.04802798404910045,0.04802798404910045,0.0,0.31213348121094026,1,0,0,1,0.31213348121094026,0.0
6170,26,171,36,80,70,0,2153.84,40,1258.874,MORE,-382,1226,844,2,1,-10.0,-0.9374084606744876,10.0,0.17460757394239454,-0.4720923974693368,-0.9300276162405856,150,80,70,1,-0.19945027481823535,0.0,-0.3901668515136753,-0.8276444527499438,-0.32162586424426864,0.32162586424426864,-0.3901668515136753,0.0,0,0,0,1,0.0,-0.3901668515136753
6171,26,172,28,80,93,1,2562.301,70,795.434,MORE,464,920,1384,3,2,13.0,1.218630998876834,13.0,0.6984302957695783,0.7289907339014143,-0.7103150857080343,173,80,93,0,0.25928535726370594,0.0,0.5072169069677779,0.11823492182142054,0.47105840508830776,0.47105840508830776,0.5072169069677779,0.0,1,0,1,1,0.5072169069677779,0.0
6172,26,173,21,82,80,0,2594.663,30,1106.685,MORE,-716,1694,978,2,1,-2.0,-0.18748169213489754,2.0,-1.222253017596762,-0.8724534412595871,-0.6929074582647914,162,82,80,1,0.03989005496364707,0.07803337030273506,0.0,-0.8276444527499438,-0.6345768641935364,0.6345768641935364,0.0,0.07803337030273506,0,0,0,1,0.07803337030273506,0.0
6173,26,174,19,50,41,0,4674.205,0,1720.573,MORE,-714,3132,2418,4,1,-9.0,-0.8436676146070391,9.0,0.0,-2.073536572630338,0.4256851005565485,91,50,41,1,-1.376206896245824,-1.170500554541026,-1.5216507209033339,1.0641142963927848,-0.6327029061100079,0.6327029061100079,-1.5216507209033339,-1.170500554541026,0,1,0,0,-1.170500554541026,-1.5216507209033339
6174,26,175,56,96,110,1,4044.829,20,1001.397,MORE,888,1580,2468,3,1,14.0,1.3123718449442827,14.0,0.8730378697119728,-1.2728144850498375,0.08714165671134635,206,96,110,0,0.9174712641638826,0.6242669624218805,1.170500554541026,0.11823492182142054,0.8683375187963602,0.8683375187963602,1.170500554541026,0.6242669624218805,0,0,1,2,1.170500554541026,0.6242669624218805
6175,26,176,23,80,85,1,3204.199,60,1556.942,MORE,212,1466,1678,3,2,5.0,0.4687042303372438,5.0,-0.6984302957695783,0.32862969011116394,-0.3650360164118621,165,80,85,0,0.09972513740911768,0.0,0.19508342575683765,0.11823492182142054,0.23493968656371053,0.23493968656371053,0.19508342575683765,0.0,1,1,1,1,0.19508342575683765,0.0
6176,26,177,10,60,50,1,3188.273,40,766.791,MORE,700,1120,1820,3,2,-10.0,-0.9374084606744876,10.0,0.17460757394239454,-0.4720923974693368,-0.3736026647852965,110,60,50,1,-0.9972513740911768,-0.7803337030273506,-1.170500554541026,0.11823492182142054,0.6921854589446766,0.6921854589446766,-1.170500554541026,-0.7803337030273506,0,0,1,0,-0.7803337030273506,-1.170500554541026
6177,26,178,19,41,50,1,1857.293,60,1874.084,MORE,592,558,1150,1,2,9.0,0.8436676146070391,9.0,0.0,0.32862969011116394,-1.0895412339221675,91,41,50,0,-1.376206896245824,-1.5216507209033339,-1.170500554541026,-1.773523827321308,0.5909917224341349,0.5909917224341349,-1.170500554541026,-1.5216507209033339,1,0,1,0,-1.5216507209033339,-1.170500554541026
6178,26,179,56,110,96,0,2550.861,70,973.907,MORE,-22,1534,1512,3,2,-14.0,-1.3123718449442827,14.0,0.8730378697119728,0.7289907339014143,-0.7164686997600305,206,110,96,1,0.9174712641638826,1.170500554541026,0.6242669624218805,0.11823492182142054,0.015686590790870234,0.015686590790870234,0.6242669624218805,1.170500554541026,1,1,0,2,1.170500554541026,0.6242669624218805
6179,26,180,35,72,80,1,3109.831,60,916.73,MORE,98,1382,1480,3,2,8.0,0.7499267685395902,8.0,-0.17460757394239454,0.32862969011116394,-0.4157968775009154,152,72,80,0,-0.1595602198545883,-0.31213348121094026,0.0,0.11823492182142054,0.1281240758025832,0.1281240758025832,0.0,-0.31213348121094026,1,1,0,1,-0.31213348121094026,0.0
6180,26,181,11,49,50,1,3238.687,90,1553.341,MORE,884,1416,2300,3,2,1.0,0.09374084606744876,1.0,-1.3968605915391563,1.5297128214819151,-0.34648480649706825,99,49,50,0,-1.2166466763912356,-1.2095172396923934,-1.170500554541026,0.11823492182142054,0.8645896026293032,0.8645896026293032,-1.170500554541026,-1.2095172396923934,1,1,1,0,-1.2095172396923934,-1.170500554541026
6181,26,182,17,43,50,1,3525.751,10,2178.64,MORE,-1108,2878,1770,2,1,7.0,0.6561859224721414,7.0,-0.34921514788478913,-1.6731755288400882,-0.1920721260580632,93,43,50,0,-1.3363168412821769,-1.4436173506005987,-1.170500554541026,-0.8276444527499438,-1.0018726485651321,1.0018726485651321,-1.170500554541026,-1.4436173506005987,0,0,0,0,-1.4436173506005987,-1.170500554541026
6182,26,183,1,51,50,1,3750.855,70,1593.43,MORE,446,1400,1846,3,2,-1.0,-0.09374084606744876,1.0,-1.3968605915391563,0.7289907339014143,-0.07098793571186257,101,51,50,1,-1.1767566214275886,-1.1314838693896585,-1.170500554541026,0.11823492182142054,0.4541927823365508,0.4541927823365508,-1.170500554541026,-1.1314838693896585,1,1,1,0,-1.1314838693896585,-1.170500554541026
6183,26,184,41,112,110,1,3371.85,50,1061.327,MORE,1022,1044,2066,3,2,-2.0,-0.18748169213489754,2.0,-1.222253017596762,-0.07173135367908642,-0.2748559858671766,222,112,110,1,1.2365917038730592,1.248533924843761,1.170500554541026,0.11823492182142054,0.9938927103927729,0.9938927103927729,1.170500554541026,1.248533924843761,0,1,1,2,1.248533924843761,1.170500554541026
6184,26,185,20,40,50,1,3067.544000000001,70,1343.456,MORE,828,1222,2050,3,2,10.0,0.9374084606744876,10.0,0.17460757394239454,0.7289907339014143,-0.4385431954569256,90,40,50,0,-1.3961519237276474,-1.5606674060547012,-1.170500554541026,0.11823492182142054,0.8121187762905038,0.8121187762905038,-1.170500554541026,-1.5606674060547012,1,1,1,0,-1.5606674060547012,-1.170500554541026
6185,26,186,1,50,51,1,4316.018,40,928.846,MORE,240,1766,2006,2,2,1.0,0.09374084606744876,1.0,-1.3968605915391563,-0.4720923974693368,0.2330151218465541,101,50,51,0,-1.1767566214275886,-1.170500554541026,-1.1314838693896585,-0.8276444527499438,0.2611750997331102,0.2611750997331102,-1.1314838693896585,-1.170500554541026,0,0,1,0,-1.170500554541026,-1.1314838693896585
6186,26,187,23,85,80,1,5624.833000000001,70,885.232,MORE,188,2492,2680,3,2,-5.0,-0.4687042303372438,5.0,-0.6984302957695783,0.7289907339014143,0.9370310637576832,165,85,80,1,0.09972513740911768,0.19508342575683765,0.0,0.11823492182142054,0.21245218956136794,0.21245218956136794,0.0,0.19508342575683765,1,0,0,1,0.19508342575683765,0.0
6187,26,188,11,50,49,1,5768.844,50,2176.09,MORE,1238,1978,3216,3,2,-1.0,-0.09374084606744876,1.0,-1.3968605915391563,-0.07173135367908642,1.0144950596704458,99,50,49,1,-1.2166466763912356,-1.170500554541026,-1.2095172396923934,0.11823492182142054,1.1962801834138563,1.1962801834138563,-1.2095172396923934,-1.170500554541026,0,0,1,0,-1.170500554541026,-1.2095172396923934
6188,26,189,17,50,43,0,4310.734,80,1535.6989999999996,MORE,296,2016,2312,4,2,-7.0,-0.6561859224721414,7.0,-0.34921514788478913,1.1293517776916646,0.23017284067078966,93,50,43,1,-1.3363168412821769,-1.170500554541026,-1.4436173506005987,1.0641142963927848,0.3136459260719096,0.3136459260719096,-1.4436173506005987,-1.170500554541026,1,1,1,0,-1.170500554541026,-1.4436173506005987
6189,26,190,21,80,82,1,3845.923,30,2337.938,MORE,518,1482,2000,3,2,2.0,0.18748169213489754,2.0,-1.222253017596762,-0.8724534412595871,-0.01985054229445294,162,80,82,0,0.03989005496364707,0.0,0.07803337030273506,0.11823492182142054,0.5216552733435786,0.5216552733435786,0.07803337030273506,0.0,0,0,1,1,0.07803337030273506,0.0
6190,26,191,10,50,60,1,5282.875,40,1858.481,MORE,804,1972,2776,3,2,10.0,0.9374084606744876,10.0,0.17460757394239454,-0.4720923974693368,0.7530907181289683,110,50,60,0,-0.9972513740911768,-1.170500554541026,-0.7803337030273506,0.11823492182142054,0.7896312792881611,0.7896312792881611,-0.7803337030273506,-1.170500554541026,0,0,1,0,-1.170500554541026,-0.7803337030273506
6191,26,192,3,53,50,1,3154.436,70,1708.7679999999998,MORE,716,1170,1886,3,2,-3.0,-0.28122253820234633,3.0,-1.0476454436543674,0.7289907339014143,-0.39180369963471895,103,53,50,1,-1.1368665664639415,-1.0534504990869233,-1.170500554541026,0.11823492182142054,0.707177123612905,0.707177123612905,-1.170500554541026,-1.0534504990869233,1,0,1,0,-1.0534504990869233,-1.170500554541026
6192,26,193,45,122,110,0,3155.11,90,1492.862,MORE,702,1390,2092,2,2,-12.0,-1.124890152809385,12.0,0.5238227218271837,1.5297128214819151,-0.3914411527928444,232,122,110,1,1.4360419786912946,1.6387007763574364,1.170500554541026,-0.8276444527499438,0.6940594170282052,0.6940594170282052,1.170500554541026,1.6387007763574364,1,0,1,2,1.6387007763574364,1.170500554541026
6193,26,194,38,67,80,1,3158.929,70,1587.622,MORE,232,1224,1456,3,2,13.0,1.218630998876834,13.0,0.6984302957695783,0.7289907339014143,-0.3893868999899971,147,67,80,0,-0.25928535726370594,-0.5072169069677779,0.0,0.11823492182142054,0.25367926739899604,0.25367926739899604,0.0,-0.5072169069677779,1,0,1,1,-0.5072169069677779,0.0
6194,26,195,38,80,67,1,3323.891,80,1643.736,MORE,3066,514,3580,1,2,-13.0,-1.218630998876834,13.0,0.6984302957695783,1.1293517776916646,-0.30065329148952635,147,80,67,1,-0.25928535726370594,0.0,-0.5072169069677779,-1.773523827321308,2.9090778717589507,2.9090778717589507,-0.5072169069677779,0.0,1,0,1,1,0.0,-0.5072169069677779
6195,26,196,36,70,80,1,4285.535,20,2299.906,MORE,254,1758,2012,3,1,10.0,0.9374084606744876,10.0,0.17460757394239454,-1.2728144850498375,0.21661821475328494,150,70,80,0,-0.19945027481823535,-0.3901668515136753,0.0,0.11823492182142054,0.27429280631781006,0.27429280631781006,0.0,-0.3901668515136753,0,0,1,1,-0.3901668515136753,0.0
6196,26,197,45,110,122,1,3362.234000000001,70,2122.181,MORE,502,1114,1616,2,2,12.0,1.124890152809385,12.0,0.5238227218271837,0.7289907339014143,-0.2800284642521407,232,110,122,0,1.4360419786912946,1.170500554541026,1.6387007763574364,-0.8276444527499438,0.5066636086753502,0.5066636086753502,1.6387007763574364,1.170500554541026,1,0,1,2,1.6387007763574364,1.170500554541026
6197,26,198,42,110,115,1,5032.0920000000015,0,1153.975,MORE,20,2492,2512,5,1,5.0,0.4687042303372438,5.0,-0.6984302957695783,-2.073536572630338,0.6181937082686767,225,110,115,0,1.2964267863185297,1.170500554541026,1.3655839802978638,2.0099936709641493,0.05503971054496977,0.05503971054496977,1.3655839802978638,1.170500554541026,0,1,0,2,1.3655839802978638,1.170500554541026
6198,26,199,41,110,112,1,2523.751,80,1020.806,MORE,506,1158,1664,3,2,2.0,0.18748169213489754,2.0,-1.222253017596762,1.1293517776916646,-0.7310512589339476,222,110,112,0,1.2365917038730592,1.170500554541026,1.248533924843761,0.11823492182142054,0.5104115248424073,0.5104115248424073,1.248533924843761,1.170500554541026,1,1,1,2,1.248533924843761,1.170500554541026
6199,26,200,53,110,103,1,5720.895,30,2292.981,MORE,1336,2040,3376,3,2,-7.0,-0.6561859224721414,7.0,-0.34921514788478913,-0.8724534412595871,0.9887031330813588,213,110,103,1,1.0570864565366473,1.170500554541026,0.8973837584814532,0.11823492182142054,1.2881041295067552,1.2881041295067552,0.8973837584814532,1.170500554541026,0,1,1,2,1.170500554541026,0.8973837584814532
6200,26,201,3,50,53,0,2557.246,100,1683.946,LESS,10,1272,1282,2,2,3.0,0.28122253820234633,3.0,-1.0476454436543674,1.9300738652721652,-0.7130341870220936,103,50,53,1,-1.1368665664639415,-1.170500554541026,-1.0534504990869233,-0.8276444527499438,0.04566992012732703,0.04566992012732703,-1.0534504990869233,-1.170500554541026,1,0,1,0,-1.170500554541026,-1.0534504990869233
6201,26,202,20,50,40,1,2706.55,10,1146.422,LESS,-702,2054,1352,3,1,-10.0,-0.9374084606744876,10.0,0.17460757394239454,-1.6731755288400882,-0.6327230688036295,90,50,40,0,-1.3961519237276474,-1.170500554541026,-1.5606674060547012,0.11823492182142054,-0.6214591576088366,0.6214591576088366,-1.5606674060547012,-1.170500554541026,0,1,0,0,-1.170500554541026,-1.5606674060547012
6202,26,203,25,80,88,0,3796.593,40,1679.651,LESS,-424,1876,1452,4,1,8.0,0.7499267685395902,8.0,-0.17460757394239454,-0.4720923974693368,-0.04638531337705508,168,80,88,1,0.1595602198545883,0.0,0.31213348121094026,1.0641142963927848,-0.3609789839983682,0.3609789839983682,0.31213348121094026,0.0,0,1,0,1,0.31213348121094026,0.0
6203,26,204,42,115,110,0,1872.349,80,982.285,LESS,-106,1194,1088,2,2,-5.0,-0.4687042303372438,5.0,-0.6984302957695783,1.1293517776916646,-1.0814425614425476,225,115,110,0,1.2964267863185297,1.3655839802978638,1.170500554541026,-0.8276444527499438,-0.06301964871732883,0.06301964871732883,1.170500554541026,1.3655839802978638,1,0,1,2,1.3655839802978638,1.170500554541026
6204,26,205,53,103,110,0,2463.985,90,2416.573,LESS,422,1468,1890,4,2,7.0,0.6561859224721414,7.0,-0.34921514788478913,1.5297128214819151,-0.7631995891290176,213,103,110,1,1.0570864565366473,0.8973837584814532,1.170500554541026,1.0641142963927848,0.4317052853342082,0.4317052853342082,1.170500554541026,0.8973837584814532,1,1,1,2,1.170500554541026,0.8973837584814532
6205,26,206,26,90,80,0,3838.883,50,1220.3,LESS,-882,1952,1070,4,1,-10.0,-0.9374084606744876,10.0,0.17460757394239454,-0.07173135367908642,-0.02363738171106592,170,90,80,0,0.19945027481823535,0.3901668515136753,0.0,1.0641142963927848,-0.790115385126406,0.790115385126406,0.0,0.3901668515136753,0,1,0,1,0.3901668515136753,0.0
6206,26,207,35,80,72,0,2455.096,20,1935.301,LESS,-2188,2994,806,2,1,-8.0,-0.7499267685395902,8.0,-0.17460757394239454,-1.2728144850498375,-0.7679810117958179,152,80,72,0,-0.1595602198545883,0.0,-0.31213348121094026,-0.8276444527499438,-2.0138100136705486,2.0138100136705486,-0.31213348121094026,0.0,0,0,0,1,0.0,-0.31213348121094026
6207,26,208,28,93,80,1,5683.111,30,1007.413,LESS,36,2262,2298,5,2,-13.0,-1.218630998876834,13.0,0.6984302957695783,-0.8724534412595871,0.968378993803332,173,93,80,0,0.25928535726370594,0.5072169069677779,0.0,2.0099936709641493,0.07003137521319817,0.07003137521319817,0.0,0.5072169069677779,0,1,1,1,0.5072169069677779,0.0
6208,26,209,26,80,90,0,3791.917,70,1432.655,LESS,336,1966,2302,4,2,10.0,0.9374084606744876,10.0,0.17460757394239454,0.7289907339014143,-0.048900549330475836,170,80,90,1,0.19945027481823535,0.0,0.3901668515136753,1.0641142963927848,0.3511250877424806,0.3511250877424806,0.3901668515136753,0.0,1,1,1,1,0.3901668515136753,0.0
6209,26,210,25,88,80,0,3503.1220000000008,50,1589.485,LESS,-916,2034,1118,2,1,-8.0,-0.7499267685395902,8.0,-0.17460757394239454,-0.07173135367908642,-0.20424434042717304,168,88,80,0,0.1595602198545883,0.31213348121094026,0.0,-0.8276444527499438,-0.8219726725463914,0.8219726725463914,0.0,0.31213348121094026,0,0,0,1,0.31213348121094026,0.0
6210,26,211,36,80,70,1,6476.696,0,1800.9160000000004,LESS,-728,3892,3164,6,1,-10.0,-0.9374084606744876,10.0,0.17460757394239454,-2.073536572630338,1.3952510049443587,150,80,70,0,-0.19945027481823535,0.0,-0.3901668515136753,2.9558730455355136,-0.6458206126947077,0.6458206126947077,-0.3901668515136753,0.0,0,1,0,1,0.0,-0.3901668515136753
6211,26,212,28,80,93,0,3457.796,80,801.492,LESS,414,1544,1958,4,2,13.0,1.218630998876834,13.0,0.6984302957695783,1.1293517776916646,-0.2286253465915771,173,80,93,1,0.25928535726370594,0.0,0.5072169069677779,1.0641142963927848,0.42420945300009405,0.42420945300009405,0.5072169069677779,0.0,1,1,1,1,0.5072169069677779,0.0
6212,26,213,21,82,80,0,1964.479,40,1209.766,LESS,-812,1442,630,2,1,-2.0,-0.18748169213489754,2.0,-1.222253017596762,-0.4720923974693368,-1.031885527997582,162,82,80,0,0.03989005496364707,0.07803337030273506,0.0,-0.8276444527499438,-0.7245268522029068,0.7245268522029068,0.0,0.07803337030273506,0,0,0,1,0.07803337030273506,0.0
6213,26,214,19,50,41,0,2053.255,60,1042.605,LESS,-634,1540,906,3,2,-9.0,-0.8436676146070391,9.0,0.0,0.32862969011116394,-0.9841326223087702,91,50,41,0,-1.376206896245824,-1.170500554541026,-1.5216507209033339,0.11823492182142054,-0.5577445827688658,0.5577445827688658,-1.5216507209033339,-1.170500554541026,1,1,0,0,-1.170500554541026,-1.5216507209033339
6214,26,215,56,96,110,0,2527.177,50,1055.311,LESS,-420,1256,836,2,1,14.0,1.3123718449442827,14.0,0.8730378697119728,-0.07173135367908642,-0.7292084021383062,206,96,110,1,0.9174712641638826,0.6242669624218805,1.170500554541026,-0.8276444527499438,-0.3572310678313111,0.3572310678313111,1.170500554541026,0.6242669624218805,1,0,0,2,1.170500554541026,0.6242669624218805
6215,26,216,23,80,85,0,4151.532,30,1098.588,LESS,-568,2108,1540,4,1,5.0,0.4687042303372438,5.0,-0.6984302957695783,-0.8724534412595871,0.1445375553293658,165,80,85,1,0.09972513740911768,0.0,0.19508342575683765,1.0641142963927848,-0.49590396601242376,0.49590396601242376,0.19508342575683765,0.0,0,1,0,1,0.19508342575683765,0.0
6216,26,217,10,60,50,0,2804.157,50,1116.8339999999996,LESS,-772,1492,720,2,1,-10.0,-0.9374084606744876,10.0,0.17460757394239454,-0.07173135367908642,-0.5802199388409385,110,60,50,0,-0.9972513740911768,-0.7803337030273506,-1.170500554541026,-0.8276444527499438,-0.6870476905323358,0.6870476905323358,-1.170500554541026,-0.7803337030273506,1,0,0,0,-0.7803337030273506,-1.170500554541026
6217,26,218,19,41,50,0,2186.1710000000007,40,836.06,LESS,-548,1236,688,2,1,9.0,0.8436676146070391,9.0,0.0,-0.4720923974693368,-0.9126366638004556,91,41,50,1,-1.376206896245824,-1.5216507209033339,-1.170500554541026,-0.8276444527499438,-0.4771643851771383,0.4771643851771383,-1.170500554541026,-1.5216507209033339,0,0,0,0,-1.5216507209033339,-1.170500554541026
6218,26,219,56,110,96,0,4935.597,30,1013.063,LESS,-174,2448,2274,4,1,-14.0,-1.3123718449442827,14.0,0.8730378697119728,-0.8724534412595871,0.5662887268047452,206,110,96,0,0.9174712641638826,1.170500554541026,0.6242669624218805,1.0641142963927848,-0.12673422355729952,0.12673422355729952,0.6242669624218805,1.170500554541026,0,1,1,2,1.170500554541026,0.6242669624218805
6219,26,220,35,72,80,0,2388.042,70,593.83,LESS,-948,1652,704,2,1,8.0,0.7499267685395902,8.0,-0.17460757394239454,0.7289907339014143,-0.8040495814324043,152,72,80,1,-0.1595602198545883,-0.31213348121094026,0.0,-0.8276444527499438,-0.8519560018828481,0.8519560018828481,0.0,-0.31213348121094026,1,0,0,1,-0.31213348121094026,0.0
6220,26,221,11,49,50,0,2323.647,50,946.096,LESS,-904,1642,738,2,1,1.0,0.09374084606744876,1.0,-1.3968605915391563,-0.07173135367908642,-0.8386878661245626,99,49,50,1,-1.2166466763912356,-1.2095172396923934,-1.170500554541026,-0.8276444527499438,-0.8107289240452201,0.8107289240452201,-1.170500554541026,-1.2095172396923934,1,0,0,0,-1.2095172396923934,-1.170500554541026
6221,26,222,17,43,50,0,2301.232,60,1514.611,LESS,-814,1540,726,2,1,7.0,0.6561859224721414,7.0,-0.34921514788478913,0.32862969011116394,-0.8507449691818609,93,43,50,1,-1.3363168412821769,-1.4436173506005987,-1.170500554541026,-0.8276444527499438,-0.7264008102864353,0.7264008102864353,-1.170500554541026,-1.4436173506005987,1,0,0,0,-1.4436173506005987,-1.170500554541026
6222,26,223,1,51,50,0,2179.766,50,1103.774,LESS,-412,1190,778,2,1,-1.0,-0.09374084606744876,1.0,-1.3968605915391563,-0.07173135367908642,-0.9160819346049168,101,51,50,0,-1.1767566214275886,-1.1314838693896585,-1.170500554541026,-0.8276444527499438,-0.34973523549719693,0.34973523549719693,-1.170500554541026,-1.1314838693896585,1,1,0,0,-1.1314838693896585,-1.170500554541026
6223,26,224,41,112,110,0,2751.792,0,1812.319,LESS,-2346,3102,756,2,1,-2.0,-0.18748169213489754,2.0,-1.222253017596762,-2.073536572630338,-0.6083872465186289,222,112,110,0,1.2365917038730592,1.248533924843761,1.170500554541026,-0.8276444527499438,-2.161852702269304,2.161852702269304,1.170500554541026,1.248533924843761,0,0,0,2,1.248533924843761,1.170500554541026
6224,26,225,20,40,50,1,1819.369,100,1656.5220000000004,LESS,1678,506,2184,1,2,10.0,0.9374084606744876,10.0,0.17460757394239454,1.9300738652721652,-1.1099406796658653,90,40,50,1,-1.3961519237276474,-1.5606674060547012,-1.170500554541026,-1.773523827321308,1.6085509617901372,1.6085509617901372,-1.170500554541026,-1.5606674060547012,1,0,1,0,-1.5606674060547012,-1.170500554541026
6225,26,226,1,50,51,1,2228.339,50,1055.735,LESS,1018,448,1466,1,2,1.0,0.09374084606744876,1.0,-1.3968605915391563,-0.07173135367908642,-0.889954356340266,101,50,51,1,-1.1767566214275886,-1.170500554541026,-1.1314838693896585,-1.773523827321308,0.9901447942257159,0.9901447942257159,-1.1314838693896585,-1.170500554541026,1,0,1,0,-1.170500554541026,-1.1314838693896585
6226,26,227,23,85,80,1,3792.063,80,1057.819,LESS,464,1584,2048,3,2,-5.0,-0.4687042303372438,5.0,-0.6984302957695783,1.1293517776916646,-0.04882201544484712,165,85,80,0,0.09972513740911768,0.19508342575683765,0.0,0.11823492182142054,0.47105840508830776,0.47105840508830776,0.0,0.19508342575683765,1,1,1,1,0.19508342575683765,0.0
6227,26,228,11,50,49,1,1906.59,70,845.148,LESS,848,578,1426,1,2,-1.0,-0.09374084606744876,1.0,-1.3968605915391563,0.7289907339014143,-1.0630242136493309,99,50,49,0,-1.2166466763912356,-1.170500554541026,-1.2095172396923934,-1.773523827321308,0.8308583571257893,0.8308583571257893,-1.2095172396923934,-1.170500554541026,1,0,1,0,-1.170500554541026,-1.2095172396923934
6228,26,229,17,50,43,1,2741.057,50,875.753,LESS,154,1142,1296,3,2,-7.0,-0.6561859224721414,7.0,-0.34921514788478913,-0.07173135367908642,-0.6141616387256376,93,50,43,0,-1.3363168412821769,-1.170500554541026,-1.4436173506005987,0.11823492182142054,0.1805949021413826,0.1805949021413826,-1.4436173506005987,-1.170500554541026,1,1,1,0,-1.170500554541026,-1.4436173506005987
6229,26,230,21,80,82,1,1906.411,30,1332.615,LESS,376,750,1126,1,2,2.0,0.18748169213489754,2.0,-1.222253017596762,-0.8724534412595871,-1.0631204983447249,162,80,82,1,0.03989005496364707,0.0,0.07803337030273506,-1.773523827321308,0.3886042494130516,0.3886042494130516,0.07803337030273506,0.0,0,0,1,1,0.07803337030273506,0.0
6230,26,231,10,50,60,1,3047.259,70,788.507,LESS,570,1298,1868,3,2,10.0,0.9374084606744876,10.0,0.17460757394239454,0.7289907339014143,-0.4494545644293684,110,50,60,1,-0.9972513740911768,-1.170500554541026,-0.7803337030273506,0.11823492182142054,0.5703781835153209,0.5703781835153209,-0.7803337030273506,-1.170500554541026,1,1,1,0,-1.170500554541026,-0.7803337030273506
6231,26,232,3,53,50,1,1978.091,50,842.543,LESS,984,550,1534,1,2,-3.0,-0.28122253820234633,3.0,-1.0476454436543674,-0.07173135367908642,-1.0245635879210289,103,53,50,0,-1.1368665664639415,-1.0534504990869233,-1.170500554541026,-1.773523827321308,0.9582875068057306,0.9582875068057306,-1.170500554541026,-1.0534504990869233,1,0,1,0,-1.0534504990869233,-1.170500554541026
6232,26,233,45,122,110,1,3814.17,60,914.123,LESS,868,1312,2180,3,2,-12.0,-1.124890152809385,12.0,0.5238227218271837,0.32862969011116394,-0.036930586612025584,232,122,110,0,1.4360419786912946,1.6387007763574364,1.170500554541026,0.11823492182142054,0.8495979379610747,0.8495979379610747,1.170500554541026,1.6387007763574364,1,1,1,2,1.6387007763574364,1.170500554541026
6233,26,234,38,67,80,1,3913.72,40,1470.682,LESS,-272,2186,1914,3,1,13.0,1.218630998876834,13.0,0.6984302957695783,-0.4720923974693368,0.016617689513517473,147,67,80,1,-0.25928535726370594,-0.5072169069677779,0.0,0.11823492182142054,-0.21855816965019845,0.21855816965019845,0.0,-0.5072169069677779,0,1,0,1,-0.5072169069677779,0.0
6234,26,235,38,80,67,0,2412.024,70,1245.859,LESS,-430,1274,844,2,1,-13.0,-1.218630998876834,13.0,0.6984302957695783,0.7289907339014143,-0.7911495838629138,147,80,67,0,-0.25928535726370594,0.0,-0.5072169069677779,-0.8276444527499438,-0.36660085824895383,0.36660085824895383,-0.5072169069677779,0.0,1,0,0,1,0.0,-0.5072169069677779
6235,26,236,36,70,80,0,2991.058,50,1590.604,LESS,-678,1488,810,2,1,10.0,0.9374084606744876,10.0,0.17460757394239454,-0.07173135367908642,-0.4796852692664518,150,70,80,1,-0.19945027481823535,-0.3901668515136753,0.0,-0.8276444527499438,-0.598971660606494,0.598971660606494,0.0,-0.3901668515136753,0,0,0,1,-0.3901668515136753,0.0
6236,26,237,45,110,122,0,2817.886,20,1207.511,LESS,-1380,2218,838,2,1,12.0,1.124890152809385,12.0,0.5238227218271837,-1.2728144850498375,-0.572835064075217,232,110,122,1,1.4360419786912946,1.170500554541026,1.6387007763574364,-0.8276444527499438,-1.256730947925015,1.256730947925015,1.6387007763574364,1.170500554541026,0,0,0,2,1.6387007763574364,1.170500554541026
6237,26,238,42,110,115,0,5008.878,0,1998.855,LESS,-1860,3544,1684,3,1,5.0,0.4687042303372438,5.0,-0.6984302957695783,-2.073536572630338,0.6057068204537249,225,110,115,1,1.2964267863185297,1.170500554541026,1.3655839802978638,0.11823492182142054,-1.706480887971867,1.706480887971867,1.3655839802978638,1.170500554541026,0,1,0,2,1.3655839802978638,1.170500554541026
6238,26,239,41,110,112,0,4788.343,30,1218.571,LESS,-78,2184,2106,6,1,2.0,0.18748169213489754,2.0,-1.222253017596762,-0.8724534412595871,0.4870803104050392,222,110,112,1,1.2365917038730592,1.170500554541026,1.248533924843761,2.9558730455355136,-0.03678423554792915,0.03678423554792915,1.248533924843761,1.170500554541026,0,1,1,2,1.248533924843761,1.170500554541026
6239,26,240,53,110,103,1,2959.277,50,1066.295,LESS,-86,1524,1438,3,2,-7.0,-0.6561859224721414,7.0,-0.34921514788478913,-0.07173135367908642,-0.4967803748771589,213,110,103,0,1.0570864565366473,1.170500554541026,0.8973837584814532,0.11823492182142054,-0.04428006788204335,0.04428006788204335,0.8973837584814532,1.170500554541026,0,1,1,2,1.170500554541026,0.8973837584814532
6240,27,1,49,110,131,0,3950.737,84,1719.524,LESS,-1348,2482,1134,2,2,21.0,1.9685577674164243,21.0,2.0952908873087353,1.0454555243129342,-0.3852288100491818,241,110,131,1,1.6155472260277064,1.170500554541026,1.9898509427197442,-0.8488473726357884,-1.266954566327759,1.266954566327759,1.9898509427197442,1.170500554541026,1,0,0,2,1.9898509427197442,1.170500554541026
6241,27,2,13,47,50,1,5835.02,54,1821.111,LESS,-134,2750,2616,3,1,3.0,0.28122253820234633,3.0,-1.0476454436543674,-0.5399024738027202,0.7221316233601502,97,47,50,1,-1.2565367313548828,-1.2875506099951286,-1.170500554541026,-0.02405640327307912,0.1356804856726357,0.1356804856726357,-1.170500554541026,-1.2875506099951286,0,0,1,0,-1.2875506099951286,-1.170500554541026
6242,27,3,16,50,44,1,5352.883000000002,84,2135.482,LESS,774,1868,2642,3,2,-6.0,-0.5624450764046927,6.0,-0.5238227218271837,1.0454555243129342,0.4387880718433803,94,50,44,0,-1.3163718138003533,-1.170500554541026,-1.4046006654492311,-0.02405640327307912,1.1847683169875933,1.1847683169875933,-1.4046006654492311,-1.170500554541026,1,0,1,0,-1.170500554541026,-1.4046006654492311
6243,27,4,7,57,50,1,4507.477,74,1531.509,LESS,974,1926,2900,3,2,-7.0,-0.6561859224721414,7.0,-0.34921514788478913,0.5170028582743827,-0.05804236953238516,107,57,50,0,-1.0570864565366473,-0.8973837584814532,-1.170500554541026,-0.02405640327307912,1.4158449318146766,1.4158449318146766,-1.170500554541026,-0.8973837584814532,1,0,1,0,-0.8973837584814532,-1.170500554541026
6244,27,5,18,42,50,0,6834.804,14,2287.815,LESS,-1988,4280,2292,4,1,8.0,0.7499267685395902,8.0,-0.17460757394239454,-2.653713137956926,1.3096873374199358,92,42,50,1,-1.3562618687640005,-1.4826340357519663,-1.170500554541026,0.8007345660896301,-2.0063997337744253,2.0063997337744253,-1.170500554541026,-1.4826340357519663,0,1,0,0,-1.4826340357519663,-1.170500554541026
6245,27,6,51,108,110,1,6077.44,74,1935.88,LESS,1112,2692,3804,3,2,2.0,0.18748169213489754,2.0,-1.222253017596762,0.5170028582743827,0.8645976522247577,218,108,110,1,1.156811593945765,1.092467184238291,1.170500554541026,-0.02405640327307912,1.575287796045364,1.575287796045364,1.170500554541026,1.092467184238291,1,0,1,2,1.170500554541026,1.092467184238291
6246,27,7,31,78,80,0,5213.457,64,2270.312,LESS,-1568,3342,1774,3,1,2.0,0.18748169213489754,2.0,-1.222253017596762,-0.011449807764168715,0.3568498301946837,158,78,80,1,-0.03989005496364707,-0.07803337030273506,0.0,-0.02405640327307912,-1.5211388426375507,1.5211388426375507,0.0,-0.07803337030273506,1,0,0,1,-0.07803337030273506,0.0
6247,27,8,58,110,92,0,5328.029,34,2339.981,LESS,-1316,3592,2276,4,1,-18.0,-1.6873352292140782,18.0,1.571468165481551,-1.5968078058798232,0.4241818071729689,202,110,92,0,0.8376911542365885,1.170500554541026,0.4682002218164104,0.8007345660896301,-1.2299823079554257,1.2299823079554257,0.4682002218164104,1.170500554541026,0,1,0,2,1.170500554541026,0.4682002218164104
6248,27,9,12,50,48,1,9261.84,64,2103.168,LESS,2668,3176,5844,3,1,-2.0,-0.18748169213489754,2.0,-1.222253017596762,-0.011449807764168715,2.7360142940713787,98,50,48,0,-1.2365917038730592,-1.170500554541026,-1.248533924843761,-0.02405640327307912,3.3730638594000713,3.3730638594000713,-1.248533924843761,-1.170500554541026,1,0,1,0,-1.170500554541026,-1.248533924843761
6249,27,10,54,110,101,1,6691.854,64,2101.861,LESS,210,2952,3162,1,2,-9.0,-0.8436676146070391,9.0,0.0,-0.011449807764168715,1.2256781021002603,211,110,101,0,1.0171964015730004,1.170500554541026,0.8193503881787182,-1.6736383419984977,0.5331322631752188,0.5331322631752188,0.8193503881787182,1.170500554541026,1,0,1,2,1.170500554541026,0.8193503881787182
6250,27,11,14,46,50,0,7757.531,64,2055.109,LESS,-1266,3942,2676,6,1,4.0,0.3749633842697951,4.0,-0.8730378697119728,-0.011449807764168715,1.8519579892479745,96,46,50,1,-1.2764817588367063,-1.3265672951464962,-1.170500554541026,2.450316504815049,-1.1722131542486551,1.1722131542486551,-1.170500554541026,-1.3265672951464962,1,1,0,0,-1.3265672951464962,-1.170500554541026
6251,27,12,22,80,83,0,4448.349,34,1787.2979999999998,LESS,-1272,2318,1046,1,1,3.0,0.28122253820234633,3.0,-1.0476454436543674,-1.5968078058798232,-0.09279086946929838,163,80,83,1,0.05983508244547061,0.0,0.1170500554541026,-1.6736383419984977,-1.1791454526934675,1.1791454526934675,0.1170500554541026,0.0,0,0,0,1,0.1170500554541026,0.0
6252,27,13,6,50,56,0,7716.714,44,1692.193,LESS,-900,3922,3022,4,1,6.0,0.5624450764046927,6.0,-0.5238227218271837,-1.0683551398412716,1.8279705463795368,106,50,56,1,-1.077031484018471,-1.170500554541026,-0.9364004436328208,0.8007345660896301,-0.7493429491150928,0.7493429491150928,-0.9364004436328208,-1.170500554541026,0,1,0,0,-1.170500554541026,-0.9364004436328208
6253,27,14,13,50,47,1,4408.253,64,1899.319,LESS,-204,1974,1770,3,2,-3.0,-0.28122253820234633,3.0,-1.0476454436543674,-0.011449807764168715,-0.11635459314455368,97,50,47,0,-1.2565367313548828,-1.170500554541026,-1.2875506099951286,-0.02405640327307912,0.05480367048315656,0.05480367048315656,-1.2875506099951286,-1.170500554541026,1,0,0,0,-1.170500554541026,-1.2875506099951286
6254,27,15,46,110,124,0,7122.705,74,1625.943,LESS,-1376,3492,2116,3,2,14.0,1.3123718449442827,14.0,0.8730378697119728,0.5170028582743827,1.4788817610489657,234,110,124,1,1.4759320336549415,1.170500554541026,1.7167341466601715,-0.02405640327307912,-1.2993052924035509,1.2993052924035509,1.7167341466601715,1.170500554541026,1,1,0,2,1.7167341466601715,1.170500554541026
6255,27,16,27,91,80,1,5303.804,74,1836.715,LESS,6,2552,2558,4,2,-11.0,-1.0311493067419364,11.0,0.34921514788478913,0.5170028582743827,0.4099451948916176,171,91,80,0,0.21939530230005888,0.4291835366650429,0.0,0.8007345660896301,0.2974341160515939,0.2974341160515939,0.0,0.4291835366650429,1,1,1,1,0.4291835366650429,0.0
6256,27,17,40,64,80,0,7383.269,54,1619.711,LESS,-1258,3900,2642,3,1,16.0,1.4998535370791803,16.0,1.222253017596762,-0.5399024738027202,1.6320107039789131,144,64,80,1,-0.3191204397091766,-0.6242669624218805,0.0,-0.02405640327307912,-1.1629700896555717,1.1629700896555717,0.0,-0.6242669624218805,0,0,0,1,-0.6242669624218805,0.0
6257,27,18,22,83,80,1,5048.714,74,1596.4520000000002,LESS,1138,1914,3052,3,2,-3.0,-0.28122253820234633,3.0,-1.0476454436543674,0.5170028582743827,0.2600332268070005,163,83,80,0,0.05983508244547061,0.1170500554541026,0.0,-0.02405640327307912,1.6053277559728847,1.6053277559728847,0.0,0.1170500554541026,1,0,1,1,0.1170500554541026,0.0
6258,27,19,54,101,110,0,6305.976,84,2144.483,LESS,-1016,3660,2644,4,2,9.0,0.8436676146070391,9.0,0.0,1.0454555243129342,0.998904295127992,211,101,110,1,1.0171964015730004,0.8193503881787182,1.170500554541026,0.8007345660896301,-0.8833673857148011,0.8833673857148011,1.170500554541026,0.8193503881787182,1,1,0,2,1.170500554541026,0.8193503881787182
6259,27,20,6,56,50,1,4163.416,84,1758.405,LESS,958,1676,2634,3,2,-6.0,-0.5624450764046927,6.0,-0.5238227218271837,1.0454555243129342,-0.2602410509827022,106,56,50,0,-1.077031484018471,-0.9364004436328208,-1.170500554541026,-0.02405640327307912,1.39735880262851,1.39735880262851,-1.170500554541026,-0.9364004436328208,1,1,1,0,-0.9364004436328208,-1.170500554541026
6260,27,21,18,50,42,1,4185.19,100,1837.192,LESS,1124,1574,2698,3,2,-8.0,-0.7499267685395902,8.0,-0.17460757394239454,1.8909797899746168,-0.2474448488851117,92,50,42,0,-1.3562618687640005,-1.170500554541026,-1.4826340357519663,-0.02405640327307912,1.5891523929349889,1.5891523929349889,-1.4826340357519663,-1.170500554541026,1,1,1,0,-1.170500554541026,-1.4826340357519663
6261,27,22,43,110,117,0,4748.806,24,2468.8920000000007,LESS,-1552,3056,1504,4,1,7.0,0.6561859224721414,7.0,-0.34921514788478913,-2.1252604719183745,0.08378249755724007,227,110,117,1,1.3363168412821769,1.170500554541026,1.4436173506005987,0.8007345660896301,-1.502652713451384,1.502652713451384,1.4436173506005987,1.170500554541026,0,1,0,2,1.4436173506005987,1.170500554541026
6262,27,23,32,77,80,1,3863.596,64,1439.2479999999996,LESS,422,1140,1562,2,2,3.0,0.28122253820234633,3.0,-1.0476454436543674,-0.011449807764168715,-0.43644006415895337,157,77,80,1,-0.05983508244547061,-0.1170500554541026,0.0,-0.8488473726357884,0.778073474891927,0.778073474891927,0.0,-0.1170500554541026,1,0,1,1,-0.1170500554541026,0.0
6263,27,24,27,80,91,0,7102.542,54,2163.847,LESS,-2262,3090,828,2,1,11.0,1.0311493067419364,11.0,0.34921514788478913,-0.5399024738027202,1.4670323157061846,171,80,91,1,0.21939530230005888,0.0,0.4291835366650429,-0.8488473726357884,-2.3229746960875293,2.3229746960875293,0.4291835366650429,0.0,0,0,0,1,0.4291835366650429,0.0
6264,27,25,16,44,50,1,4330.574000000001,84,1904.944,LESS,1234,1464,2698,3,2,6.0,0.5624450764046927,6.0,-0.5238227218271837,1.0454555243129342,-0.16200519398678467,94,44,50,1,-1.3163718138003533,-1.4046006654492311,-1.170500554541026,-0.02405640327307912,1.7162445310898846,1.7162445310898846,-1.170500554541026,-1.4046006654492311,1,0,1,0,-1.4046006654492311,-1.170500554541026
6265,27,26,7,50,57,1,8992.131,44,1794.7479999999996,LESS,-450,4174,3724,5,2,7.0,0.6561859224721414,7.0,-0.34921514788478913,-1.0683551398412716,2.577510993275056,107,50,57,1,-1.0570864565366473,-1.170500554541026,-0.8973837584814532,1.6255255354523395,-0.22942056575415573,0.22942056575415573,-0.8973837584814532,-1.170500554541026,0,1,0,0,-1.170500554541026,-0.8973837584814532
6266,27,27,14,50,46,1,3646.563,64,1347.323,LESS,636,1272,1908,3,2,-4.0,-0.3749633842697951,4.0,-0.8730378697119728,-0.011449807764168715,-0.5639865934988282,96,50,46,0,-1.2764817588367063,-1.170500554541026,-1.3265672951464962,-0.02405640327307912,1.025325452756906,1.025325452756906,-1.3265672951464962,-1.170500554541026,1,1,1,0,-1.170500554541026,-1.3265672951464962
6267,27,28,51,110,108,1,5312.972,64,1492.578,LESS,2138,1662,3800,3,2,-2.0,-0.18748169213489754,2.0,-1.222253017596762,-0.011449807764168715,0.4153330694590241,218,110,108,0,1.156811593945765,1.170500554541026,1.092467184238291,-0.02405640327307912,2.7607108301083008,2.7607108301083008,1.092467184238291,1.170500554541026,1,1,1,2,1.170500554541026,1.092467184238291
6268,27,29,50,133,110,0,7022.679,24,2050.33,LESS,-1008,3710,2702,4,1,-23.0,-2.1560394595513217,23.0,2.444506035193524,-2.1252604719183745,1.4200982159486804,243,133,110,0,1.6554372809913533,2.0678843130224793,1.170500554541026,0.8007345660896301,-0.8741243211217178,0.8741243211217178,1.170500554541026,2.0678843130224793,0,1,0,2,2.0678843130224793,1.170500554541026
6269,27,30,49,131,110,0,5082.712,44,1685.6470000000004,LESS,-1654,3154,1500,4,1,-21.0,-1.9685577674164243,21.0,2.0952908873087353,-1.0683551398412716,0.2800132616611339,241,131,110,0,1.6155472260277064,1.9898509427197442,1.170500554541026,0.8007345660896301,-1.6205017870131964,1.6205017870131964,1.170500554541026,1.9898509427197442,0,1,0,2,1.9898509427197442,1.170500554541026
6270,27,31,47,126,110,1,5260.004,54,4288.685,LESS,694,2242,2936,5,2,-16.0,-1.4998535370791803,16.0,1.222253017596762,-0.5399024738027202,0.3842046946677505,236,126,110,0,1.5158220886185887,1.7947675169629065,1.170500554541026,1.6255255354523395,1.09233767105676,1.09233767105676,1.170500554541026,1.7947675169629065,0,1,1,2,1.7947675169629065,1.170500554541026
6271,27,32,50,110,133,0,5862.397,34,2436.616,LESS,-1362,3778,2416,6,1,23.0,2.1560394595513217,23.0,2.444506035193524,-1.5968078058798232,0.7382206113653738,243,110,133,1,1.6554372809913533,1.170500554541026,2.0678843130224793,2.450316504815049,-1.283129929365655,1.283129929365655,2.0678843130224793,1.170500554541026,0,1,0,2,2.0678843130224793,1.170500554541026
6272,27,33,47,110,126,1,4152.259,54,1592.024,LESS,718,1304,2022,3,2,16.0,1.4998535370791803,16.0,1.222253017596762,-0.5399024738027202,-0.26679782634794624,236,110,126,1,1.5158220886185887,1.170500554541026,1.7947675169629065,-0.02405640327307912,1.1200668648360101,1.1200668648360101,1.7947675169629065,1.170500554541026,0,1,1,2,1.7947675169629065,1.170500554541026
6273,27,34,12,48,50,1,3599.014,54,1636.954,LESS,808,1270,2078,3,2,2.0,0.18748169213489754,2.0,-1.222253017596762,-0.5399024738027202,-0.5919303159907152,98,48,50,1,-1.2365917038730592,-1.248533924843761,-1.170500554541026,-0.02405640327307912,1.2240513415081975,1.2240513415081975,-1.170500554541026,-1.248533924843761,0,1,1,0,-1.248533924843761,-1.170500554541026
6274,27,35,32,80,77,1,8363.168,54,1844.959,LESS,450,3828,4278,7,2,-3.0,-0.28122253820234633,3.0,-1.0476454436543674,-0.5399024738027202,2.2078803484735934,157,80,77,0,-0.05983508244547061,0.0,-0.1170500554541026,3.2751074741777577,0.8104242009677186,0.8104242009677186,-0.1170500554541026,0.0,0,1,1,1,0.0,-0.1170500554541026
6275,27,36,43,117,110,1,3620.641,64,2020.563,LESS,726,1312,2038,3,2,-7.0,-0.6561859224721414,7.0,-0.34921514788478913,-0.011449807764168715,-0.5792205032431907,227,117,110,0,1.3363168412821769,1.4436173506005987,1.170500554541026,-0.02405640327307912,1.1293099294290934,1.1293099294290934,1.170500554541026,1.4436173506005987,1,1,1,2,1.4436173506005987,1.170500554541026
6276,27,37,40,80,64,1,3040.126,44,2527.75,LESS,-168,1206,1038,3,2,-16.0,-1.4998535370791803,16.0,1.222253017596762,-1.0683551398412716,-0.9203790988472578,144,80,64,0,-0.3191204397091766,0.0,-0.6242669624218805,-0.02405640327307912,0.09639746115203153,0.09639746115203153,-0.6242669624218805,0.0,0,1,1,1,0.0,-0.6242669624218805
6277,27,38,31,80,78,1,6458.051,44,2102.894,LESS,768,2390,3158,5,2,-2.0,-0.18748169213489754,2.0,-1.222253017596762,-1.0683551398412716,1.0882761346609735,158,80,78,0,-0.03989005496364707,0.0,-0.07803337030273506,1.6255255354523395,1.177836018542781,1.177836018542781,-0.07803337030273506,0.0,0,1,1,1,0.0,-0.07803337030273506
6278,27,39,46,124,110,0,4473.641,84,2191.469,LESS,-718,2396,1678,4,2,-14.0,-1.3123718449442827,14.0,0.8730378697119728,1.0454555243129342,-0.07792719979664929,234,124,110,0,1.4759320336549415,1.7167341466601715,1.170500554541026,0.8007345660896301,-0.5390632296224472,0.5390632296224472,1.170500554541026,1.7167341466601715,1,1,0,2,1.7167341466601715,1.170500554541026
6279,27,40,58,92,110,0,3180.253,84,1593.1,LESS,-1012,2340,1328,2,1,18.0,1.6873352292140782,18.0,1.571468165481551,1.0454555243129342,-0.8380288916584494,202,92,110,1,0.8376911542365885,0.4682002218164104,1.170500554541026,-0.8488473726357884,-0.8787458534182594,0.8787458534182594,1.170500554541026,0.4682002218164104,1,0,0,2,1.170500554541026,0.4682002218164104
6280,27,41,49,110,131,1,1634.2720000000004,84,1293.404,MORE,-144,660,516,1,2,21.0,1.9685577674164243,21.0,2.0952908873087353,1.0454555243129342,-1.7465751080190448,241,110,131,0,1.6155472260277064,1.170500554541026,1.9898509427197442,-1.6736383419984977,0.12412665493128151,0.12412665493128151,1.9898509427197442,1.170500554541026,1,0,1,2,1.9898509427197442,1.170500554541026
6281,27,42,13,47,50,1,3381.251,64,1585.4229999999998,MORE,-200,1748,1548,3,1,3.0,0.28122253820234633,3.0,-1.0476454436543674,-0.011449807764168715,-0.7199058536676545,97,47,50,0,-1.2565367313548828,-1.2875506099951286,-1.170500554541026,-0.02405640327307912,0.059425202779698226,0.059425202779698226,-1.170500554541026,-1.2875506099951286,1,1,1,0,-1.2875506099951286,-1.170500554541026
6282,27,43,16,50,44,0,5654.203,64,1741.015,MORE,-2090,2894,804,1,1,-6.0,-0.5624450764046927,6.0,-0.5238227218271837,-0.011449807764168715,0.6158686089999,94,50,44,1,-1.3163718138003533,-1.170500554541026,-1.4046006654492311,-1.6736383419984977,-2.1242488073362376,2.1242488073362376,-1.4046006654492311,-1.170500554541026,1,0,0,0,-1.170500554541026,-1.4046006654492311
6283,27,44,7,57,50,0,2911.667,94,1756.09,MORE,-988,2072,1084,2,2,-7.0,-0.6561859224721414,7.0,-0.34921514788478913,1.5739081903514858,-0.9958722248348773,107,57,50,1,-1.0570864565366473,-0.8973837584814532,-1.170500554541026,-0.8488473726357884,-0.8510166596390094,0.8510166596390094,-1.170500554541026,-0.8973837584814532,1,0,0,0,-0.8973837584814532,-1.170500554541026
6284,27,45,18,42,50,0,5072.245,54,2288.561,MORE,-228,2726,2498,4,2,8.0,0.7499267685395902,8.0,-0.17460757394239454,-0.5399024738027202,0.27386198732681355,92,42,50,0,-1.3562618687640005,-1.4826340357519663,-1.170500554541026,0.8007345660896301,0.027074476703906582,0.027074476703906582,-1.170500554541026,-1.4826340357519663,0,1,1,0,-1.4826340357519663,-1.170500554541026
6285,27,46,51,108,110,0,5156.361,24,1484.891,MORE,-1188,3080,1892,4,1,2.0,0.18748169213489754,2.0,-1.222253017596762,-2.1252604719183745,0.3232955014097084,218,108,110,0,1.156811593945765,1.092467184238291,1.170500554541026,0.8007345660896301,-1.0820932744660925,1.0820932744660925,1.170500554541026,1.092467184238291,0,1,0,2,1.170500554541026,1.092467184238291
6286,27,47,31,78,80,0,6440.121,64,1683.017,MORE,-814,3546,2732,4,1,2.0,0.18748169213489754,2.0,-1.222253017596762,-0.011449807764168715,1.0777389846834864,158,78,80,0,-0.03989005496364707,-0.07803337030273506,0.0,0.8007345660896301,-0.6499800047394471,0.6499800047394471,0.0,-0.07803337030273506,0,1,0,1,-0.07803337030273506,0.0
6287,27,48,58,110,92,0,4220.8809999999985,64,1397.671,MORE,-44,1942,1898,4,1,-18.0,-1.6873352292140782,18.0,1.571468165481551,-0.011449807764168715,-0.22646986729858185,202,110,92,1,0.8376911542365885,1.170500554541026,0.4682002218164104,0.8007345660896301,0.2396649623448231,0.2396649623448231,0.4682002218164104,1.170500554541026,1,1,1,2,1.170500554541026,0.4682002218164104
6288,27,49,12,50,48,0,4035.792,54,1520.808,MORE,-298,2034,1736,4,1,-2.0,-0.18748169213489754,2.0,-1.222253017596762,-0.5399024738027202,-0.3352434619546384,98,50,48,1,-1.2365917038730592,-1.170500554541026,-1.248533924843761,0.8007345660896301,-0.05380233848557253,0.05380233848557253,-1.248533924843761,-1.170500554541026,0,1,0,0,-1.170500554541026,-1.248533924843761
6289,27,50,54,110,101,0,3726.873,64,1725.974,MORE,-1032,2282,1250,2,1,-9.0,-0.8436676146070391,9.0,0.0,-0.011449807764168715,-0.5167897995952037,211,110,101,1,1.0171964015730004,1.170500554541026,0.8193503881787182,-0.8488473726357884,-0.9018535149009678,0.9018535149009678,0.8193503881787182,1.170500554541026,0,0,0,2,1.170500554541026,0.8193503881787182
6290,27,51,14,46,50,0,3927.085,74,2235.898,MORE,-438,2118,1680,4,1,4.0,0.3749633842697951,4.0,-0.8730378697119728,0.5170028582743827,-0.39912868017007,96,46,50,0,-1.2764817588367063,-1.3265672951464962,-1.170500554541026,0.8007345660896301,-0.21555596886453074,0.21555596886453074,-1.170500554541026,-1.3265672951464962,1,1,0,0,-1.3265672951464962,-1.170500554541026
6291,27,52,22,80,83,0,6430.405,44,2253.509,MORE,-1066,3766,2700,6,1,3.0,0.28122253820234633,3.0,-1.0476454436543674,-1.0683551398412716,1.0720290600219542,163,80,83,0,0.05983508244547061,0.0,0.1170500554541026,2.450316504815049,-0.9411365394215718,0.9411365394215718,0.1170500554541026,0.0,0,1,0,1,0.1170500554541026,0.0
6292,27,53,6,50,56,0,3712.042,94,1621.451,MORE,-1722,2702,980,2,2,6.0,0.5624450764046927,6.0,-0.5238227218271837,1.5739081903514858,-0.5255057210294543,106,50,56,0,-1.077031484018471,-1.170500554541026,-0.9364004436328208,-0.8488473726357884,-1.6990678360544047,1.6990678360544047,-0.9364004436328208,-1.170500554541026,1,0,0,0,-1.170500554541026,-0.9364004436328208
6293,27,54,13,50,47,1,7043.8780000000015,14,1298.954,MORE,-260,3762,3502,5,1,-3.0,-0.28122253820234633,3.0,-1.0476454436543674,-2.653713137956926,1.432556500520502,97,50,47,1,-1.2565367313548828,-1.170500554541026,-1.2875506099951286,1.6255255354523395,-0.009897781668426725,0.009897781668426725,-1.2875506099951286,-1.170500554541026,0,1,1,0,-1.170500554541026,-1.2875506099951286
6294,27,55,46,110,124,1,3192.733,84,1806.809,MORE,710,1476,2186,1,2,14.0,1.3123718449442827,14.0,0.8730378697119728,1.0454555243129342,-0.8306946121426078,234,110,124,0,1.4759320336549415,1.170500554541026,1.7167341466601715,-1.6736383419984977,1.1108238002429267,1.1108238002429267,1.7167341466601715,1.170500554541026,1,0,1,2,1.7167341466601715,1.170500554541026
6295,27,56,27,91,80,1,7772.035,4,1778.322,MORE,-2246,5078,2832,5,1,-11.0,-1.0311493067419364,11.0,0.34921514788478913,-3.1821658039954777,1.8604817384545265,171,91,80,1,0.21939530230005888,0.4291835366650429,0.0,1.6255255354523395,-2.3044885669013624,2.3044885669013624,0.0,0.4291835366650429,0,1,0,1,0.4291835366650429,0.0
6296,27,57,40,64,80,1,4538.813,64,2028.574,MORE,8,2060,2068,2,2,16.0,1.4998535370791803,16.0,1.222253017596762,-0.011449807764168715,-0.03962674590190338,144,64,80,0,-0.3191204397091766,-0.6242669624218805,0.0,-0.8488473726357884,0.2997448821998647,0.2997448821998647,0.0,-0.6242669624218805,0,0,1,1,-0.6242669624218805,0.0
6297,27,58,22,83,80,1,4973.142,64,2238.83,MORE,14,2362,2376,3,2,-3.0,-0.28122253820234633,3.0,-1.0476454436543674,-0.011449807764168715,0.21562087331572016,163,83,80,1,0.05983508244547061,0.1170500554541026,0.0,-0.02405640327307912,0.30667718064467725,0.30667718064467725,0.0,0.1170500554541026,0,0,1,1,0.1170500554541026,0.0
6298,27,59,54,101,110,1,7627.573,74,2506.9770000000008,MORE,-92,3696,3604,5,1,9.0,0.8436676146070391,9.0,0.0,0.5170028582743827,1.7755839269627396,211,101,110,0,1.0171964015730004,0.8193503881787182,1.170500554541026,1.6255255354523395,0.18420657478632316,0.18420657478632316,1.170500554541026,0.8193503881787182,1,1,1,2,1.170500554541026,0.8193503881787182
6299,27,60,6,56,50,1,8058.478,54,1476.098,MORE,276,3566,3842,5,2,-6.0,-0.5624450764046927,6.0,-0.5238227218271837,-0.5399024738027202,2.0288193207747347,106,56,50,1,-1.077031484018471,-0.9364004436328208,-1.170500554541026,1.6255255354523395,0.6093875460681563,0.6093875460681563,-1.170500554541026,-0.9364004436328208,0,1,1,0,-0.9364004436328208,-1.170500554541026
6300,27,61,18,50,42,0,4196.297000000001,44,2574.369,MORE,176,2048,2224,4,1,-8.0,-0.7499267685395902,8.0,-0.17460757394239454,-1.0683551398412716,-0.2409174576525424,92,50,42,1,-1.3562618687640005,-1.170500554541026,-1.4826340357519663,0.8007345660896301,0.4938492386546146,0.4938492386546146,-1.4826340357519663,-1.170500554541026,0,1,1,0,-1.170500554541026,-1.4826340357519663
6301,27,62,43,110,117,1,8401.134,34,2081.757,MORE,322,3848,4170,7,2,7.0,0.6561859224721414,7.0,-0.34921514788478913,-1.5968078058798232,2.2301923080968664,227,110,117,0,1.3363168412821769,1.170500554541026,1.4436173506005987,3.2751074741777577,0.6625351674783854,0.6625351674783854,1.4436173506005987,1.170500554541026,0,1,1,2,1.4436173506005987,1.170500554541026
6302,27,63,32,77,80,0,7273.249,54,1431.306,MORE,-1028,3710,2682,4,1,3.0,0.28122253820234633,3.0,-1.0476454436543674,-0.5399024738027202,1.5673538584394189,157,77,80,0,-0.05983508244547061,-0.1170500554541026,0.0,0.8007345660896301,-0.897231982604426,0.897231982604426,0.0,-0.1170500554541026,0,1,0,1,-0.1170500554541026,0.0
6303,27,64,27,80,91,1,5805.11,74,1301.04,MORE,-572,3082,2510,3,2,11.0,1.0311493067419364,11.0,0.34921514788478913,0.5170028582743827,0.7045540351935776,171,80,91,0,0.21939530230005888,0.0,0.4291835366650429,-0.02405640327307912,-0.3703773007986765,0.3703773007986765,0.4291835366650429,0.0,1,1,0,1,0.4291835366650429,0.0
6304,27,65,16,44,50,1,6627.435,64,1785.149,MORE,918,2602,3520,5,1,6.0,0.5624450764046927,6.0,-0.5238227218271837,-0.011449807764168715,1.1878201732436102,94,44,50,0,-1.3163718138003533,-1.4046006654492311,-1.170500554541026,1.6255255354523395,1.3511434796630932,1.3511434796630932,-1.170500554541026,-1.4046006654492311,0,1,1,0,-1.4046006654492311,-1.170500554541026
6305,27,66,7,50,57,0,5796.05,44,1672.2479999999996,MORE,-1182,3512,2330,4,1,7.0,0.6561859224721414,7.0,-0.34921514788478913,-1.0683551398412716,0.6992296303527505,107,50,57,0,-1.0570864565366473,-1.170500554541026,-0.8973837584814532,0.8007345660896301,-1.0751609760212801,1.0751609760212801,-0.8973837584814532,-1.170500554541026,0,1,0,0,-1.170500554541026,-0.8973837584814532
6306,27,67,14,50,46,0,5306.809,74,1503.534,MORE,492,2502,2994,4,2,-4.0,-0.3749633842697951,4.0,-0.8730378697119728,0.5170028582743827,0.4117111812654241,96,50,46,1,-1.2764817588367063,-1.170500554541026,-1.3265672951464962,0.8007345660896301,0.8589502900814061,0.8589502900814061,-1.3265672951464962,-1.170500554541026,1,1,1,0,-1.170500554541026,-1.3265672951464962
6307,27,68,51,110,108,0,6284.7469999999985,74,1810.549,MORE,180,2936,3116,4,2,-2.0,-0.18748169213489754,2.0,-1.222253017596762,0.5170028582743827,0.9864283800765652,218,110,108,1,1.156811593945765,1.170500554541026,1.092467184238291,0.8007345660896301,0.4984707709511563,0.4984707709511563,1.092467184238291,1.170500554541026,1,1,1,2,1.170500554541026,1.092467184238291
6308,27,69,50,133,110,1,5995.246,64,1624.388,MORE,1954,1756,3710,4,2,-23.0,-2.1560394595513217,23.0,2.444506035193524,-0.011449807764168715,0.8162936642019151,243,133,110,1,1.6554372809913533,2.0678843130224793,1.170500554541026,0.8007345660896301,2.548120344467384,2.548120344467384,1.170500554541026,2.0678843130224793,0,1,1,2,2.0678843130224793,1.170500554541026
6309,27,70,49,131,110,1,6570.651,54,1608.285,MORE,304,2718,3022,5,2,-21.0,-1.9685577674164243,21.0,2.0952908873087353,-0.5399024738027202,1.1544492014465308,241,131,110,1,1.6155472260277064,1.9898509427197442,1.170500554541026,1.6255255354523395,0.6417382721439479,0.6417382721439479,1.170500554541026,1.9898509427197442,0,1,1,2,1.9898509427197442,1.170500554541026
6310,27,71,47,126,110,0,3542.327,54,2498.294,MORE,-482,1820,1338,2,1,-16.0,-1.4998535370791803,16.0,1.222253017596762,-0.5399024738027202,-0.6252442825704034,236,126,110,1,1.5158220886185887,1.7947675169629065,1.170500554541026,-0.8488473726357884,-0.26639282412648907,0.26639282412648907,1.170500554541026,1.7947675169629065,0,0,0,2,1.7947675169629065,1.170500554541026
6311,27,72,50,110,133,0,4593.874,54,1668.4520000000002,MORE,-1320,2844,1524,4,1,23.0,2.1560394595513217,23.0,2.444506035193524,-0.5399024738027202,-0.0072683513168273215,243,110,133,0,1.6554372809913533,1.170500554541026,2.0678843130224793,0.8007345660896301,-1.2346038402519675,1.2346038402519675,2.0678843130224793,1.170500554541026,0,1,0,2,2.0678843130224793,1.170500554541026
6312,27,73,47,110,126,1,8201.263,74,1255.722,MORE,294,2820,3114,4,2,16.0,1.4998535370791803,16.0,1.222253017596762,0.5170028582743827,2.112731588456581,236,110,126,0,1.5158220886185887,1.170500554541026,1.7947675169629065,0.8007345660896301,0.6301844414025938,0.6301844414025938,1.7947675169629065,1.170500554541026,1,1,1,2,1.7947675169629065,1.170500554541026
6313,27,74,12,48,50,1,2960.969,74,1227.455,MORE,378,1224,1602,3,2,2.0,0.18748169213489754,2.0,-1.222253017596762,0.5170028582743827,-0.9668982946513821,98,48,50,0,-1.2365917038730592,-1.248533924843761,-1.170500554541026,-0.02405640327307912,0.7272366196299687,0.7272366196299687,-1.170500554541026,-1.248533924843761,1,1,1,0,-1.248533924843761,-1.170500554541026
6314,27,75,32,80,77,0,5422.187,54,1647.024,MORE,44,2446,2490,4,1,-3.0,-0.28122253820234633,3.0,-1.0476454436543674,-0.5399024738027202,0.4795168304624404,157,80,77,1,-0.05983508244547061,0.0,-0.1170500554541026,0.8007345660896301,0.3413386728687397,0.3413386728687397,-0.1170500554541026,0.0,0,1,1,1,0.0,-0.1170500554541026
6315,27,76,43,117,110,0,6118.182,44,1355.009,MORE,-312,2826,2514,4,1,-7.0,-0.6561859224721414,7.0,-0.34921514788478913,-1.0683551398412716,0.8885410188941822,227,117,110,1,1.3363168412821769,1.4436173506005987,1.170500554541026,0.8007345660896301,-0.06997770152346836,0.06997770152346836,1.170500554541026,1.4436173506005987,0,1,0,2,1.4436173506005987,1.170500554541026
6316,27,77,40,80,64,1,4753.687,44,1644.473,MORE,-124,2118,1994,3,2,-16.0,-1.4998535370791803,16.0,1.222253017596762,-1.0683551398412716,0.08665097658903695,144,80,64,1,-0.3191204397091766,0.0,-0.6242669624218805,-0.02405640327307912,0.14723431641398985,0.14723431641398985,-0.6242669624218805,0.0,0,1,1,1,0.0,-0.6242669624218805
6317,27,78,31,80,78,1,6103.596,74,1481.7120000000002,MORE,-20,2932,2912,5,2,-2.0,-0.18748169213489754,2.0,-1.222253017596762,0.5170028582743827,0.8799690797100422,158,80,78,1,-0.03989005496364707,0.0,-0.07803337030273506,1.6255255354523395,0.2673941561240731,0.2673941561240731,-0.07803337030273506,0.0,1,1,1,1,0.0,-0.07803337030273506
6318,27,79,46,124,110,1,3166.2,94,1454.8729999999996,MORE,1118,1080,2198,3,2,-14.0,-1.3123718449442827,14.0,0.8730378697119728,1.5739081903514858,-0.8462875959882671,234,124,110,1,1.4759320336549415,1.7167341466601715,1.170500554541026,-0.02405640327307912,1.5822200944901765,1.5822200944901765,1.170500554541026,1.7167341466601715,1,1,1,2,1.7167341466601715,1.170500554541026
6319,27,80,58,92,110,1,2077.775,94,2091.151,MORE,-8,1472,1464,1,2,18.0,1.6873352292140782,18.0,1.571468165481551,1.5739081903514858,-1.4859360881380936,202,92,110,0,0.8376911542365885,0.4682002218164104,1.170500554541026,-1.6736383419984977,0.28125875301369807,0.28125875301369807,1.170500554541026,0.4682002218164104,1,0,1,2,1.170500554541026,0.4682002218164104
6320,27,81,48,128,110,1,4239.498,54,2052.26,LESS,762,1612,2374,2,2,-18.0,-1.6873352292140782,18.0,1.571468165481551,-0.5399024738027202,-0.2155289793381307,238,128,110,0,1.5557121435822359,1.8728008872656416,1.170500554541026,-0.8488473726357884,1.1709037200979684,1.1709037200979684,1.170500554541026,1.8728008872656416,0,0,1,2,1.8728008872656416,1.170500554541026
6321,27,82,8,50,58,0,4625.924,94,1012.787,LESS,-956,2732,1776,4,2,8.0,0.7499267685395902,8.0,-0.17460757394239454,1.5739081903514858,0.01156687772826266,108,50,58,1,-1.0371414290548238,-1.170500554541026,-0.8583670733300858,0.8007345660896301,-0.8140444012666761,0.8140444012666761,-0.8583670733300858,-1.170500554541026,1,1,0,0,-1.170500554541026,-0.8583670733300858
6322,27,83,4,54,50,1,4072.04,84,1615.845,LESS,408,1736,2144,2,1,-4.0,-0.3749633842697951,4.0,-0.8730378697119728,1.0454555243129342,-0.31394114113010113,104,54,50,0,-1.116921538982118,-1.0144338139355558,-1.170500554541026,-0.8488473726357884,0.7618981118540311,0.7618981118540311,-1.170500554541026,-1.0144338139355558,1,0,1,0,-1.0144338139355558,-1.170500554541026
6323,27,84,37,80,69,1,4906.705,64,1320.8770000000004,LESS,714,2036,2750,3,2,-11.0,-1.0311493067419364,11.0,0.34921514788478913,-0.011449807764168715,0.17657700086428071,149,80,69,0,-0.21939530230005888,0.0,-0.4291835366650429,-0.02405640327307912,1.1154453325394684,1.1154453325394684,-0.4291835366650429,0.0,1,0,1,1,0.0,-0.4291835366650429
6324,27,85,52,105,110,0,4292.288,84,1665.2520000000004,LESS,-364,2264,1900,4,2,5.0,0.4687042303372438,5.0,-0.6984302957695783,1.0454555243129342,-0.1845052120591824,215,105,110,1,1.0969765115002945,0.9754171287841883,1.170500554541026,0.8007345660896301,-0.13005762137850999,0.13005762137850999,1.170500554541026,0.9754171287841883,1,1,0,2,1.170500554541026,0.9754171287841883
6325,27,86,5,55,50,0,5769.833000000001,44,1489.2220000000002,LESS,-1172,3468,2296,4,1,-5.0,-0.4687042303372438,5.0,-0.6984302957695783,-1.0683551398412716,0.6838223542256024,105,55,50,0,-1.0969765115002945,-0.9754171287841883,-1.170500554541026,0.8007345660896301,-1.0636071452799258,1.0636071452799258,-1.170500554541026,-0.9754171287841883,0,1,0,0,-0.9754171287841883,-1.170500554541026
6326,27,87,30,96,80,0,4733.5909999999985,64,1325.629,LESS,-1672,3030,1358,4,1,-16.0,-1.4998535370791803,16.0,1.222253017596762,-0.011449807764168715,0.07484090598404003,176,96,80,0,0.3191204397091766,0.6242669624218805,0.0,0.8007345660896301,-1.6412986823476339,1.6412986823476339,0.0,0.6242669624218805,1,1,0,1,0.6242669624218805,0.0
6327,27,88,33,80,75,0,6157.984,54,1498.239,LESS,-1516,3832,2316,4,1,-5.0,-0.4687042303372438,5.0,-0.6984302957695783,-0.5399024738027202,0.9119319638693048,155,80,75,0,-0.09972513740911768,0.0,-0.19508342575683765,0.8007345660896301,-1.461058922782509,1.461058922782509,-0.19508342575683765,0.0,0,1,0,1,0.0,-0.19508342575683765
6328,27,89,48,110,128,0,4234.539000000002,54,1286.187,LESS,-1446,2822,1376,2,1,18.0,1.6873352292140782,18.0,1.571468165481551,-0.5399024738027202,-0.21844329761690026,238,110,128,1,1.5557121435822359,1.170500554541026,1.8728008872656416,-0.8488473726357884,-1.3801821075930298,1.3801821075930298,1.8728008872656416,1.170500554541026,0,0,0,2,1.8728008872656416,1.170500554541026
6329,27,90,9,59,50,1,3630.714,84,1340.6629999999998,LESS,1066,1034,2100,3,1,-9.0,-0.8436676146070391,9.0,0.0,1.0454555243129342,-0.5733007758743549,109,59,50,0,-1.0171964015730004,-0.8193503881787182,-1.170500554541026,-0.02405640327307912,1.5221401746351348,1.5221401746351348,-1.170500554541026,-0.8193503881787182,1,1,1,0,-0.8193503881787182,-1.170500554541026
6330,27,91,44,110,119,1,6557.871,74,1608.854,LESS,808,2730,3538,3,2,9.0,0.8436676146070391,9.0,0.0,0.5170028582743827,1.1469386171346354,229,110,119,1,1.376206896245824,1.170500554541026,1.5216507209033339,-0.02405640327307912,1.2240513415081975,1.2240513415081975,1.5216507209033339,1.170500554541026,1,1,1,2,1.5216507209033339,1.170500554541026
6331,27,92,2,52,50,0,5309.828,74,1915.119,LESS,-846,3046,2200,4,1,-2.0,-0.18748169213489754,2.0,-1.222253017596762,0.5170028582743827,0.4134853951963798,102,52,50,0,-1.156811593945765,-1.092467184238291,-1.170500554541026,0.8007345660896301,-0.6869522631117804,0.6869522631117804,-1.170500554541026,-1.092467184238291,1,1,0,0,-1.092467184238291,-1.170500554541026
6332,27,93,8,58,50,1,4604.851,44,1799.499,LESS,-984,2866,1882,3,1,-8.0,-0.7499267685395902,8.0,-0.17460757394239454,-1.0683551398412716,-0.0008173588292158094,108,58,50,0,-1.0371414290548238,-0.8583670733300858,-1.170500554541026,-0.02405640327307912,-0.8463951273424678,0.8463951273424678,-1.170500554541026,-0.8583670733300858,0,1,0,0,-0.8583670733300858,-1.170500554541026
6333,27,94,44,119,110,1,5040.161,54,1553.737,LESS,1172,2022,3194,3,2,-9.0,-0.8436676146070391,9.0,0.0,-0.5399024738027202,0.2550067770715043,229,119,110,0,1.376206896245824,1.5216507209033339,1.170500554541026,-0.02405640327307912,1.6446107804934889,1.6446107804934889,1.170500554541026,1.5216507209033339,0,1,1,2,1.5216507209033339,1.170500554541026
6334,27,95,34,74,80,0,5441.323,54,1414.341,LESS,-478,2820,2342,4,1,6.0,0.5624450764046927,6.0,-0.5238227218271837,-0.5399024738027202,0.4907627257200644,154,74,80,1,-0.11967016489094122,-0.2341001109082052,0.0,0.8007345660896301,-0.2617712918299474,0.2617712918299474,0.0,-0.2341001109082052,0,1,0,1,-0.2341001109082052,0.0
6335,27,96,24,86,80,1,5291.478,44,1132.285,LESS,-186,2460,2274,3,2,-6.0,-0.5624450764046927,6.0,-0.5238227218271837,-1.0683551398412716,0.40270141850441693,166,86,80,0,0.11967016489094122,0.2341001109082052,0.0,-0.02405640327307912,0.07560056581759406,0.07560056581759406,0.0,0.2341001109082052,0,1,1,1,0.2341001109082052,0.0
6336,27,97,39,66,80,0,4339.1309999999985,54,1691.366,LESS,-42,2304,2262,4,2,14.0,1.3123718449442827,14.0,0.8730378697119728,-0.5399024738027202,-0.15697639352067613,146,66,80,1,-0.2792303847455295,-0.5462335921191455,0.0,0.8007345660896301,0.24197572849309393,0.24197572849309393,0.0,-0.5462335921191455,0,1,1,1,-0.5462335921191455,0.0
6337,27,98,9,50,59,0,3678.944,54,1990.919,LESS,-1588,2822,1234,2,1,9.0,0.8436676146070391,9.0,0.0,-0.5399024738027202,-0.5449568414954257,109,50,59,1,-1.0171964015730004,-1.170500554541026,-0.8193503881787182,-0.8488473726357884,-1.5442465041202589,1.5442465041202589,-0.8193503881787182,-1.170500554541026,0,0,0,0,-1.170500554541026,-0.8193503881787182
6338,27,99,57,94,110,0,5376.17,24,1683.1129999999996,LESS,-1414,3248,1834,4,1,16.0,1.4998535370791803,16.0,1.222253017596762,-2.1252604719183745,0.4524734377957354,204,94,110,1,0.8775812092002355,0.5462335921191455,1.170500554541026,0.8007345660896301,-1.3432098492206965,1.3432098492206965,1.170500554541026,0.5462335921191455,0,1,0,2,1.170500554541026,0.5462335921191455
6339,27,100,60,110,87,1,2604.992,94,1726.885,LESS,412,1248,1660,1,2,-23.0,-2.1560394595513217,23.0,2.444506035193524,1.5739081903514858,-1.1760998026009597,197,110,87,0,0.7379660168274708,1.170500554541026,0.27311679605957273,-1.6736383419984977,0.7665196441505728,0.7665196441505728,0.27311679605957273,1.170500554541026,1,0,1,2,1.170500554541026,0.27311679605957273
6340,27,101,33,75,80,1,5154.389,64,1505.261,LESS,832,1648,2480,2,1,5.0,0.4687042303372438,5.0,-0.6984302957695783,-0.011449807764168715,0.322136591216981,155,75,80,1,-0.09972513740911768,-0.19508342575683765,0.0,-0.8488473726357884,1.2517805352874476,1.2517805352874476,0.0,-0.19508342575683765,1,0,1,1,-0.19508342575683765,0.0
6341,27,102,15,50,45,1,5868.849,94,2308.107,LESS,-40,3116,3076,4,2,-5.0,-0.4687042303372438,5.0,-0.6984302957695783,1.5739081903514858,0.7420123398458395,95,50,45,0,-1.2964267863185297,-1.170500554541026,-1.3655839802978638,0.8007345660896301,0.24428649464136476,0.24428649464136476,-1.3655839802978638,-1.170500554541026,1,1,1,0,-1.170500554541026,-1.3655839802978638
6342,27,103,59,89,110,0,5130.935,54,1365.625,LESS,-1220,2902,1682,2,1,21.0,1.9685577674164243,21.0,2.0952908873087353,-0.5399024738027202,0.3083530822614885,199,89,110,1,0.7778560717911179,0.3511501663623078,1.170500554541026,-0.8488473726357884,-1.1190655328384258,1.1190655328384258,1.170500554541026,0.3511501663623078,0,0,0,2,1.170500554541026,0.3511501663623078
6343,27,104,29,80,94,0,5026.089,74,1470.591,LESS,-340,2536,2196,1,1,14.0,1.3123718449442827,14.0,0.8730378697119728,0.5170028582743827,0.2467369067712701,174,80,94,1,0.2792303847455295,0.0,0.5462335921191455,-1.6736383419984977,-0.10232842759926,0.10232842759926,0.5462335921191455,0.0,1,0,0,1,0.5462335921191455,0.0
6344,27,105,55,110,98,0,6148.575,64,2120.34,LESS,272,3130,3402,5,2,-12.0,-1.124890152809385,12.0,0.5238227218271837,-0.011449807764168715,0.9064024577824012,208,110,98,0,0.9573613191275298,1.170500554541026,0.7023003327246156,1.6255255354523395,0.6047660137716145,0.6047660137716145,0.7023003327246156,1.170500554541026,0,1,1,2,1.170500554541026,0.7023003327246156
6345,27,106,29,94,80,1,5467.923000000002,44,2086.919,LESS,-310,2716,2406,3,1,-14.0,-1.3123718449442827,14.0,0.8730378697119728,-1.0683551398412716,0.5063950843035094,174,94,80,0,0.2792303847455295,0.5462335921191455,0.0,-0.02405640327307912,-0.06766693537519752,0.06766693537519752,0.0,0.5462335921191455,0,0,0,1,0.5462335921191455,0.0
6346,27,107,57,110,94,1,4826.5340000000015,94,1436.001,LESS,860,2228,3088,3,2,-16.0,-1.4998535370791803,16.0,1.222253017596762,1.5739081903514858,0.12946189484949536,204,110,94,0,0.8775812092002355,1.170500554541026,0.5462335921191455,-0.02405640327307912,1.2841312613632392,1.2841312613632392,0.5462335921191455,1.170500554541026,1,0,1,2,1.170500554541026,0.5462335921191455
6347,27,108,39,80,66,1,5872.719,84,1256.41,LESS,-234,3308,3074,3,2,-14.0,-1.3123718449442827,14.0,0.8730378697119728,1.0454555243129342,0.7442866717149345,146,80,66,0,-0.2792303847455295,0.0,-0.5462335921191455,-0.02405640327307912,0.020142178259094087,0.020142178259094087,-0.5462335921191455,0.0,1,0,0,1,0.0,-0.5462335921191455
6348,27,109,4,50,54,0,6741.633000000002,74,1637.813,LESS,-1292,3706,2414,4,1,4.0,0.3749633842697951,4.0,-0.8730378697119728,0.5170028582743827,1.254932356909482,104,50,54,1,-1.116921538982118,-1.170500554541026,-1.0144338139355558,0.8007345660896301,-1.2022531141761759,1.2022531141761759,-1.0144338139355558,-1.170500554541026,1,1,0,0,-1.170500554541026,-1.0144338139355558
6349,27,110,55,98,110,0,7723.039000000002,64,2769.731,LESS,-738,4364,3626,4,2,12.0,1.124890152809385,12.0,0.5238227218271837,-0.011449807764168715,1.8316876391630068,208,98,110,1,0.9573613191275298,0.7023003327246156,1.170500554541026,0.8007345660896301,-0.5621708911051555,0.5621708911051555,1.170500554541026,0.7023003327246156,0,1,0,2,1.170500554541026,0.7023003327246156
6350,27,111,2,50,52,1,6462.609,64,1545.205,LESS,-516,3194,2678,5,2,2.0,0.18748169213489754,2.0,-1.222253017596762,-0.011449807764168715,1.0909547921956857,102,50,52,1,-1.156811593945765,-1.170500554541026,-1.092467184238291,1.6255255354523395,-0.3056758486470932,0.3056758486470932,-1.092467184238291,-1.170500554541026,0,1,0,0,-1.170500554541026,-1.092467184238291
6351,27,112,59,110,89,0,3577.235,84,1395.313,LESS,-438,1840,1402,2,2,-21.0,-1.9685577674164243,21.0,2.0952908873087353,1.0454555243129342,-0.6047294565015736,199,110,89,0,0.7778560717911179,1.170500554541026,0.3511501663623078,-0.8488473726357884,-0.21555596886453074,0.21555596886453074,0.3511501663623078,1.170500554541026,1,0,0,2,1.170500554541026,0.3511501663623078
6352,27,113,60,87,110,1,8134.953,54,1298.109,LESS,232,3568,3800,4,1,23.0,2.1560394595513217,23.0,2.444506035193524,-0.5399024738027202,2.073762351702137,197,87,110,1,0.7379660168274708,0.27311679605957273,1.170500554541026,0.8007345660896301,0.5585506908061979,0.5585506908061979,1.170500554541026,0.27311679605957273,0,1,1,2,1.170500554541026,0.27311679605957273
6353,27,114,52,110,105,0,8271.287,24,1833.789,LESS,-190,2770,2580,4,1,-5.0,-0.4687042303372438,5.0,-0.6984302957695783,-2.1252604719183745,2.153883478586171,215,110,105,0,1.0969765115002945,1.170500554541026,0.9754171287841883,0.8007345660896301,0.07097903352105239,0.07097903352105239,0.9754171287841883,1.170500554541026,0,1,0,2,1.170500554541026,0.9754171287841883
6354,27,115,30,80,96,0,5890.257,74,1544.888,LESS,0,2734,2734,6,1,16.0,1.4998535370791803,16.0,1.222253017596762,0.5170028582743827,0.7545934500922442,176,80,96,1,0.3191204397091766,0.0,0.6242669624218805,2.450316504815049,0.2905018176067814,0.2905018176067814,0.6242669624218805,0.0,1,1,1,1,0.6242669624218805,0.0
6355,27,116,24,80,86,1,6681.145,44,2163.726,LESS,-756,3836,3080,6,1,6.0,0.5624450764046927,6.0,-0.5238227218271837,-1.0683551398412716,1.2193846085637905,166,80,86,1,0.11967016489094122,0.0,0.2341001109082052,2.450316504815049,-0.582967786439593,0.582967786439593,0.2341001109082052,0.0,0,1,0,1,0.2341001109082052,0.0
6356,27,117,5,50,55,1,3931.176,24,1339.5320000000004,LESS,-352,2050,1698,3,1,5.0,0.4687042303372438,5.0,-0.6984302957695783,-2.1252604719183745,-0.3967244704345486,105,50,55,1,-1.0969765115002945,-1.170500554541026,-0.9754171287841883,-0.02405640327307912,-0.11619302448888498,0.11619302448888498,-0.9754171287841883,-1.170500554541026,0,0,0,0,-1.170500554541026,-0.9754171287841883
6357,27,118,34,80,74,1,5814.201,74,2043.1,LESS,376,2410,2786,3,2,-6.0,-0.5624450764046927,6.0,-0.5238227218271837,0.5170028582743827,0.7098966581966639,154,80,74,0,-0.11967016489094122,0.0,-0.2341001109082052,-0.02405640327307912,0.7249258534816978,0.7249258534816978,-0.2341001109082052,0.0,1,0,1,1,0.0,-0.2341001109082052
6358,27,119,15,45,50,1,3750.232,84,1947.713,LESS,876,1476,2352,3,2,5.0,0.4687042303372438,5.0,-0.6984302957695783,1.0454555243129342,-0.5030621204917948,95,45,50,1,-1.2964267863185297,-1.3655839802978638,-1.170500554541026,-0.02405640327307912,1.3026173905494058,1.3026173905494058,-1.170500554541026,-1.3655839802978638,1,0,1,0,-1.3655839802978638,-1.170500554541026
6359,27,120,37,69,80,0,6426.749,54,1638.576,LESS,-876,3446,2570,4,1,11.0,1.0311493067419364,11.0,0.34921514788478913,-0.5399024738027202,1.069880492240711,149,69,80,1,-0.21939530230005888,-0.4291835366650429,0.0,0.8007345660896301,-0.7216137553358428,0.7216137553358428,0.0,-0.4291835366650429,0,1,0,1,-0.4291835366650429,0.0
6360,27,121,48,128,110,0,2793.149000000001,84,1264.338,MORE,-610,1462,852,2,1,-18.0,-1.6873352292140782,18.0,1.571468165481551,1.0454555243129342,-1.065523197563924,238,128,110,1,1.5557121435822359,1.8728008872656416,1.170500554541026,-0.8488473726357884,-0.41428185761582226,0.41428185761582226,1.170500554541026,1.8728008872656416,1,0,0,2,1.8728008872656416,1.170500554541026
6361,27,122,8,50,58,1,1761.971,94,878.846,MORE,598,816,1414,1,2,8.0,0.7499267685395902,8.0,-0.17460757394239454,1.5739081903514858,-1.6715286208480955,108,50,58,0,-1.0371414290548238,-1.170500554541026,-0.8583670733300858,-1.6736383419984977,0.9814208959397601,0.9814208959397601,-0.8583670733300858,-1.170500554541026,1,0,1,0,-1.170500554541026,-0.8583670733300858
6362,27,123,4,54,50,0,2598.195,74,1378.2420000000004,MORE,-738,1690,952,2,1,-4.0,-0.3749633842697951,4.0,-0.8730378697119728,0.5170028582743827,-1.180094281596887,104,54,50,1,-1.116921538982118,-1.0144338139355558,-1.170500554541026,-0.8488473726357884,-0.5621708911051555,0.5621708911051555,-1.170500554541026,-1.0144338139355558,1,0,0,0,-1.0144338139355558,-1.170500554541026
6363,27,124,37,80,69,1,1883.892,84,1800.104,MORE,-300,1286,986,2,1,-11.0,-1.0311493067419364,11.0,0.34921514788478913,1.0454555243129342,-1.5998777640491442,149,80,69,1,-0.21939530230005888,0.0,-0.4291835366650429,-0.8488473726357884,-0.056113104633843364,0.056113104633843364,-0.4291835366650429,0.0,1,0,0,1,0.0,-0.4291835366650429
6364,27,125,52,105,110,1,3591.919000000001,94,1535.0,MORE,238,1712,1950,3,2,5.0,0.4687042303372438,5.0,-0.6984302957695783,1.5739081903514858,-0.5960999244173891,215,105,110,0,1.0969765115002945,0.9754171287841883,1.170500554541026,-0.02405640327307912,0.5654829892510104,0.5654829892510104,1.170500554541026,0.9754171287841883,1,0,1,2,1.170500554541026,0.9754171287841883
6365,27,126,5,55,50,0,2259.483,84,1258.268,MORE,-382,1302,920,2,1,-5.0,-0.4687042303372438,5.0,-0.6984302957695783,1.0454555243129342,-1.3791494485335634,105,55,50,1,-1.0969765115002945,-0.9754171287841883,-1.170500554541026,-0.8488473726357884,-0.15085451671294747,0.15085451671294747,-1.170500554541026,-0.9754171287841883,1,0,0,0,-0.9754171287841883,-1.170500554541026
6366,27,127,30,96,80,0,1895.624,84,1524.148,MORE,-392,1218,826,2,2,-16.0,-1.4998535370791803,16.0,1.222253017596762,1.0454555243129342,-1.5929830711581299,176,96,80,1,0.3191204397091766,0.6242669624218805,0.0,-0.8488473726357884,-0.16240834745430163,0.16240834745430163,0.0,0.6242669624218805,1,0,0,1,0.6242669624218805,0.0
6367,27,128,33,80,75,0,2325.33,74,1205.6660000000004,MORE,-556,1430,874,2,1,-5.0,-0.4687042303372438,5.0,-0.6984302957695783,0.5170028582743827,-1.3404523088476967,155,80,75,1,-0.09972513740911768,0.0,-0.19508342575683765,-0.8488473726357884,-0.3518911716125098,0.3518911716125098,-0.19508342575683765,0.0,1,0,0,1,0.0,-0.19508342575683765
6368,27,129,48,110,128,1,1899.811,84,1436.09,MORE,152,792,944,1,2,18.0,1.6873352292140782,18.0,1.571468165481551,1.0454555243129342,-1.5905224438878711,238,110,128,0,1.5557121435822359,1.170500554541026,1.8728008872656416,-1.6736383419984977,0.4661200448753646,0.4661200448753646,1.8728008872656416,1.170500554541026,1,0,1,2,1.8728008872656416,1.170500554541026
6369,27,130,9,59,50,0,2326.667,64,1837.218,MORE,-1612,2222,610,2,1,-9.0,-0.8436676146070391,9.0,0.0,-0.011449807764168715,-1.33966657713995,109,59,50,1,-1.0171964015730004,-0.8193503881787182,-1.170500554541026,-0.8488473726357884,-1.571975697899509,1.571975697899509,-1.170500554541026,-0.8193503881787182,0,0,0,0,-0.8193503881787182,-1.170500554541026
6370,27,131,44,110,119,1,1969.001,54,1610.737,MORE,430,784,1214,1,1,9.0,0.8436676146070391,9.0,0.0,-0.5399024738027202,-1.5498606810913105,229,110,119,0,1.376206896245824,1.170500554541026,1.5216507209033339,-1.6736383419984977,0.7873165394850103,0.7873165394850103,1.5216507209033339,1.170500554541026,0,0,1,2,1.5216507209033339,1.170500554541026
6371,27,132,2,52,50,0,2065.614,64,1332.374,MORE,-740,1388,648,2,1,-2.0,-0.18748169213489754,2.0,-1.222253017596762,-0.011449807764168715,-1.4930828968874643,102,52,50,1,-1.156811593945765,-1.092467184238291,-1.170500554541026,-0.8488473726357884,-0.5644816572534264,0.5644816572534264,-1.170500554541026,-1.092467184238291,0,0,0,0,-1.092467184238291,-1.170500554541026
6372,27,133,8,58,50,0,2554.223,44,1364.4820000000002,MORE,-648,1550,902,1,1,-8.0,-0.7499267685395902,8.0,-0.17460757394239454,-1.0683551398412716,-1.2059358632371582,108,58,50,1,-1.0371414290548238,-0.8583670733300858,-1.170500554541026,-1.6736383419984977,-0.4581864144329681,0.4581864144329681,-1.170500554541026,-0.8583670733300858,0,0,0,0,-0.8583670733300858,-1.170500554541026
6373,27,134,44,119,110,0,2516.719,54,1229.33,MORE,-1194,1876,682,2,1,-9.0,-0.8436676146070391,9.0,0.0,-0.5399024738027202,-1.2279763134745076,229,119,110,1,1.376206896245824,1.5216507209033339,1.170500554541026,-0.8488473726357884,-1.089025572910905,1.089025572910905,1.170500554541026,1.5216507209033339,0,0,0,2,1.5216507209033339,1.170500554541026
6374,27,135,34,74,80,1,1687.995,64,2107.613,MORE,-590,1306,716,1,1,6.0,0.5624450764046927,6.0,-0.5238227218271837,-0.011449807764168715,-1.7150030328243693,154,74,80,0,-0.11967016489094122,-0.2341001109082052,0.0,-1.6736383419984977,-0.391174196133114,0.391174196133114,0.0,-0.2341001109082052,0,0,0,1,-0.2341001109082052,0.0
6375,27,136,24,86,80,0,4735.542,64,1709.612,MORE,-1306,3046,1740,4,1,-6.0,-0.5624450764046927,6.0,-0.5238227218271837,-0.011449807764168715,0.07598747484104486,166,86,80,1,0.11967016489094122,0.2341001109082052,0.0,0.8007345660896301,-1.2184284772140717,1.2184284772140717,0.0,0.2341001109082052,0,1,0,1,0.2341001109082052,0.0
6376,27,137,39,66,80,0,1879.412,84,1041.983,MORE,-428,1388,960,2,1,14.0,1.3123718449442827,14.0,0.8730378697119728,1.0454555243129342,-1.6025105823368817,146,66,80,0,-0.2792303847455295,-0.5462335921191455,0.0,-0.8488473726357884,-0.2040021381231766,0.2040021381231766,0.0,-0.5462335921191455,1,0,0,1,-0.5462335921191455,0.0
6377,27,138,9,50,59,1,1839.355,74,1426.639,MORE,4,808,812,1,1,9.0,0.8436676146070391,9.0,0.0,0.5170028582743827,-1.62605138638865,109,50,59,0,-1.0171964015730004,-1.170500554541026,-0.8193503881787182,-1.6736383419984977,0.29512334990332306,0.29512334990332306,-0.8193503881787182,-1.170500554541026,1,0,1,0,-1.170500554541026,-0.8193503881787182
6378,27,139,57,94,110,1,1714.704,94,933.895,MORE,108,780,888,1,2,16.0,1.4998535370791803,16.0,1.222253017596762,1.5739081903514858,-1.6993066168316922,204,94,110,0,0.8775812092002355,0.5462335921191455,1.170500554541026,-1.6736383419984977,0.4152831896134063,0.4152831896134063,1.170500554541026,0.5462335921191455,1,0,1,2,1.170500554541026,0.5462335921191455
6379,27,140,60,110,87,0,2315.388,84,1485.057,MORE,-554,1694,1140,2,2,-23.0,-2.1560394595513217,23.0,2.444506035193524,1.0454555243129342,-1.3462950497889223,197,110,87,1,0.7379660168274708,1.170500554541026,0.27311679605957273,-0.8488473726357884,-0.349580405464239,0.349580405464239,0.27311679605957273,1.170500554541026,1,0,0,2,1.170500554541026,0.27311679605957273
6380,27,141,33,75,80,1,3015.833,74,1162.931,MORE,34,1446,1480,3,2,5.0,0.4687042303372438,5.0,-0.6984302957695783,0.5170028582743827,-0.9346556735490478,155,75,80,0,-0.09972513740911768,-0.19508342575683765,0.0,-0.02405640327307912,0.32978484212738557,0.32978484212738557,0.0,-0.19508342575683765,1,1,1,1,-0.19508342575683765,0.0
6381,27,142,15,50,45,0,2288.812,84,1820.057,MORE,-684,1658,974,2,1,-5.0,-0.4687042303372438,5.0,-0.6984302957695783,1.0454555243129342,-1.3619133039886824,95,50,45,1,-1.2964267863185297,-1.170500554541026,-1.3655839802978638,-0.8488473726357884,-0.49978020510184307,0.49978020510184307,-1.3655839802978638,-1.170500554541026,1,0,0,0,-1.170500554541026,-1.3655839802978638
6382,27,143,59,89,110,1,1425.4879999999996,64,1285.658,MORE,408,648,1056,2,1,21.0,1.9685577674164243,21.0,2.0952908873087353,-0.011449807764168715,-1.869273843150092,199,89,110,0,0.7778560717911179,0.3511501663623078,1.170500554541026,-0.8488473726357884,0.7618981118540311,0.7618981118540311,1.170500554541026,0.3511501663623078,0,0,1,2,1.170500554541026,0.3511501663623078
6383,27,144,29,80,94,1,3827.167,84,1420.756,MORE,-198,1888,1690,3,2,14.0,1.3123718449442827,14.0,0.8730378697119728,1.0454555243129342,-0.4578487555437765,174,80,94,0,0.2792303847455295,0.0,0.5462335921191455,-0.02405640327307912,0.06173596892796906,0.06173596892796906,0.5462335921191455,0.0,1,1,1,1,0.5462335921191455,0.0
6384,27,145,55,110,98,0,3103.408,100,1741.057,MORE,-54,1822,1768,2,2,-12.0,-1.124890152809385,12.0,0.5238227218271837,1.8909797899746168,-0.8831893651676518,208,110,98,1,0.9573613191275298,1.170500554541026,0.7023003327246156,-0.8488473726357884,0.22811113160346894,0.22811113160346894,0.7023003327246156,1.170500554541026,1,0,1,2,1.170500554541026,0.7023003327246156
6385,27,146,29,94,80,0,3757.802,74,1467.1729999999998,MORE,-1486,2560,1074,1,1,-14.0,-1.3123718449442827,14.0,0.8730378697119728,0.5170028582743827,-0.4986133628047018,174,94,80,1,0.2792303847455295,0.5462335921191455,0.0,-1.6736383419984977,-1.4263974305584466,1.4263974305584466,0.0,0.5462335921191455,1,0,0,1,0.5462335921191455,0.0
6386,27,147,57,110,94,1,4216.771,94,1462.345,MORE,158,2144,2302,3,2,-16.0,-1.4998535370791803,16.0,1.222253017596762,1.5739081903514858,-0.2288852430045193,204,110,94,1,0.8775812092002355,1.170500554541026,0.5462335921191455,-0.02405640327307912,0.4730523433201771,0.4730523433201771,0.5462335921191455,1.170500554541026,1,1,1,2,1.170500554541026,0.5462335921191455
6387,27,148,39,80,66,0,2605.559,44,1840.543,MORE,-688,1648,960,2,1,-14.0,-1.3123718449442827,14.0,0.8730378697119728,-1.0683551398412716,-1.1757665865364175,146,80,66,1,-0.2792303847455295,0.0,-0.5462335921191455,-0.8488473726357884,-0.5044017373983847,0.5044017373983847,-0.5462335921191455,0.0,0,0,0,1,0.0,-0.5462335921191455
6388,27,149,4,50,54,0,3330.238,74,1758.255,MORE,-1122,2232,1110,3,1,4.0,0.3749633842697951,4.0,-0.8730378697119728,0.5170028582743827,-0.7498853088713106,104,50,54,0,-1.116921538982118,-1.170500554541026,-1.0144338139355558,-0.02405640327307912,-1.0058379915731552,1.0058379915731552,-1.0144338139355558,-1.170500554541026,1,1,0,0,-1.170500554541026,-1.0144338139355558
6389,27,150,55,98,110,1,3604.612,84,1623.0220000000004,MORE,306,1518,1824,3,2,12.0,1.124890152809385,12.0,0.5238227218271837,1.0454555243129342,-0.5886404684963498,208,98,110,0,0.9573613191275298,0.7023003327246156,1.170500554541026,-0.02405640327307912,0.6440490382922187,0.6440490382922187,1.170500554541026,0.7023003327246156,1,1,1,2,1.170500554541026,0.7023003327246156
6390,27,151,2,50,52,1,4480.564,84,1763.924,MORE,574,2010,2584,3,2,2.0,0.18748169213489754,2.0,-1.222253017596762,1.0454555243129342,-0.07385867278637878,102,50,52,0,-1.156811593945765,-1.170500554541026,-1.092467184238291,-0.02405640327307912,0.9536917021605101,0.9536917021605101,-1.092467184238291,-1.170500554541026,1,1,1,0,-1.170500554541026,-1.092467184238291
6391,27,152,59,110,89,0,2731.316,54,2472.92,MORE,-1426,2134,708,2,1,-21.0,-1.9685577674164243,21.0,2.0952908873087353,-0.5399024738027202,-1.1018613790785905,199,110,89,1,0.7778560717911179,1.170500554541026,0.3511501663623078,-0.8488473726357884,-1.3570744461103217,1.3570744461103217,0.3511501663623078,1.170500554541026,0,0,0,2,1.170500554541026,0.3511501663623078
6392,27,153,60,87,110,1,3602.432,44,1239.614,MORE,904,1206,2110,3,2,23.0,2.1560394595513217,23.0,2.444506035193524,-1.0683551398412716,-0.5899216166810082,197,87,110,0,0.7379660168274708,0.27311679605957273,1.170500554541026,-0.02405640327307912,1.3349681166251974,1.3349681166251974,1.170500554541026,0.27311679605957273,0,1,1,2,1.170500554541026,0.27311679605957273
6393,27,154,52,110,105,1,3767.766,74,1670.378,MORE,-342,2150,1808,3,1,-5.0,-0.4687042303372438,5.0,-0.6984302957695783,0.5170028582743827,-0.4927576928450988,215,110,105,1,1.0969765115002945,1.170500554541026,0.9754171287841883,-0.02405640327307912,-0.10463919374753083,0.10463919374753083,0.9754171287841883,1.170500554541026,1,1,0,2,1.170500554541026,0.9754171287841883
6394,27,155,30,80,96,1,5021.5909999999985,64,1690.826,MORE,-64,2510,2446,3,2,16.0,1.4998535370791803,16.0,1.222253017596762,-0.011449807764168715,0.24409351019576805,176,80,96,0,0.3191204397091766,0.0,0.6242669624218805,-0.02405640327307912,0.21655730086211478,0.21655730086211478,0.6242669624218805,0.0,0,1,1,1,0.6242669624218805,0.0
6395,27,156,24,80,86,1,5970.427,74,2131.628,MORE,532,2536,3068,3,1,6.0,0.5624450764046927,6.0,-0.5238227218271837,0.5170028582743827,0.8017079684243771,166,80,86,0,0.11967016489094122,0.0,0.2341001109082052,-0.02405640327307912,0.9051656130468227,0.9051656130468227,0.2341001109082052,0.0,1,1,1,1,0.2341001109082052,0.0
6396,27,157,5,50,55,1,3998.942,44,1739.099,MORE,-458,2328,1870,3,1,5.0,0.4687042303372438,5.0,-0.6984302957695783,-1.0683551398412716,-0.3568995677365904,105,50,55,0,-1.0969765115002945,-1.170500554541026,-0.9754171287841883,-0.02405640327307912,-0.23866363034723906,0.23866363034723906,-0.9754171287841883,-1.170500554541026,0,0,0,0,-1.170500554541026,-0.9754171287841883
6397,27,158,34,80,74,0,4672.95,54,2318.937,MORE,-1448,3324,1876,4,1,-6.0,-0.5624450764046927,6.0,-0.5238227218271837,-0.5399024738027202,0.0392032421923623,154,80,74,1,-0.11967016489094122,0.0,-0.2341001109082052,0.8007345660896301,-1.3824928737413007,1.3824928737413007,-0.2341001109082052,0.0,0,1,0,1,0.0,-0.2341001109082052
6398,27,159,15,45,50,1,4111.8420000000015,100,1781.536,MORE,1174,1738,2912,3,2,5.0,0.4687042303372438,5.0,-0.6984302957695783,1.8909797899746168,-0.2905501961549781,95,45,50,0,-1.2964267863185297,-1.3655839802978638,-1.170500554541026,-0.02405640327307912,1.6469215466417597,1.6469215466417597,-1.170500554541026,-1.3655839802978638,1,0,1,0,-1.3655839802978638,-1.170500554541026
6399,27,160,37,69,80,1,3268.259,84,3051.212,MORE,886,1802,2688,3,2,11.0,1.0311493067419364,11.0,0.34921514788478913,1.0454555243129342,-0.7863092920533893,149,69,80,0,-0.21939530230005888,-0.4291835366650429,0.0,-0.02405640327307912,1.31417122129076,1.31417122129076,0.0,-0.4291835366650429,1,0,1,1,-0.4291835366650429,0.0
6400,27,161,3,50,53,1,5299.463000000002,64,1571.9520000000002,LESS,952,1856,2808,3,1,3.0,0.28122253820234633,3.0,-1.0476454436543674,-0.011449807764168715,0.4073940644927188,103,50,53,1,-1.1368665664639415,-1.170500554541026,-1.0534504990869233,-0.02405640327307912,1.3904265041836974,1.3904265041836974,-1.0534504990869233,-1.170500554541026,0,0,1,0,-1.170500554541026,-1.0534504990869233
6401,27,162,20,50,40,1,7262.565,44,1410.611,LESS,-182,3246,3064,1,1,-10.0,-0.9374084606744876,10.0,0.17460757394239454,-1.0683551398412716,1.5610750569692862,90,50,40,0,-1.3961519237276474,-1.170500554541026,-1.5606674060547012,-1.6736383419984977,0.08022209811413572,0.08022209811413572,-1.5606674060547012,-1.170500554541026,0,0,1,0,-1.170500554541026,-1.5606674060547012
6402,27,163,25,80,88,0,2547.739,94,1203.915,LESS,-370,1806,1436,2,2,8.0,0.7499267685395902,8.0,-0.17460757394239454,1.5739081903514858,-1.2097463975625358,168,80,88,1,0.1595602198545883,0.0,0.31213348121094026,-0.8488473726357884,-0.13698991982332248,0.13698991982332248,0.31213348121094026,0.0,1,0,0,1,0.31213348121094026,0.0
6403,27,164,42,115,110,1,4122.298,54,1856.781,LESS,752,1444,2196,3,2,-5.0,-0.4687042303372438,5.0,-0.6984302957695783,-0.5399024738027202,-0.2844053863298477,225,115,110,0,1.2964267863185297,1.3655839802978638,1.170500554541026,-0.02405640327307912,1.1593498893566143,1.1593498893566143,1.170500554541026,1.3655839802978638,0,0,1,2,1.3655839802978638,1.170500554541026
6404,27,165,53,103,110,0,6899.056,64,1555.7910000000004,LESS,-2288,4550,2262,4,2,7.0,0.6561859224721414,7.0,-0.34921514788478913,-0.011449807764168715,1.3474471232734493,213,103,110,1,1.0570864565366473,0.8973837584814532,1.170500554541026,0.8007345660896301,-2.35301465601505,2.35301465601505,1.170500554541026,0.8973837584814532,0,1,0,2,1.170500554541026,0.8973837584814532
6405,27,166,26,90,80,1,3600.4640000000004,44,1773.586,LESS,-1104,2268,1164,3,1,-10.0,-0.9374084606744876,10.0,0.17460757394239454,-1.0683551398412716,-0.5910781761431213,170,90,80,0,0.19945027481823535,0.3901668515136753,0.0,-0.02405640327307912,-0.9850410962387177,0.9850410962387177,0.0,0.3901668515136753,0,0,0,1,0.3901668515136753,0.0
6406,27,167,35,80,72,1,4702.821,74,1679.779,LESS,1456,1634,3090,2,2,-8.0,-0.7499267685395902,8.0,-0.17460757394239454,0.5170028582743827,0.056757910735447524,152,80,72,0,-0.1595602198545883,0.0,-0.31213348121094026,-0.8488473726357884,1.972739573547947,1.972739573547947,-0.31213348121094026,0.0,1,0,1,1,0.0,-0.31213348121094026
6407,27,168,28,93,80,0,3088.199,64,1768.839,LESS,-1270,2148,878,2,1,-13.0,-1.218630998876834,13.0,0.6984302957695783,-0.011449807764168715,-0.89212743064493,173,93,80,0,0.25928535726370594,0.5072169069677779,0.0,-0.8488473726357884,-1.1768346865451966,1.1768346865451966,0.0,0.5072169069677779,0,0,0,1,0.5072169069677779,0.0
6408,27,169,26,80,90,0,7539.236,74,2026.978,LESS,-1266,4090,2824,4,1,10.0,0.9374084606744876,10.0,0.17460757394239454,0.5170028582743827,1.7236698043993663,170,80,90,1,0.19945027481823535,0.0,0.3901668515136753,0.8007345660896301,-1.1722131542486551,1.1722131542486551,0.3901668515136753,0.0,1,1,0,1,0.3901668515136753,0.0
6409,27,170,25,88,80,1,4671.322,44,1454.112,LESS,824,1696,2520,3,2,-8.0,-0.7499267685395902,8.0,-0.17460757394239454,-1.0683551398412716,0.0382464948324434,168,88,80,0,0.1595602198545883,0.31213348121094026,0.0,-0.02405640327307912,1.2425374706943642,1.2425374706943642,0.0,0.31213348121094026,0,0,1,1,0.31213348121094026,0.0
6410,27,171,36,80,70,1,5220.196,74,2876.902,LESS,1046,1864,2910,3,2,-10.0,-0.9374084606744876,10.0,0.17460757394239454,0.5170028582743827,0.3608102235967072,150,80,70,0,-0.19945027481823535,0.0,-0.3901668515136753,-0.02405640327307912,1.4990325131524265,1.4990325131524265,-0.3901668515136753,0.0,1,0,1,1,0.0,-0.3901668515136753
6411,27,172,28,80,93,0,6322.4659999999985,44,1834.326,LESS,-1238,3840,2602,4,1,13.0,1.218630998876834,13.0,0.6984302957695783,-1.0683551398412716,1.0085951820844201,173,80,93,1,0.25928535726370594,0.0,0.5072169069677779,0.8007345660896301,-1.1398624281728633,1.1398624281728633,0.5072169069677779,0.0,0,1,0,1,0.5072169069677779,0.0
6412,27,173,21,82,80,1,5002.960999999998,84,1441.11,LESS,-280,2312,2032,3,2,-2.0,-0.18748169213489754,2.0,-1.222253017596762,1.0454555243129342,0.23314498236082185,162,82,80,0,0.03989005496364707,0.07803337030273506,0.0,-0.02405640327307912,-0.033005443151135044,0.033005443151135044,0.0,0.07803337030273506,1,0,0,1,0.07803337030273506,0.0
6413,27,174,19,50,41,1,4142.707,94,1301.212,LESS,352,1798,2150,3,2,-9.0,-0.8436676146070391,9.0,0.0,1.5739081903514858,-0.2724113710543017,91,50,41,0,-1.376206896245824,-1.170500554541026,-1.5216507209033339,-0.02405640327307912,0.6971966597024478,0.6971966597024478,-1.5216507209033339,-1.170500554541026,1,0,1,0,-1.170500554541026,-1.5216507209033339
6414,27,175,56,96,110,0,3767.635,74,1460.72,LESS,-288,2010,1722,2,1,14.0,1.3123718449442827,14.0,0.8730378697119728,0.5170028582743827,-0.4928346792727089,206,96,110,1,0.9174712641638826,0.6242669624218805,1.170500554541026,-0.8488473726357884,-0.04224850774421837,0.04224850774421837,1.170500554541026,0.6242669624218805,1,0,0,2,1.170500554541026,0.6242669624218805
6415,27,176,23,80,85,1,6446.426,64,2015.498,LESS,-778,3552,2774,3,1,5.0,0.4687042303372438,5.0,-0.6984302957695783,-0.011449807764168715,1.0814443238138856,165,80,85,1,0.09972513740911768,0.0,0.19508342575683765,-0.02405640327307912,-0.6083862140705721,0.6083862140705721,0.19508342575683765,0.0,1,0,0,1,0.19508342575683765,0.0
6416,27,177,10,60,50,1,2007.432,64,1888.864,LESS,220,1226,1446,2,1,-10.0,-0.9374084606744876,10.0,0.17460757394239454,-0.011449807764168715,-1.527275449034155,110,60,50,0,-0.9972513740911768,-0.7803337030273506,-1.170500554541026,-0.8488473726357884,0.5446860939165729,0.5446860939165729,-1.170500554541026,-0.7803337030273506,1,0,1,0,-0.7803337030273506,-1.170500554541026
6417,27,178,19,41,50,0,6654.523,54,1472.441,LESS,-802,3482,2680,4,1,9.0,0.8436676146070391,9.0,0.0,-0.5399024738027202,1.203739320961969,91,41,50,1,-1.376206896245824,-1.5216507209033339,-1.170500554541026,0.8007345660896301,-0.6361154078498221,0.6361154078498221,-1.170500554541026,-1.5216507209033339,0,1,0,0,-1.5216507209033339,-1.170500554541026
6418,27,179,56,110,96,1,3623.594,54,1366.471,LESS,50,1614,1664,3,2,-14.0,-1.3123718449442827,14.0,0.8730378697119728,-0.5399024738027202,-0.577485076367367,206,110,96,0,0.9174712641638826,1.170500554541026,0.6242669624218805,-0.02405640327307912,0.3482709713135522,0.3482709713135522,0.6242669624218805,1.170500554541026,0,0,1,2,1.170500554541026,0.6242669624218805
6419,27,180,35,72,80,0,5884.854,44,2467.675,LESS,586,2460,3046,2,1,8.0,0.7499267685395902,8.0,-0.17460757394239454,-1.0683551398412716,0.7514182007153142,152,72,80,1,-0.1595602198545883,-0.31213348121094026,0.0,-0.8488473726357884,0.9675562990501352,0.9675562990501352,0.0,-0.31213348121094026,0,0,1,1,-0.31213348121094026,0.0
6420,27,181,11,49,50,1,3695.386,44,1322.527,LESS,408,1480,1888,3,2,1.0,0.09374084606744876,1.0,-1.3968605915391563,-1.0683551398412716,-0.5352941633063658,99,49,50,1,-1.2166466763912356,-1.2095172396923934,-1.170500554541026,-0.02405640327307912,0.7618981118540311,0.7618981118540311,-1.170500554541026,-1.2095172396923934,0,0,1,0,-1.2095172396923934,-1.170500554541026
6421,27,182,17,43,50,0,5105.959,64,3563.943,LESS,-1206,2926,1720,3,1,7.0,0.6561859224721414,7.0,-0.34921514788478913,-0.011449807764168715,0.2936751203073489,93,43,50,1,-1.3363168412821769,-1.4436173506005987,-1.170500554541026,-0.02405640327307912,-1.10289016980053,1.10289016980053,-1.170500554541026,-1.4436173506005987,0,0,0,0,-1.4436173506005987,-1.170500554541026
6422,27,183,1,51,50,0,3536.975,54,2194.422,LESS,-1348,2540,1192,2,1,-1.0,-0.09374084606744876,1.0,-1.3968605915391563,-0.5399024738027202,-0.6283895601320049,101,51,50,0,-1.1767566214275886,-1.1314838693896585,-1.170500554541026,-0.8488473726357884,-1.266954566327759,1.266954566327759,-1.170500554541026,-1.1314838693896585,0,0,0,0,-1.1314838693896585,-1.170500554541026
6423,27,184,41,112,110,1,2521.818,54,1891.971,LESS,204,1002,1206,1,2,-2.0,-0.18748169213489754,2.0,-1.222253017596762,-0.5399024738027202,-1.2249797196242451,222,112,110,0,1.2365917038730592,1.248533924843761,1.170500554541026,-1.6736383419984977,0.5261999647304062,0.5261999647304062,1.170500554541026,1.248533924843761,0,0,1,2,1.248533924843761,1.170500554541026
6424,27,185,20,40,50,0,5945.755,74,1577.929,LESS,-544,3048,2504,4,2,10.0,0.9374084606744876,10.0,0.17460757394239454,0.5170028582743827,0.7872086619969059,90,40,50,1,-1.3961519237276474,-1.5606674060547012,-1.170500554541026,0.8007345660896301,-0.33802657472288483,0.33802657472288483,-1.170500554541026,-1.5606674060547012,1,1,0,0,-1.5606674060547012,-1.170500554541026
6425,27,186,1,50,51,1,8233.828000000001,14,2159.725,LESS,2,3830,3832,5,2,1.0,0.09374084606744876,1.0,-1.3968605915391563,-2.653713137956926,2.1318694740682305,101,50,51,1,-1.1767566214275886,-1.170500554541026,-1.1314838693896585,1.6255255354523395,0.29281258375505226,0.29281258375505226,-1.1314838693896585,-1.170500554541026,0,1,1,0,-1.170500554541026,-1.1314838693896585
6426,27,187,23,85,80,1,3162.231,74,1772.765,LESS,-94,1776,1682,4,1,-5.0,-0.4687042303372438,5.0,-0.6984302957695783,0.5170028582743827,-0.8486201084400596,165,85,80,0,0.09972513740911768,0.19508342575683765,0.0,0.8007345660896301,0.18189580863805233,0.18189580863805233,0.0,0.19508342575683765,1,1,1,1,0.19508342575683765,0.0
6427,27,188,11,50,49,1,4366.012,84,1288.055,LESS,50,2056,2106,3,2,-1.0,-0.09374084606744876,1.0,-1.3968605915391563,1.0454555243129342,-0.14117889611159395,99,50,49,0,-1.2166466763912356,-1.170500554541026,-1.2095172396923934,-0.02405640327307912,0.3482709713135522,0.3482709713135522,-1.2095172396923934,-1.170500554541026,1,0,1,0,-1.170500554541026,-1.2095172396923934
6428,27,189,17,50,43,1,8532.418,44,1569.104,LESS,-750,3632,2882,3,1,-7.0,-0.6561859224721414,7.0,-0.34921514788478913,-1.0683551398412716,2.30734563758066,93,50,43,0,-1.3363168412821769,-1.170500554541026,-1.4436173506005987,-0.02405640327307912,-0.5760354879947805,0.5760354879947805,-1.4436173506005987,-1.170500554541026,0,0,0,0,-1.170500554541026,-1.4436173506005987
6429,27,190,21,80,82,1,4736.5059999999985,54,1536.672,LESS,334,1960,2294,3,2,2.0,0.18748169213489754,2.0,-1.222253017596762,-0.5399024738027202,0.07655400091903022,162,80,82,1,0.03989005496364707,0.0,0.07803337030273506,-0.02405640327307912,0.6763997643680104,0.6763997643680104,0.07803337030273506,0.0,0,0,1,1,0.07803337030273506,0.0
6430,27,191,10,50,60,0,6030.07,84,1492.1129999999996,LESS,32,2970,3002,4,2,10.0,0.9374084606744876,10.0,0.17460757394239454,1.0454555243129342,0.8367591249278497,110,50,60,1,-0.9972513740911768,-1.170500554541026,-0.7803337030273506,0.8007345660896301,0.3274740759791147,0.3274740759791147,-0.7803337030273506,-1.170500554541026,1,1,1,0,-1.170500554541026,-0.7803337030273506
6431,27,192,3,53,50,0,3036.054,90,1343.63,LESS,-136,2012,1876,2,2,-3.0,-0.28122253820234633,3.0,-1.0476454436543674,1.3625271239360648,-0.9227721426123624,103,53,50,0,-1.1368665664639415,-1.0534504990869233,-1.170500554541026,-0.8488473726357884,0.13336971952436485,0.13336971952436485,-1.170500554541026,-1.0534504990869233,1,0,1,0,-1.0534504990869233,-1.170500554541026
6432,27,193,45,122,110,0,3162.565,64,1405.39,LESS,-832,2078,1246,2,1,-12.0,-1.124890152809385,12.0,0.5238227218271837,-0.011449807764168715,-0.8484238224337863,232,122,110,0,1.4360419786912946,1.6387007763574364,1.170500554541026,-0.8488473726357884,-0.6707769000738846,0.6707769000738846,1.170500554541026,1.6387007763574364,1,0,0,2,1.6387007763574364,1.170500554541026
6433,27,194,38,67,80,1,4667.88,44,1399.372,LESS,1148,1596,2744,3,2,13.0,1.218630998876834,13.0,0.6984302957695783,-1.0683551398412716,0.036223691139051835,147,67,80,1,-0.25928535726370594,-0.5072169069677779,0.0,-0.02405640327307912,1.616881586714239,1.616881586714239,0.0,-0.5072169069677779,0,0,1,1,-0.5072169069677779,0.0
6434,27,195,38,80,67,1,4011.585,84,1362.865,LESS,748,1562,2310,3,2,-13.0,-1.218630998876834,13.0,0.6984302957695783,1.0454555243129342,-0.3494694959482262,147,80,67,0,-0.25928535726370594,0.0,-0.5072169069677779,-0.02405640327307912,1.1547283570600726,1.1547283570600726,-0.5072169069677779,0.0,1,0,1,1,0.0,-0.5072169069677779
6435,27,196,36,70,80,0,4987.245,64,1596.557,LESS,-1502,3064,1562,4,1,10.0,0.9374084606744876,10.0,0.17460757394239454,-0.011449807764168715,0.22390896177821326,150,70,80,1,-0.19945027481823535,-0.3901668515136753,0.0,0.8007345660896301,-1.4448835597446132,1.4448835597446132,0.0,-0.3901668515136753,1,1,0,1,-0.3901668515136753,0.0
6436,27,197,45,110,122,1,4882.907,44,1597.28,LESS,352,1912,2264,4,1,12.0,1.124890152809385,12.0,0.5238227218271837,-1.0683551398412716,0.1625913290759798,232,110,122,1,1.4360419786912946,1.170500554541026,1.6387007763574364,0.8007345660896301,0.6971966597024478,0.6971966597024478,1.6387007763574364,1.170500554541026,0,1,1,2,1.6387007763574364,1.170500554541026
6437,27,198,42,110,115,1,5823.348000000001,34,1919.383,LESS,-306,2864,2558,5,2,5.0,0.4687042303372438,5.0,-0.6984302957695783,-1.5968078058798232,0.7152721914283473,225,110,115,1,1.2964267863185297,1.170500554541026,1.3655839802978638,1.6255255354523395,-0.06304540307865586,0.06304540307865586,1.3655839802978638,1.170500554541026,0,1,0,2,1.3655839802978638,1.170500554541026
6438,27,199,41,110,112,0,5319.627,84,1746.177,LESS,-414,2946,2532,4,2,2.0,0.18748169213489754,2.0,-1.222253017596762,1.0454555243129342,0.4192440975181531,222,110,112,1,1.2365917038730592,1.170500554541026,1.248533924843761,0.8007345660896301,-0.18782677508528078,0.18782677508528078,1.248533924843761,1.170500554541026,1,1,0,2,1.248533924843761,1.170500554541026
6439,27,200,53,110,103,1,4829.936,74,1272.654,LESS,1500,1908,3408,2,1,-7.0,-0.6561859224721414,7.0,-0.34921514788478913,0.5170028582743827,0.13146119123674535,213,110,103,0,1.0570864565366473,1.170500554541026,0.8973837584814532,-0.8488473726357884,2.023576428809905,2.023576428809905,0.8973837584814532,1.170500554541026,1,0,1,2,1.170500554541026,0.8973837584814532
6440,27,201,3,50,53,1,2048.961,84,1541.725,MORE,412,852,1264,1,2,3.0,0.28122253820234633,3.0,-1.0476454436543674,1.0454555243129342,-1.5028695761164157,103,50,53,0,-1.1368665664639415,-1.170500554541026,-1.0534504990869233,-1.6736383419984977,0.7665196441505728,0.7665196441505728,-1.0534504990869233,-1.170500554541026,1,0,1,0,-1.170500554541026,-1.0534504990869233
6441,27,202,20,50,40,0,2841.402,74,1506.4879999999996,MORE,-682,1838,1156,2,2,-10.0,-0.9374084606744876,10.0,0.17460757394239454,0.5170028582743827,-1.0371657464839643,90,50,40,1,-1.3961519237276474,-1.170500554541026,-1.5606674060547012,-0.8488473726357884,-0.4974694389535722,0.4974694389535722,-1.5606674060547012,-1.170500554541026,1,0,0,0,-1.170500554541026,-1.5606674060547012
6442,27,203,25,80,88,1,4139.177,94,963.586,MORE,8,2024,2032,3,2,8.0,0.7499267685395902,8.0,-0.17460757394239454,1.5739081903514858,-0.2744858908212028,168,80,88,0,0.1595602198545883,0.0,0.31213348121094026,-0.02405640327307912,0.2997448821998647,0.2997448821998647,0.31213348121094026,0.0,1,1,1,1,0.31213348121094026,0.0
6443,27,204,42,115,110,0,4477.379,64,1438.899,MORE,-50,2184,2134,4,1,-5.0,-0.4687042303372438,5.0,-0.6984302957695783,-0.011449807764168715,-0.07573044203781774,225,115,110,1,1.2964267863185297,1.3655839802978638,1.170500554541026,0.8007345660896301,0.2327326639000106,0.2327326639000106,1.170500554541026,1.3655839802978638,0,1,1,2,1.3655839802978638,1.170500554541026
6444,27,205,53,103,110,0,2071.375,44,1413.1760000000004,MORE,-672,1436,764,2,1,7.0,0.6561859224721414,7.0,-0.34921514788478913,-1.0683551398412716,-1.4896972571205764,213,103,110,0,1.0570864565366473,0.8973837584814532,1.170500554541026,-0.8488473726357884,-0.4859156082122181,0.4859156082122181,1.170500554541026,0.8973837584814532,0,0,0,2,1.170500554541026,0.8973837584814532
6445,27,206,26,90,80,0,4195.264,64,1537.033,MORE,-1238,2738,1500,2,1,-10.0,-0.9374084606744876,10.0,0.17460757394239454,-0.011449807764168715,-0.241524533833622,170,90,80,1,0.19945027481823535,0.3901668515136753,0.0,-0.8488473726357884,-1.1398624281728633,1.1398624281728633,0.0,0.3901668515136753,0,0,0,1,0.3901668515136753,0.0
6446,27,207,35,80,72,0,2468.563,74,1763.799,MORE,-952,1740,788,2,1,-8.0,-0.7499267685395902,8.0,-0.17460757394239454,0.5170028582743827,-1.2562767593370772,152,80,72,1,-0.1595602198545883,0.0,-0.31213348121094026,-0.8488473726357884,-0.8094228689701345,0.8094228689701345,-0.31213348121094026,0.0,1,0,0,1,0.0,-0.31213348121094026
6447,27,208,28,93,80,0,2853.293,64,1607.899,MORE,-622,1724,1102,1,1,-13.0,-1.218630998876834,13.0,0.6984302957695783,-0.011449807764168715,-1.0301776120510415,173,93,80,1,0.25928535726370594,0.5072169069677779,0.0,-1.6736383419984977,-0.42814645450544725,0.42814645450544725,0.0,0.5072169069677779,0,0,0,1,0.5072169069677779,0.0
6448,27,209,26,80,90,1,3875.861,54,1584.639,MORE,342,2002,2344,3,2,10.0,0.9374084606744876,10.0,0.17460757394239454,-0.5399024738027202,-0.4292321364136172,170,80,90,0,0.19945027481823535,0.0,0.3901668515136753,-0.02405640327307912,0.6856428289610937,0.6856428289610937,0.3901668515136753,0.0,0,0,1,1,0.3901668515136753,0.0
6449,27,210,25,88,80,0,3800.704,64,1475.823,MORE,-374,2072,1698,2,1,-8.0,-0.7499267685395902,8.0,-0.17460757394239454,-0.011449807764168715,-0.4734006016036894,168,88,80,1,0.1595602198545883,0.31213348121094026,0.0,-0.8488473726357884,-0.14161145211986415,0.14161145211986415,0.0,0.31213348121094026,0,0,0,1,0.31213348121094026,0.0
6450,27,211,36,80,70,0,2758.2,64,1482.283,MORE,-314,1608,1294,2,1,-10.0,-0.9374084606744876,10.0,0.17460757394239454,-0.011449807764168715,-1.0860621186215484,150,80,70,1,-0.19945027481823535,0.0,-0.3901668515136753,-0.8488473726357884,-0.07228846767173919,0.07228846767173919,-0.3901668515136753,0.0,0,0,0,1,0.0,-0.3901668515136753
6451,27,212,28,80,93,1,4489.419,100,893.11,MORE,318,2298,2616,3,2,13.0,1.218630998876834,13.0,0.6984302957695783,1.8909797899746168,-0.0686547428895219,173,80,93,0,0.25928535726370594,0.0,0.5072169069677779,-0.02405640327307912,0.6579136351818438,0.6579136351818438,0.5072169069677779,0.0,1,1,1,1,0.5072169069677779,0.0
6452,27,213,21,82,80,0,4576.46,74,602.053,MORE,-1282,2852,1570,4,1,-2.0,-0.18748169213489754,2.0,-1.222253017596762,0.5170028582743827,-0.017502257045101596,162,82,80,1,0.03989005496364707,0.07803337030273506,0.0,0.8007345660896301,-1.1906992834348218,1.1906992834348218,0.0,0.07803337030273506,1,1,0,1,0.07803337030273506,0.0
6453,27,214,19,50,41,0,2232.776,64,2354.958,MORE,-920,1590,670,2,1,-9.0,-0.8436676146070391,9.0,0.0,-0.011449807764168715,-1.3948446891609338,91,50,41,1,-1.376206896245824,-1.170500554541026,-1.5216507209033339,-0.8488473726357884,-0.7724506105978012,0.7724506105978012,-1.5216507209033339,-1.170500554541026,0,0,0,0,-1.170500554541026,-1.5216507209033339
6454,27,215,56,96,110,1,3329.848,64,1623.18,MORE,1024,1146,2170,3,2,14.0,1.3123718449442827,14.0,0.8730378697119728,-0.011449807764168715,-0.7501145051061805,206,96,110,0,0.9174712641638826,0.6242669624218805,1.170500554541026,-0.02405640327307912,1.4736140855214472,1.4736140855214472,1.170500554541026,0.6242669624218805,0,1,1,2,1.170500554541026,0.6242669624218805
6455,27,216,23,80,85,1,4914.487,54,1555.2820000000004,MORE,-586,2434,1848,4,1,5.0,0.4687042303372438,5.0,-0.6984302957695783,-0.5399024738027202,0.18115034727391852,165,80,85,0,0.09972513740911768,0.0,0.19508342575683765,0.8007345660896301,-0.38655266383657233,0.38655266383657233,0.19508342575683765,0.0,0,1,0,1,0.19508342575683765,0.0
6456,27,217,10,60,50,1,4604.038,54,1182.902,MORE,444,2078,2522,4,1,-10.0,-0.9374084606744876,10.0,0.17460757394239454,-0.5399024738027202,-0.0012951448265218933,110,60,50,1,-0.9972513740911768,-0.7803337030273506,-1.170500554541026,0.8007345660896301,0.8034919025229061,0.8034919025229061,-1.170500554541026,-0.7803337030273506,0,1,1,0,-0.7803337030273506,-1.170500554541026
6457,27,218,19,41,50,0,2672.665,74,1892.01,MORE,854,1566,2420,3,2,9.0,0.8436676146070391,9.0,0.0,0.5170028582743827,-1.136329554389778,91,41,50,0,-1.376206896245824,-1.5216507209033339,-1.170500554541026,-0.02405640327307912,1.2771989629184266,1.2771989629184266,-1.170500554541026,-1.5216507209033339,1,1,1,0,-1.5216507209033339,-1.170500554541026
6458,27,219,56,110,96,1,4926.926,74,1311.464,MORE,-48,2374,2326,3,2,-14.0,-1.3123718449442827,14.0,0.8730378697119728,0.5170028582743827,0.18846053180096625,206,110,96,1,0.9174712641638826,1.170500554541026,0.6242669624218805,-0.02405640327307912,0.23504343004828143,0.23504343004828143,0.6242669624218805,1.170500554541026,1,1,1,2,1.170500554541026,0.6242669624218805
6459,27,220,35,72,80,1,4475.167,54,1509.4,MORE,554,1918,2472,3,2,8.0,0.7499267685395902,8.0,-0.17460757394239454,-0.5399024738027202,-0.0770303960673881,152,72,80,0,-0.1595602198545883,-0.31213348121094026,0.0,-0.02405640327307912,0.9305840406778019,0.9305840406778019,0.0,-0.31213348121094026,0,1,1,1,-0.31213348121094026,0.0
6460,27,221,11,49,50,0,3143.668,54,1819.824,MORE,-188,1896,1708,2,2,1.0,0.09374084606744876,1.0,-1.3968605915391563,-0.5399024738027202,-0.8595292615372204,99,49,50,0,-1.2166466763912356,-1.2095172396923934,-1.170500554541026,-0.8488473726357884,0.07328979966932322,0.07328979966932322,-1.170500554541026,-1.2095172396923934,0,0,1,0,-1.2095172396923934,-1.170500554541026
6461,27,222,17,43,50,0,6849.225,14,1618.56,MORE,-362,3386,3024,4,1,7.0,0.6561859224721414,7.0,-0.34921514788478913,-2.653713137956926,1.3181623089662462,93,43,50,0,-1.3363168412821769,-1.4436173506005987,-1.170500554541026,0.8007345660896301,-0.12774685523023915,0.12774685523023915,-1.170500554541026,-1.4436173506005987,0,1,0,0,-1.4436173506005987,-1.170500554541026
6462,27,223,1,51,50,0,2395.993,74,1776.495,MORE,-1084,1912,828,2,1,-1.0,-0.09374084606744876,1.0,-1.3968605915391563,0.5170028582743827,-1.2989248895025114,101,51,50,1,-1.1767566214275886,-1.1314838693896585,-1.170500554541026,-0.8488473726357884,-0.9619334347560093,0.9619334347560093,-1.170500554541026,-1.1314838693896585,1,0,0,0,-1.1314838693896585,-1.170500554541026
6463,27,224,41,112,110,0,3890.698,84,1454.292,MORE,-1656,2684,1028,2,1,-2.0,-0.18748169213489754,2.0,-1.222253017596762,1.0454555243129342,-0.4205126888834456,222,112,110,1,1.2365917038730592,1.248533924843761,1.170500554541026,-0.8488473726357884,-1.6228125531614672,1.6228125531614672,1.170500554541026,1.248533924843761,1,0,0,2,1.248533924843761,1.170500554541026
6464,27,225,20,40,50,1,5010.068,54,1325.915,MORE,250,2056,2306,3,2,10.0,0.9374084606744876,10.0,0.17460757394239454,-0.5399024738027202,0.2373216429793394,90,40,50,0,-1.3961519237276474,-1.5606674060547012,-1.170500554541026,-0.02405640327307912,0.5793475861406354,0.5793475861406354,-1.170500554541026,-1.5606674060547012,0,1,1,0,-1.5606674060547012,-1.170500554541026
6465,27,226,1,50,51,0,3374.686,54,1268.14,MORE,-618,1990,1372,2,1,1.0,0.09374084606744876,1.0,-1.3968605915391563,-0.5399024738027202,-0.723763990287967,101,50,51,0,-1.1767566214275886,-1.170500554541026,-1.1314838693896585,-0.8488473726357884,-0.4235249222089056,0.4235249222089056,-1.1314838693896585,-1.170500554541026,0,0,0,0,-1.170500554541026,-1.1314838693896585
6466,27,227,23,85,80,0,2589.66,64,1695.562,MORE,-812,1774,962,2,1,-5.0,-0.4687042303372438,5.0,-0.6984302957695783,-0.011449807764168715,-1.1851101530446202,165,85,80,1,0.09972513740911768,0.19508342575683765,0.0,-0.8488473726357884,-0.6476692385911762,0.6476692385911762,0.0,0.19508342575683765,1,0,0,1,0.19508342575683765,0.0
6467,27,228,11,50,49,0,3277.458,44,2245.8160000000007,MORE,-1328,2638,1310,2,1,-1.0,-0.09374084606744876,1.0,-1.3968605915391563,-1.0683551398412716,-0.7809031993237237,99,50,49,1,-1.2166466763912356,-1.170500554541026,-1.2095172396923934,-0.8488473726357884,-1.243846904845051,1.243846904845051,-1.2095172396923934,-1.170500554541026,0,0,0,0,-1.170500554541026,-1.2095172396923934
6468,27,229,17,50,43,1,4888.513,44,1682.594,MORE,-394,2580,2186,3,2,-7.0,-0.6561859224721414,7.0,-0.34921514788478913,-1.0683551398412716,0.16588587803157326,93,50,43,1,-1.3363168412821769,-1.170500554541026,-1.4436173506005987,-0.02405640327307912,-0.16471911360257246,0.16471911360257246,-1.4436173506005987,-1.170500554541026,0,1,0,0,-1.170500554541026,-1.4436173506005987
6469,27,230,21,80,82,1,3538.1740000000004,74,1719.415,MORE,480,1410,1890,3,2,2.0,0.18748169213489754,2.0,-1.222253017596762,0.5170028582743827,-0.6276849286304426,162,80,82,0,0.03989005496364707,0.0,0.07803337030273506,-0.02405640327307912,0.8450856931917811,0.8450856931917811,0.07803337030273506,0.0,1,1,1,1,0.07803337030273506,0.0
6470,27,231,10,50,60,1,2017.232,100,1666.083,MORE,142,1178,1320,1,2,10.0,0.9374084606744876,10.0,0.17460757394239454,1.8909797899746168,-1.5215161590297281,110,50,60,0,-0.9972513740911768,-1.170500554541026,-0.7803337030273506,-1.6736383419984977,0.45456621413401044,0.45456621413401044,-0.7803337030273506,-1.170500554541026,1,0,1,0,-1.170500554541026,-0.7803337030273506
6471,27,232,3,53,50,0,7481.734,54,1546.868,MORE,-520,3798,3278,6,1,-3.0,-0.28122253820234633,3.0,-1.0476454436543674,-0.5399024738027202,1.6898768764570653,103,53,50,1,-1.1368665664639415,-1.0534504990869233,-1.170500554541026,2.450316504815049,-0.31029738094363485,0.31029738094363485,-1.170500554541026,-1.0534504990869233,0,1,0,0,-1.0534504990869233,-1.170500554541026
6472,27,233,45,122,110,0,3836.637,74,1825.508,MORE,-1430,2610,1180,2,1,-12.0,-1.124890152809385,12.0,0.5238227218271837,0.5170028582743827,-0.4522834008150087,232,122,110,1,1.4360419786912946,1.6387007763574364,1.170500554541026,-0.8488473726357884,-1.3616959784068632,1.3616959784068632,1.170500554541026,1.6387007763574364,1,0,0,2,1.6387007763574364,1.170500554541026
6473,27,234,38,67,80,1,2667.166,100,982.713,MORE,-536,1784,1248,1,2,13.0,1.218630998876834,13.0,0.6984302957695783,1.8909797899746168,-1.1395612213014457,147,67,80,0,-0.25928535726370594,-0.5072169069677779,0.0,-1.6736383419984977,-0.3287835101298015,0.3287835101298015,0.0,-0.5072169069677779,1,0,0,1,-0.5072169069677779,0.0
6474,27,235,38,80,67,0,4229.895,44,1618.259,MORE,-1866,3120,1254,2,1,-13.0,-1.218630998876834,13.0,0.6984302957695783,-1.0683551398412716,-0.221172495859815,147,80,67,1,-0.25928535726370594,0.0,-0.5072169069677779,-0.8488473726357884,-1.8654429987299046,1.8654429987299046,-0.5072169069677779,0.0,0,0,0,1,0.0,-0.5072169069677779
6475,27,236,36,70,80,1,4699.266,54,1236.732,MORE,660,1902,2562,3,2,10.0,0.9374084606744876,10.0,0.17460757394239454,-0.5399024738027202,0.05466869890220883,150,70,80,0,-0.19945027481823535,-0.3901668515136753,0.0,-0.02405640327307912,1.0530546465361559,1.0530546465361559,0.0,-0.3901668515136753,0,1,1,1,-0.3901668515136753,0.0
6476,27,237,45,110,122,1,1650.606,44,1155.923,MORE,214,732,946,1,2,12.0,1.124890152809385,12.0,0.5238227218271837,-1.0683551398412716,-1.7369758995565647,232,110,122,0,1.4360419786912946,1.170500554541026,1.6387007763574364,-1.6736383419984977,0.5377537954717604,0.5377537954717604,1.6387007763574364,1.170500554541026,0,0,1,2,1.6387007763574364,1.170500554541026
6477,27,238,42,110,115,1,3467.038,44,1248.775,MORE,-238,1792,1554,3,2,5.0,0.4687042303372438,5.0,-0.6984302957695783,-1.0683551398412716,-0.6694903218707396,225,110,115,0,1.2964267863185297,1.170500554541026,1.3655839802978638,-0.02405640327307912,0.015520645962552424,0.015520645962552424,1.3655839802978638,1.170500554541026,0,1,1,2,1.3655839802978638,1.170500554541026
6478,27,239,41,110,112,1,2262.936,84,1596.346,MORE,-30,1256,1226,1,2,2.0,0.18748169213489754,2.0,-1.222253017596762,1.0454555243129342,-1.3771201803309832,222,110,112,0,1.2365917038730592,1.170500554541026,1.248533924843761,-1.6736383419984977,0.25584032538271895,0.25584032538271895,1.248533924843761,1.170500554541026,1,0,1,2,1.248533924843761,1.170500554541026
6479,27,240,53,110,103,0,6140.96,74,1756.757,MORE,-1588,3722,2134,4,1,-7.0,-0.6561859224721414,7.0,-0.34921514788478913,0.5170028582743827,0.9019272543759004,213,110,103,1,1.0570864565366473,1.170500554541026,0.8973837584814532,0.8007345660896301,-1.5442465041202589,1.5442465041202589,0.8973837584814532,1.170500554541026,1,1,0,2,1.170500554541026,0.8973837584814532
6480,28,1,49,110,131,1,2420.685,40,1677.281,MORE,64,1098,1162,3,1,21.0,1.9685577674164243,21.0,2.0952908873087353,-0.3195877089069253,0.08571055463172537,241,110,131,0,1.6155472260277064,1.170500554541026,1.9898509427197442,-0.20908137272485844,0.6315847632776644,0.6315847632776644,1.9898509427197442,1.170500554541026,0,0,1,2,1.9898509427197442,1.170500554541026
6481,28,2,13,47,50,1,3499.168,10,783.562,MORE,-476,1810,1334,5,2,3.0,0.28122253820234633,3.0,-1.0476454436543674,-2.553598877965045,1.138045330346932,97,47,50,0,-1.2565367313548828,-1.2875506099951286,-1.170500554541026,1.266787140627084,-0.532958050869634,0.532958050869634,-1.170500554541026,-1.2875506099951286,0,1,0,0,-1.2875506099951286,-1.170500554541026
6482,28,3,16,50,44,0,2986.17,30,1317.757,MORE,-222,1234,1012,3,1,-6.0,-0.5624450764046927,6.0,-0.5238227218271837,-1.0642580985929653,0.6374851590022288,94,50,44,1,-1.3163718138003533,-1.170500554541026,-1.4046006654492311,-0.20908137272485844,0.01480838393298418,0.01480838393298418,-1.4046006654492311,-1.170500554541026,0,1,0,0,-1.170500554541026,-1.4046006654492311
6483,28,4,7,57,50,0,5100.094,40,1793.034,MORE,112,1952,2064,6,2,-7.0,-0.6561859224721414,7.0,-0.34921514788478913,-0.3195877089069253,2.7001562798441814,107,57,50,1,-1.0570864565366473,-0.8973837584814532,-1.170500554541026,2.0047213973030553,0.7350996800907577,0.7350996800907577,-1.170500554541026,-0.8973837584814532,0,1,1,0,-0.8973837584814532,-1.170500554541026
6484,28,5,18,42,50,1,1725.954,60,841.822,MORE,-36,712,676,5,2,8.0,0.7499267685395902,8.0,-0.17460757394239454,1.1697530704651546,-0.5921764320592111,92,42,50,0,-1.3562618687640005,-1.4826340357519663,-1.170500554541026,1.266787140627084,0.4159286865837203,0.4159286865837203,-1.170500554541026,-1.4826340357519663,1,1,1,0,-1.4826340357519663,-1.170500554541026
6485,28,6,51,108,110,1,2108.725,50,1323.233,MORE,154,760,914,1,2,2.0,0.18748169213489754,2.0,-1.222253017596762,0.42508268077911465,-0.2186858583225037,218,108,110,0,1.156811593945765,1.092467184238291,1.170500554541026,-1.684949886076801,0.8256752323022142,0.8256752323022142,1.170500554541026,1.092467184238291,1,0,1,2,1.170500554541026,1.092467184238291
6486,28,7,31,78,80,1,1724.844,60,1933.509,MORE,100,766,866,4,1,2.0,0.18748169213489754,2.0,-1.222253017596762,1.1697530704651546,-0.5932595196934562,158,78,80,0,-0.03989005496364707,-0.07803337030273506,0.0,0.5288528839511129,0.7092209508874844,0.7092209508874844,0.0,-0.07803337030273506,1,1,1,1,-0.07803337030273506,0.0
6487,28,8,58,110,92,0,2432.793,50,1621.2420000000004,MORE,-254,1244,990,5,1,-18.0,-1.6873352292140782,18.0,1.571468165481551,0.42508268077911465,0.0975249916366294,202,110,92,1,0.8376911542365885,1.170500554541026,0.4682002218164104,1.266787140627084,-0.05420156060907795,0.05420156060907795,0.4682002218164104,1.170500554541026,1,1,0,2,1.170500554541026,0.4682002218164104
6488,28,9,12,50,48,1,1830.792,50,1088.873,MORE,142,710,852,3,2,-2.0,-0.18748169213489754,2.0,-1.222253017596762,0.42508268077911465,-0.4898802686366713,98,50,48,1,-1.2365917038730592,-1.170500554541026,-1.248533924843761,-0.20908137272485844,0.7997965030989409,0.7997965030989409,-1.248533924843761,-1.170500554541026,1,1,1,0,-1.170500554541026,-1.248533924843761
6489,28,10,54,110,101,0,1901.438,60,1736.784,MORE,-636,1070,434,2,1,-9.0,-0.8436676146070391,9.0,0.0,1.1697530704651546,-0.4209471073673916,211,110,101,1,1.0171964015730004,1.170500554541026,0.8193503881787182,-0.9470156294008297,-0.8780077735799446,0.8780077735799446,0.8193503881787182,1.170500554541026,1,0,0,2,1.170500554541026,0.8193503881787182
6490,28,11,14,46,50,1,1768.948,60,945.168,MORE,188,656,844,3,2,4.0,0.3749633842697951,4.0,-0.8730378697119728,1.1697530704651546,-0.5502248376927724,96,46,50,0,-1.2764817588367063,-1.3265672951464962,-1.170500554541026,-0.20908137272485844,0.8989982983781553,0.8989982983781553,-1.170500554541026,-1.3265672951464962,1,1,1,0,-1.3265672951464962,-1.170500554541026
6491,28,12,22,80,83,0,1780.24,60,1202.345,MORE,-684,1066,382,2,1,3.0,0.28122253820234633,3.0,-1.0476454436543674,1.1697530704651546,-0.5392066164622329,163,80,83,0,0.05983508244547061,0.0,0.1170500554541026,-0.9470156294008297,-0.9815226903930379,0.9815226903930379,0.1170500554541026,0.0,1,0,0,1,0.1170500554541026,0.0
6492,28,13,6,50,56,0,1923.951,60,1375.3570000000002,MORE,-368,952,584,1,2,6.0,0.5624450764046927,6.0,-0.5238227218271837,1.1697530704651546,-0.39897994348471905,106,50,56,0,-1.077031484018471,-1.170500554541026,-0.9364004436328208,-1.684949886076801,-0.3000494880401743,0.3000494880401743,-0.9364004436328208,-1.170500554541026,1,0,0,0,-1.170500554541026,-0.9364004436328208
6493,28,14,13,50,47,0,1376.2120000000002,60,1399.081,MORE,-366,758,392,1,1,-3.0,-0.28122253820234633,3.0,-1.0476454436543674,1.1697530704651546,-0.9334388062720519,97,50,47,1,-1.2565367313548828,-1.170500554541026,-1.2875506099951286,-1.684949886076801,-0.2957363665062954,0.2957363665062954,-1.2875506099951286,-1.170500554541026,1,0,0,0,-1.170500554541026,-1.2875506099951286
6494,28,15,46,110,124,1,1570.3429999999996,60,2276.711,MORE,-234,1032,798,3,1,14.0,1.3123718449442827,14.0,0.8730378697119728,1.1697530704651546,-0.7440145850795361,234,110,124,0,1.4759320336549415,1.170500554541026,1.7167341466601715,-0.20908137272485844,-0.011070345270289116,0.011070345270289116,1.7167341466601715,1.170500554541026,1,1,0,2,1.7167341466601715,1.170500554541026
6495,28,16,27,91,80,1,1976.101,60,1040.594,MORE,20,800,820,3,2,-11.0,-1.0311493067419364,11.0,0.34921514788478913,1.1697530704651546,-0.34809433976769416,171,91,80,1,0.21939530230005888,0.4291835366650429,0.0,-0.20908137272485844,0.5366960895323291,0.5366960895323291,0.0,0.4291835366650429,1,1,1,1,0.4291835366650429,0.0
6496,28,17,40,64,80,1,2043.473,50,1883.045,MORE,-30,1258,1228,6,1,16.0,1.4998535370791803,16.0,1.222253017596762,0.42508268077911465,-0.2823557991421259,144,64,80,0,-0.3191204397091766,-0.6242669624218805,0.0,2.0047213973030553,0.428868051185357,0.428868051185357,0.0,-0.6242669624218805,1,1,1,1,-0.6242669624218805,0.0
6497,28,18,22,83,80,1,2049.897,60,852.252,MORE,226,730,956,3,2,-3.0,-0.28122253820234633,3.0,-1.0476454436543674,1.1697530704651546,-0.2760875514282589,163,83,80,1,0.05983508244547061,0.1170500554541026,0.0,-0.20908137272485844,0.980947607521854,0.980947607521854,0.0,0.1170500554541026,1,1,1,1,0.1170500554541026,0.0
6498,28,19,54,101,110,1,1996.728,50,1264.687,MORE,174,728,902,3,2,9.0,0.8436676146070391,9.0,0.0,0.42508268077911465,-0.3279674491086133,211,101,110,0,1.0171964015730004,0.8193503881787182,1.170500554541026,-0.20908137272485844,0.868806447641003,0.868806447641003,1.170500554541026,0.8193503881787182,0,1,1,2,1.170500554541026,0.8193503881787182
6499,28,20,6,56,50,1,2073.991,30,703.327,MORE,434,560,994,2,2,-6.0,-0.5624450764046927,6.0,-0.5238227218271837,-1.0642580985929653,-0.25257771948275554,106,56,50,1,-1.077031484018471,-0.9364004436328208,-1.170500554541026,-0.9470156294008297,1.429512247045258,1.429512247045258,-1.170500554541026,-0.9364004436328208,0,0,1,0,-0.9364004436328208,-1.170500554541026
6500,28,21,18,50,42,1,2177.599,40,1363.973,MORE,284,758,1042,3,2,-8.0,-0.7499267685395902,8.0,-0.17460757394239454,-0.3195877089069253,-0.15148173424951472,92,50,42,1,-1.3562618687640005,-1.170500554541026,-1.4826340357519663,-0.20908137272485844,1.1060281320043417,1.1060281320043417,-1.4826340357519663,-1.170500554541026,0,1,1,0,-1.170500554541026,-1.4826340357519663
6501,28,22,43,110,117,0,1628.771,30,1370.227,MORE,-1056,1458,402,2,1,7.0,0.6561859224721414,7.0,-0.34921514788478913,-1.0642580985929653,-0.6870031938239591,227,110,117,0,1.3363168412821769,1.170500554541026,1.4436173506005987,-0.9470156294008297,-1.78376329569451,1.78376329569451,1.4436173506005987,1.170500554541026,0,0,0,2,1.4436173506005987,1.170500554541026
6502,28,23,32,77,80,1,1985.741,40,1965.911,MORE,-192,1114,922,3,2,3.0,0.28122253820234633,3.0,-1.0476454436543674,-0.3195877089069253,-0.3386880651783919,157,77,80,0,-0.05983508244547061,-0.1170500554541026,0.0,-0.20908137272485844,0.07950520694116743,0.07950520694116743,0.0,-0.1170500554541026,0,1,0,1,-0.1170500554541026,0.0
6503,28,24,27,80,91,1,2123.308,60,1953.278,MORE,408,672,1080,2,1,11.0,1.0311493067419364,11.0,0.34921514788478913,1.1697530704651546,-0.20445642861962016,171,80,91,0,0.21939530230005888,0.0,0.4291835366650429,-0.9470156294008297,1.3734416671048324,1.3734416671048324,0.4291835366650429,0.0,1,0,1,1,0.4291835366650429,0.0
6504,28,25,16,44,50,1,1968.519,10,637.836,MORE,-394,1160,766,3,1,6.0,0.5624450764046927,6.0,-0.5238227218271837,-2.553598877965045,-0.3554925113378281,94,44,50,0,-1.3163718138003533,-1.4046006654492311,-1.170500554541026,-0.20908137272485844,-0.35612006798059975,0.35612006798059975,-1.170500554541026,-1.4046006654492311,0,1,0,0,-1.4046006654492311,-1.170500554541026
6505,28,26,7,50,57,1,2070.932,30,1414.395,MORE,-70,876,806,3,1,7.0,0.6561859224721414,7.0,-0.34921514788478913,-1.0642580985929653,-0.255562552881996,107,50,57,0,-1.0570864565366473,-1.170500554541026,-0.8973837584814532,-0.20908137272485844,0.3426056205077793,0.3426056205077793,-0.8973837584814532,-1.170500554541026,0,1,1,0,-1.170500554541026,-0.8973837584814532
6506,28,27,14,50,46,0,2660.077,30,1523.839,MORE,-414,1388,974,4,1,-4.0,-0.3749633842697951,4.0,-0.8730378697119728,-1.0642580985929653,0.3192984059265673,96,50,46,1,-1.2764817588367063,-1.170500554541026,-1.3265672951464962,0.5288528839511129,-0.3992512833193886,0.3992512833193886,-1.3265672951464962,-1.170500554541026,0,1,0,0,-1.170500554541026,-1.3265672951464962
6507,28,28,51,110,108,0,2584.98,30,1254.477,MORE,-534,1496,962,4,1,-2.0,-0.18748169213489754,2.0,-1.222253017596762,-1.0642580985929653,0.24602216081942602,218,110,108,1,1.156811593945765,1.170500554541026,1.092467184238291,0.5288528839511129,-0.6580385753521216,0.6580385753521216,1.092467184238291,1.170500554541026,0,1,0,2,1.170500554541026,1.092467184238291
6508,28,29,50,133,110,0,2274.049,40,1640.901,MORE,-290,1114,824,4,1,-23.0,-2.1560394595513217,23.0,2.444506035193524,-0.3195877089069253,-0.05737020062521885,243,133,110,1,1.6554372809913533,2.0678843130224793,1.170500554541026,0.5288528839511129,-0.13183774821889785,0.13183774821889785,1.170500554541026,2.0678843130224793,0,1,0,2,2.0678843130224793,1.170500554541026
6509,28,30,49,131,110,0,1861.168,40,1384.749,MORE,-458,918,460,2,1,-21.0,-1.9685577674164243,21.0,2.0952908873087353,-0.3195877089069253,-0.4602407461341144,241,131,110,1,1.6155472260277064,1.9898509427197442,1.170500554541026,-0.9470156294008297,-0.494139957064724,0.494139957064724,1.170500554541026,1.9898509427197442,0,0,0,2,1.9898509427197442,1.170500554541026
6510,28,31,47,126,110,0,2473.36,40,1233.672,MORE,-402,1190,788,3,2,-16.0,-1.4998535370791803,16.0,1.222253017596762,-0.3195877089069253,0.13710842952710964,236,126,110,1,1.5158220886185887,1.7947675169629065,1.170500554541026,-0.20908137272485844,-0.3733725541161153,0.3733725541161153,1.170500554541026,1.7947675169629065,0,1,0,2,1.7947675169629065,1.170500554541026
6511,28,32,50,110,133,1,1736.281,60,1265.43,MORE,40,810,850,3,2,23.0,2.1560394595513217,23.0,2.444506035193524,1.1697530704651546,-0.582099814042227,243,110,133,0,1.6554372809913533,1.170500554541026,2.0678843130224793,-0.20908137272485844,0.5798273048711179,0.5798273048711179,2.0678843130224793,1.170500554541026,1,1,1,2,2.0678843130224793,1.170500554541026
6512,28,33,47,110,126,1,1742.155,50,1016.453,MORE,136,712,848,3,2,16.0,1.4998535370791803,16.0,1.222253017596762,0.42508268077911465,-0.5763682313723554,236,110,126,0,1.5158220886185887,1.170500554541026,1.7947675169629065,-0.20908137272485844,0.7868571384973042,0.7868571384973042,1.7947675169629065,1.170500554541026,1,1,1,2,1.7947675169629065,1.170500554541026
6513,28,34,12,48,50,0,2913.099,30,1187.129,MORE,-792,1540,748,4,1,2.0,0.18748169213489754,2.0,-1.222253017596762,-1.0642580985929653,0.5661857927662421,98,48,50,0,-1.2365917038730592,-1.248533924843761,-1.170500554541026,0.5288528839511129,-1.2144312532224975,1.2144312532224975,-1.170500554541026,-1.248533924843761,0,1,0,0,-1.248533924843761,-1.170500554541026
6514,28,35,32,80,77,0,2627.482,30,978.383,MORE,-164,1324,1160,4,1,-3.0,-0.28122253820234633,3.0,-1.0476454436543674,-1.0642580985929653,0.28749368391014474,157,80,77,1,-0.05983508244547061,0.0,-0.1170500554541026,0.5288528839511129,0.1398889084154718,0.1398889084154718,-0.1170500554541026,0.0,0,1,0,1,0.0,-0.1170500554541026
6515,28,36,43,117,110,0,1826.294,30,1147.378,MORE,-852,1302,450,2,1,-7.0,-0.6561859224721414,7.0,-0.34921514788478913,-1.0642580985929653,-0.4942692129419287,227,117,110,1,1.3363168412821769,1.4436173506005987,1.170500554541026,-0.9470156294008297,-1.343824899238864,1.343824899238864,1.170500554541026,1.4436173506005987,0,0,0,2,1.4436173506005987,1.170500554541026
6516,28,37,40,80,64,0,1354.626,30,1180.308,MORE,-432,786,354,2,1,-16.0,-1.4998535370791803,16.0,1.222253017596762,-1.0642580985929653,-0.9545014456169362,144,80,64,1,-0.3191204397091766,0.0,-0.6242669624218805,-0.9470156294008297,-0.43806937712429855,0.43806937712429855,-0.6242669624218805,0.0,0,0,0,1,0.0,-0.6242669624218805
6517,28,38,31,80,78,0,1646.504,40,1297.063,MORE,-710,1076,366,2,1,-2.0,-0.18748169213489754,2.0,-1.222253017596762,-0.3195877089069253,-0.6697001370509199,158,80,78,1,-0.03989005496364707,0.0,-0.07803337030273506,-0.9470156294008297,-1.0375932703334634,1.0375932703334634,-0.07803337030273506,0.0,0,0,0,1,0.0,-0.07803337030273506
6518,28,39,46,124,110,0,2885.32,50,1107.384,MORE,-186,1148,962,4,1,-14.0,-1.3123718449442827,14.0,0.8730378697119728,0.42508268077911465,0.5390803050259692,234,124,110,1,1.4759320336549415,1.7167341466601715,1.170500554541026,0.5288528839511129,0.09244457154280408,0.09244457154280408,1.170500554541026,1.7167341466601715,1,1,0,2,1.7167341466601715,1.170500554541026
6519,28,40,58,92,110,1,1566.876,60,2047.593,MORE,14,826,840,3,1,18.0,1.6873352292140782,18.0,1.571468165481551,1.1697530704651546,-0.7473975263659581,202,92,110,0,0.8376911542365885,0.4682002218164104,1.170500554541026,-0.20908137272485844,0.5237567249306924,0.5237567249306924,1.170500554541026,0.4682002218164104,1,1,1,2,1.170500554541026,0.4682002218164104
6520,28,41,49,110,131,0,2516.803,40,2001.615,LESS,-696,1474,778,5,1,21.0,1.9685577674164243,21.0,2.0952908873087353,-0.3195877089069253,0.17949813772037318,241,110,131,1,1.6155472260277064,1.170500554541026,1.9898509427197442,1.266787140627084,-1.007401419596311,1.007401419596311,1.9898509427197442,1.170500554541026,1,1,0,2,1.9898509427197442,1.170500554541026
6521,28,42,13,47,50,0,4611.667,30,1559.172,LESS,-158,2094,1936,6,1,3.0,0.28122253820234633,3.0,-1.0476454436543674,-1.0642580985929653,2.22357137540132,97,47,50,1,-1.2565367313548828,-1.2875506099951286,-1.170500554541026,2.0047213973030553,0.15282827301710844,0.15282827301710844,-1.170500554541026,-1.2875506099951286,0,1,1,0,-1.2875506099951286,-1.170500554541026
6522,28,43,16,50,44,0,3162.954,40,2198.769,LESS,-124,1738,1614,4,1,-6.0,-0.5624450764046927,6.0,-0.5238227218271837,-0.3195877089069253,0.8099829647071284,94,50,44,0,-1.3163718138003533,-1.170500554541026,-1.4046006654492311,0.5288528839511129,0.22615133909304946,0.22615133909304946,-1.4046006654492311,-1.170500554541026,1,1,1,0,-1.170500554541026,-1.4046006654492311
6523,28,44,7,57,50,1,4274.44,30,948.37,LESS,480,1534,2014,5,2,-7.0,-0.6561859224721414,7.0,-0.34921514788478913,-1.0642580985929653,1.894520570325939,107,57,50,0,-1.0570864565366473,-0.8973837584814532,-1.170500554541026,1.266787140627084,1.528714042324472,1.528714042324472,-1.170500554541026,-0.8973837584814532,0,1,1,0,-0.8973837584814532,-1.170500554541026
6524,28,45,18,42,50,0,1320.3429999999996,30,1164.784,LESS,-220,696,476,2,1,8.0,0.7499267685395902,8.0,-0.17460757394239454,-1.0642580985929653,-0.9879532414411122,92,42,50,1,-1.3562618687640005,-1.4826340357519663,-1.170500554541026,-0.9470156294008297,0.019121505466863066,0.019121505466863066,-1.170500554541026,-1.4826340357519663,0,0,1,0,-1.4826340357519663,-1.170500554541026
6525,28,46,51,108,110,0,3516.693,60,492.315,LESS,-540,1828,1288,6,1,2.0,0.18748169213489754,2.0,-1.222253017596762,1.1697530704651546,1.1551454301578783,218,108,110,1,1.156811593945765,1.092467184238291,1.170500554541026,2.0047213973030553,-0.6709779399537582,0.6709779399537582,1.170500554541026,1.092467184238291,1,1,0,2,1.170500554541026,1.092467184238291
6526,28,47,31,78,80,0,4181.559,20,1380.206,LESS,-302,1872,1570,4,1,2.0,0.18748169213489754,2.0,-1.222253017596762,-1.808928488279005,1.8038915049598607,158,78,80,1,-0.03989005496364707,-0.07803337030273506,0.0,0.5288528839511129,-0.15771647742217115,0.15771647742217115,0.0,-0.07803337030273506,0,1,0,1,-0.07803337030273506,0.0
6527,28,48,58,110,92,1,3230.012,40,1248.421,LESS,594,1034,1628,3,1,-18.0,-1.6873352292140782,18.0,1.571468165481551,-0.3195877089069253,0.8754151183803066,202,110,92,0,0.8376911542365885,1.170500554541026,0.4682002218164104,-0.20908137272485844,1.7745619697555686,1.7745619697555686,0.4682002218164104,1.170500554541026,1,0,1,2,1.170500554541026,0.4682002218164104
6528,28,49,12,50,48,1,3748.777,40,2038.68,LESS,-196,1592,1396,4,1,-2.0,-0.18748169213489754,2.0,-1.222253017596762,-0.3195877089069253,1.3816024666499584,98,50,48,0,-1.2365917038730592,-1.170500554541026,-1.248533924843761,0.5288528839511129,0.07087896387340967,0.07087896387340967,-1.248533924843761,-1.170500554541026,1,1,1,0,-1.170500554541026,-1.248533924843761
6529,28,50,54,110,101,0,4056.129,30,1276.353,LESS,-176,1794,1618,6,1,-9.0,-0.8436676146070391,9.0,0.0,-1.0642580985929653,1.6815026022901307,211,110,101,0,1.0171964015730004,1.170500554541026,0.8193503881787182,2.0047213973030553,0.1140101792121985,0.1140101792121985,0.8193503881787182,1.170500554541026,0,1,1,2,1.170500554541026,0.8193503881787182
6530,28,51,14,46,50,0,1765.118,30,1223.774,LESS,-782,1210,428,2,1,4.0,0.3749633842697951,4.0,-0.8730378697119728,-1.0642580985929653,-0.5539619779082319,96,46,50,1,-1.2764817588367063,-1.3265672951464962,-1.170500554541026,-0.9470156294008297,-1.192865645553103,1.192865645553103,-1.170500554541026,-1.3265672951464962,0,0,0,0,-1.3265672951464962,-1.170500554541026
6531,28,52,22,80,83,1,2491.894,30,1369.306,LESS,378,1010,1388,3,1,3.0,0.28122253820234633,3.0,-1.0476454436543674,-1.0642580985929653,0.1551930657551311,163,80,83,1,0.05983508244547061,0.0,0.1170500554541026,-0.20908137272485844,1.3087448440966492,1.3087448440966492,0.1170500554541026,0.0,0,0,1,1,0.1170500554541026,0.0
6532,28,53,6,50,56,0,2776.723,50,1943.611,LESS,84,1304,1388,5,2,6.0,0.5624450764046927,6.0,-0.5238227218271837,0.42508268077911465,0.43311627996637664,106,50,56,1,-1.077031484018471,-1.170500554541026,-0.9364004436328208,1.266787140627084,0.6747159786164533,0.6747159786164533,-0.9364004436328208,-1.170500554541026,1,1,1,0,-1.170500554541026,-0.9364004436328208
6533,28,54,13,50,47,1,2389.414,40,1090.0510000000004,LESS,78,1046,1124,3,2,-3.0,-0.28122253820234633,3.0,-1.0476454436543674,-0.3195877089069253,0.05519773173939426,97,50,47,0,-1.2565367313548828,-1.170500554541026,-1.2875506099951286,-0.20908137272485844,0.6617766140148167,0.6617766140148167,-1.2875506099951286,-1.170500554541026,1,1,1,0,-1.170500554541026,-1.2875506099951286
6534,28,55,46,110,124,0,3909.992,50,1890.126,LESS,-1184,2326,1142,5,2,14.0,1.3123718449442827,14.0,0.8730378697119728,0.42508268077911465,1.5389087485912845,234,110,124,1,1.4759320336549415,1.170500554541026,1.7167341466601715,1.266787140627084,-2.0598030738627586,2.0598030738627586,1.7167341466601715,1.170500554541026,1,1,0,2,1.7167341466601715,1.170500554541026
6535,28,56,27,91,80,1,5017.354,50,2152.942,LESS,842,1724,2566,8,2,-11.0,-1.0311493067419364,11.0,0.34921514788478913,0.42508268077911465,2.619422342134755,171,91,80,0,0.21939530230005888,0.4291835366650429,0.0,3.4805899106549982,2.3093890399565504,2.3093890399565504,0.0,0.4291835366650429,1,1,1,1,0.4291835366650429,0.0
6536,28,57,40,64,80,0,1897.163,60,621.935,LESS,-454,1046,592,4,1,16.0,1.4998535370791803,16.0,1.222253017596762,1.1697530704651546,-0.4251184583911746,144,64,80,1,-0.3191204397091766,-0.6242669624218805,0.0,0.5288528839511129,-0.48551371399696625,0.48551371399696625,0.0,-0.6242669624218805,1,1,0,1,-0.6242669624218805,0.0
6537,28,58,22,83,80,1,4054.092,50,2917.179,LESS,162,1596,1758,6,1,-3.0,-0.28122253820234633,3.0,-1.0476454436543674,0.42508268077911465,1.6795149901180968,163,83,80,0,0.05983508244547061,0.1170500554541026,0.0,2.0047213973030553,0.8429277184377297,0.8429277184377297,0.0,0.1170500554541026,1,1,1,1,0.1170500554541026,0.0
6538,28,59,54,101,110,0,2561.493,20,2223.618,LESS,-1762,2570,808,4,1,9.0,0.8436676146070391,9.0,0.0,-1.808928488279005,0.22310461193156852,211,101,110,1,1.0171964015730004,0.8193503881787182,1.170500554541026,0.5288528839511129,-3.3062951971537555,3.3062951971537555,1.170500554541026,0.8193503881787182,0,1,0,2,1.170500554541026,0.8193503881787182
6539,28,60,6,56,50,0,2424.959,30,1206.742,LESS,-550,1474,924,4,1,-6.0,-0.5624450764046927,6.0,-0.5238227218271837,-1.0642580985929653,0.08988092990088277,106,56,50,0,-1.077031484018471,-0.9364004436328208,-1.170500554541026,0.5288528839511129,-0.6925435476231526,0.6925435476231526,-1.170500554541026,-0.9364004436328208,0,1,0,0,-0.9364004436328208,-1.170500554541026
6540,28,61,18,50,42,1,2090.37,40,1109.921,LESS,254,762,1016,2,1,-8.0,-0.7499267685395902,8.0,-0.17460757394239454,-0.3195877089069253,-0.23659583447257065,92,50,42,0,-1.3562618687640005,-1.170500554541026,-1.4826340357519663,-0.9470156294008297,1.0413313089961584,1.0413313089961584,-1.4826340357519663,-1.170500554541026,1,0,1,0,-1.170500554541026,-1.4826340357519663
6541,28,62,43,110,117,1,2656.322,50,1626.08,LESS,52,1002,1054,5,1,7.0,0.6561859224721414,7.0,-0.34921514788478913,0.42508268077911465,0.3156344473080163,227,110,117,1,1.3363168412821769,1.170500554541026,1.4436173506005987,1.266787140627084,0.6057060340743912,0.6057060340743912,1.4436173506005987,1.170500554541026,1,1,1,2,1.4436173506005987,1.170500554541026
6542,28,63,32,77,80,0,2934.752,60,1831.22,LESS,190,1116,1306,5,1,3.0,0.28122253820234633,3.0,-1.0476454436543674,1.1697530704651546,0.5873138076710306,157,77,80,1,-0.05983508244547061,-0.1170500554541026,0.0,1.266787140627084,0.9033114199120341,0.9033114199120341,0.0,-0.1170500554541026,1,1,1,1,-0.1170500554541026,0.0
6543,28,64,27,80,91,0,2613.508,50,1158.817,LESS,-282,1060,778,3,2,11.0,1.0311493067419364,11.0,0.34921514788478913,0.42508268077911465,0.273858488774158,171,80,91,1,0.21939530230005888,0.0,0.4291835366650429,-0.20908137272485844,-0.11458526208338231,0.11458526208338231,0.4291835366650429,0.0,1,1,0,1,0.4291835366650429,0.0
6544,28,65,16,44,50,0,1588.852,50,846.128,LESS,-408,892,484,2,1,6.0,0.5624450764046927,6.0,-0.5238227218271837,0.42508268077911465,-0.72595434271715,94,44,50,1,-1.3163718138003533,-1.4046006654492311,-1.170500554541026,-0.9470156294008297,-0.38631191871775195,0.38631191871775195,-1.170500554541026,-1.4046006654492311,1,0,0,0,-1.4046006654492311,-1.170500554541026
6545,28,66,7,50,57,0,1666.338,60,2739.336,LESS,-1216,1586,370,2,1,7.0,0.6561859224721414,7.0,-0.34921514788478913,1.1697530704651546,-0.6503470198098178,107,50,57,1,-1.0570864565366473,-1.170500554541026,-0.8973837584814532,-0.9470156294008297,-2.128813018404821,2.128813018404821,-0.8973837584814532,-1.170500554541026,1,0,0,0,-1.170500554541026,-0.8973837584814532
6546,28,67,14,50,46,0,1429.186,50,1511.894,LESS,-428,796,368,2,1,-4.0,-0.3749633842697951,4.0,-0.8730378697119728,0.42508268077911465,-0.8817491807436598,96,50,46,0,-1.2764817588367063,-1.170500554541026,-1.3265672951464962,-0.9470156294008297,-0.4294431340565408,0.4294431340565408,-1.3265672951464962,-1.170500554541026,1,0,0,0,-1.170500554541026,-1.3265672951464962
6547,28,68,51,110,108,0,2283.973,50,1379.0410000000004,LESS,-464,1308,844,4,1,-2.0,-0.18748169213489754,2.0,-1.222253017596762,0.42508268077911465,-0.04768681172228975,218,110,108,0,1.156811593945765,1.170500554541026,1.092467184238291,0.5288528839511129,-0.5070793216663607,0.5070793216663607,1.092467184238291,1.170500554541026,1,1,0,2,1.170500554541026,1.092467184238291
6548,28,69,50,133,110,1,5978.587,30,1642.651,LESS,160,2682,2842,5,1,-23.0,-2.1560394595513217,23.0,2.444506035193524,-1.0642580985929653,3.5573498880163825,243,133,110,0,1.6554372809913533,2.0678843130224793,1.170500554541026,1.266787140627084,0.8386145969038509,0.8386145969038509,1.170500554541026,2.0678843130224793,0,1,1,2,2.0678843130224793,1.170500554541026
6549,28,70,49,131,110,0,3715.7790000000014,70,594.028,LESS,-918,1790,872,4,1,-21.0,-1.9685577674164243,21.0,2.0952908873087353,1.9144234601511947,1.3494045155194827,241,131,110,0,1.6155472260277064,1.9898509427197442,1.170500554541026,0.5288528839511129,-1.4861579098568671,1.4861579098568671,1.170500554541026,1.9898509427197442,1,1,0,2,1.9898509427197442,1.170500554541026
6550,28,71,47,126,110,1,3857.005,40,1147.344,LESS,-312,1630,1318,4,1,-16.0,-1.4998535370791803,16.0,1.222253017596762,-0.3195877089069253,1.4872064382527612,236,126,110,0,1.5158220886185887,1.7947675169629065,1.170500554541026,0.5288528839511129,-0.17928208509156557,0.17928208509156557,1.170500554541026,1.7947675169629065,1,1,0,2,1.7947675169629065,1.170500554541026
6551,28,72,50,110,133,0,2976.1040000000007,30,1153.847,LESS,-414,1356,942,3,1,23.0,2.1560394595513217,23.0,2.444506035193524,-1.0642580985929653,0.6276632129424871,243,110,133,1,1.6554372809913533,1.170500554541026,2.0678843130224793,-0.20908137272485844,-0.3992512833193886,0.3992512833193886,2.0678843130224793,1.170500554541026,0,0,0,2,2.0678843130224793,1.170500554541026
6552,28,73,47,110,126,0,5246.761,40,782.893,LESS,104,1900,2004,3,1,16.0,1.4998535370791803,16.0,1.222253017596762,-0.3195877089069253,2.8432672834945154,236,110,126,1,1.5158220886185887,1.170500554541026,1.7947675169629065,-0.20908137272485844,0.7178471939552421,0.7178471939552421,1.7947675169629065,1.170500554541026,1,0,1,2,1.7947675169629065,1.170500554541026
6553,28,74,12,48,50,1,2561.83,50,1397.421,LESS,-12,994,982,4,2,2.0,0.18748169213489754,2.0,-1.222253017596762,0.42508268077911465,0.22343344124034395,98,48,50,1,-1.2365917038730592,-1.248533924843761,-1.170500554541026,0.5288528839511129,0.4676861449902669,0.4676861449902669,-1.170500554541026,-1.248533924843761,1,1,1,0,-1.248533924843761,-1.170500554541026
6554,28,75,32,80,77,0,3181.643,30,1375.626,LESS,-330,1356,1026,4,1,-3.0,-0.28122253820234633,3.0,-1.0476454436543674,-1.0642580985929653,0.8282188429020941,157,80,77,0,-0.05983508244547061,0.0,-0.1170500554541026,0.5288528839511129,-0.2181001788964755,0.2181001788964755,-0.1170500554541026,0.0,0,1,0,1,0.0,-0.1170500554541026
6555,28,76,43,117,110,1,2615.883,40,2247.793,LESS,148,906,1054,3,2,-7.0,-0.6561859224721414,7.0,-0.34921514788478913,-0.3195877089069253,0.2761759060095929,227,117,110,0,1.3363168412821769,1.4436173506005987,1.170500554541026,-0.20908137272485844,0.8127358677005776,0.8127358677005776,1.170500554541026,1.4436173506005987,1,1,1,2,1.4436173506005987,1.170500554541026
6556,28,77,40,80,64,1,1252.518,30,1787.536,LESS,80,794,874,1,1,-16.0,-1.4998535370791803,16.0,1.222253017596762,-1.0642580985929653,-1.0541337989120074,144,80,64,0,-0.3191204397091766,0.0,-0.6242669624218805,-1.684949886076801,0.6660897355486955,0.6660897355486955,-0.6242669624218805,0.0,0,0,1,1,0.0,-0.6242669624218805
6557,28,78,31,80,78,1,6176.735,50,1776.283,LESS,-244,2548,2304,4,1,-2.0,-0.18748169213489754,2.0,-1.222253017596762,0.42508268077911465,3.7506937155393167,158,80,78,0,-0.03989005496364707,0.0,-0.07803337030273506,0.5288528839511129,-0.032635952939683535,0.032635952939683535,-0.07803337030273506,0.0,1,1,1,1,0.0,-0.07803337030273506
6558,28,79,46,124,110,1,1861.325,50,1541.19,LESS,150,774,924,3,1,-14.0,-1.3123718449442827,14.0,0.8730378697119728,0.42508268077911465,-0.4600875526579192,234,124,110,0,1.4759320336549415,1.7167341466601715,1.170500554541026,-0.20908137272485844,0.8170489892344565,0.8170489892344565,1.170500554541026,1.7167341466601715,1,1,1,2,1.7167341466601715,1.170500554541026
6559,28,80,58,92,110,0,2567.343,30,1064.982,LESS,-154,1080,926,4,1,18.0,1.6873352292140782,18.0,1.571468165481551,-1.0642580985929653,0.22881277649042936,202,92,110,1,0.8376911542365885,0.4682002218164104,1.170500554541026,0.5288528839511129,0.16145451608486622,0.16145451608486622,1.170500554541026,0.4682002218164104,0,1,1,2,1.170500554541026,0.4682002218164104
6560,28,81,48,128,110,0,4468.678,40,1873.734,MORE,-702,2244,1542,5,1,-18.0,-1.6873352292140782,18.0,1.571468165481551,-0.3195877089069253,2.0840491972633783,238,128,110,1,1.5557121435822359,1.8728008872656416,1.170500554541026,1.266787140627084,-1.0203407841979477,1.0203407841979477,1.170500554541026,1.8728008872656416,0,1,0,2,1.8728008872656416,1.170500554541026
6561,28,82,8,50,58,0,1771.2379999999996,30,1766.246,MORE,-1346,1802,456,2,1,8.0,0.7499267685395902,8.0,-0.17460757394239454,-1.0642580985929653,-0.5479903596005009,108,50,58,0,-1.0371414290548238,-1.170500554541026,-0.8583670733300858,-0.9470156294008297,-2.409165918106948,2.409165918106948,-0.8583670733300858,-1.170500554541026,0,0,0,0,-1.170500554541026,-0.8583670733300858
6562,28,83,4,54,50,1,2045.798,30,1932.952,MORE,36,976,1012,3,1,-4.0,-0.3749633842697951,4.0,-0.8730378697119728,-1.0642580985929653,-0.2800871696379632,104,54,50,1,-1.116921538982118,-1.0144338139355558,-1.170500554541026,-0.20908137272485844,0.57120106180336,0.57120106180336,-1.170500554541026,-1.0144338139355558,0,1,1,0,-1.0144338139355558,-1.170500554541026
6563,28,84,37,80,69,1,2012.281,40,1675.895,MORE,-68,912,844,3,1,-11.0,-1.0311493067419364,11.0,0.34921514788478913,-0.3195877089069253,-0.31279153741904697,149,80,69,1,-0.21939530230005888,0.0,-0.4291835366650429,-0.20908137272485844,0.3469187420416582,0.3469187420416582,-0.4291835366650429,0.0,0,1,1,1,0.0,-0.4291835366650429
6564,28,85,52,105,110,1,5198.2,40,2001.564,MORE,-100,2236,2136,8,1,5.0,0.4687042303372438,5.0,-0.6984302957695783,-0.3195877089069253,2.7958836631282167,215,105,110,0,1.0969765115002945,0.9754171287841883,1.170500554541026,3.4805899106549982,0.27790879749959607,0.27790879749959607,1.170500554541026,0.9754171287841883,0,1,1,2,1.170500554541026,0.9754171287841883
6565,28,86,5,55,50,0,4256.2170000000015,40,1773.704,MORE,62,1470,1532,4,1,-5.0,-0.4687042303372438,5.0,-0.6984302957695783,-0.3195877089069253,1.8767393937864325,105,55,50,1,-1.0969765115002945,-0.9754171287841883,-1.170500554541026,0.5288528839511129,0.6272716417437856,0.6272716417437856,-1.170500554541026,-0.9754171287841883,0,1,1,0,-0.9754171287841883,-1.170500554541026
6566,28,87,30,96,80,1,1661.0929999999996,40,995.649,MORE,322,540,862,3,2,-16.0,-1.4998535370791803,16.0,1.222253017596762,-0.3195877089069253,-0.6554648528202839,176,96,80,1,0.3191204397091766,0.6242669624218805,0.0,-0.20908137272485844,1.1879774411480404,1.1879774411480404,0.0,0.6242669624218805,0,1,1,1,0.6242669624218805,0.0
6567,28,88,33,80,75,1,2058.237,40,1796.838,MORE,630,650,1280,3,2,-5.0,-0.4687042303372438,5.0,-0.6984302957695783,-0.3195877089069253,-0.26794975785203656,155,80,75,1,-0.09972513740911768,0.0,-0.19508342575683765,-0.20908137272485844,1.8521981573653883,1.8521981573653883,-0.19508342575683765,0.0,0,1,1,1,0.0,-0.19508342575683765
6568,28,89,48,110,128,0,2207.346,20,2575.88,MORE,-1316,2296,980,5,1,18.0,1.6873352292140782,18.0,1.571468165481551,-1.808928488279005,-0.12245596140636365,238,110,128,0,1.5557121435822359,1.170500554541026,1.8728008872656416,1.266787140627084,-2.3444690950987646,2.3444690950987646,1.8728008872656416,1.170500554541026,0,1,0,2,1.8728008872656416,1.170500554541026
6569,28,90,9,59,50,0,2443.773,60,1301.724,MORE,-356,1184,828,4,1,-9.0,-0.8436676146070391,9.0,0.0,1.1697530704651546,0.10823877742402983,109,59,50,1,-1.0171964015730004,-0.8193503881787182,-1.170500554541026,0.5288528839511129,-0.274170758836901,0.274170758836901,-1.170500554541026,-0.8193503881787182,1,1,0,0,-0.8193503881787182,-1.170500554541026
6570,28,91,44,110,119,1,4032.071,60,1654.177,MORE,122,1690,1812,6,2,9.0,0.8436676146070391,9.0,0.0,1.1697530704651546,1.6580278975111435,229,110,119,0,1.376206896245824,1.170500554541026,1.5216507209033339,2.0047213973030553,0.7566652877601521,0.7566652877601521,1.5216507209033339,1.170500554541026,1,1,1,2,1.5216507209033339,1.170500554541026
6571,28,92,2,52,50,0,5208.3409999999985,30,2054.608,MORE,-344,2176,1832,7,1,-2.0,-0.18748169213489754,2.0,-1.222253017596762,-1.0642580985929653,2.8057787907848666,102,52,50,1,-1.156811593945765,-1.092467184238291,-1.170500554541026,2.7426556539790266,-0.24829202963362768,0.24829202963362768,-1.170500554541026,-1.092467184238291,0,1,0,0,-1.092467184238291,-1.170500554541026
6572,28,93,8,58,50,0,5404.922,60,2644.857,MORE,774,1640,2414,3,1,-8.0,-0.7499267685395902,8.0,-0.17460757394239454,1.1697530704651546,2.9975936108097274,108,58,50,1,-1.0371414290548238,-0.8583670733300858,-1.170500554541026,-0.20908137272485844,2.162742907804668,2.162742907804668,-1.170500554541026,-0.8583670733300858,1,1,1,0,-0.8583670733300858,-1.170500554541026
6573,28,94,44,119,110,0,2616.782,60,2361.83,MORE,-374,1314,940,3,1,-9.0,-0.8436676146070391,9.0,0.0,1.1697530704651546,0.2770531094178695,229,119,110,1,1.376206896245824,1.5216507209033339,1.170500554541026,-0.20908137272485844,-0.3129888526418109,0.3129888526418109,1.170500554541026,1.5216507209033339,1,1,0,2,1.5216507209033339,1.170500554541026
6574,28,95,34,74,80,1,3760.149,30,1409.537,MORE,-100,1740,1640,5,2,6.0,0.5624450764046927,6.0,-0.5238227218271837,-1.0642580985929653,1.3926987482505335,154,74,80,0,-0.11967016489094122,-0.2341001109082052,0.0,1.266787140627084,0.27790879749959607,0.27790879749959607,0.0,-0.2341001109082052,0,1,1,1,-0.2341001109082052,0.0
6575,28,96,24,86,80,1,3205.041,60,868.5039999999998,MORE,-102,1290,1188,5,2,-6.0,-0.5624450764046927,6.0,-0.5238227218271837,1.1697530704651546,0.8510495496282869,166,86,80,1,0.11967016489094122,0.2341001109082052,0.0,1.266787140627084,0.27359567596571716,0.27359567596571716,0.0,0.2341001109082052,1,1,1,1,0.2341001109082052,0.0
6576,28,97,39,66,80,1,4463.401,60,1270.583,MORE,212,1716,1928,7,2,14.0,1.3123718449442827,14.0,0.8730378697119728,1.1697530704651546,2.0789001401048983,146,66,80,0,-0.2792303847455295,-0.5462335921191455,0.0,2.7426556539790266,0.9507557567847018,0.9507557567847018,0.0,-0.5462335921191455,1,1,1,1,-0.5462335921191455,0.0
6577,28,98,9,50,59,1,1761.095,40,1461.78,MORE,-156,858,702,3,2,9.0,0.8436676146070391,9.0,0.0,-0.3195877089069253,-0.5578874387664023,109,50,59,0,-1.0171964015730004,-1.170500554541026,-0.8193503881787182,-0.20908137272485844,0.15714139455098733,0.15714139455098733,-0.8193503881787182,-1.170500554541026,0,1,0,0,-1.170500554541026,-0.8193503881787182
6578,28,99,57,94,110,1,2115.848,60,1828.437,MORE,100,836,936,3,2,16.0,1.4998535370791803,16.0,1.222253017596762,1.1697530704651546,-0.21173555812544964,204,94,110,0,0.8775812092002355,0.5462335921191455,1.170500554541026,-0.20908137272485844,0.7092209508874844,0.7092209508874844,1.170500554541026,0.5462335921191455,1,1,1,2,1.170500554541026,0.5462335921191455
6579,28,100,60,110,87,0,1370.259,60,1640.996,MORE,-390,864,474,2,1,-23.0,-2.1560394595513217,23.0,2.444506035193524,1.1697530704651546,-0.939247473557334,197,110,87,1,0.7379660168274708,1.170500554541026,0.27311679605957273,-0.9470156294008297,-0.347493824912842,0.347493824912842,0.27311679605957273,1.170500554541026,1,0,0,2,1.170500554541026,0.27311679605957273
6580,28,101,33,75,80,1,1849.079,60,1582.665,MORE,264,686,950,3,2,5.0,0.4687042303372438,5.0,-0.6984302957695783,1.1697530704651546,-0.4720366438011348,155,75,80,0,-0.09972513740911768,-0.19508342575683765,0.0,-0.20908137272485844,1.0628969166655529,1.0628969166655529,0.0,-0.19508342575683765,1,0,1,1,-0.19508342575683765,0.0
6581,28,102,15,50,45,0,1562.185,60,1387.62,MORE,-786,1174,388,2,1,-5.0,-0.4687042303372438,5.0,-0.6984302957695783,1.1697530704651546,-0.7519747913139267,95,50,45,1,-1.2964267863185297,-1.170500554541026,-1.3655839802978638,-0.9470156294008297,-1.2014918886208608,1.2014918886208608,-1.3655839802978638,-1.170500554541026,1,0,0,0,-1.170500554541026,-1.3655839802978638
6582,28,103,59,89,110,1,1564.402,60,997.968,MORE,82,732,814,3,2,21.0,1.9685577674164243,21.0,2.0952908873087353,1.1697530704651546,-0.7498115433093122,199,89,110,0,0.7778560717911179,0.3511501663623078,1.170500554541026,-0.20908137272485844,0.6704028570825744,0.6704028570825744,1.170500554541026,0.3511501663623078,1,0,1,2,1.170500554541026,0.3511501663623078
6583,28,104,29,80,94,1,2548.512,60,1809.345,MORE,228,1040,1268,3,2,14.0,1.3123718449442827,14.0,0.8730378697119728,1.1697530704651546,0.21043834113865031,174,80,94,0,0.2792303847455295,0.0,0.5462335921191455,-0.20908137272485844,0.9852607290557329,0.9852607290557329,0.5462335921191455,0.0,1,0,1,1,0.5462335921191455,0.0
6584,28,105,55,110,98,0,2215.732,40,1739.494,MORE,-386,1074,688,5,1,-12.0,-1.124890152809385,12.0,0.5238227218271837,-0.3195877089069253,-0.11427328311737098,208,110,98,1,0.9573613191275298,1.170500554541026,0.7023003327246156,1.266787140627084,-0.33886758184508425,0.33886758184508425,0.7023003327246156,1.170500554541026,0,1,0,2,1.170500554541026,0.7023003327246156
6585,28,106,29,94,80,0,1978.714,60,1869.662,MORE,-926,1356,430,2,1,-14.0,-1.3123718449442827,14.0,0.8730378697119728,1.1697530704651546,-0.3455446929314031,174,94,80,1,0.2792303847455295,0.5462335921191455,0.0,-0.9470156294008297,-1.5034103959923826,1.5034103959923826,0.0,0.5462335921191455,1,0,0,1,0.5462335921191455,0.0
6586,28,107,57,110,94,0,1413.678,60,2162.103,MORE,-740,1152,412,2,1,-16.0,-1.4998535370791803,16.0,1.222253017596762,1.1697530704651546,-0.8968811834750808,204,110,94,1,0.8775812092002355,1.170500554541026,0.5462335921191455,-0.9470156294008297,-1.1022900933416466,1.1022900933416466,0.5462335921191455,1.170500554541026,1,0,0,2,1.170500554541026,0.5462335921191455
6587,28,108,39,80,66,0,1406.06,60,1232.107,MORE,-448,822,374,2,1,-14.0,-1.3123718449442827,14.0,0.8730378697119728,1.1697530704651546,-0.9043144822117308,146,80,66,1,-0.2792303847455295,0.0,-0.5462335921191455,-0.9470156294008297,-0.4725743493953296,0.4725743493953296,-0.5462335921191455,0.0,1,0,0,1,0.0,-0.5462335921191455
6588,28,109,4,50,54,0,1984.556,60,1392.078,MORE,-272,1052,780,4,1,4.0,0.3749633842697951,4.0,-0.8730378697119728,1.1697530704651546,-0.3398443344095457,104,50,54,0,-1.116921538982118,-1.170500554541026,-1.0144338139355558,0.5288528839511129,-0.09301965441398789,0.09301965441398789,-1.0144338139355558,-1.170500554541026,1,1,0,0,-1.170500554541026,-1.0144338139355558
6589,28,110,55,98,110,0,1729.361,60,2657.47,MORE,-886,1326,440,2,1,12.0,1.124890152809385,12.0,0.5238227218271837,1.1697530704651546,-0.5888520360503152,208,98,110,0,0.9573613191275298,0.7023003327246156,1.170500554541026,-0.9470156294008297,-1.417147965314805,1.417147965314805,1.170500554541026,0.7023003327246156,1,0,0,2,1.170500554541026,0.7023003327246156
6590,28,111,2,50,52,1,1893.587,60,1515.056,MORE,208,800,1008,3,2,2.0,0.18748169213489754,2.0,-1.222253017596762,1.1697530704651546,-0.4286077569317706,102,50,52,0,-1.156811593945765,-1.170500554541026,-1.092467184238291,-0.20908137272485844,0.9421295137169441,0.9421295137169441,-1.092467184238291,-1.170500554541026,1,0,1,0,-1.170500554541026,-1.092467184238291
6591,28,112,59,110,89,0,1659.555,60,2153.562,MORE,-698,1112,414,2,1,-21.0,-1.9685577674164243,21.0,2.0952908873087353,1.1697530704651546,-0.65696556343422,199,110,89,1,0.7778560717911179,1.170500554541026,0.3511501663623078,-0.9470156294008297,-1.01171454113019,1.01171454113019,0.3511501663623078,1.170500554541026,1,0,0,2,1.170500554541026,0.3511501663623078
6592,28,113,60,87,110,1,1861.601,60,1702.036,MORE,214,780,994,3,2,23.0,2.1560394595513217,23.0,2.444506035193524,1.1697530704651546,-0.45981824438129604,197,87,110,0,0.7379660168274708,0.27311679605957273,1.170500554541026,-0.20908137272485844,0.9550688783185807,0.9550688783185807,1.170500554541026,0.27311679605957273,1,0,1,2,1.170500554541026,0.27311679605957273
6593,28,114,52,110,105,0,2189.725,60,1648.918,MORE,-762,1262,500,2,1,-5.0,-0.4687042303372438,5.0,-0.6984302957695783,1.1697530704651546,-0.13964973366135308,215,110,105,1,1.0969765115002945,1.170500554541026,0.9754171287841883,-0.9470156294008297,-1.1497344302143142,1.1497344302143142,0.9754171287841883,1.170500554541026,1,0,0,2,1.170500554541026,0.9754171287841883
6594,28,115,30,80,96,1,1472.016,60,1619.519,MORE,236,904,1140,2,2,16.0,1.4998535370791803,16.0,1.222253017596762,1.1697530704651546,-0.8399576101357944,176,80,96,0,0.3191204397091766,0.0,0.6242669624218805,-0.9470156294008297,1.0025132151912484,1.0025132151912484,0.6242669624218805,0.0,1,0,1,1,0.6242669624218805,0.0
6595,28,116,24,80,86,0,2468.265,50,1859.87,MORE,-544,1252,708,1,1,6.0,0.5624450764046927,6.0,-0.5238227218271837,0.42508268077911465,0.13213695971046047,166,80,86,0,0.11967016489094122,0.0,0.2341001109082052,-1.684949886076801,-0.679604183021516,0.679604183021516,0.2341001109082052,0.0,1,0,0,1,0.2341001109082052,0.0
6596,28,117,5,50,55,1,1835.74,50,2334.708,MORE,-38,776,738,4,2,5.0,0.4687042303372438,5.0,-0.6984302957695783,0.42508268077911465,-0.485052234749963,105,50,55,0,-1.0969765115002945,-1.170500554541026,-0.9754171287841883,0.5288528839511129,0.4116155650498414,0.4116155650498414,-0.9754171287841883,-1.170500554541026,1,1,1,0,-1.170500554541026,-0.9754171287841883
6597,28,118,34,80,74,1,2070.189,50,1621.638,MORE,324,706,1030,3,2,-6.0,-0.5624450764046927,6.0,-0.5238227218271837,0.42508268077911465,-0.25628753856870257,154,80,74,1,-0.11967016489094122,0.0,-0.2341001109082052,-0.20908137272485844,1.1922905626819194,1.1922905626819194,-0.2341001109082052,0.0,0,0,1,1,0.0,-0.2341001109082052
6598,28,119,15,45,50,1,1764.396,30,2160.585,MORE,124,722,846,3,2,5.0,0.4687042303372438,5.0,-0.6984302957695783,-1.0642580985929653,-0.5546664727478041,95,45,50,0,-1.2964267863185297,-1.3655839802978638,-1.170500554541026,-0.20908137272485844,0.7609784092940309,0.7609784092940309,-1.170500554541026,-1.3655839802978638,0,0,1,0,-1.3655839802978638,-1.170500554541026
6599,28,120,37,69,80,1,2566.94,40,2897.783,MORE,-590,1390,800,4,1,11.0,1.0311493067419364,11.0,0.34921514788478913,-0.3195877089069253,0.2284195473763747,149,69,80,0,-0.21939530230005888,-0.4291835366650429,0.0,0.5288528839511129,-0.7788059783007303,0.7788059783007303,0.0,-0.4291835366650429,0,1,0,1,-0.4291835366650429,0.0
6600,28,121,48,128,110,1,6297.531999999998,40,1283.797,LESS,-256,1740,1484,9,2,-18.0,-1.6873352292140782,18.0,1.571468165481551,-0.3195877089069253,3.868561947029352,238,128,110,0,1.5557121435822359,1.8728008872656416,1.170500554541026,4.218524167330969,-0.05851468214295683,0.05851468214295683,1.170500554541026,1.8728008872656416,1,1,1,2,1.8728008872656416,1.170500554541026
6601,28,122,8,50,58,0,1401.089,40,1679.2420000000004,LESS,-672,1030,358,2,1,8.0,0.7499267685395902,8.0,-0.17460757394239454,-0.3195877089069253,-0.9091649584548246,108,50,58,1,-1.0371414290548238,-1.170500554541026,-0.8583670733300858,-0.9470156294008297,-0.9556439611897645,0.9556439611897645,-0.8583670733300858,-1.170500554541026,1,0,0,0,-1.170500554541026,-0.8583670733300858
6602,28,123,4,54,50,1,2104.552,50,2421.526,LESS,34,890,924,3,1,-4.0,-0.3749633842697951,4.0,-0.8730378697119728,0.42508268077911465,-0.22275768237449087,104,54,50,0,-1.116921538982118,-1.0144338139355558,-1.170500554541026,-0.20908137272485844,0.5668879402694812,0.5668879402694812,-1.170500554541026,-1.0144338139355558,1,1,1,0,-1.0144338139355558,-1.170500554541026
6603,28,124,37,80,69,1,2359.182,30,1638.789,LESS,-420,1258,838,2,1,-11.0,-1.0311493067419364,11.0,0.34921514788478913,-1.0642580985929653,0.025698717902901173,149,80,69,0,-0.21939530230005888,0.0,-0.4291835366650429,-0.9470156294008297,-0.4121906479210252,0.4121906479210252,-0.4291835366650429,0.0,0,0,0,1,0.0,-0.4291835366650429
6604,28,125,52,105,110,1,3290.019,40,1502.1229999999996,LESS,162,1218,1380,4,2,5.0,0.4687042303372438,5.0,-0.6984302957695783,-0.3195877089069253,0.9339672261894626,215,105,110,1,1.0969765115002945,0.9754171287841883,1.170500554541026,0.5288528839511129,0.8429277184377297,0.8429277184377297,1.170500554541026,0.9754171287841883,1,1,1,2,1.170500554541026,0.9754171287841883
6605,28,126,5,55,50,1,1893.093,20,936.468,LESS,-14,826,812,3,1,-5.0,-0.4687042303372438,5.0,-0.6984302957695783,-1.808928488279005,-0.429089779716741,105,55,50,0,-1.0969765115002945,-0.9754171287841883,-1.170500554541026,-0.20908137272485844,0.46337302345638803,0.46337302345638803,-1.170500554541026,-0.9754171287841883,0,1,1,0,-0.9754171287841883,-1.170500554541026
6606,28,127,30,96,80,1,2076.873,30,1467.062,LESS,426,758,1184,3,2,-16.0,-1.4998535370791803,16.0,1.222253017596762,-1.0642580985929653,-0.2497655946522193,176,96,80,0,0.3191204397091766,0.6242669624218805,0.0,-0.20908137272485844,1.4122597609097423,1.4122597609097423,0.0,0.6242669624218805,0,1,1,1,0.6242669624218805,0.0
6607,28,128,33,80,75,1,1671.487,30,2222.445,LESS,46,916,962,3,1,-5.0,-0.4687042303372438,5.0,-0.6984302957695783,-1.0642580985929653,-0.6453228592433947,155,80,75,0,-0.09972513740911768,0.0,-0.19508342575683765,-0.20908137272485844,0.5927666694727545,0.5927666694727545,-0.19508342575683765,0.0,0,1,1,1,0.0,-0.19508342575683765
6608,28,129,48,110,128,0,1379.1629999999998,30,1290.153,LESS,-1140,1508,368,2,1,18.0,1.6873352292140782,18.0,1.571468165481551,-1.0642580985929653,-0.9305593543723604,238,110,128,1,1.5557121435822359,1.170500554541026,1.8728008872656416,-0.9470156294008297,-1.9649144001174232,1.9649144001174232,1.8728008872656416,1.170500554541026,0,0,0,2,1.8728008872656416,1.170500554541026
6609,28,130,9,59,50,0,1890.568,40,2576.768,LESS,-530,1176,646,2,2,-9.0,-0.8436676146070391,9.0,0.0,-0.3195877089069253,-0.431553560145993,109,59,50,0,-1.0171964015730004,-0.8193503881787182,-1.170500554541026,-0.9470156294008297,-0.6494123322843638,0.6494123322843638,-1.170500554541026,-0.8193503881787182,1,0,0,0,-0.8193503881787182,-1.170500554541026
6610,28,131,44,110,119,1,1916.058,30,1317.807,LESS,388,722,1110,3,2,9.0,0.8436676146070391,9.0,0.0,-1.0642580985929653,-0.4066815747433667,229,110,119,1,1.376206896245824,1.170500554541026,1.5216507209033339,-0.20908137272485844,1.3303104517660436,1.3303104517660436,1.5216507209033339,1.170500554541026,0,0,1,2,1.5216507209033339,1.170500554541026
6611,28,132,2,52,50,0,1265.762,40,1152.652,LESS,-440,846,406,2,1,-2.0,-0.18748169213489754,2.0,-1.222253017596762,-0.3195877089069253,-1.0412109046525966,102,52,50,0,-1.156811593945765,-1.092467184238291,-1.170500554541026,-0.9470156294008297,-0.45532186325981405,0.45532186325981405,-1.170500554541026,-1.092467184238291,1,0,0,0,-1.092467184238291,-1.170500554541026
6612,28,133,8,58,50,1,1345.4679999999996,30,1245.626,LESS,172,714,886,2,1,-8.0,-0.7499267685395902,8.0,-0.17460757394239454,-1.0642580985929653,-0.9634374064767738,108,58,50,0,-1.0371414290548238,-0.8583670733300858,-1.170500554541026,-0.9470156294008297,0.8644933261071241,0.8644933261071241,-1.170500554541026,-0.8583670733300858,0,0,1,0,-0.8583670733300858,-1.170500554541026
6613,28,134,44,119,110,1,1792.846,40,1381.5870000000002,LESS,-136,892,756,3,1,-9.0,-0.8436676146070391,9.0,0.0,-0.3195877089069253,-0.5269062536538567,229,119,110,0,1.376206896245824,1.5216507209033339,1.170500554541026,-0.20908137272485844,0.20027260988977616,0.20027260988977616,1.170500554541026,1.5216507209033339,1,0,1,2,1.5216507209033339,1.170500554541026
6614,28,135,34,74,80,0,4371.712,20,1366.908,LESS,-654,2152,1498,7,1,6.0,0.5624450764046927,6.0,-0.5238227218271837,-1.808928488279005,1.989434174252352,154,74,80,1,-0.11967016489094122,-0.2341001109082052,0.0,2.7426556539790266,-0.9168258673848546,0.9168258673848546,0.0,-0.2341001109082052,0,1,0,1,-0.2341001109082052,0.0
6615,28,136,24,86,80,1,1260.809,40,1700.477,LESS,344,354,698,1,2,-6.0,-0.5624450764046927,6.0,-0.5238227218271837,-0.3195877089069253,-1.046043817312432,166,86,80,0,0.11967016489094122,0.2341001109082052,0.0,-1.684949886076801,1.2354217780207082,1.2354217780207082,0.0,0.2341001109082052,1,0,1,1,0.2341001109082052,0.0
6616,28,137,39,66,80,0,2755.008,40,1536.217,LESS,-324,1126,802,3,2,14.0,1.3123718449442827,14.0,0.8730378697119728,-0.3195877089069253,0.41192776827481004,146,66,80,1,-0.2792303847455295,-0.5462335921191455,0.0,-0.20908137272485844,-0.20516081429483884,0.20516081429483884,0.0,-0.5462335921191455,1,0,0,1,-0.5462335921191455,0.0
6617,28,138,9,50,59,0,1298.415,30,1763.3970000000004,LESS,-476,890,414,2,1,9.0,0.8436676146070391,9.0,0.0,-1.0642580985929653,-1.0093495888678985,109,50,59,1,-1.0171964015730004,-1.170500554541026,-0.8193503881787182,-0.9470156294008297,-0.532958050869634,0.532958050869634,-0.8193503881787182,-1.170500554541026,0,0,0,0,-1.170500554541026,-0.8193503881787182
6618,28,139,57,94,110,0,2360.726,30,826.4830000000002,LESS,-798,1548,750,4,1,16.0,1.4998535370791803,16.0,1.222253017596762,-1.0642580985929653,0.027205283044590592,204,94,110,1,0.8775812092002355,0.5462335921191455,1.170500554541026,0.5288528839511129,-1.2273706178241341,1.2273706178241341,1.170500554541026,0.5462335921191455,0,1,0,2,1.170500554541026,0.5462335921191455
6619,28,140,60,110,87,1,3837.262,40,913.723,LESS,318,1024,1342,2,2,-23.0,-2.1560394595513217,23.0,2.444506035193524,-0.3195877089069253,1.4679421146825749,197,110,87,0,0.7379660168274708,1.170500554541026,0.27311679605957273,-0.9470156294008297,1.1793511980802827,1.1793511980802827,0.27311679605957273,1.170500554541026,1,0,1,2,1.170500554541026,0.27311679605957273
6620,28,141,33,75,80,0,1772.3529999999996,30,1423.8770000000004,LESS,-746,1280,534,2,1,5.0,0.4687042303372438,5.0,-0.6984302957695783,-1.0642580985929653,-0.5469023931931283,155,75,80,1,-0.09972513740911768,-0.19508342575683765,0.0,-0.9470156294008297,-1.115229457943283,1.115229457943283,0.0,-0.19508342575683765,0,0,0,1,-0.19508342575683765,0.0
6621,28,142,15,50,45,1,2033.685,30,1662.506,LESS,214,834,1048,3,2,-5.0,-0.4687042303372438,5.0,-0.6984302957695783,-1.0642580985929653,-0.29190648541599434,95,50,45,0,-1.2964267863185297,-1.170500554541026,-1.3655839802978638,-0.20908137272485844,0.9550688783185807,0.9550688783185807,-1.3655839802978638,-1.170500554541026,0,0,1,0,-1.170500554541026,-1.3655839802978638
6622,28,143,59,89,110,0,1944.72,60,1854.842,LESS,-684,1030,346,2,1,21.0,1.9685577674164243,21.0,2.0952908873087353,1.1697530704651546,-0.3787144956688247,199,89,110,1,0.7778560717911179,0.3511501663623078,1.170500554541026,-0.9470156294008297,-0.9815226903930379,0.9815226903930379,1.170500554541026,0.3511501663623078,1,0,0,2,1.170500554541026,0.3511501663623078
6623,28,144,29,80,94,0,2595.402,60,1603.3339999999996,LESS,-472,1330,858,4,1,14.0,1.3123718449442827,14.0,0.8730378697119728,1.1697530704651546,0.2561914755258274,174,80,94,1,0.2792303847455295,0.0,0.5462335921191455,0.5288528839511129,-0.5243318078018762,0.5243318078018762,0.5462335921191455,0.0,1,1,0,1,0.5462335921191455,0.0
6624,28,145,55,110,98,1,3124.884,70,1605.565,LESS,312,1338,1650,6,2,-12.0,-1.124890152809385,12.0,0.5238227218271837,1.9144234601511947,0.7728359861163874,208,110,98,0,0.9573613191275298,1.170500554541026,0.7023003327246156,2.0047213973030553,1.166411833478646,1.166411833478646,0.7023003327246156,1.170500554541026,1,1,1,2,1.170500554541026,0.7023003327246156
6625,28,146,29,94,80,1,1874.184,50,1716.922,LESS,184,824,1008,3,2,-14.0,-1.3123718449442827,14.0,0.8730378697119728,0.42508268077911465,-0.4475403239293053,174,94,80,0,0.2792303847455295,0.5462335921191455,0.0,-0.20908137272485844,0.8903720553103974,0.8903720553103974,0.0,0.5462335921191455,1,0,1,1,0.5462335921191455,0.0
6626,28,147,57,110,94,1,1970.511,60,2105.297,LESS,114,732,846,3,2,-16.0,-1.4998535370791803,16.0,1.222253017596762,1.1697530704651546,-0.35354880812393913,204,110,94,0,0.8775812092002355,1.170500554541026,0.5462335921191455,-0.20908137272485844,0.7394128016246365,0.7394128016246365,0.5462335921191455,1.170500554541026,1,0,1,2,1.170500554541026,0.5462335921191455
6627,28,148,39,80,66,1,1708.575,50,1337.866,LESS,14,710,724,3,2,-14.0,-1.3123718449442827,14.0,0.8730378697119728,0.42508268077911465,-0.6091340716948422,146,80,66,0,-0.2792303847455295,0.0,-0.5462335921191455,-0.20908137272485844,0.5237567249306924,0.5237567249306924,-0.5462335921191455,0.0,1,0,1,1,0.0,-0.5462335921191455
6628,28,149,4,50,54,0,1147.188,60,1639.719,LESS,-418,810,392,2,1,4.0,0.3749633842697951,4.0,-0.8730378697119728,1.1697530704651546,-1.1569100336102665,104,50,54,1,-1.116921538982118,-1.170500554541026,-1.0144338139355558,-0.9470156294008297,-0.40787752638714636,0.40787752638714636,-1.0144338139355558,-1.170500554541026,1,0,0,0,-1.170500554541026,-1.0144338139355558
6629,28,150,55,98,110,0,1963.095,40,1374.175,LESS,-506,1192,686,4,1,12.0,1.124890152809385,12.0,0.5238227218271837,-0.3195877089069253,-0.3607850044262489,208,98,110,1,0.9573613191275298,0.7023003327246156,1.170500554541026,0.5288528839511129,-0.5976548738778172,0.5976548738778172,1.170500554541026,0.7023003327246156,0,1,0,2,1.170500554541026,0.7023003327246156
6630,28,151,2,50,52,0,1404.836,40,2258.436,LESS,-420,1060,640,2,1,2.0,0.18748169213489754,2.0,-1.222253017596762,-0.3195877089069253,-0.9055088058732772,102,50,52,1,-1.156811593945765,-1.170500554541026,-1.092467184238291,-0.9470156294008297,-0.4121906479210252,0.4121906479210252,-1.092467184238291,-1.170500554541026,0,0,0,0,-1.170500554541026,-1.092467184238291
6631,28,152,59,110,89,1,1831.547,60,1458.58,LESS,292,740,1032,3,2,-21.0,-1.9685577674164243,21.0,2.0952908873087353,1.1697530704651546,-0.4891435738944593,199,110,89,0,0.7778560717911179,1.170500554541026,0.3511501663623078,-0.20908137272485844,1.1232806181398571,1.1232806181398571,0.3511501663623078,1.170500554541026,1,0,1,2,1.170500554541026,0.3511501663623078
6632,28,153,60,87,110,0,3129.259,30,1356.669,LESS,-874,1740,866,4,1,23.0,2.1560394595513217,23.0,2.444506035193524,-1.0642580985929653,0.7771049126027149,197,87,110,1,0.7379660168274708,0.27311679605957273,1.170500554541026,0.5288528839511129,-1.3912692361115317,1.3912692361115317,1.170500554541026,0.27311679605957273,0,1,0,2,1.170500554541026,0.27311679605957273
6633,28,154,52,110,105,1,5533.476,40,2265.879,LESS,716,1952,2668,6,2,-5.0,-0.4687042303372438,5.0,-0.6984302957695783,-0.3195877089069253,3.123030770929352,215,110,105,0,1.0969765115002945,1.170500554541026,0.9754171287841883,2.0047213973030553,2.0376623833221803,2.0376623833221803,0.9754171287841883,1.170500554541026,0,1,1,2,1.170500554541026,0.9754171287841883
6634,28,155,30,80,96,0,2495.93,80,418.32,LESS,-200,1298,1098,4,2,16.0,1.4998535370791803,16.0,1.222253017596762,2.6590938498372347,0.15913121142343242,176,80,96,1,0.3191204397091766,0.0,0.6242669624218805,0.5288528839511129,0.0622527208056519,0.0622527208056519,0.6242669624218805,0.0,1,1,1,1,0.6242669624218805,0.0
6635,28,156,24,80,86,0,1847.687,30,1585.25,LESS,-564,1042,478,2,1,6.0,0.5624450764046927,6.0,-0.5238227218271837,-1.0642580985929653,-0.4733948942397561,166,80,86,1,0.11967016489094122,0.0,0.2341001109082052,-0.9470156294008297,-0.7227353983603049,0.7227353983603049,0.2341001109082052,0.0,0,0,0,1,0.2341001109082052,0.0
6636,28,157,5,50,55,0,1486.134,60,1948.906,LESS,238,564,802,2,2,5.0,0.4687042303372438,5.0,-0.6984302957695783,1.1697530704651546,-0.8261819063337436,105,50,55,1,-1.0969765115002945,-1.170500554541026,-0.9754171287841883,-0.9470156294008297,1.0068263367251273,1.0068263367251273,-0.9754171287841883,-1.170500554541026,1,0,1,0,-1.170500554541026,-0.9754171287841883
6637,28,158,34,80,74,1,2800.127,60,1439.183,LESS,-126,830,704,4,1,-6.0,-0.5624450764046927,6.0,-0.5238227218271837,1.1697530704651546,0.4559528412203219,154,80,74,0,-0.11967016489094122,0.0,-0.2341001109082052,0.5288528839511129,0.22183821755917058,0.22183821755917058,-0.2341001109082052,0.0,1,1,1,1,0.0,-0.2341001109082052
6638,28,159,15,45,50,0,1148.0,40,1643.815,LESS,-742,1136,394,2,1,5.0,0.4687042303372438,5.0,-0.6984302957695783,-0.3195877089069253,-1.1561177208544042,95,45,50,1,-1.2964267863185297,-1.3655839802978638,-1.170500554541026,-0.9470156294008297,-1.1066032148755254,1.1066032148755254,-1.170500554541026,-1.3655839802978638,0,0,0,0,-1.3655839802978638,-1.170500554541026
6639,28,160,37,69,80,0,1277.401,60,1393.118,LESS,-380,714,334,1,2,11.0,1.0311493067419364,11.0,0.34921514788478913,1.1697530704651546,-1.0298540965670269,149,69,80,1,-0.21939530230005888,-0.4291835366650429,0.0,-1.684949886076801,-0.32592821724344756,0.32592821724344756,0.0,-0.4291835366650429,1,0,0,1,-0.4291835366650429,0.0
6640,28,161,3,50,53,0,2159.33,40,2155.9210000000007,MORE,72,1230,1302,5,2,3.0,0.28122253820234633,3.0,-1.0476454436543674,-0.3195877089069253,-0.16930779550179348,103,50,53,0,-1.1368665664639415,-1.170500554541026,-1.0534504990869233,1.266787140627084,0.64883724941318,0.64883724941318,-1.0534504990869233,-1.170500554541026,0,1,1,0,-1.170500554541026,-1.0534504990869233
6641,28,162,20,50,40,0,2488.713,40,1703.0510000000004,MORE,-344,1338,994,4,1,-10.0,-0.9374084606744876,10.0,0.17460757394239454,-0.3195877089069253,0.1520891902915868,90,50,40,1,-1.3961519237276474,-1.170500554541026,-1.5606674060547012,0.5288528839511129,-0.24829202963362768,0.24829202963362768,-1.5606674060547012,-1.170500554541026,0,1,0,0,-1.170500554541026,-1.5606674060547012
6642,28,163,25,80,88,1,1611.4720000000002,70,1403.743,MORE,-76,730,654,4,2,8.0,0.7499267685395902,8.0,-0.17460757394239454,1.9144234601511947,-0.7038827730895545,168,80,88,0,0.1595602198545883,0.0,0.31213348121094026,0.5288528839511129,0.3296662559061426,0.3296662559061426,0.31213348121094026,0.0,1,1,1,1,0.31213348121094026,0.0
6643,28,164,42,115,110,0,1414.435,70,669.216,MORE,-604,1004,400,2,1,-5.0,-0.4687042303372438,5.0,-0.6984302957695783,1.9144234601511947,-0.8961425372236181,225,115,110,1,1.2964267863185297,1.3655839802978638,1.170500554541026,-0.9470156294008297,-0.8089978290378825,0.8089978290378825,1.170500554541026,1.3655839802978638,1,0,0,2,1.3655839802978638,1.170500554541026
6644,28,165,53,103,110,1,2200.57,60,1204.977,MORE,-14,998,984,4,2,7.0,0.6561859224721414,7.0,-0.34921514788478913,1.1697530704651546,-0.12906767474838765,213,103,110,0,1.0570864565366473,0.8973837584814532,1.170500554541026,0.5288528839511129,0.46337302345638803,0.46337302345638803,1.170500554541026,0.8973837584814532,1,1,1,2,1.170500554541026,0.8973837584814532
6645,28,166,26,90,80,1,2157.932,40,2873.828,MORE,-614,1326,712,3,2,-10.0,-0.9374084606744876,10.0,0.17460757394239454,-0.3195877089069253,-0.17067190046816755,170,90,80,1,0.19945027481823535,0.3901668515136753,0.0,-0.20908137272485844,-0.830563436707277,0.830563436707277,0.0,0.3901668515136753,0,0,0,1,0.3901668515136753,0.0
6646,28,167,35,80,72,1,1588.725,50,1130.891,MORE,22,744,766,3,2,-8.0,-0.7499267685395902,8.0,-0.17460757394239454,0.42508268077911465,-0.7260782635545818,152,80,72,1,-0.1595602198545883,0.0,-0.31213348121094026,-0.20908137272485844,0.5410092110662079,0.5410092110662079,-0.31213348121094026,0.0,0,0,1,1,0.0,-0.31213348121094026
6647,28,168,28,93,80,0,1140.825,60,1596.126,MORE,-508,842,334,2,1,-13.0,-1.218630998876834,13.0,0.6984302957695783,1.1697530704651546,-1.1631187602919817,173,93,80,1,0.25928535726370594,0.5072169069677779,0.0,-0.9470156294008297,-0.6019679954116961,0.6019679954116961,0.0,0.5072169069677779,1,0,0,1,0.5072169069677779,0.0
6648,28,169,26,80,90,1,1770.784,60,1735.015,MORE,-4,780,776,3,1,10.0,0.9374084606744876,10.0,0.17460757394239454,1.1697530704651546,-0.5484333522004529,170,80,90,0,0.19945027481823535,0.0,0.3901668515136753,-0.20908137272485844,0.48493863112578245,0.48493863112578245,0.3901668515136753,0.0,1,0,1,1,0.3901668515136753,0.0
6649,28,170,25,88,80,0,1158.955,60,2544.991,MORE,-708,1074,366,2,1,-8.0,-0.7499267685395902,8.0,-0.17460757394239454,1.1697530704651546,-1.14542832893264,168,88,80,1,0.1595602198545883,0.31213348121094026,0.0,-0.9470156294008297,-1.0332801487995844,1.0332801487995844,0.0,0.31213348121094026,1,0,0,1,0.31213348121094026,0.0
6650,28,171,36,80,70,0,1323.297,60,2837.073,MORE,-970,1326,356,2,1,-10.0,-0.9374084606744876,10.0,0.17460757394239454,1.1697530704651546,-0.9850708622775434,150,80,70,1,-0.19945027481823535,0.0,-0.3901668515136753,-0.9470156294008297,-1.5982990697377182,1.5982990697377182,-0.3901668515136753,0.0,1,0,0,1,0.0,-0.3901668515136753
6651,28,172,28,80,93,1,1678.715,70,826.8330000000002,MORE,226,540,766,3,2,13.0,1.218630998876834,13.0,0.6984302957695783,1.9144234601511947,-0.6382701048106689,173,80,93,0,0.25928535726370594,0.0,0.5072169069677779,-0.20908137272485844,0.980947607521854,0.980947607521854,0.5072169069677779,0.0,1,0,1,1,0.5072169069677779,0.0
6652,28,173,21,82,80,0,2269.262,60,1723.568,MORE,-492,1210,718,4,1,-2.0,-0.18748169213489754,2.0,-1.222253017596762,1.1697530704651546,-0.06204113801723012,162,82,80,1,0.03989005496364707,0.07803337030273506,0.0,0.5288528839511129,-0.567463023140665,0.567463023140665,0.0,0.07803337030273506,1,1,0,1,0.07803337030273506,0.0
6653,28,174,19,50,41,0,2093.765,80,891.753,MORE,340,1080,1420,4,2,-9.0,-0.8436676146070391,9.0,0.0,2.6590938498372347,-0.23328314751918044,91,50,41,1,-1.376206896245824,-1.170500554541026,-1.5216507209033339,0.5288528839511129,1.2267955349529502,1.2267955349529502,-1.5216507209033339,-1.170500554541026,1,1,1,0,-1.170500554541026,-1.5216507209033339
6654,28,175,56,96,110,1,2250.652,60,1254.562,MORE,196,912,1108,2,2,14.0,1.3123718449442827,14.0,0.8730378697119728,1.1697530704651546,-0.08019993159678597,206,96,110,0,0.9174712641638826,0.6242669624218805,1.170500554541026,-0.9470156294008297,0.9162507845136707,0.9162507845136707,1.170500554541026,0.6242669624218805,1,0,1,2,1.170500554541026,0.6242669624218805
6655,28,176,23,80,85,1,2292.908,40,1555.524,MORE,158,908,1066,2,1,5.0,0.4687042303372438,5.0,-0.6984302957695783,-0.3195877089069253,-0.03896844414392708,165,80,85,0,0.09972513740911768,0.0,0.19508342575683765,-0.9470156294008297,0.834301475369972,0.834301475369972,0.19508342575683765,0.0,0,0,1,1,0.19508342575683765,0.0
6656,28,177,10,60,50,1,2159.21,40,1757.269,MORE,448,862,1310,3,2,-10.0,-0.9374084606744876,10.0,0.17460757394239454,-0.3195877089069253,-0.1694248860568469,110,60,50,1,-0.9972513740911768,-0.7803337030273506,-1.170500554541026,-0.20908137272485844,1.45970409778241,1.45970409778241,-1.170500554541026,-0.7803337030273506,0,0,1,0,-0.7803337030273506,-1.170500554541026
6657,28,178,19,41,50,1,1787.445,50,1745.374,MORE,288,706,994,3,2,9.0,0.8436676146070391,9.0,0.0,0.42508268077911465,-0.5321763043858923,91,41,50,0,-1.376206896245824,-1.5216507209033339,-1.170500554541026,-0.20908137272485844,1.1146543750720994,1.1146543750720994,-1.170500554541026,-1.5216507209033339,0,0,1,0,-1.5216507209033339,-1.170500554541026
6658,28,179,56,110,96,0,1305.127,30,1923.41,MORE,-522,952,430,2,1,-14.0,-1.3123718449442827,14.0,0.8730378697119728,-1.0642580985929653,-1.0028003238219028,206,110,96,1,0.9174712641638826,1.170500554541026,0.6242669624218805,-0.9470156294008297,-0.6321598461488482,0.6321598461488482,0.6242669624218805,1.170500554541026,0,0,0,2,1.170500554541026,0.6242669624218805
6659,28,180,35,72,80,1,1742.888,40,1559.204,MORE,-4,886,882,3,1,8.0,0.7499267685395902,8.0,-0.17460757394239454,-0.3195877089069253,-0.5756530032319033,152,72,80,0,-0.1595602198545883,-0.31213348121094026,0.0,-0.20908137272485844,0.48493863112578245,0.48493863112578245,0.0,-0.31213348121094026,0,0,1,1,-0.31213348121094026,0.0
6660,28,181,11,49,50,1,1798.86,50,1605.6429999999998,MORE,-58,756,698,3,2,1.0,0.09374084606744876,1.0,-1.3968605915391563,0.42508268077911465,-0.5210380653364227,99,49,50,0,-1.2166466763912356,-1.2095172396923934,-1.170500554541026,-0.20908137272485844,0.3684843497110526,0.3684843497110526,-1.170500554541026,-1.2095172396923934,1,0,1,0,-1.2095172396923934,-1.170500554541026
6661,28,182,17,43,50,1,1404.8670000000004,50,1521.2120000000002,MORE,120,624,744,3,2,7.0,0.6561859224721414,7.0,-0.34921514788478913,0.42508268077911465,-0.905478557479888,93,43,50,0,-1.3363168412821769,-1.4436173506005987,-1.170500554541026,-0.20908137272485844,0.7523521662262732,0.7523521662262732,-1.170500554541026,-1.4436173506005987,0,0,1,0,-1.4436173506005987,-1.170500554541026
6662,28,183,1,51,50,1,3310.125,50,2198.408,MORE,-252,1564,1312,4,1,-1.0,-0.09374084606744876,1.0,-1.3968605915391563,0.42508268077911465,0.9535857486886862,101,51,50,1,-1.1767566214275886,-1.1314838693896585,-1.170500554541026,0.5288528839511129,-0.04988843907519906,0.04988843907519906,-1.170500554541026,-1.1314838693896585,1,1,0,0,-1.1314838693896585,-1.170500554541026
6663,28,184,41,112,110,0,2951.5290000000005,40,2708.357,MORE,-350,1724,1374,4,2,-2.0,-0.18748169213489754,2.0,-1.222253017596762,-0.3195877089069253,0.6036840430221437,222,112,110,1,1.2365917038730592,1.248533924843761,1.170500554541026,0.5288528839511129,-0.2612313942352643,0.2612313942352643,1.170500554541026,1.248533924843761,0,1,0,2,1.248533924843761,1.170500554541026
6664,28,185,20,40,50,1,2557.18,40,1716.9489999999996,MORE,722,800,1522,3,2,10.0,0.9374084606744876,10.0,0.17460757394239454,-0.3195877089069253,0.21889618223201854,90,40,50,0,-1.3961519237276474,-1.5606674060547012,-1.170500554541026,-0.20908137272485844,2.050601747923817,2.050601747923817,-1.170500554541026,-1.5606674060547012,0,0,1,0,-1.5606674060547012,-1.170500554541026
6665,28,186,1,50,51,1,1978.016,50,2263.453,MORE,16,914,930,2,2,1.0,0.09374084606744876,1.0,-1.3968605915391563,0.42508268077911465,-0.3462257696599645,101,50,51,0,-1.1767566214275886,-1.170500554541026,-1.1314838693896585,-0.9470156294008297,0.5280698464645712,0.5280698464645712,-1.1314838693896585,-1.170500554541026,0,0,1,0,-1.170500554541026,-1.1314838693896585
6666,28,187,23,85,80,1,2645.023,50,1639.3529999999996,MORE,-158,1070,912,3,1,-5.0,-0.4687042303372438,5.0,-0.6984302957695783,0.42508268077911465,0.3046093957950985,165,85,80,1,0.09972513740911768,0.19508342575683765,0.0,-0.20908137272485844,0.15282827301710844,0.15282827301710844,0.0,0.19508342575683765,0,0,0,1,0.19508342575683765,0.0
6667,28,188,11,50,49,1,1501.464,40,1491.174,MORE,174,610,784,3,2,-1.0,-0.09374084606744876,1.0,-1.3968605915391563,-0.3195877089069253,-0.8112235879256517,99,50,49,1,-1.2166466763912356,-1.170500554541026,-1.2095172396923934,-0.20908137272485844,0.868806447641003,0.868806447641003,-1.2095172396923934,-1.170500554541026,0,0,1,0,-1.170500554541026,-1.2095172396923934
6668,28,189,17,50,43,0,1488.466,40,1823.809,MORE,-1228,1614,386,2,1,-7.0,-0.6561859224721414,7.0,-0.34921514788478913,-0.3195877089069253,-0.8239064465472029,93,50,43,1,-1.3363168412821769,-1.170500554541026,-1.4436173506005987,-0.9470156294008297,-2.1546917476080942,2.1546917476080942,-1.4436173506005987,-1.170500554541026,0,0,0,0,-1.170500554541026,-1.4436173506005987
6669,28,190,21,80,82,1,1986.598,30,1299.484,MORE,180,1012,1192,3,2,2.0,0.18748169213489754,2.0,-1.222253017596762,-1.0642580985929653,-0.3378518434643845,162,80,82,0,0.03989005496364707,0.0,0.07803337030273506,-0.20908137272485844,0.8817458122426397,0.8817458122426397,0.07803337030273506,0.0,0,0,1,1,0.07803337030273506,0.0
6670,28,191,10,50,60,1,1781.49,50,2017.903,MORE,-320,1158,838,4,1,10.0,0.9374084606744876,10.0,0.17460757394239454,0.42508268077911465,-0.5379869231804251,110,50,60,0,-0.9972513740911768,-1.170500554541026,-0.7803337030273506,0.5288528839511129,-0.1965345712270811,0.1965345712270811,-0.7803337030273506,-1.170500554541026,1,1,0,0,-1.170500554541026,-0.7803337030273506
6671,28,192,3,53,50,0,2184.128,40,1755.743,MORE,-788,1382,594,3,1,-3.0,-0.28122253820234633,3.0,-1.0476454436543674,-0.3195877089069253,-0.1451110322999758,103,53,50,1,-1.1368665664639415,-1.0534504990869233,-1.170500554541026,-0.20908137272485844,-1.2058050101547397,1.2058050101547397,-1.170500554541026,-1.0534504990869233,0,0,0,0,-1.0534504990869233,-1.170500554541026
6672,28,193,45,122,110,0,1408.63,60,1616.333,MORE,-358,786,428,2,1,-12.0,-1.124890152809385,12.0,0.5238227218271837,1.1697530704651546,-0.9018067928243338,232,122,110,1,1.4360419786912946,1.6387007763574364,1.170500554541026,-0.9470156294008297,-0.27848388037077987,0.27848388037077987,1.170500554541026,1.6387007763574364,1,0,0,2,1.6387007763574364,1.170500554541026
6673,28,194,38,67,80,1,1646.805,30,2512.201,MORE,-564,1470,906,3,1,13.0,1.218630998876834,13.0,0.6984302957695783,-1.0642580985929653,-0.6694064349086604,147,67,80,0,-0.25928535726370594,-0.5072169069677779,0.0,-0.20908137272485844,-0.7227353983603049,0.7227353983603049,0.0,-0.5072169069677779,0,0,0,1,-0.5072169069677779,0.0
6674,28,195,38,80,67,0,2586.648,50,1762.299,MORE,-1110,1880,770,4,1,-13.0,-1.218630998876834,13.0,0.6984302957695783,0.42508268077911465,0.2476497195346705,147,80,67,1,-0.25928535726370594,0.0,-0.5072169069677779,0.5288528839511129,-1.90021757710924,1.90021757710924,-0.5072169069677779,0.0,1,1,0,1,0.0,-0.5072169069677779
6675,28,196,36,70,80,1,2204.263,60,2261.313,MORE,216,874,1090,2,1,10.0,0.9374084606744876,10.0,0.17460757394239454,1.1697530704651546,-0.1254642129166147,150,70,80,0,-0.19945027481823535,-0.3901668515136753,0.0,-0.9470156294008297,0.9593819998524595,0.9593819998524595,0.0,-0.3901668515136753,1,0,1,1,-0.3901668515136753,0.0
6676,28,197,45,110,122,0,2057.507,40,1822.36,MORE,-908,1608,700,1,1,12.0,1.124890152809385,12.0,0.5238227218271837,-0.3195877089069253,-0.2686620587286124,232,110,122,0,1.4360419786912946,1.170500554541026,1.6387007763574364,-1.684949886076801,-1.4645923021874727,1.4645923021874727,1.6387007763574364,1.170500554541026,0,0,0,2,1.6387007763574364,1.170500554541026
6677,28,198,42,110,115,1,1726.428,40,1205.561,MORE,298,706,1004,3,2,5.0,0.4687042303372438,5.0,-0.6984302957695783,-0.3195877089069253,-0.5917139243667493,225,110,115,0,1.2964267863185297,1.170500554541026,1.3655839802978638,-0.20908137272485844,1.1362199827414938,1.1362199827414938,1.3655839802978638,1.170500554541026,0,0,1,2,1.3655839802978638,1.170500554541026
6678,28,199,41,110,112,1,1897.421,50,1855.817,MORE,236,772,1008,3,2,2.0,0.18748169213489754,2.0,-1.222253017596762,0.42508268077911465,-0.42486671369780943,222,110,112,0,1.2365917038730592,1.170500554541026,1.248533924843761,-0.20908137272485844,1.0025132151912484,1.0025132151912484,1.248533924843761,1.170500554541026,0,0,1,2,1.248533924843761,1.170500554541026
6679,28,200,53,110,103,0,2529.854,30,1644.753,MORE,-364,1368,1004,4,1,-7.0,-0.6561859224721414,7.0,-0.34921514788478913,-1.0642580985929653,0.1922327113370728,213,110,103,1,1.0570864565366473,1.170500554541026,0.8973837584814532,0.5288528839511129,-0.2914232449724165,0.2914232449724165,0.8973837584814532,1.170500554541026,0,1,0,2,1.170500554541026,0.8973837584814532
6680,28,201,3,50,53,0,2797.915,30,1379.286,LESS,-886,1600,714,4,1,3.0,0.28122253820234633,3.0,-1.0476454436543674,-1.0642580985929653,0.4537944719888347,103,50,53,1,-1.1368665664639415,-1.170500554541026,-1.0534504990869233,0.5288528839511129,-1.417147965314805,1.417147965314805,-1.0534504990869233,-1.170500554541026,0,1,0,0,-1.170500554541026,-1.0534504990869233
6681,28,202,20,50,40,1,1747.437,50,1348.484,LESS,176,806,982,3,1,-10.0,-0.9374084606744876,10.0,0.17460757394239454,0.42508268077911465,-0.5712142954407481,90,50,40,0,-1.3961519237276474,-1.170500554541026,-1.5606674060547012,-0.20908137272485844,0.8731195691748819,0.8731195691748819,-1.5606674060547012,-1.170500554541026,1,0,1,0,-1.170500554541026,-1.5606674060547012
6682,28,203,25,80,88,0,1347.686,50,1237.307,LESS,-354,892,538,3,2,8.0,0.7499267685395902,8.0,-0.17460757394239454,0.42508268077911465,-0.9612731827175336,168,80,88,1,0.1595602198545883,0.0,0.31213348121094026,-0.20908137272485844,-0.2698576373030221,0.2698576373030221,0.31213348121094026,0.0,1,0,0,1,0.31213348121094026,0.0
6683,28,204,42,115,110,0,1417.795,40,1503.591,LESS,-746,1090,344,2,1,-5.0,-0.4687042303372438,5.0,-0.6984302957695783,-0.3195877089069253,-0.8928640016821184,225,115,110,0,1.2964267863185297,1.3655839802978638,1.170500554541026,-0.9470156294008297,-1.115229457943283,1.115229457943283,1.170500554541026,1.3655839802978638,0,0,0,2,1.3655839802978638,1.170500554541026
6684,28,205,53,103,110,0,2121.8160000000007,40,1433.671,LESS,-434,1184,750,4,1,7.0,0.6561859224721414,7.0,-0.34921514788478913,-0.3195877089069253,-0.20591225452078532,213,103,110,1,1.0570864565366473,0.8973837584814532,1.170500554541026,0.5288528839511129,-0.4423824986581774,0.4423824986581774,1.170500554541026,0.8973837584814532,0,1,0,2,1.170500554541026,0.8973837584814532
6685,28,206,26,90,80,1,2185.408,60,1791.182,LESS,262,834,1096,3,2,-10.0,-0.9374084606744876,10.0,0.17460757394239454,1.1697530704651546,-0.14386206637940474,170,90,80,0,0.19945027481823535,0.3901668515136753,0.0,-0.20908137272485844,1.0585837951316739,1.0585837951316739,0.0,0.3901668515136753,1,0,1,1,0.3901668515136753,0.0
6686,28,207,35,80,72,1,5207.333,60,1724.733,LESS,-12,2408,2396,6,2,-8.0,-0.7499267685395902,8.0,-0.17460757394239454,1.1697530704651546,2.804795230122417,152,80,72,0,-0.1595602198545883,0.0,-0.31213348121094026,2.0047213973030553,0.4676861449902669,0.4676861449902669,-0.31213348121094026,0.0,1,1,1,1,0.0,-0.31213348121094026
6687,28,208,28,93,80,1,2165.593,20,1982.195,LESS,-280,1458,1178,3,1,-13.0,-1.218630998876834,13.0,0.6984302957695783,-1.808928488279005,-0.16319664428262334,173,93,80,0,0.25928535726370594,0.5072169069677779,0.0,-0.20908137272485844,-0.11027214054950343,0.11027214054950343,0.0,0.5072169069677779,0,0,0,1,0.5072169069677779,0.0
6688,28,209,26,80,90,0,2110.669,20,755.43,LESS,-692,1386,694,4,1,10.0,0.9374084606744876,10.0,0.17460757394239454,-1.808928488279005,-0.21678899133063612,170,80,90,1,0.19945027481823535,0.0,0.3901668515136753,0.5288528839511129,-0.9987751765285533,0.9987751765285533,0.3901668515136753,0.0,0,1,0,1,0.3901668515136753,0.0
6689,28,210,25,88,80,1,2865.8540000000007,60,1260.194,LESS,328,1176,1504,5,2,-8.0,-0.7499267685395902,8.0,-0.17460757394239454,1.1697530704651546,0.520086265487032,168,88,80,0,0.1595602198545883,0.31213348121094026,0.0,1.266787140627084,1.200916805749677,1.200916805749677,0.0,0.31213348121094026,1,1,1,1,0.31213348121094026,0.0
6690,28,211,36,80,70,1,1830.256,30,1822.569,LESS,-82,1210,1128,3,1,-10.0,-0.9374084606744876,10.0,0.17460757394239454,-1.0642580985929653,-0.4904032731159104,150,80,70,0,-0.19945027481823535,0.0,-0.3901668515136753,-0.20908137272485844,0.316726891304506,0.316726891304506,-0.3901668515136753,0.0,0,0,1,1,0.0,-0.3901668515136753
6691,28,212,28,80,93,0,2949.485,50,1736.475,LESS,-1066,2048,982,4,1,13.0,1.218630998876834,13.0,0.6984302957695783,0.42508268077911465,0.6016896005677312,173,80,93,1,0.25928535726370594,0.0,0.5072169069677779,0.5288528839511129,-1.8053289033639044,1.8053289033639044,0.5072169069677779,0.0,1,1,0,1,0.5072169069677779,0.0
6692,28,213,21,82,80,0,2504.76,40,1510.099,LESS,-482,1414,932,4,1,-2.0,-0.18748169213489754,2.0,-1.222253017596762,-0.3195877089069253,0.16774712476612366,162,82,80,0,0.03989005496364707,0.07803337030273506,0.0,0.5288528839511129,-0.5458974154712706,0.5458974154712706,0.0,0.07803337030273506,0,1,0,1,0.07803337030273506,0.0
6693,28,214,19,50,41,1,1805.355,50,1207.854,LESS,194,782,976,3,2,-9.0,-0.8436676146070391,9.0,0.0,0.42508268077911465,-0.5147005390441489,91,50,41,0,-1.376206896245824,-1.170500554541026,-1.5216507209033339,-0.20908137272485844,0.9119376629797918,0.9119376629797918,-1.5216507209033339,-1.170500554541026,1,1,1,0,-1.170500554541026,-1.5216507209033339
6694,28,215,56,96,110,0,2436.003,40,1314.629,LESS,-692,1702,1010,4,1,14.0,1.3123718449442827,14.0,0.8730378697119728,-0.3195877089069253,0.10065716398431207,206,96,110,1,0.9174712641638826,0.6242669624218805,1.170500554541026,0.5288528839511129,-0.9987751765285533,0.9987751765285533,1.170500554541026,0.6242669624218805,0,1,0,2,1.170500554541026,0.6242669624218805
6695,28,216,23,80,85,0,1165.694,20,955.801,LESS,-424,780,356,2,1,5.0,0.4687042303372438,5.0,-0.6984302957695783,-1.808928488279005,-1.1388527185117574,165,80,85,1,0.09972513740911768,0.0,0.19508342575683765,-0.9470156294008297,-0.420816890988783,0.420816890988783,0.19508342575683765,0.0,0,0,0,1,0.19508342575683765,0.0
6696,28,217,10,60,50,1,1898.451,60,2335.686,LESS,484,698,1182,3,2,-10.0,-0.9374084606744876,10.0,0.17460757394239454,1.1697530704651546,-0.4238616864335998,110,60,50,0,-0.9972513740911768,-0.7803337030273506,-1.170500554541026,-0.20908137272485844,1.53734028539223,1.53734028539223,-1.170500554541026,-0.7803337030273506,1,0,1,0,-0.7803337030273506,-1.170500554541026
6697,28,218,19,41,50,0,2716.545,40,1123.14,LESS,-150,1294,1144,3,1,9.0,0.8436676146070391,9.0,0.0,-0.3195877089069253,0.374397318116269,91,41,50,1,-1.376206896245824,-1.5216507209033339,-1.170500554541026,-0.20908137272485844,0.17008075915262397,0.17008075915262397,-1.170500554541026,-1.5216507209033339,0,0,1,0,-1.5216507209033339,-1.170500554541026
6698,28,219,56,110,96,0,5059.486,30,2467.723,LESS,574,1860,2434,7,1,-14.0,-1.3123718449442827,14.0,0.8730378697119728,-1.0642580985929653,2.6605328360140583,206,110,96,0,0.9174712641638826,1.170500554541026,0.6242669624218805,2.7426556539790266,1.7314307544167797,1.7314307544167797,0.6242669624218805,1.170500554541026,0,1,1,2,1.170500554541026,0.6242669624218805
6699,28,220,35,72,80,0,1643.581,30,819.57,LESS,-864,1272,408,2,1,8.0,0.7499267685395902,8.0,-0.17460757394239454,-1.0642580985929653,-0.6725522678210994,152,72,80,1,-0.1595602198545883,-0.31213348121094026,0.0,-0.9470156294008297,-1.3697036284421373,1.3697036284421373,0.0,-0.31213348121094026,0,0,0,1,-0.31213348121094026,0.0
6700,28,221,11,49,50,1,2790.734000000001,30,1182.255,LESS,404,1048,1452,3,1,1.0,0.09374084606744876,1.0,-1.3968605915391563,-1.0642580985929653,0.4467875780235057,99,49,50,1,-1.2166466763912356,-1.2095172396923934,-1.170500554541026,-0.20908137272485844,1.3648154240370747,1.3648154240370747,-1.170500554541026,-1.2095172396923934,0,0,1,0,-1.2095172396923934,-1.170500554541026
6701,28,222,17,43,50,0,1351.956,40,1438.2620000000004,LESS,-554,964,410,2,1,7.0,0.6561859224721414,7.0,-0.34921514788478913,-0.3195877089069253,-0.957106710466878,93,43,50,1,-1.3363168412821769,-1.4436173506005987,-1.170500554541026,-0.9470156294008297,-0.7011697906909105,0.7011697906909105,-1.170500554541026,-1.4436173506005987,0,0,0,0,-1.4436173506005987,-1.170500554541026
6702,28,223,1,51,50,0,1314.693,20,1037.344,LESS,-1006,1392,386,2,1,-1.0,-0.09374084606744876,1.0,-1.3968605915391563,-1.808928488279005,-0.9934662550748834,101,51,50,0,-1.1767566214275886,-1.1314838693896585,-1.170500554541026,-0.9470156294008297,-1.675935257347538,1.675935257347538,-1.170500554541026,-1.1314838693896585,0,0,0,0,-1.1314838693896585,-1.170500554541026
6703,28,224,41,112,110,1,1949.92,50,1478.194,LESS,50,942,992,3,1,-2.0,-0.18748169213489754,2.0,-1.222253017596762,0.42508268077911465,-0.3736405716165039,222,112,110,0,1.2365917038730592,1.248533924843761,1.170500554541026,-0.20908137272485844,0.6013929125405123,0.6013929125405123,1.170500554541026,1.248533924843761,1,0,1,2,1.248533924843761,1.170500554541026
6704,28,225,20,40,50,0,1411.48,40,2330.187,LESS,-1678,2094,416,2,1,10.0,0.9374084606744876,10.0,0.17460757394239454,-0.3195877089069253,-0.8990258921418119,90,40,50,1,-1.3961519237276474,-1.5606674060547012,-1.170500554541026,-0.9470156294008297,-3.1251440927308423,3.1251440927308423,-1.170500554541026,-1.5606674060547012,0,0,0,0,-1.5606674060547012,-1.170500554541026
6705,28,226,1,50,51,1,1795.223,40,1985.472,LESS,-228,1080,852,3,1,1.0,0.09374084606744876,1.0,-1.3968605915391563,-0.3195877089069253,-0.5245868849091709,101,50,51,1,-1.1767566214275886,-1.170500554541026,-1.1314838693896585,-0.20908137272485844,0.0018690193313475323,0.0018690193313475323,-1.1314838693896585,-1.170500554541026,0,1,1,0,-1.170500554541026,-1.1314838693896585
6706,28,227,23,85,80,1,1928.204,40,1436.605,LESS,84,930,1014,3,1,-5.0,-0.4687042303372438,5.0,-0.6984302957695783,-0.3195877089069253,-0.394830059062696,165,85,80,0,0.09972513740911768,0.19508342575683765,0.0,-0.20908137272485844,0.6747159786164533,0.6747159786164533,0.0,0.19508342575683765,0,1,1,1,0.19508342575683765,0.0
6707,28,228,11,50,49,0,1282.97,20,1649.184,LESS,-1324,1690,366,2,1,-1.0,-0.09374084606744876,1.0,-1.3968605915391563,-1.808928488279005,-1.0244201190579163,99,50,49,0,-1.2166466763912356,-1.170500554541026,-1.2095172396923934,-0.9470156294008297,-2.36172158123428,2.36172158123428,-1.2095172396923934,-1.170500554541026,0,0,0,0,-1.170500554541026,-1.2095172396923934
6708,28,229,17,50,43,0,1320.439,30,801.7189999999998,LESS,-548,930,382,2,1,-7.0,-0.6561859224721414,7.0,-0.34921514788478913,-1.0642580985929653,-0.9878595689970688,93,50,43,0,-1.3363168412821769,-1.170500554541026,-1.4436173506005987,-0.9470156294008297,-0.6882304260892738,0.6882304260892738,-1.4436173506005987,-1.170500554541026,0,0,0,0,-1.170500554541026,-1.4436173506005987
6709,28,230,21,80,82,0,1425.7020000000002,10,545.45,LESS,-860,1202,342,2,1,2.0,0.18748169213489754,2.0,-1.222253017596762,-2.553598877965045,-0.8851487098587144,162,80,82,1,0.03989005496364707,0.0,0.07803337030273506,-0.9470156294008297,-1.3610773853743796,1.3610773853743796,0.07803337030273506,0.0,0,0,0,1,0.07803337030273506,0.0
6710,28,231,10,50,60,0,1091.249,50,1380.885,LESS,-418,790,372,2,1,10.0,0.9374084606744876,10.0,0.17460757394239454,0.42508268077911465,-1.2114927716031074,110,50,60,1,-0.9972513740911768,-1.170500554541026,-0.7803337030273506,-0.9470156294008297,-0.40787752638714636,0.40787752638714636,-0.7803337030273506,-1.170500554541026,1,0,0,0,-1.170500554541026,-0.7803337030273506
6711,28,232,3,53,50,0,1135.555,40,1462.204,LESS,-900,1260,360,2,1,-3.0,-0.28122253820234633,3.0,-1.0476454436543674,-0.3195877089069253,-1.1682609871680834,103,53,50,0,-1.1368665664639415,-1.0534504990869233,-1.170500554541026,-0.9470156294008297,-1.4473398160519573,1.4473398160519573,-1.170500554541026,-1.0534504990869233,0,0,0,0,-1.0534504990869233,-1.170500554541026
6712,28,233,45,122,110,1,1952.816,40,2242.788,LESS,458,660,1118,2,2,-12.0,-1.124890152809385,12.0,0.5238227218271837,-0.3195877089069253,-0.37081478622121145,232,122,110,0,1.4360419786912946,1.6387007763574364,1.170500554541026,-0.9470156294008297,1.4812697054518045,1.4812697054518045,1.170500554541026,1.6387007763574364,1,0,1,2,1.6387007763574364,1.170500554541026
6713,28,234,38,67,80,0,1114.602,40,1539.823,LESS,-360,738,378,2,1,13.0,1.218630998876834,13.0,0.6984302957695783,-0.3195877089069253,-1.1887059738350598,147,67,80,1,-0.25928535726370594,-0.5072169069677779,0.0,-0.9470156294008297,-0.28279700190465873,0.28279700190465873,0.0,-0.5072169069677779,1,0,0,1,-0.5072169069677779,0.0
6714,28,235,38,80,67,1,1701.323,40,1424.7020000000002,LESS,184,700,884,3,2,-13.0,-1.218630998876834,13.0,0.6984302957695783,-0.3195877089069253,-0.6162102442385787,147,80,67,0,-0.25928535726370594,0.0,-0.5072169069677779,-0.20908137272485844,0.8903720553103974,0.8903720553103974,-0.5072169069677779,0.0,0,0,1,1,0.0,-0.5072169069677779
6715,28,236,36,70,80,0,1118.927,40,1194.378,LESS,-418,762,344,2,1,10.0,0.9374084606744876,10.0,0.17460757394239454,-0.3195877089069253,-1.1844858350800047,150,70,80,1,-0.19945027481823535,-0.3901668515136753,0.0,-0.9470156294008297,-0.40787752638714636,0.40787752638714636,0.0,-0.3901668515136753,0,0,0,1,-0.3901668515136753,0.0
6716,28,237,45,110,122,0,2236.474,40,1346.8629999999996,LESS,-216,1092,876,4,1,12.0,1.124890152809385,12.0,0.5238227218271837,-0.3195877089069253,-0.09403418067636356,232,110,122,1,1.4360419786912946,1.170500554541026,1.6387007763574364,0.5288528839511129,0.02774774853462083,0.02774774853462083,1.6387007763574364,1.170500554541026,0,1,1,2,1.6387007763574364,1.170500554541026
6717,28,238,42,110,115,0,2228.576,30,1535.247,LESS,-438,1304,866,4,1,5.0,0.4687042303372438,5.0,-0.6984302957695783,-1.0642580985929653,-0.1017406907081386,225,110,115,1,1.2964267863185297,1.170500554541026,1.3655839802978638,0.5288528839511129,-0.4510087417259352,0.4510087417259352,1.3655839802978638,1.170500554541026,0,1,0,2,1.3655839802978638,1.170500554541026
6718,28,239,41,110,112,1,2740.866,30,1337.7179999999996,LESS,-402,1688,1286,5,1,2.0,0.18748169213489754,2.0,-1.222253017596762,-1.0642580985929653,0.39812864636174855,222,110,112,1,1.2365917038730592,1.170500554541026,1.248533924843761,1.266787140627084,-0.3733725541161153,0.3733725541161153,1.248533924843761,1.170500554541026,0,1,0,2,1.248533924843761,1.170500554541026
6719,28,240,53,110,103,0,2461.829,30,1602.804,LESS,-1170,2006,836,4,1,-7.0,-0.6561859224721414,7.0,-0.34921514788478913,-1.0642580985929653,0.12585700294108834,213,110,103,0,1.0570864565366473,1.170500554541026,0.8973837584814532,0.5288528839511129,-2.0296112231256065,2.0296112231256065,0.8973837584814532,1.170500554541026,0,1,0,2,1.170500554541026,0.8973837584814532
6720,29,1,49,110,131,0,2307.362,4,2276.424,LESS,-1280,2322,1042,4,1,21.0,1.9685577674164243,21.0,2.0952908873087353,-1.5943419881996734,0.8790197013484878,241,110,131,1,1.6155472260277064,1.170500554541026,1.9898509427197442,1.5399680346203743,-1.6428522204316505,1.6428522204316505,1.9898509427197442,1.170500554541026,0,1,0,2,1.9898509427197442,1.170500554541026
6721,29,2,13,47,50,0,3727.04,0,2195.545,LESS,-1982,3444,1462,4,1,3.0,0.28122253820234633,3.0,-1.0476454436543674,-1.7138802815979617,3.6479255876562178,97,47,50,1,-1.2565367313548828,-1.2875506099951286,-1.170500554541026,1.5399680346203743,-2.503446399032515,2.503446399032515,-1.170500554541026,-1.2875506099951286,0,1,0,0,-1.2875506099951286,-1.170500554541026
6722,29,3,16,50,44,1,2097.398,74,1632.437,LESS,502,722,1224,3,2,-6.0,-0.5624450764046927,6.0,-0.5238227218271837,0.49757814627037605,0.4695109567509692,94,50,44,0,-1.3163718138003533,-1.170500554541026,-1.4046006654492311,0.42337489773551096,0.5417330021705442,0.5417330021705442,-1.4046006654492311,-1.170500554541026,1,1,1,0,-1.170500554541026,-1.4046006654492311
6723,29,4,7,57,50,1,2346.408,84,1837.604,LESS,792,812,1604,3,2,-7.0,-0.6561859224721414,7.0,-0.34921514788478913,0.7964238797660974,0.9551740822973868,107,57,50,0,-1.0570864565366473,-0.8973837584814532,-1.170500554541026,0.42337489773551096,0.8972491158375681,0.8972491158375681,-1.170500554541026,-0.8973837584814532,1,1,1,0,-0.8973837584814532,-1.170500554541026
6724,29,5,18,42,50,0,1552.626,100,928.061,LESS,20,1066,1086,3,2,8.0,0.7499267685395902,8.0,-0.17460757394239454,1.2745770533592515,-0.5929992726782642,92,42,50,1,-1.3562618687640005,-1.4826340357519663,-1.170500554541026,0.42337489773551096,-0.049159297096716056,0.049159297096716056,-1.170500554541026,-1.4826340357519663,1,1,1,0,-1.4826340357519663,-1.170500554541026
6725,29,6,51,108,110,1,1965.545,14,1272.365,LESS,80,1112,1192,4,1,2.0,0.18748169213489754,2.0,-1.222253017596762,-1.295496254703952,0.21234803119508025,218,108,110,1,1.156811593945765,1.092467184238291,1.170500554541026,1.5399680346203743,0.024395760903357842,0.024395760903357842,1.170500554541026,1.092467184238291,0,1,1,2,1.170500554541026,1.092467184238291
6726,29,7,31,78,80,0,2016.642,94,2010.782,LESS,776,1122,1898,2,2,2.0,0.18748169213489754,2.0,-1.222253017596762,1.0952696132618187,0.3120063932128519,158,78,80,1,-0.03989005496364707,-0.07803337030273506,0.0,-0.6932182391493525,0.877634433704215,0.877634433704215,0.0,-0.07803337030273506,1,0,1,1,-0.07803337030273506,0.0
6727,29,8,58,110,92,1,1999.75,100,1055.109,LESS,1490,624,2114,3,2,-18.0,-1.6873352292140782,18.0,1.571468165481551,1.2745770533592515,0.2790606419710137,202,110,92,0,0.8376911542365885,1.170500554541026,0.4682002218164104,0.42337489773551096,1.7529396239050945,1.7529396239050945,0.4682002218164104,1.170500554541026,1,1,1,2,1.170500554541026,0.4682002218164104
6728,29,9,12,50,48,0,2637.325,54,1593.303,LESS,-426,1410,984,4,1,-2.0,-0.18748169213489754,2.0,-1.222253017596762,-0.1001133207210667,1.5225716145032715,98,50,48,0,-1.2365917038730592,-1.170500554541026,-1.248533924843761,1.5399680346203743,-0.5959185615639321,0.5959185615639321,-1.248533924843761,-1.170500554541026,0,1,0,0,-1.170500554541026,-1.248533924843761
6729,29,10,54,110,101,1,2055.193,64,1058.53,LESS,248,750,998,3,2,-9.0,-0.8436676146070391,9.0,0.0,0.19873241277465464,0.3871953380461519,211,110,101,0,1.0171964015730004,1.170500554541026,0.8193503881787182,0.42337489773551096,0.23034992330356477,0.23034992330356477,0.8193503881787182,1.170500554541026,0,1,1,2,1.170500554541026,0.8193503881787182
6730,29,11,14,46,50,0,1455.74,100,1053.635,LESS,-162,1032,870,2,2,4.0,0.3749633842697951,4.0,-0.8730378697119728,1.2745770533592515,-0.7819634009529931,96,46,50,1,-1.2764817588367063,-1.3265672951464962,-1.170500554541026,-0.6932182391493525,-0.2722763063636069,0.2722763063636069,-1.170500554541026,-1.3265672951464962,1,0,0,0,-1.3265672951464962,-1.170500554541026
6731,29,12,22,80,83,1,2133.939,54,1527.317,LESS,620,854,1474,3,2,3.0,0.28122253820234633,3.0,-1.0476454436543674,-0.1001133207210667,0.5407796458421363,163,80,83,1,0.05983508244547061,0.0,0.1170500554541026,0.42337489773551096,0.6863912829040228,0.6863912829040228,0.1170500554541026,0.0,0,1,1,1,0.1170500554541026,0.0
6732,29,13,6,50,56,0,2207.377,14,2949.62,LESS,-1516,2194,678,2,1,6.0,0.5624450764046927,6.0,-0.5238227218271837,-1.295496254703952,0.6840113578773073,106,50,56,1,-1.077031484018471,-1.170500554541026,-0.9364004436328208,-0.6932182391493525,-1.9321687818986077,1.9321687818986077,-0.9364004436328208,-1.170500554541026,0,0,0,0,-1.170500554541026,-0.9364004436328208
6733,29,14,13,50,47,0,1621.04,4,2207.535,LESS,-1834,2302,468,2,1,-3.0,-0.28122253820234633,3.0,-1.0476454436543674,-1.5943419881996734,-0.4595662496224325,97,50,47,0,-1.2565367313548828,-1.170500554541026,-1.2875506099951286,-0.6932182391493525,-2.3220105892989995,2.3220105892989995,-1.2875506099951286,-1.170500554541026,0,0,0,0,-1.170500554541026,-1.2875506099951286
6734,29,15,46,110,124,0,1620.499,64,1800.042,LESS,-288,1032,744,2,2,14.0,1.3123718449442827,14.0,0.8730378697119728,0.19873241277465464,-0.4606214030336232,234,110,124,1,1.4759320336549415,1.170500554541026,1.7167341466601715,-0.6932182391493525,-0.4267419281637621,0.4267419281637621,1.7167341466601715,1.170500554541026,1,0,0,2,1.7167341466601715,1.170500554541026
6735,29,16,27,91,80,1,2113.161,94,2258.088,LESS,2414,706,3120,3,2,-11.0,-1.0311493067419364,11.0,0.34921514788478913,1.0952696132618187,0.5002547334988434,171,91,80,0,0.21939530230005888,0.4291835366650429,0.0,0.42337489773551096,2.8856875171062324,2.8856875171062324,0.0,0.4291835366650429,1,1,1,1,0.4291835366650429,0.0
6736,29,17,40,64,80,0,1347.364,100,1115.451,LESS,160,804,964,2,2,16.0,1.4998535370791803,16.0,1.222253017596762,1.2745770533592515,-0.9933373493655814,144,64,80,1,-0.3191204397091766,-0.6242669624218805,0.0,-0.6932182391493525,0.12246917157012305,0.12246917157012305,0.0,-0.6242669624218805,1,0,1,1,-0.6242669624218805,0.0
6737,29,18,22,83,80,1,1945.038,64,2055.755,LESS,376,860,1236,3,1,-3.0,-0.28122253820234633,3.0,-1.0476454436543674,0.19873241277465464,0.1723516707453777,163,83,80,0,0.05983508244547061,0.1170500554541026,0.0,0.42337489773551096,0.38726738037038905,0.38726738037038905,0.0,0.1170500554541026,0,1,1,1,0.1170500554541026,0.0
6738,29,19,54,101,110,0,1461.631,74,932.383,LESS,-492,916,424,2,1,9.0,0.8436676146070391,9.0,0.0,0.49757814627037605,-0.7704737359893612,211,101,110,1,1.0171964015730004,0.8193503881787182,1.170500554541026,-0.6932182391493525,-0.6768291253640133,0.6768291253640133,1.170500554541026,0.8193503881787182,1,0,0,2,1.170500554541026,0.8193503881787182
6739,29,20,6,56,50,0,1986.005,0,1446.98,LESS,-1628,2230,602,2,1,-6.0,-0.5624450764046927,6.0,-0.5238227218271837,-1.7138802815979617,0.2522527239732005,106,56,50,0,-1.077031484018471,-0.9364004436328208,-1.170500554541026,-0.6932182391493525,-2.069471556832079,2.069471556832079,-1.170500554541026,-0.9364004436328208,0,0,0,0,-0.9364004436328208,-1.170500554541026
6740,29,21,18,50,42,0,2873.722,0,2435.405,LESS,-1640,2794,1154,4,1,-8.0,-0.7499267685395902,8.0,-0.17460757394239454,-1.7138802815979617,1.983634647673814,92,50,42,0,-1.3562618687640005,-1.170500554541026,-1.4826340357519663,1.5399680346203743,-2.0841825684320936,2.0841825684320936,-1.4826340357519663,-1.170500554541026,0,1,0,0,-1.170500554541026,-1.4826340357519663
6741,29,22,43,110,117,1,3685.171,0,1071.685,LESS,-372,2220,1848,6,1,7.0,0.6561859224721414,7.0,-0.34921514788478913,-1.7138802815979617,3.566265295284413,227,110,117,1,1.3363168412821769,1.170500554541026,1.4436173506005987,3.7731543083901014,-0.5297190093638655,0.5297190093638655,1.4436173506005987,1.170500554541026,0,1,0,2,1.4436173506005987,1.170500554541026
6742,29,23,32,77,80,0,2989.911,4,1332.542,LESS,-1342,2514,1172,4,1,3.0,0.28122253820234633,3.0,-1.0476454436543674,-1.5943419881996734,2.210246883704948,157,77,80,1,-0.05983508244547061,-0.1170500554541026,0.0,1.5399680346203743,-1.7188591136983935,1.7188591136983935,0.0,-0.1170500554541026,0,1,0,1,-0.1170500554541026,0.0
6743,29,24,27,80,91,0,1489.596,84,1442.203,LESS,-688,1126,438,2,2,11.0,1.0311493067419364,11.0,0.34921514788478913,0.7964238797660974,-0.7159314713979571,171,80,91,1,0.21939530230005888,0.0,0.4291835366650429,-0.6932182391493525,-0.9171089814975881,0.9171089814975881,0.4291835366650429,0.0,1,0,0,1,0.4291835366650429,0.0
6744,29,25,16,44,50,0,1718.2620000000004,74,1447.2720000000004,LESS,-512,1078,566,2,2,6.0,0.5624450764046927,6.0,-0.5238227218271837,0.49757814627037605,-0.26994679501468954,94,44,50,1,-1.3163718138003533,-1.4046006654492311,-1.170500554541026,-0.6932182391493525,-0.7013474780307046,0.7013474780307046,-1.170500554541026,-1.4046006654492311,1,0,0,0,-1.4046006654492311,-1.170500554541026
6745,29,26,7,50,57,0,1651.589,24,1990.177,LESS,-610,1110,500,2,1,7.0,0.6561859224721414,7.0,-0.34921514788478913,-0.9966505212082308,-0.3999842134699988,107,50,57,1,-1.0570864565366473,-1.170500554541026,-0.8973837584814532,-0.6932182391493525,-0.821487406097492,0.821487406097492,-0.8973837584814532,-1.170500554541026,0,0,0,0,-1.170500554541026,-0.8973837584814532
6746,29,27,14,50,46,0,1406.5079999999996,100,2647.007,LESS,794,948,1742,2,2,-4.0,-0.3749633842697951,4.0,-0.8730378697119728,1.2745770533592515,-0.8779843117473446,96,50,46,0,-1.2764817588367063,-1.170500554541026,-1.3265672951464962,-0.6932182391493525,0.8997009511042372,0.8997009511042372,-1.3265672951464962,-1.170500554541026,1,0,1,0,-1.170500554541026,-1.3265672951464962
6747,29,28,51,110,108,1,1894.46,74,1224.099,LESS,312,678,990,3,2,-2.0,-0.18748169213489754,2.0,-1.222253017596762,0.49757814627037605,0.07370555386699239,218,110,108,0,1.156811593945765,1.170500554541026,1.092467184238291,0.42337489773551096,0.3088086518369769,0.3088086518369769,1.092467184238291,1.170500554541026,1,1,1,2,1.170500554541026,1.092467184238291
6748,29,29,50,133,110,1,1955.987,64,1549.529,LESS,366,660,1026,3,2,-23.0,-2.1560394595513217,23.0,2.444506035193524,0.19873241277465464,0.1937063374720464,243,133,110,0,1.6554372809913533,2.0678843130224793,1.170500554541026,0.42337489773551096,0.3750082040370434,0.3750082040370434,1.170500554541026,2.0678843130224793,0,1,1,2,2.0678843130224793,1.170500554541026
6749,29,30,49,131,110,1,2029.414,74,1496.082,LESS,308,740,1048,3,2,-21.0,-1.9685577674164243,21.0,2.0952908873087353,0.49757814627037605,0.3369165953713147,241,131,110,0,1.6155472260277064,1.9898509427197442,1.170500554541026,0.42337489773551096,0.3039049813036387,0.3039049813036387,1.170500554541026,1.9898509427197442,1,1,1,2,1.9898509427197442,1.170500554541026
6750,29,31,47,126,110,0,1618.197,0,1126.66,LESS,-1534,1986,452,2,1,-16.0,-1.4998535370791803,16.0,1.222253017596762,-1.7138802815979617,-0.4651111685651597,236,126,110,0,1.5158220886185887,1.7947675169629065,1.170500554541026,-0.6932182391493525,-1.9542352992986298,1.9542352992986298,1.170500554541026,1.7947675169629065,0,0,0,2,1.7947675169629065,1.170500554541026
6751,29,32,50,110,133,0,1427.059,100,652.335,LESS,-266,1112,846,3,2,23.0,2.1560394595513217,23.0,2.444506035193524,1.2745770533592515,-0.8379021347540326,243,110,133,1,1.6554372809913533,1.170500554541026,2.0678843130224793,0.42337489773551096,-0.3997717402304017,0.3997717402304017,2.0678843130224793,1.170500554541026,1,1,0,2,2.0678843130224793,1.170500554541026
6752,29,33,47,110,126,0,1549.8270000000002,0,2110.754,LESS,-1970,2414,444,2,1,16.0,1.4998535370791803,16.0,1.222253017596762,-1.7138802815979617,-0.5984583750773819,236,110,126,1,1.5158220886185887,1.170500554541026,1.7947675169629065,-0.6932182391493525,-2.4887353874325004,2.4887353874325004,1.7947675169629065,1.170500554541026,0,0,0,2,1.7947675169629065,1.170500554541026
6753,29,34,12,48,50,0,1447.861,100,1867.96,LESS,490,1142,1632,2,1,2.0,0.18748169213489754,2.0,-1.222253017596762,1.2745770533592515,-0.7973304133869523,98,48,50,1,-1.2365917038730592,-1.248533924843761,-1.170500554541026,-0.6932182391493525,0.5270219905705295,0.5270219905705295,-1.170500554541026,-1.248533924843761,1,0,1,0,-1.248533924843761,-1.170500554541026
6754,29,35,32,80,77,1,2712.057,4,1340.009,LESS,-52,1530,1478,3,1,-3.0,-0.28122253820234633,3.0,-1.0476454436543674,-1.5943419881996734,1.668327113070939,157,80,77,0,-0.05983508244547061,0.0,-0.1170500554541026,0.42337489773551096,-0.13742536669680472,0.13742536669680472,-0.1170500554541026,0.0,0,1,0,1,0.0,-0.1170500554541026
6755,29,36,43,117,110,1,1603.18,74,1581.554,LESS,1770,308,2078,1,2,-7.0,-0.6561859224721414,7.0,-0.34921514788478913,0.49757814627037605,-0.4943999648236653,227,117,110,0,1.3363168412821769,1.4436173506005987,1.170500554541026,-1.809811376034216,2.0961965612387727,2.0961965612387727,1.170500554541026,1.4436173506005987,1,0,1,2,1.4436173506005987,1.170500554541026
6756,29,37,40,80,64,1,1527.441,64,1724.094,LESS,368,458,826,1,2,-16.0,-1.4998535370791803,16.0,1.222253017596762,0.19873241277465464,-0.6421194920143812,144,80,64,0,-0.3191204397091766,0.0,-0.6242669624218805,-1.809811376034216,0.3774600393037125,0.3774600393037125,-0.6242669624218805,0.0,0,0,1,1,0.0,-0.6242669624218805
6757,29,38,31,80,78,1,2162.75,34,1573.917,LESS,78,950,1028,3,2,-2.0,-0.18748169213489754,2.0,-1.222253017596762,-0.6978047877125094,0.5969719285220204,158,80,78,0,-0.03989005496364707,0.0,-0.07803337030273506,0.42337489773551096,0.02194392563668871,0.02194392563668871,-0.07803337030273506,0.0,0,1,1,1,0.0,-0.07803337030273506
6758,29,39,46,124,110,0,2738.155,4,1971.786,LESS,-1874,2860,986,4,1,-14.0,-1.3123718449442827,14.0,0.8730378697119728,-1.5943419881996734,1.7192280256869408,234,124,110,0,1.4759320336549415,1.7167341466601715,1.170500554541026,1.5399680346203743,-2.371047294632382,2.371047294632382,1.170500554541026,1.7167341466601715,0,1,0,2,1.7167341466601715,1.170500554541026
6759,29,40,58,92,110,0,1592.1570000000004,94,1659.02,LESS,446,1298,1744,2,1,18.0,1.6873352292140782,18.0,1.571468165481551,1.0952696132618187,-0.5158989593736754,202,92,110,1,0.8376911542365885,0.4682002218164104,1.170500554541026,-0.6932182391493525,0.4730816147038086,0.4730816147038086,1.170500554541026,0.4682002218164104,1,0,1,2,1.170500554541026,0.4682002218164104
6760,29,41,49,110,131,1,2625.011,84,1788.54,MORE,1250,930,2180,3,2,21.0,1.9685577674164243,21.0,2.0952908873087353,0.7964238797660974,1.4985546845487374,241,110,131,0,1.6155472260277064,1.170500554541026,1.9898509427197442,0.42337489773551096,1.458719391904799,1.458719391904799,1.9898509427197442,1.170500554541026,1,1,1,2,1.9898509427197442,1.170500554541026
6761,29,42,13,47,50,1,2022.252,74,1287.107,MORE,844,356,1200,1,2,3.0,0.28122253820234633,3.0,-1.0476454436543674,0.49757814627037605,0.32294800252298145,97,47,50,0,-1.2565367313548828,-1.2875506099951286,-1.170500554541026,-1.809811376034216,0.9609968327709655,0.9609968327709655,-1.170500554541026,-1.2875506099951286,1,0,1,0,-1.2875506099951286,-1.170500554541026
6762,29,43,16,50,44,0,1587.345,94,715.653,MORE,-118,1064,946,2,2,-6.0,-0.5624450764046927,6.0,-0.5238227218271837,1.0952696132618187,-0.5252841686428997,94,50,44,1,-1.3163718138003533,-1.170500554541026,-1.4046006654492311,-0.6932182391493525,-0.21833593049688602,0.21833593049688602,-1.4046006654492311,-1.170500554541026,1,0,0,0,-1.170500554541026,-1.4046006654492311
6763,29,44,7,57,50,1,2544.321,4,1352.126,MORE,-490,1774,1284,3,1,-7.0,-0.6561859224721414,7.0,-0.34921514788478913,-1.5943419881996734,1.3411788458260334,107,57,50,1,-1.0570864565366473,-0.8973837584814532,-1.170500554541026,0.42337489773551096,-0.6743772900973443,0.6743772900973443,-1.170500554541026,-0.8973837584814532,0,1,0,0,-0.8973837584814532,-1.170500554541026
6764,29,45,18,42,50,1,1134.701,100,1200.417,MORE,1318,368,1686,1,2,8.0,0.7499267685395902,8.0,-0.17460757394239454,1.2745770533592515,-1.4081101587631073,92,42,50,0,-1.3562618687640005,-1.4826340357519663,-1.170500554541026,-1.809811376034216,1.5420817909715494,1.5420817909715494,-1.170500554541026,-1.4826340357519663,1,0,1,0,-1.4826340357519663,-1.170500554541026
6765,29,46,51,108,110,1,2711.432,34,1047.216,MORE,-26,1160,1134,3,2,2.0,0.18748169213489754,2.0,-1.222253017596762,-0.6978047877125094,1.6671081280764952,218,108,110,0,1.156811593945765,1.092467184238291,1.170500554541026,0.42337489773551096,-0.10555150823010603,0.10555150823010603,1.170500554541026,1.092467184238291,0,1,0,2,1.170500554541026,1.092467184238291
6766,29,47,31,78,80,1,2270.95,4,2302.53,MORE,-1048,2138,1090,3,1,2.0,0.18748169213489754,2.0,-1.222253017596762,-1.5943419881996734,0.8080026107601729,158,78,80,0,-0.03989005496364707,-0.07803337030273506,0.0,0.42337489773551096,-1.3584393294980313,1.3584393294980313,0.0,-0.07803337030273506,0,1,0,1,-0.07803337030273506,0.0
6767,29,48,58,110,92,0,1572.9920000000004,94,1498.2089999999996,MORE,774,872,1646,2,2,-18.0,-1.6873352292140782,18.0,1.571468165481551,1.0952696132618187,-0.5532779152433075,202,110,92,1,0.8376911542365885,1.170500554541026,0.4682002218164104,-0.6932182391493525,0.8751825984375459,0.8751825984375459,0.4682002218164104,1.170500554541026,1,0,1,2,1.170500554541026,0.4682002218164104
6768,29,49,12,50,48,1,1417.839,100,709.2819999999998,MORE,1176,340,1516,1,2,-2.0,-0.18748169213489754,2.0,-1.222253017596762,1.2745770533592515,-0.8558846013920712,98,50,48,1,-1.2365917038730592,-1.170500554541026,-1.248533924843761,-1.809811376034216,1.3680014870380413,1.3680014870380413,-1.248533924843761,-1.170500554541026,1,0,1,0,-1.170500554541026,-1.248533924843761
6769,29,50,54,110,101,0,1800.773,34,1718.085,MORE,-342,1038,696,2,2,-9.0,-0.8436676146070391,9.0,0.0,-0.6978047877125094,-0.10901932161217448,211,110,101,1,1.0171964015730004,1.170500554541026,0.8193503881787182,-0.6932182391493525,-0.4929414803638286,0.4929414803638286,0.8193503881787182,1.170500554541026,0,0,0,2,1.170500554541026,0.8193503881787182
6770,29,51,14,46,50,1,2680.177,74,924.195,MORE,608,876,1484,3,2,4.0,0.3749633842697951,4.0,-0.8730378697119728,0.49757814627037605,1.6061491264743382,96,46,50,0,-1.2764817588367063,-1.3265672951464962,-1.170500554541026,0.42337489773551096,0.6716802713040081,0.6716802713040081,-1.170500554541026,-1.3265672951464962,1,1,1,0,-1.3265672951464962,-1.170500554541026
6771,29,52,22,80,83,1,1480.3010000000004,94,890.7589999999999,MORE,1210,356,1566,1,2,3.0,0.28122253820234633,3.0,-1.0476454436543674,1.0952696132618187,-0.7340602162353281,163,80,83,0,0.05983508244547061,0.0,0.1170500554541026,-1.809811376034216,1.4096826865714163,1.4096826865714163,0.1170500554541026,0.0,1,0,1,1,0.1170500554541026,0.0
6772,29,53,6,50,56,1,2127.983,100,2249.688,MORE,1300,888,2188,3,2,6.0,0.5624450764046927,6.0,-0.5238227218271837,1.2745770533592515,0.5291632064390829,106,50,56,0,-1.077031484018471,-1.170500554541026,-0.9364004436328208,0.42337489773551096,1.5200152735715273,1.5200152735715273,-0.9364004436328208,-1.170500554541026,1,1,1,0,-1.170500554541026,-0.9364004436328208
6773,29,54,13,50,47,1,1363.34,64,1535.394,MORE,388,330,718,1,2,-3.0,-0.28122253820234633,3.0,-1.0476454436543674,0.19873241277465464,-0.9621781425316008,97,50,47,1,-1.2565367313548828,-1.170500554541026,-1.2875506099951286,-1.809811376034216,0.4019783919704038,0.4019783919704038,-1.2875506099951286,-1.170500554541026,1,0,1,0,-1.170500554541026,-1.2875506099951286
6774,29,55,46,110,124,1,2241.911,100,638.739,MORE,580,880,1460,3,2,14.0,1.3123718449442827,14.0,0.8730378697119728,1.2745770533592515,0.7513656423543164,234,110,124,0,1.4759320336549415,1.170500554541026,1.7167341466601715,0.42337489773551096,0.6373545775706403,0.6373545775706403,1.7167341466601715,1.170500554541026,1,1,1,2,1.7167341466601715,1.170500554541026
6775,29,56,27,91,80,0,1507.8429999999996,54,1290.633,MORE,-482,914,432,2,1,-11.0,-1.0311493067419364,11.0,0.34921514788478913,-0.1001133207210667,-0.680342960688165,171,91,80,1,0.21939530230005888,0.4291835366650429,0.0,-0.6932182391493525,-0.6645699490306677,0.6645699490306677,0.0,0.4291835366650429,0,0,0,1,0.4291835366650429,0.0
6776,29,57,40,64,80,1,1436.8870000000004,100,1949.376,MORE,1896,348,2244,1,2,16.0,1.4998535370791803,16.0,1.222253017596762,1.2745770533592515,-0.8187338395133981,144,64,80,0,-0.3191204397091766,-0.6242669624218805,0.0,-1.809811376034216,2.2506621830389277,2.2506621830389277,0.0,-0.6242669624218805,1,0,1,1,-0.6242669624218805,0.0
6777,29,58,22,83,80,1,2441.337,34,1770.5410000000004,MORE,338,884,1222,3,1,-3.0,-0.28122253820234633,3.0,-1.0476454436543674,-0.6978047877125094,1.1403213247575128,163,83,80,1,0.05983508244547061,0.1170500554541026,0.0,0.42337489773551096,0.3406825103036756,0.3406825103036756,0.0,0.1170500554541026,0,1,1,1,0.1170500554541026,0.0
6778,29,59,54,101,110,1,2046.589,94,546.918,MORE,110,766,876,2,2,9.0,0.8436676146070391,9.0,0.0,1.0952696132618187,0.3704143030186369,211,101,110,0,1.0171964015730004,0.8193503881787182,1.170500554541026,-0.6932182391493525,0.06117328990339479,0.06117328990339479,1.170500554541026,0.8193503881787182,1,0,0,2,1.170500554541026,0.8193503881787182
6779,29,60,6,56,50,1,3059.759,4,1709.438,MORE,-282,1624,1342,3,1,-6.0,-0.5624450764046927,6.0,-0.5238227218271837,-1.5943419881996734,2.3464767459320317,106,56,50,1,-1.077031484018471,-0.9364004436328208,-1.170500554541026,0.42337489773551096,-0.41938642236375473,0.41938642236375473,-1.170500554541026,-0.9364004436328208,0,1,0,0,-0.9364004436328208,-1.170500554541026
6780,29,61,18,50,42,0,2743.615,24,1539.392,MORE,-444,1526,1082,4,1,-8.0,-0.7499267685395902,8.0,-0.17460757394239454,-0.9966505212082308,1.7298770785984032,92,50,42,1,-1.3562618687640005,-1.170500554541026,-1.4826340357519663,1.5399680346203743,-0.6179850789639543,0.6179850789639543,-1.4826340357519663,-1.170500554541026,0,1,0,0,-1.170500554541026,-1.4826340357519663
6781,29,62,43,110,117,1,2354.465,54,1296.261,MORE,30,992,1022,3,2,7.0,0.6561859224721414,7.0,-0.34921514788478913,-0.1001133207210667,0.9708882616577644,227,110,117,0,1.3363168412821769,1.170500554541026,1.4436173506005987,0.42337489773551096,-0.03690012076337041,0.03690012076337041,1.4436173506005987,1.170500554541026,0,1,0,2,1.4436173506005987,1.170500554541026
6782,29,63,32,77,80,0,1772.96,74,894.1239999999998,MORE,-28,1084,1056,2,2,3.0,0.28122253820234633,3.0,-1.0476454436543674,0.49757814627037605,-0.16326512905292972,157,77,80,0,-0.05983508244547061,-0.1170500554541026,0.0,-0.6932182391493525,-0.10800334349677516,0.10800334349677516,0.0,-0.1170500554541026,1,0,0,1,-0.1170500554541026,0.0
6783,29,64,27,80,91,1,1193.783,100,1659.519,MORE,1564,304,1868,1,2,11.0,1.0311493067419364,11.0,0.34921514788478913,1.2745770533592515,-1.2928780444563188,171,80,91,0,0.21939530230005888,0.0,0.4291835366650429,-1.809811376034216,1.8436575287718524,1.8436575287718524,0.4291835366650429,0.0,1,0,1,1,0.4291835366650429,0.0
6784,29,65,16,44,50,1,1566.408,44,1573.169,MORE,378,748,1126,2,2,6.0,0.5624450764046927,6.0,-0.5238227218271837,-0.3989590542167881,-0.5661191907687798,94,44,50,0,-1.3163718138003533,-1.4046006654492311,-1.170500554541026,-0.6932182391493525,0.3897192156370582,0.3897192156370582,-1.170500554541026,-1.4046006654492311,0,0,1,0,-1.4046006654492311,-1.170500554541026
6785,29,66,7,50,57,0,2047.311,34,2038.618,MORE,-414,1308,894,2,2,7.0,0.6561859224721414,7.0,-0.34921514788478913,-0.6978047877125094,0.3718224744842186,107,50,57,0,-1.0570864565366473,-1.170500554541026,-0.8973837584814532,-0.6932182391493525,-0.5812075499639173,0.5812075499639173,-0.8973837584814532,-1.170500554541026,0,0,0,0,-1.170500554541026,-0.8973837584814532
6786,29,67,14,50,46,0,3993.035,84,1357.763,MORE,-1772,2574,802,2,2,-4.0,-0.3749633842697951,4.0,-0.8730378697119728,0.7964238797660974,4.166715849411648,96,50,46,1,-1.2764817588367063,-1.170500554541026,-1.3265672951464962,-0.6932182391493525,-2.2460036960322562,2.2460036960322562,-1.3265672951464962,-1.170500554541026,1,0,0,0,-1.170500554541026,-1.3265672951464962
6787,29,68,51,110,108,0,3554.465,14,1500.506,MORE,-1124,2218,1094,4,1,-2.0,-0.18748169213489754,2.0,-1.222253017596762,-1.295496254703952,3.3113394509903284,218,110,108,1,1.156811593945765,1.170500554541026,1.092467184238291,1.5399680346203743,-1.4516090696314583,1.4516090696314583,1.092467184238291,1.170500554541026,0,1,0,2,1.170500554541026,1.092467184238291
6788,29,69,50,133,110,0,1699.0120000000004,34,1143.171,MORE,-650,1062,412,2,1,-23.0,-2.1560394595513217,23.0,2.444506035193524,-0.6978047877125094,-0.3074915328435661,243,133,110,1,1.6554372809913533,2.0678843130224793,1.170500554541026,-0.6932182391493525,-0.8705241114308746,0.8705241114308746,1.170500554541026,2.0678843130224793,0,0,0,2,2.0678843130224793,1.170500554541026
6789,29,70,49,131,110,0,1700.664,74,1127.409,MORE,-234,1050,816,2,1,-21.0,-1.9685577674164243,21.0,2.0952908873087353,0.49757814627037605,-0.3042695117062524,241,131,110,1,1.6155472260277064,1.9898509427197442,1.170500554541026,-0.6932182391493525,-0.3605423759636956,0.3605423759636956,1.170500554541026,1.9898509427197442,1,0,0,2,1.9898509427197442,1.170500554541026
6790,29,71,47,126,110,0,1732.599,64,941.417,MORE,-572,1044,472,2,1,-16.0,-1.4998535370791803,16.0,1.222253017596762,0.19873241277465464,-0.24198425443013966,236,126,110,1,1.5158220886185887,1.7947675169629065,1.170500554541026,-0.6932182391493525,-0.7749025360307785,0.7749025360307785,1.170500554541026,1.7947675169629065,0,0,0,2,1.7947675169629065,1.170500554541026
6791,29,72,50,110,133,1,1333.759,100,2169.929,MORE,1568,474,2042,1,2,23.0,2.1560394595513217,23.0,2.444506035193524,1.2745770533592515,-1.0198722147246393,243,110,133,0,1.6554372809913533,1.170500554541026,2.0678843130224793,-1.809811376034216,1.8485611993051907,1.8485611993051907,2.0678843130224793,1.170500554541026,1,0,1,2,2.0678843130224793,1.170500554541026
6792,29,73,47,110,126,0,3034.337,0,1124.528,MORE,-986,2120,1134,4,1,16.0,1.4998535370791803,16.0,1.222253017596762,-1.7138802815979617,2.2968942874860216,236,110,126,0,1.5158220886185887,1.170500554541026,1.7947675169629065,1.5399680346203743,-1.2824324362312882,1.2824324362312882,1.7947675169629065,1.170500554541026,0,1,0,2,1.7947675169629065,1.170500554541026
6793,29,74,12,48,50,1,1806.022,44,1052.835,MORE,-42,736,694,3,2,2.0,0.18748169213489754,2.0,-1.222253017596762,-0.3989590542167881,-0.09878179803483557,98,48,50,0,-1.2365917038730592,-1.248533924843761,-1.170500554541026,0.42337489773551096,-0.12516619036345908,0.12516619036345908,-1.170500554541026,-1.248533924843761,0,1,0,0,-1.248533924843761,-1.170500554541026
6794,29,75,32,80,77,1,2526.978,44,1668.378,MORE,468,1086,1554,3,2,-3.0,-0.28122253820234633,3.0,-1.0476454436543674,-0.3989590542167881,1.3073534750122051,157,80,77,1,-0.05983508244547061,0.0,-0.1170500554541026,0.42337489773551096,0.500051802637169,0.500051802637169,-0.1170500554541026,0.0,0,1,1,1,0.0,-0.1170500554541026
6795,29,76,43,117,110,0,1565.227,100,1630.6760000000004,MORE,660,974,1634,2,2,-7.0,-0.6561859224721414,7.0,-0.34921514788478913,1.2745770533592515,-0.568422584814281,227,117,110,1,1.3363168412821769,1.4436173506005987,1.170500554541026,-0.6932182391493525,0.7354279882374055,0.7354279882374055,1.170500554541026,1.4436173506005987,1,0,1,2,1.4436173506005987,1.170500554541026
6796,29,77,40,80,64,0,1795.685,34,1143.9589999999996,MORE,-826,1236,410,2,1,-16.0,-1.4998535370791803,16.0,1.222253017596762,-0.6978047877125094,-0.11894283465494447,144,80,64,1,-0.3191204397091766,0.0,-0.6242669624218805,-0.6932182391493525,-1.086285614897758,1.086285614897758,-0.6242669624218805,0.0,0,0,0,1,0.0,-0.6242669624218805
6797,29,78,31,80,78,1,2020.008,44,883.8610000000001,MORE,410,870,1280,3,2,-2.0,-0.18748169213489754,2.0,-1.222253017596762,-0.3989590542167881,0.3185713587989297,158,80,78,1,-0.03989005496364707,0.0,-0.07803337030273506,0.42337489773551096,0.4289485799037643,0.4289485799037643,-0.07803337030273506,0.0,0,1,1,1,0.0,-0.07803337030273506
6798,29,79,46,124,110,0,1867.222,34,1314.109,MORE,-686,1056,370,2,1,-14.0,-1.3123718449442827,14.0,0.8730378697119728,-0.6978047877125094,0.02058121262112529,234,124,110,1,1.4759320336549415,1.7167341466601715,1.170500554541026,-0.6932182391493525,-0.914657146230919,0.914657146230919,1.170500554541026,1.7167341466601715,0,0,0,2,1.7167341466601715,1.170500554541026
6799,29,80,58,92,110,1,1173.69,94,2074.294,MORE,1460,836,2296,2,2,18.0,1.6873352292140782,18.0,1.571468165481551,1.0952696132618187,-1.3320669492457011,202,92,110,0,0.8376911542365885,0.4682002218164104,1.170500554541026,-0.6932182391493525,1.7161620949050576,1.7161620949050576,1.170500554541026,0.4682002218164104,1,0,1,2,1.170500554541026,0.4682002218164104
6800,29,81,48,128,110,1,2293.7,74,872.701,LESS,1260,694,1954,3,2,-18.0,-1.6873352292140782,18.0,1.571468165481551,0.49757814627037605,0.8523736645579361,238,128,110,0,1.5557121435822359,1.8728008872656416,1.170500554541026,0.42337489773551096,1.4709785682381447,1.4709785682381447,1.170500554541026,1.8728008872656416,1,1,1,2,1.8728008872656416,1.170500554541026
6801,29,82,8,50,58,0,1379.592,94,817.4989999999998,LESS,-62,960,898,2,2,8.0,0.7499267685395902,8.0,-0.17460757394239454,1.0952696132618187,-0.9304806319240729,108,50,58,1,-1.0371414290548238,-1.170500554541026,-0.8583670733300858,-0.6932182391493525,-0.14968454303015039,0.14968454303015039,-0.8583670733300858,-1.170500554541026,1,0,0,0,-1.170500554541026,-0.8583670733300858
6802,29,83,4,54,50,1,1907.898,4,1193.037,LESS,-422,1394,972,3,1,-4.0,-0.3749633842697951,4.0,-0.8730378697119728,-1.5943419881996734,0.09991470643553464,104,54,50,0,-1.116921538982118,-1.0144338139355558,-1.170500554541026,0.42337489773551096,-0.5910148910305938,0.5910148910305938,-1.170500554541026,-1.0144338139355558,0,1,0,0,-1.0144338139355558,-1.170500554541026
6803,29,84,37,80,69,1,2088.514,0,1095.232,LESS,-330,1628,1298,4,1,-11.0,-1.0311493067419364,11.0,0.34921514788478913,-1.7138802815979617,0.4521838164459437,149,80,69,0,-0.21939530230005888,0.0,-0.4291835366650429,1.5399680346203743,-0.4782304687638138,0.4782304687638138,-0.4291835366650429,0.0,0,1,0,1,0.0,-0.4291835366650429
6804,29,85,52,105,110,0,1478.069,14,2048.935,LESS,-1168,1716,548,2,1,5.0,0.4687042303372438,5.0,-0.6984302957695783,-1.295496254703952,-0.7384134554474876,215,105,110,1,1.0969765115002945,0.9754171287841883,1.170500554541026,-0.6932182391493525,-1.505549445498179,1.505549445498179,1.170500554541026,0.9754171287841883,0,0,0,2,1.170500554541026,0.9754171287841883
6805,29,86,5,55,50,1,2214.443,74,1321.183,LESS,1348,718,2066,3,2,-5.0,-0.4687042303372438,5.0,-0.6984302957695783,0.49757814627037605,0.6977927146304943,105,55,50,0,-1.0969765115002945,-0.9754171287841883,-1.170500554541026,0.42337489773551096,1.5788593199715864,1.5788593199715864,-1.170500554541026,-0.9754171287841883,1,1,1,0,-0.9754171287841883,-1.170500554541026
6806,29,87,30,96,80,1,2047.621,54,1813.428,LESS,702,680,1382,3,2,-16.0,-1.4998535370791803,16.0,1.222253017596762,-0.1001133207210667,0.3724270910414632,176,96,80,0,0.3191204397091766,0.6242669624218805,0.0,0.42337489773551096,0.7869165288374572,0.7869165288374572,0.0,0.6242669624218805,0,1,1,1,0.6242669624218805,0.0
6807,29,88,33,80,75,1,2330.495,0,1457.885,LESS,-342,1638,1296,3,1,-5.0,-0.4687042303372438,5.0,-0.6984302957695783,-1.7138802815979617,0.924137749150846,155,80,75,0,-0.09972513740911768,0.0,-0.19508342575683765,0.42337489773551096,-0.4929414803638286,0.4929414803638286,-0.19508342575683765,0.0,0,1,0,1,0.0,-0.19508342575683765
6808,29,89,48,110,128,0,1695.688,74,1909.201,LESS,352,1174,1526,2,2,18.0,1.6873352292140782,18.0,1.571468165481551,0.49757814627037605,-0.31397458263801786,238,110,128,1,1.5557121435822359,1.170500554541026,1.8728008872656416,-0.6932182391493525,0.3578453571703595,0.3578453571703595,1.8728008872656416,1.170500554541026,1,0,1,2,1.8728008872656416,1.170500554541026
6809,29,90,9,59,50,1,2020.932,100,1810.546,LESS,1392,774,2166,3,2,-9.0,-0.8436676146070391,9.0,0.0,1.2745770533592515,0.3203735062147157,109,59,50,0,-1.0171964015730004,-0.8193503881787182,-1.170500554541026,0.42337489773551096,1.6327996958383073,1.6327996958383073,-1.170500554541026,-0.8193503881787182,1,1,1,0,-0.8193503881787182,-1.170500554541026
6810,29,91,44,110,119,0,1294.907,100,751.455,LESS,0,882,882,2,2,9.0,0.8436676146070391,9.0,0.0,1.2745770533592515,-1.0956482227312636,229,110,119,1,1.376206896245824,1.170500554541026,1.5216507209033339,-0.6932182391493525,-0.07367764976340736,0.07367764976340736,1.5216507209033339,1.170500554541026,1,0,1,2,1.5216507209033339,1.170500554541026
6811,29,92,2,52,50,1,2457.139,14,1614.8829999999996,LESS,-38,1228,1190,3,1,-2.0,-0.18748169213489754,2.0,-1.222253017596762,-1.295496254703952,1.1711411661690407,102,52,50,0,-1.156811593945765,-1.092467184238291,-1.170500554541026,0.42337489773551096,-0.12026251983012082,0.12026251983012082,-1.170500554541026,-1.092467184238291,0,1,1,0,-1.092467184238291,-1.170500554541026
6812,29,93,8,58,50,1,2134.499,0,2607.456,LESS,-514,1802,1288,3,1,-8.0,-0.7499267685395902,8.0,-0.17460757394239454,-1.7138802815979617,0.5418718563971581,108,58,50,0,-1.0371414290548238,-0.8583670733300858,-1.170500554541026,0.42337489773551096,-0.7037993132973738,0.7037993132973738,-1.170500554541026,-0.8583670733300858,0,1,0,0,-0.8583670733300858,-1.170500554541026
6813,29,94,44,119,110,1,1841.079,24,757.461,LESS,378,620,998,3,2,-9.0,-0.8436676146070391,9.0,0.0,-0.9966505212082308,-0.030407466914475788,229,119,110,0,1.376206896245824,1.5216507209033339,1.170500554541026,0.42337489773551096,0.3897192156370582,0.3897192156370582,1.170500554541026,1.5216507209033339,0,1,1,2,1.5216507209033339,1.170500554541026
6814,29,95,34,74,80,0,1418.898,74,1821.814,LESS,-406,926,520,2,2,6.0,0.5624450764046927,6.0,-0.5238227218271837,0.49757814627037605,-0.8538191532174852,154,74,80,1,-0.11967016489094122,-0.2341001109082052,0.0,-0.6932182391493525,-0.5714002088972407,0.5714002088972407,0.0,-0.2341001109082052,1,0,0,1,-0.2341001109082052,0.0
6815,29,96,24,86,80,1,1977.168,74,1193.61,LESS,664,774,1438,3,2,-6.0,-0.5624450764046927,6.0,-0.5238227218271837,0.49757814627037605,0.2350172513397569,166,86,80,0,0.11967016489094122,0.2341001109082052,0.0,0.42337489773551096,0.7403316587707438,0.7403316587707438,0.0,0.2341001109082052,1,1,1,1,0.2341001109082052,0.0
6816,29,97,39,66,80,0,1711.474,84,867.096,LESS,-324,1352,1028,3,2,14.0,1.3123718449442827,14.0,0.8730378697119728,0.7964238797660974,-0.2831859472423483,146,66,80,1,-0.2792303847455295,-0.5462335921191455,0.0,0.42337489773551096,-0.47087496296380643,0.47087496296380643,0.0,-0.5462335921191455,1,1,0,1,-0.5462335921191455,0.0
6817,29,98,9,50,59,0,1456.35,84,1785.414,LESS,606,864,1470,2,2,9.0,0.8436676146070391,9.0,0.0,0.7964238797660974,-0.7807736715984159,109,50,59,1,-1.0171964015730004,-1.170500554541026,-0.8193503881787182,-0.6932182391493525,0.669228436037339,0.669228436037339,-0.8193503881787182,-1.170500554541026,1,0,1,0,-1.170500554541026,-0.8193503881787182
6818,29,99,57,94,110,0,1388.543,74,1124.576,LESS,-146,1050,904,2,2,16.0,1.4998535370791803,16.0,1.222253017596762,0.49757814627037605,-0.9130228164276436,204,94,110,1,0.8775812092002355,0.5462335921191455,1.170500554541026,-0.6932182391493525,-0.25266162423025385,0.25266162423025385,1.170500554541026,0.5462335921191455,1,0,0,2,1.170500554541026,0.5462335921191455
6819,29,100,60,110,87,1,2021.057,84,1524.151,LESS,1364,700,2064,3,2,-23.0,-2.1560394595513217,23.0,2.444506035193524,0.7964238797660974,0.3206173032136045,197,110,87,0,0.7379660168274708,1.170500554541026,0.27311679605957273,0.42337489773551096,1.5984740021049393,1.5984740021049393,0.27311679605957273,1.170500554541026,1,1,1,2,1.170500554541026,0.27311679605957273
6820,29,101,33,75,80,0,1696.056,24,1651.9229999999998,LESS,-740,1096,356,2,1,5.0,0.4687042303372438,5.0,-0.6984302957695783,-0.9966505212082308,-0.3132568442732893,155,75,80,1,-0.09972513740911768,-0.19508342575683765,0.0,-0.6932182391493525,-0.9808566984309854,0.9808566984309854,0.0,-0.19508342575683765,0,0,0,1,-0.19508342575683765,0.0
6821,29,102,15,50,45,1,2179.365,44,1784.562,LESS,138,852,990,3,2,-5.0,-0.4687042303372438,5.0,-0.6984302957695783,-0.3989590542167881,0.6293774256143204,95,50,45,0,-1.2964267863185297,-1.170500554541026,-1.3655839802978638,0.42337489773551096,0.09549898363676262,0.09549898363676262,-1.3655839802978638,-1.170500554541026,0,1,1,0,-1.170500554541026,-1.3655839802978638
6822,29,103,59,89,110,0,1528.295,84,718.118,LESS,-138,998,860,2,2,21.0,1.9685577674164243,21.0,2.0952908873087353,0.7964238797660974,-0.6404538709179729,199,89,110,1,0.7778560717911179,0.3511501663623078,1.170500554541026,-0.6932182391493525,-0.24285428316357732,0.24285428316357732,1.170500554541026,0.3511501663623078,1,0,0,2,1.170500554541026,0.3511501663623078
6823,29,104,29,80,94,0,1949.66,74,2079.34,LESS,-396,1410,1014,2,2,14.0,1.3123718449442827,14.0,0.8730378697119728,0.49757814627037605,0.18136630857629046,174,80,94,1,0.2792303847455295,0.0,0.5462335921191455,-0.6932182391493525,-0.5591410325638951,0.5591410325638951,0.5462335921191455,0.0,1,0,0,1,0.5462335921191455,0.0
6824,29,105,55,110,98,1,1855.783,94,2188.679,LESS,1214,710,1924,3,2,-12.0,-1.124890152809385,12.0,0.5238227218271837,1.0952696132618187,-0.0017291383411875295,208,110,98,0,0.9573613191275298,1.170500554541026,0.7023003327246156,0.42337489773551096,1.4145863571047546,1.4145863571047546,0.7023003327246156,1.170500554541026,1,1,1,2,1.170500554541026,0.7023003327246156
6825,29,106,29,94,80,1,1886.716,84,987.766,LESS,1318,760,2078,3,2,-14.0,-1.3123718449442827,14.0,0.8730378697119728,0.7964238797660974,0.05860184219183263,174,94,80,0,0.2792303847455295,0.5462335921191455,0.0,0.42337489773551096,1.5420817909715494,1.5420817909715494,0.0,0.5462335921191455,1,1,1,1,0.5462335921191455,0.0
6826,29,107,57,110,94,1,1912.885,100,1745.35,LESS,1472,660,2132,3,2,-16.0,-1.4998535370791803,16.0,1.222253017596762,1.2745770533592515,0.10964123150320272,204,110,94,0,0.8775812092002355,1.170500554541026,0.5462335921191455,0.42337489773551096,1.7308731065050724,1.7308731065050724,0.5462335921191455,1.170500554541026,1,1,1,2,1.170500554541026,0.5462335921191455
6827,29,108,39,80,66,0,1505.0020000000004,94,1297.618,LESS,244,960,1204,2,2,-14.0,-1.3123718449442827,14.0,0.8730378697119728,1.0952696132618187,-0.6858839788789084,146,80,66,0,-0.2792303847455295,0.0,-0.5462335921191455,-0.6932182391493525,0.2254462527702265,0.2254462527702265,-0.5462335921191455,0.0,1,0,1,1,0.0,-0.5462335921191455
6828,29,109,4,50,54,0,1393.3239999999996,84,1502.1170000000004,LESS,322,658,980,2,2,4.0,0.3749633842697951,4.0,-0.8730378697119728,0.7964238797660974,-0.903698068814145,104,50,54,1,-1.116921538982118,-1.170500554541026,-1.0144338139355558,-0.6932182391493525,0.32106782817032253,0.32106782817032253,-1.0144338139355558,-1.170500554541026,1,0,1,0,-1.170500554541026,-1.0144338139355558
6829,29,110,55,98,110,0,2635.146,34,1050.371,LESS,-472,1496,1024,5,2,12.0,1.124890152809385,12.0,0.5238227218271837,-0.6978047877125094,1.5183217452186424,208,98,110,1,0.9573613191275298,0.7023003327246156,1.170500554541026,2.656561171505238,-0.6523107726973221,0.6523107726973221,1.170500554541026,0.7023003327246156,0,1,0,2,1.170500554541026,0.7023003327246156
6830,29,111,2,50,52,0,2665.32,74,975.885,LESS,374,1250,1624,4,2,2.0,0.18748169213489754,2.0,-1.222253017596762,0.49757814627037605,1.5771723903744097,102,50,52,1,-1.156811593945765,-1.170500554541026,-1.092467184238291,1.5399680346203743,0.3848155451037199,0.3848155451037199,-1.092467184238291,-1.170500554541026,1,1,1,0,-1.170500554541026,-1.092467184238291
6831,29,112,59,110,89,1,1820.593,84,775.063,LESS,646,710,1356,3,2,-21.0,-1.9685577674164243,21.0,2.0952908873087353,0.7964238797660974,-0.07036286946836462,199,110,89,0,0.7778560717911179,1.170500554541026,0.3511501663623078,0.42337489773551096,0.7182651413707216,0.7182651413707216,0.3511501663623078,1.170500554541026,1,1,1,2,1.170500554541026,0.3511501663623078
6832,29,113,60,87,110,0,1431.295,100,1687.159,LESS,810,786,1596,2,2,23.0,2.1560394595513217,23.0,2.444506035193524,1.2745770533592515,-0.8296403420556885,197,87,110,1,0.7379660168274708,0.27311679605957273,1.170500554541026,-0.6932182391493525,0.9193156332375902,0.9193156332375902,1.170500554541026,0.27311679605957273,1,0,1,2,1.170500554541026,0.27311679605957273
6833,29,114,52,110,105,1,1868.039,0,974.44,LESS,-352,1284,932,3,1,-5.0,-0.4687042303372438,5.0,-0.6984302957695783,-1.7138802815979617,0.022174669805862558,215,110,105,0,1.0969765115002945,1.170500554541026,0.9754171287841883,0.42337489773551096,-0.5052006566971743,0.5052006566971743,0.9754171287841883,1.170500554541026,0,1,0,2,1.170500554541026,0.9754171287841883
6834,29,115,30,80,96,0,1472.836,64,1032.859,LESS,100,882,982,2,2,16.0,1.4998535370791803,16.0,1.222253017596762,0.19873241277465464,-0.7486197730089685,176,80,96,1,0.3191204397091766,0.0,0.6242669624218805,-0.6932182391493525,0.04891411357004914,0.04891411357004914,0.6242669624218805,0.0,0,0,1,1,0.6242669624218805,0.0
6835,29,116,24,80,86,0,1436.216,64,1262.446,LESS,368,834,1202,2,2,6.0,0.5624450764046927,6.0,-0.5238227218271837,0.19873241277465464,-0.8200425418034342,166,80,86,1,0.11967016489094122,0.0,0.2341001109082052,-0.6932182391493525,0.3774600393037125,0.3774600393037125,0.2341001109082052,0.0,0,0,1,1,0.2341001109082052,0.0
6836,29,117,5,50,55,0,1424.26,54,1165.056,LESS,-342,944,602,2,2,5.0,0.4687042303372438,5.0,-0.6984302957695783,-0.1001133207210667,-0.8433612371531508,105,50,55,1,-1.0969765115002945,-1.170500554541026,-0.9754171287841883,-0.6932182391493525,-0.4929414803638286,0.4929414803638286,-0.9754171287841883,-1.170500554541026,0,0,0,0,-1.170500554541026,-0.9754171287841883
6837,29,118,34,80,74,0,1686.889,74,2812.9790000000007,LESS,-776,1536,760,2,2,-6.0,-0.5624450764046927,6.0,-0.5238227218271837,0.49757814627037605,-0.3311359409837993,154,80,74,0,-0.11967016489094122,0.0,-0.2341001109082052,-0.6932182391493525,-1.0249897332310298,1.0249897332310298,-0.2341001109082052,0.0,1,0,0,1,0.0,-0.2341001109082052
6838,29,119,15,45,50,0,1229.458,54,1497.7720000000004,LESS,-620,924,304,2,1,5.0,0.4687042303372438,5.0,-0.6984302957695783,-0.1001133207210667,-1.2232983809734523,95,45,50,1,-1.2964267863185297,-1.3655839802978638,-1.170500554541026,-0.6932182391493525,-0.8337465824308377,0.8337465824308377,-1.170500554541026,-1.3655839802978638,0,0,0,0,-1.3655839802978638,-1.170500554541026
6839,29,120,37,69,80,0,1823.161,64,1393.158,LESS,56,1246,1302,2,2,11.0,1.0311493067419364,11.0,0.34921514788478913,0.19873241277465464,-0.06535430392319297,149,69,80,1,-0.21939530230005888,-0.4291835366650429,0.0,-0.6932182391493525,-0.0050262622966717185,0.0050262622966717185,0.0,-0.4291835366650429,0,0,1,1,-0.4291835366650429,0.0
6840,29,121,48,128,110,0,2785.523,64,966.374,MORE,-326,1516,1190,5,2,-18.0,-1.6873352292140782,18.0,1.571468165481551,0.19873241277465464,1.8116134356338616,238,128,110,1,1.5557121435822359,1.8728008872656416,1.170500554541026,2.656561171505238,-0.4733267982304756,0.4733267982304756,1.170500554541026,1.8728008872656416,1,1,0,2,1.8728008872656416,1.170500554541026
6841,29,122,8,50,58,1,1348.098,100,2401.919,MORE,2398,382,2780,1,2,8.0,0.7499267685395902,8.0,-0.17460757394239454,1.2745770533592515,-0.9919057733881064,108,50,58,0,-1.0371414290548238,-1.170500554541026,-0.8583670733300858,-1.809811376034216,2.8660728349728797,2.8660728349728797,-0.8583670733300858,-1.170500554541026,1,0,1,0,-1.170500554541026,-0.8583670733300858
6842,29,123,4,54,50,1,2232.807,74,1642.546,MORE,1762,786,2548,3,2,-4.0,-0.3749633842697951,4.0,-0.8730378697119728,0.49757814627037605,0.7336094193312461,104,54,50,1,-1.116921538982118,-1.0144338139355558,-1.170500554541026,0.42337489773551096,2.086389220172096,2.086389220172096,-1.170500554541026,-1.0144338139355558,1,1,1,0,-1.0144338139355558,-1.170500554541026
6843,29,124,37,80,69,0,2035.471,64,1506.394,MORE,-856,1538,682,2,2,-11.0,-1.0311493067419364,11.0,0.34921514788478913,0.19873241277465464,0.34873002274947085,149,80,69,1,-0.21939530230005888,0.0,-0.4291835366650429,-0.6932182391493525,-1.123063143897795,1.123063143897795,-0.4291835366650429,0.0,1,0,0,1,0.0,-0.4291835366650429
6844,29,125,52,105,110,1,1881.036,94,1285.477,MORE,906,688,1594,3,2,5.0,0.4687042303372438,5.0,-0.6984302957695783,1.0952696132618187,0.047523706562325484,215,105,110,0,1.0969765115002945,0.9754171287841883,1.170500554541026,0.42337489773551096,1.0370037260377085,1.0370037260377085,1.170500554541026,0.9754171287841883,1,1,1,2,1.170500554541026,0.9754171287841883
6845,29,126,5,55,50,0,2333.588,74,1031.331,MORE,-394,1356,962,4,1,-5.0,-0.4687042303372438,5.0,-0.6984302957695783,0.49757814627037605,0.9301702620913512,105,55,50,1,-1.0969765115002945,-0.9754171287841883,-1.170500554541026,1.5399680346203743,-0.556689197297226,0.556689197297226,-1.170500554541026,-0.9754171287841883,1,1,0,0,-0.9754171287841883,-1.170500554541026
6846,29,127,30,96,80,0,2091.484,94,1091.174,MORE,338,1084,1422,4,2,-16.0,-1.4998535370791803,16.0,1.222253017596762,1.0952696132618187,0.4579764331395415,176,96,80,1,0.3191204397091766,0.6242669624218805,0.0,1.5399680346203743,0.3406825103036756,0.3406825103036756,0.0,0.6242669624218805,1,1,1,1,0.6242669624218805,0.0
6847,29,128,33,80,75,1,1631.6070000000002,74,1545.401,MORE,522,578,1100,3,2,-5.0,-0.4687042303372438,5.0,-0.6984302957695783,0.49757814627037605,-0.4389566265243677,155,80,75,1,-0.09972513740911768,0.0,-0.19508342575683765,0.42337489773551096,0.5662513548372355,0.5662513548372355,-0.19508342575683765,0.0,1,1,1,1,0.0,-0.19508342575683765
6848,29,129,48,110,128,1,1683.828,100,1256.152,MORE,682,570,1252,3,2,18.0,1.6873352292140782,18.0,1.571468165481551,1.2745770533592515,-0.3371060418925883,238,110,128,0,1.5557121435822359,1.170500554541026,1.8728008872656416,0.42337489773551096,0.7623981761707659,0.7623981761707659,1.8728008872656416,1.170500554541026,1,1,1,2,1.8728008872656416,1.170500554541026
6849,29,130,9,59,50,0,1756.1729999999998,14,1158.928,MORE,-652,1044,392,2,1,-9.0,-0.8436676146070391,9.0,0.0,-1.295496254703952,-0.19600609081570167,109,59,50,1,-1.0171964015730004,-0.8193503881787182,-1.170500554541026,-0.6932182391493525,-0.8729759466975437,0.8729759466975437,-1.170500554541026,-0.8193503881787182,0,0,0,0,-0.8193503881787182,-1.170500554541026
6850,29,131,44,110,119,1,3339.763,0,1704.7089999999996,MORE,-798,1938,1140,3,1,9.0,0.8436676146070391,9.0,0.0,-1.7138802815979617,2.892589824946928,229,110,119,0,1.376206896245824,1.170500554541026,1.5216507209033339,0.42337489773551096,-1.0519599211643902,1.0519599211643902,1.5216507209033339,1.170500554541026,0,1,0,2,1.5216507209033339,1.170500554541026
6851,29,132,2,52,50,1,1747.04,34,1090.734,MORE,-256,884,628,3,1,-2.0,-0.18748169213489754,2.0,-1.222253017596762,-0.6978047877125094,-0.21381887474251327,102,52,50,1,-1.156811593945765,-1.092467184238291,-1.170500554541026,0.42337489773551096,-0.387512563897056,0.387512563897056,-1.170500554541026,-1.092467184238291,0,1,0,0,-1.092467184238291,-1.170500554541026
6852,29,133,8,58,50,0,2280.312,0,1595.796,MORE,-1592,2320,728,4,1,-8.0,-0.7499267685395902,8.0,-0.17460757394239454,-1.7138802815979617,0.8262620307889492,108,58,50,1,-1.0371414290548238,-0.8583670733300858,-1.170500554541026,1.5399680346203743,-2.0253385220320346,2.0253385220320346,-1.170500554541026,-0.8583670733300858,0,1,0,0,-0.8583670733300858,-1.170500554541026
6853,29,134,44,119,110,0,2269.762,14,1077.853,MORE,-764,1488,724,4,1,-9.0,-0.8436676146070391,9.0,0.0,-1.295496254703952,0.8056855640827343,229,119,110,1,1.376206896245824,1.5216507209033339,1.170500554541026,1.5399680346203743,-1.010278721631015,1.010278721631015,1.170500554541026,1.5216507209033339,0,1,0,2,1.5216507209033339,1.170500554541026
6854,29,135,34,74,80,1,2733.7870000000007,0,1867.88,MORE,-478,1716,1238,5,1,6.0,0.5624450764046927,6.0,-0.5238227218271837,-1.7138802815979617,1.7107087833577712,154,74,80,0,-0.11967016489094122,-0.2341001109082052,0.0,2.656561171505238,-0.6596662784973294,0.6596662784973294,0.0,-0.2341001109082052,0,1,0,1,-0.2341001109082052,0.0
6855,29,136,24,86,80,0,3175.2140000000004,4,1038.162,MORE,-656,1898,1242,4,1,-6.0,-0.5624450764046927,6.0,-0.5238227218271837,-1.5943419881996734,2.5716574059856923,166,86,80,1,0.11967016489094122,0.2341001109082052,0.0,1.5399680346203743,-0.877879617230882,0.877879617230882,0.0,0.2341001109082052,0,1,0,1,0.2341001109082052,0.0
6856,29,137,39,66,80,1,1692.274,24,1455.601,MORE,174,692,866,3,2,14.0,1.3123718449442827,14.0,0.8730378697119728,-0.9966505212082308,-0.32063316627166943,146,66,80,0,-0.2792303847455295,-0.5462335921191455,0.0,0.42337489773551096,0.13963201843680695,0.13963201843680695,0.0,-0.5462335921191455,0,1,1,1,-0.5462335921191455,0.0
6857,29,138,9,50,59,1,1154.062,100,2032.339,MORE,1342,328,1670,1,2,9.0,0.8436676146070391,9.0,0.0,1.2745770533592515,-1.3703489291992177,109,50,59,0,-1.0171964015730004,-1.170500554541026,-0.8193503881787182,-1.809811376034216,1.571503814171579,1.571503814171579,-0.8193503881787182,-1.170500554541026,1,0,1,0,-1.170500554541026,-0.8193503881787182
6858,29,139,57,94,110,1,1598.132,84,1661.088,MORE,194,640,834,3,2,16.0,1.4998535370791803,16.0,1.222253017596762,0.7964238797660974,-0.5042454628267911,204,94,110,0,0.8775812092002355,0.5462335921191455,1.170500554541026,0.42337489773551096,0.16415037110349825,0.16415037110349825,1.170500554541026,0.5462335921191455,1,1,1,2,1.170500554541026,0.5462335921191455
6859,29,140,60,110,87,0,2456.125,54,1084.037,MORE,-270,1134,864,4,1,-23.0,-2.1560394595513217,23.0,2.444506035193524,-0.1001133207210667,1.1691634849140546,197,110,87,1,0.7379660168274708,1.170500554541026,0.27311679605957273,1.5399680346203743,-0.4046754107637399,0.4046754107637399,0.27311679605957273,1.170500554541026,0,1,0,2,1.170500554541026,0.27311679605957273
6860,29,141,33,75,80,1,1422.63,84,1318.5120000000004,MORE,1244,284,1528,1,2,5.0,0.4687042303372438,5.0,-0.6984302957695783,0.7964238797660974,-0.8465403500186606,155,75,80,0,-0.09972513740911768,-0.19508342575683765,0.0,-1.809811376034216,1.4513638861047915,1.4513638861047915,0.0,-0.19508342575683765,1,0,1,1,-0.19508342575683765,0.0
6861,29,142,15,50,45,1,2016.306,64,1503.52,MORE,250,792,1042,3,2,-5.0,-0.4687042303372438,5.0,-0.6984302957695783,0.19873241277465464,0.3113510668798388,95,50,45,1,-1.2964267863185297,-1.170500554541026,-1.3655839802978638,0.42337489773551096,0.23280175857023389,0.23280175857023389,-1.3655839802978638,-1.170500554541026,1,1,1,0,-1.170500554541026,-1.3655839802978638
6862,29,143,59,89,110,1,1763.932,100,1520.91,MORE,754,594,1348,3,2,21.0,1.9685577674164243,21.0,2.0952908873087353,1.2745770533592515,-0.1808731235006751,199,89,110,0,0.7778560717911179,0.3511501663623078,1.170500554541026,0.42337489773551096,0.8506642457708546,0.8506642457708546,1.170500554541026,0.3511501663623078,1,1,1,2,1.170500554541026,0.3511501663623078
6863,29,144,29,80,94,1,1796.8770000000004,94,1213.572,MORE,694,662,1356,3,2,14.0,1.3123718449442827,14.0,0.8730378697119728,1.0952696132618187,-0.1166179864735399,174,80,94,0,0.2792303847455295,0.0,0.5462335921191455,0.42337489773551096,0.7771091877707808,0.7771091877707808,0.5462335921191455,0.0,1,1,1,1,0.5462335921191455,0.0
6864,29,145,55,110,98,0,1514.104,64,1167.941,MORE,-656,1030,374,2,1,-12.0,-1.124890152809385,12.0,0.5238227218271837,0.19873241277465464,-0.6681316566078216,208,110,98,1,0.9573613191275298,1.170500554541026,0.7023003327246156,-0.6932182391493525,-0.877879617230882,0.877879617230882,0.7023003327246156,1.170500554541026,1,0,0,2,1.170500554541026,0.7023003327246156
6865,29,146,29,94,80,0,1614.409,64,1492.5020000000004,MORE,-756,1170,414,2,1,-14.0,-1.3123718449442827,14.0,0.8730378697119728,0.19873241277465464,-0.4724991928194858,174,94,80,1,0.2792303847455295,0.5462335921191455,0.0,-0.6932182391493525,-1.0004713805643386,1.0004713805643386,0.0,0.5462335921191455,1,0,0,1,0.5462335921191455,0.0
6866,29,147,57,110,94,0,1630.308,44,478.817,MORE,-626,1034,408,2,1,-16.0,-1.4998535370791803,16.0,1.222253017596762,-0.3989590542167881,-0.44149016493682064,204,110,94,1,0.8775812092002355,1.170500554541026,0.5462335921191455,-0.6932182391493525,-0.8411020882308451,0.8411020882308451,0.5462335921191455,1.170500554541026,0,0,0,2,1.170500554541026,0.5462335921191455
6867,29,148,39,80,66,0,1689.162,94,1339.3829999999996,MORE,476,1008,1484,3,2,-14.0,-1.3123718449442827,14.0,0.8730378697119728,1.0952696132618187,-0.3267027363560049,146,80,66,1,-0.2792303847455295,0.0,-0.5462335921191455,0.42337489773551096,0.5098591437038456,0.5098591437038456,-0.5462335921191455,0.0,1,1,1,1,0.0,-0.5462335921191455
6868,29,149,4,50,54,0,1618.537,34,1337.639,MORE,-436,942,506,2,1,4.0,0.3749633842697951,4.0,-0.8730378697119728,-0.6978047877125094,-0.4644480407281818,104,50,54,0,-1.116921538982118,-1.170500554541026,-1.0144338139355558,-0.6932182391493525,-0.6081777378972777,0.6081777378972777,-1.0144338139355558,-1.170500554541026,0,0,0,0,-1.170500554541026,-1.0144338139355558
6869,29,150,55,98,110,1,2423.751,64,1691.654,MORE,394,918,1312,3,2,12.0,1.124890152809385,12.0,0.5238227218271837,0.19873241277465464,1.1060220125778446,208,98,110,0,0.9573613191275298,0.7023003327246156,1.170500554541026,0.42337489773551096,0.40933389777041124,0.40933389777041124,1.170500554541026,0.7023003327246156,0,1,1,2,1.170500554541026,0.7023003327246156
6870,29,151,2,50,52,1,2028.835,74,1567.84,MORE,376,818,1194,3,2,2.0,0.18748169213489754,2.0,-1.222253017596762,0.49757814627037605,0.33578732767246183,102,50,52,0,-1.156811593945765,-1.170500554541026,-1.092467184238291,0.42337489773551096,0.38726738037038905,0.38726738037038905,-1.092467184238291,-1.170500554541026,1,1,1,0,-1.170500554541026,-1.092467184238291
6871,29,152,59,110,89,0,1647.331,100,1420.2620000000004,MORE,-94,996,902,2,2,-21.0,-1.9685577674164243,21.0,2.0952908873087353,1.2745770533592515,-0.4082889144401473,199,110,89,1,0.7778560717911179,1.170500554541026,0.3511501663623078,-0.6932182391493525,-0.18891390729685645,0.18891390729685645,0.3511501663623078,1.170500554541026,1,0,0,2,1.170500554541026,0.3511501663623078
6872,29,153,60,87,110,1,1088.229,100,1476.524,MORE,1058,306,1364,1,2,23.0,2.1560394595513217,23.0,2.444506035193524,1.2745770533592515,-1.4987480318219932,197,87,110,0,0.7379660168274708,0.27311679605957273,1.170500554541026,-1.809811376034216,1.2233432063045624,1.2233432063045624,1.170500554541026,0.27311679605957273,1,0,1,2,1.170500554541026,0.27311679605957273
6873,29,154,52,110,105,0,2262.337,44,2111.672,MORE,-372,1618,1246,5,2,-5.0,-0.4687042303372438,5.0,-0.6984302957695783,-0.3989590542167881,0.7912040223487388,215,110,105,1,1.0969765115002945,1.170500554541026,0.9754171287841883,2.656561171505238,-0.5297190093638655,0.5297190093638655,0.9754171287841883,1.170500554541026,0,1,0,2,1.170500554541026,0.9754171287841883
6874,29,155,30,80,96,1,1112.231,94,1353.6989999999996,MORE,1020,262,1282,1,2,16.0,1.4998535370791803,16.0,1.222253017596762,1.0952696132618187,-1.4519351072833595,176,80,96,0,0.3191204397091766,0.0,0.6242669624218805,-1.809811376034216,1.1767583362378489,1.1767583362378489,0.6242669624218805,0.0,1,0,1,1,0.6242669624218805,0.0
6875,29,156,24,80,86,0,2452.989,0,767.263,MORE,-1094,1918,824,4,1,6.0,0.5624450764046927,6.0,-0.5238227218271837,-1.7138802815979617,1.1630471058059322,166,80,86,0,0.11967016489094122,0.0,0.2341001109082052,1.5399680346203743,-1.4148315406314214,1.4148315406314214,0.2341001109082052,0.0,0,1,0,1,0.2341001109082052,0.0
6876,29,157,5,50,55,1,1582.194,54,1126.33,MORE,276,728,1004,3,2,5.0,0.4687042303372438,5.0,-0.6984302957695783,-0.1001133207210667,-0.5353305553731098,105,50,55,0,-1.0969765115002945,-1.170500554541026,-0.9754171287841883,0.42337489773551096,0.2646756170369326,0.2646756170369326,-0.9754171287841883,-1.170500554541026,0,0,1,0,-1.170500554541026,-0.9754171287841883
6877,29,158,34,80,74,1,1688.523,24,902.841,MORE,310,606,916,3,2,-6.0,-0.5624450764046927,6.0,-0.5238227218271837,-0.9966505212082308,-0.32794902661432473,154,80,74,1,-0.11967016489094122,0.0,-0.2341001109082052,0.42337489773551096,0.3063568165703078,0.3063568165703078,-0.2341001109082052,0.0,0,0,1,1,0.0,-0.2341001109082052
6878,29,159,15,45,50,0,1281.465,84,1685.049,MORE,600,906,1506,3,2,5.0,0.4687042303372438,5.0,-0.6984302957695783,0.7964238797660974,-1.1218651768037704,95,45,50,0,-1.2964267863185297,-1.3655839802978638,-1.170500554541026,0.42337489773551096,0.6618729302373316,0.6618729302373316,-1.170500554541026,-1.3655839802978638,1,0,1,0,-1.3655839802978638,-1.170500554541026
6879,29,160,37,69,80,1,1762.87,74,1249.513,MORE,840,778,1618,4,1,11.0,1.0311493067419364,11.0,0.34921514788478913,0.49757814627037605,-0.18294442280323467,149,69,80,0,-0.21939530230005888,-0.4291835366650429,0.0,1.5399680346203743,0.9560931622376272,0.9560931622376272,0.0,-0.4291835366650429,1,1,1,1,-0.4291835366650429,0.0
6880,29,161,3,50,53,0,2159.923,24,1405.318,LESS,-600,1100,500,2,1,3.0,0.28122253820234633,3.0,-1.0476454436543674,-0.9966505212082308,0.5914582155951507,103,50,53,1,-1.1368665664639415,-1.170500554541026,-1.0534504990869233,-0.6932182391493525,-0.8092282297641463,0.8092282297641463,-1.0534504990869233,-1.170500554541026,0,0,0,0,-1.170500554541026,-1.0534504990869233
6881,29,162,20,50,40,1,1656.1729999999998,100,1158.561,LESS,1488,516,2004,3,2,-10.0,-0.9374084606744876,10.0,0.17460757394239454,1.2745770533592515,-0.3910436899267487,90,50,40,0,-1.3961519237276474,-1.170500554541026,-1.5606674060547012,0.42337489773551096,1.7504877886384254,1.7504877886384254,-1.5606674060547012,-1.170500554541026,1,1,1,0,-1.170500554541026,-1.5606674060547012
6882,29,163,25,80,88,0,1580.1229999999996,54,1358.112,LESS,-510,938,428,2,1,8.0,0.7499267685395902,8.0,-0.17460757394239454,-0.1001133207210667,-0.5393697840507004,168,80,88,1,0.1595602198545883,0.0,0.31213348121094026,-0.6932182391493525,-0.6988956427640355,0.6988956427640355,0.31213348121094026,0.0,0,0,0,1,0.31213348121094026,0.0
6883,29,164,42,115,110,0,1873.544,0,1155.576,LESS,-988,1714,726,4,1,-5.0,-0.4687042303372438,5.0,-0.6984302957695783,-1.7138802815979617,0.03291148963692591,225,115,110,0,1.2964267863185297,1.3655839802978638,1.170500554541026,1.5399680346203743,-1.2848842714979574,1.2848842714979574,1.170500554541026,1.3655839802978638,0,1,0,2,1.3655839802978638,1.170500554541026
6884,29,165,53,103,110,0,1472.928,50,1652.31,LESS,-364,932,568,2,2,7.0,0.6561859224721414,7.0,-0.34921514788478913,-0.21965161411935524,-0.7484403384177862,213,103,110,1,1.0570864565366473,0.8973837584814532,1.170500554541026,-0.6932182391493525,-0.519911668297189,0.519911668297189,1.170500554541026,0.8973837584814532,0,0,0,2,1.170500554541026,0.8973837584814532
6885,29,166,26,90,80,0,1218.814,34,1008.992,LESS,-394,736,342,2,1,-10.0,-0.9374084606744876,10.0,0.17460757394239454,-0.6978047877125094,-1.2440581830228323,170,90,80,0,0.19945027481823535,0.3901668515136753,0.0,-0.6932182391493525,-0.556689197297226,0.556689197297226,0.0,0.3901668515136753,0,0,0,1,0.3901668515136753,0.0
6886,29,167,35,80,72,0,1613.504,4,1059.724,LESS,-1088,1534,446,2,1,-8.0,-0.7499267685395902,8.0,-0.17460757394239454,-1.5943419881996734,-0.4742642830914411,152,80,72,0,-0.1595602198545883,0.0,-0.31213348121094026,-0.6932182391493525,-1.407476034831414,1.407476034831414,-0.31213348121094026,0.0,0,0,0,1,0.0,-0.31213348121094026
6887,29,168,28,93,80,1,1653.807,64,1368.368,LESS,286,656,942,3,2,-13.0,-1.218630998876834,13.0,0.6984302957695783,0.19873241277465464,-0.3956582795217156,173,93,80,0,0.25928535726370594,0.5072169069677779,0.0,0.42337489773551096,0.2769347933702782,0.2769347933702782,0.0,0.5072169069677779,0,1,1,1,0.5072169069677779,0.0
6888,29,169,26,80,90,0,1194.884,64,721.445,LESS,-370,700,330,2,1,10.0,0.9374084606744876,10.0,0.17460757394239454,0.19873241277465464,-1.290730680490106,170,80,90,1,0.19945027481823535,0.0,0.3901668515136753,-0.6932182391493525,-0.5272671740971965,0.5272671740971965,0.3901668515136753,0.0,1,0,0,1,0.3901668515136753,0.0
6889,29,170,25,88,80,0,1343.629,14,1587.882,LESS,-894,1258,364,2,1,-8.0,-0.7499267685395902,8.0,-0.17460757394239454,-1.295496254703952,-1.0006220036923792,168,88,80,0,0.1595602198545883,0.31213348121094026,0.0,-0.6932182391493525,-1.1696480139645085,1.1696480139645085,0.0,0.31213348121094026,0,0,0,1,0.31213348121094026,0.0
6890,29,171,36,80,70,1,1314.318,64,1405.016,LESS,666,328,994,1,2,-10.0,-0.9374084606744876,10.0,0.17460757394239454,0.19873241277465464,-1.057789474367818,150,80,70,0,-0.19945027481823535,0.0,-0.3901668515136753,-1.809811376034216,0.7427834940374128,0.7427834940374128,-0.3901668515136753,0.0,0,0,1,1,0.0,-0.3901668515136753
6891,29,172,28,80,93,0,1308.85,74,1065.1989999999996,LESS,580,830,1410,2,2,13.0,1.218630998876834,13.0,0.6984302957695783,0.49757814627037605,-1.0684541302872104,173,80,93,1,0.25928535726370594,0.0,0.5072169069677779,-0.6932182391493525,0.6373545775706403,0.6373545775706403,0.5072169069677779,0.0,1,0,1,1,0.5072169069677779,0.0
6892,29,173,21,82,80,1,1679.965,84,1053.009,LESS,1072,540,1612,3,2,-2.0,-0.18748169213489754,2.0,-1.222253017596762,0.7964238797660974,-0.3446403443462481,162,82,80,0,0.03989005496364707,0.07803337030273506,0.0,0.42337489773551096,1.2405060531712462,1.2405060531712462,0.0,0.07803337030273506,1,1,1,1,0.07803337030273506,0.0
6893,29,174,19,50,41,1,1943.104,4,896.449,LESS,-42,1072,1030,3,1,-9.0,-0.8436676146070391,9.0,0.0,-1.5943419881996734,0.1685796435785701,91,50,41,0,-1.376206896245824,-1.170500554541026,-1.5216507209033339,0.42337489773551096,-0.12516619036345908,0.12516619036345908,-1.5216507209033339,-1.170500554541026,0,1,1,0,-1.170500554541026,-1.5216507209033339
6894,29,175,56,96,110,0,1272.624,100,664.8539999999998,LESS,46,572,618,2,2,14.0,1.3123718449442827,14.0,0.8730378697119728,1.2745770533592515,-1.139108450941178,206,96,110,1,0.9174712641638826,0.6242669624218805,1.170500554541026,-0.6932182391493525,-0.01728543863001737,0.01728543863001737,1.170500554541026,0.6242669624218805,1,0,1,2,1.170500554541026,0.6242669624218805
6895,29,176,23,80,85,0,1240.974,94,1281.774,LESS,626,716,1342,3,2,5.0,0.4687042303372438,5.0,-0.6984302957695783,1.0952696132618187,-1.2008378510598243,165,80,85,1,0.09972513740911768,0.0,0.19508342575683765,0.42337489773551096,0.6937467887040303,0.6937467887040303,0.19508342575683765,0.0,1,1,1,1,0.19508342575683765,0.0
6896,29,177,10,60,50,0,2196.961,34,1168.95,LESS,-658,1396,738,4,1,-10.0,-0.9374084606744876,10.0,0.17460757394239454,-0.6978047877125094,0.6636962415539003,110,60,50,0,-0.9972513740911768,-0.7803337030273506,-1.170500554541026,1.5399680346203743,-0.8803314524975512,0.8803314524975512,-1.170500554541026,-0.7803337030273506,0,1,0,0,-0.7803337030273506,-1.170500554541026
6897,29,178,19,41,50,0,1192.279,84,1034.492,LESS,726,614,1340,2,2,9.0,0.8436676146070391,9.0,0.0,0.7964238797660974,-1.2958114099469489,91,41,50,1,-1.376206896245824,-1.5216507209033339,-1.170500554541026,-0.6932182391493525,0.8163385520374868,0.8163385520374868,-1.170500554541026,-1.5216507209033339,1,0,1,0,-1.5216507209033339,-1.170500554541026
6898,29,179,56,110,96,1,1584.455,74,1649.831,LESS,684,550,1234,3,2,-14.0,-1.3123718449442827,14.0,0.8730378697119728,0.49757814627037605,-0.5309207552572092,206,110,96,0,0.9174712641638826,1.170500554541026,0.6242669624218805,0.42337489773551096,0.764850011437435,0.764850011437435,0.6242669624218805,1.170500554541026,1,1,1,2,1.170500554541026,0.6242669624218805
6899,29,180,35,72,80,0,1190.956,74,1326.6229999999996,LESS,-288,756,468,2,2,8.0,0.7499267685395902,8.0,-0.17460757394239454,0.49757814627037605,-1.298391757383188,152,72,80,1,-0.1595602198545883,-0.31213348121094026,0.0,-0.6932182391493525,-0.4267419281637621,0.4267419281637621,0.0,-0.31213348121094026,1,0,0,1,-0.31213348121094026,0.0
6900,29,181,11,49,50,0,1184.588,74,770.51,LESS,-128,728,600,2,2,1.0,0.09374084606744876,1.0,-1.3968605915391563,0.49757814627037605,-1.3108117516945794,99,49,50,1,-1.2166466763912356,-1.2095172396923934,-1.170500554541026,-0.6932182391493525,-0.23059510683023166,0.23059510683023166,-1.170500554541026,-1.2095172396923934,1,0,0,0,-1.2095172396923934,-1.170500554541026
6901,29,182,17,43,50,0,1187.92,84,1403.4589999999996,LESS,494,704,1198,3,2,7.0,0.6561859224721414,7.0,-0.34921514788478913,0.7964238797660974,-1.3043130988921992,93,43,50,1,-1.3363168412821769,-1.4436173506005987,-1.170500554541026,0.42337489773551096,0.5319256611038677,0.5319256611038677,-1.170500554541026,-1.4436173506005987,1,1,1,0,-1.4436173506005987,-1.170500554541026
6902,29,183,1,51,50,0,2085.742,74,1222.702,LESS,-120,990,870,4,2,-1.0,-0.09374084606744876,1.0,-1.3968605915391563,0.49757814627037605,0.4467773741985857,101,51,50,0,-1.1767566214275886,-1.1314838693896585,-1.170500554541026,1.5399680346203743,-0.22078776576355513,0.22078776576355513,-1.170500554541026,-1.1314838693896585,1,1,0,0,-1.1314838693896585,-1.170500554541026
6903,29,184,41,112,110,0,2533.759,0,693.86,LESS,-450,1444,994,4,1,-2.0,-0.18748169213489754,2.0,-1.222253017596762,-1.7138802815979617,1.3205789746079248,222,112,110,0,1.2365917038730592,1.248533924843761,1.170500554541026,1.5399680346203743,-0.6253405847639616,0.6253405847639616,1.170500554541026,1.248533924843761,0,1,0,2,1.248533924843761,1.170500554541026
6904,29,185,20,40,50,0,1501.316,84,2504.378,LESS,222,1264,1486,2,2,10.0,0.9374084606744876,10.0,0.17460757394239454,0.7964238797660974,-0.6930730647821423,90,40,50,1,-1.3961519237276474,-1.5606674060547012,-1.170500554541026,-0.6932182391493525,0.19847606483686608,0.19847606483686608,-1.170500554541026,-1.5606674060547012,1,0,1,0,-1.5606674060547012,-1.170500554541026
6905,29,186,1,50,51,0,1459.219,14,1299.405,LESS,-1140,1586,446,2,1,1.0,0.09374084606744876,1.0,-1.3968605915391563,-1.295496254703952,-0.7751780428799198,101,50,51,1,-1.1767566214275886,-1.170500554541026,-1.1314838693896585,-0.6932182391493525,-1.4712237517648112,1.4712237517648112,-1.1314838693896585,-1.170500554541026,0,0,0,0,-1.170500554541026,-1.1314838693896585
6906,29,187,23,85,80,0,1220.474,74,886.425,LESS,100,914,1014,2,2,-5.0,-0.4687042303372438,5.0,-0.6984302957695783,0.49757814627037605,-1.2408205588775891,165,85,80,0,0.09972513740911768,0.19508342575683765,0.0,-0.6932182391493525,0.04891411357004914,0.04891411357004914,0.0,0.19508342575683765,1,0,1,1,0.19508342575683765,0.0
6907,29,188,11,50,49,0,1540.779,0,984.798,LESS,-1540,1876,336,2,1,-1.0,-0.09374084606744876,1.0,-1.3968605915391563,-1.7138802815979617,-0.6161053770449499,99,50,49,0,-1.2166466763912356,-1.170500554541026,-1.2095172396923934,-0.6932182391493525,-1.9615908050986373,1.9615908050986373,-1.2095172396923934,-1.170500554541026,0,0,0,0,-1.170500554541026,-1.2095172396923934
6908,29,189,17,50,43,1,1720.121,54,806.1,LESS,252,588,840,3,2,-7.0,-0.6561859224721414,7.0,-0.34921514788478913,-0.1001133207210667,-0.2663210460472157,93,50,43,0,-1.3363168412821769,-1.170500554541026,-1.4436173506005987,0.42337489773551096,0.23525359383690303,0.23525359383690303,-1.4436173506005987,-1.170500554541026,0,1,1,0,-1.170500554541026,-1.4436173506005987
6909,29,190,21,80,82,0,1280.852,64,772.8430000000002,LESS,-454,774,320,2,1,2.0,0.18748169213489754,2.0,-1.222253017596762,0.19873241277465464,-1.1230607572863212,162,80,82,1,0.03989005496364707,0.0,0.07803337030273506,-0.6932182391493525,-0.6302442552972999,0.6302442552972999,0.07803337030273506,0.0,0,0,0,1,0.07803337030273506,0.0
6910,29,191,10,50,60,0,1280.357,100,816.4960000000002,LESS,336,736,1072,3,2,10.0,0.9374084606744876,10.0,0.17460757394239454,1.2745770533592515,-1.124026193401921,110,50,60,1,-0.9972513740911768,-1.170500554541026,-0.7803337030273506,0.42337489773551096,0.33823067503700643,0.33823067503700643,-0.7803337030273506,-1.170500554541026,1,1,1,0,-1.170500554541026,-0.7803337030273506
6911,29,192,3,53,50,1,1848.84,0,921.666,LESS,-158,1028,870,3,1,-3.0,-0.28122253820234633,3.0,-1.0476454436543674,-1.7138802815979617,-0.01527059884746749,103,53,50,0,-1.1368665664639415,-1.0534504990869233,-1.170500554541026,0.42337489773551096,-0.2673726358302686,0.2673726358302686,-1.170500554541026,-1.0534504990869233,0,1,0,0,-1.0534504990869233,-1.170500554541026
6912,29,193,45,122,110,1,1675.457,34,990.057,LESS,-10,870,860,3,2,-12.0,-1.124890152809385,12.0,0.5238227218271837,-0.6978047877125094,-0.3534326393141738,232,122,110,0,1.4360419786912946,1.6387007763574364,1.170500554541026,0.42337489773551096,-0.085936826096753,0.085936826096753,1.170500554541026,1.6387007763574364,0,1,1,2,1.6387007763574364,1.170500554541026
6913,29,194,38,67,80,0,1407.4779999999996,64,1137.876,LESS,-336,720,384,2,1,13.0,1.218630998876834,13.0,0.6984302957695783,0.19873241277465464,-0.8760924470359674,147,67,80,1,-0.25928535726370594,-0.5072169069677779,0.0,-0.6932182391493525,-0.4855859745638212,0.4855859745638212,0.0,-0.5072169069677779,0,0,0,1,-0.5072169069677779,0.0
6914,29,195,38,80,67,1,2247.346,14,1143.24,LESS,-892,1630,738,4,1,-13.0,-1.218630998876834,13.0,0.6984302957695783,-1.295496254703952,0.7619659358660017,147,80,67,0,-0.25928535726370594,0.0,-0.5072169069677779,1.5399680346203743,-1.1671961786978393,1.1671961786978393,-0.5072169069677779,0.0,0,1,0,1,0.0,-0.5072169069677779
6915,29,196,36,70,80,0,1306.483,44,1032.934,LESS,-462,808,346,2,1,10.0,0.9374084606744876,10.0,0.17460757394239454,-0.3989590542167881,-1.0730706702581687,150,70,80,1,-0.19945027481823535,-0.3901668515136753,0.0,-0.6932182391493525,-0.6400515963639763,0.6400515963639763,0.0,-0.3901668515136753,0,0,0,1,-0.3901668515136753,0.0
6916,29,197,45,110,122,0,1587.888,80,1268.577,LESS,-118,854,736,2,2,12.0,1.124890152809385,12.0,0.5238227218271837,0.6768855863678088,-0.5242251144797269,232,110,122,1,1.4360419786912946,1.170500554541026,1.6387007763574364,-0.6932182391493525,-0.21833593049688602,0.21833593049688602,1.6387007763574364,1.170500554541026,1,0,0,2,1.6387007763574364,1.170500554541026
6917,29,198,42,110,115,0,1319.003,100,1167.439,LESS,260,830,1090,2,2,5.0,0.4687042303372438,5.0,-0.6984302957695783,1.2745770533592515,-1.0486519628494655,225,110,115,1,1.2964267863185297,1.170500554541026,1.3655839802978638,-0.6932182391493525,0.24506093490357955,0.24506093490357955,1.3655839802978638,1.170500554541026,1,0,1,2,1.3655839802978638,1.170500554541026
6918,29,199,41,110,112,0,1630.271,74,1297.437,LESS,-992,1350,358,2,1,2.0,0.18748169213489754,2.0,-1.222253017596762,0.49757814627037605,-0.4415623288484918,222,110,112,1,1.2365917038730592,1.170500554541026,1.248533924843761,-0.6932182391493525,-1.2897879420312957,1.2897879420312957,1.248533924843761,1.170500554541026,1,0,0,2,1.248533924843761,1.170500554541026
6919,29,200,53,110,103,1,2245.057,0,1225.544,LESS,-308,1598,1290,3,1,-7.0,-0.6561859224721414,7.0,-0.34921514788478913,-1.7138802815979617,0.7575015252223494,213,110,103,0,1.0570864565366473,1.170500554541026,0.8973837584814532,0.42337489773551096,-0.4512602808304534,0.4512602808304534,0.8973837584814532,1.170500554541026,0,1,0,2,1.170500554541026,0.8973837584814532
6920,29,201,3,50,53,1,2146.514,24,853.529,MORE,126,802,928,3,2,3.0,0.28122253820234633,3.0,-1.0476454436543674,-0.9966505212082308,0.5653056239303511,103,50,53,0,-1.1368665664639415,-1.170500554541026,-1.0534504990869233,0.42337489773551096,0.08078797203674784,0.08078797203674784,-1.0534504990869233,-1.170500554541026,0,0,0,0,-1.170500554541026,-1.0534504990869233
6921,29,202,20,50,40,0,1427.287,34,1311.921,MORE,-346,750,404,2,1,-10.0,-0.9374084606744876,10.0,0.17460757394239454,-0.6978047877125094,-0.8374574490280593,90,50,40,1,-1.3961519237276474,-1.170500554541026,-1.5606674060547012,-0.6932182391493525,-0.49784515089716685,0.49784515089716685,-1.5606674060547012,-1.170500554541026,0,0,0,0,-1.170500554541026,-1.5606674060547012
6922,29,203,25,80,88,1,2003.501,4,1421.41,MORE,-718,1694,976,3,1,8.0,0.7499267685395902,8.0,-0.17460757394239454,-1.5943419881996734,0.2863765023136691,168,80,88,0,0.1595602198545883,0.0,0.31213348121094026,0.42337489773551096,-0.9538865104976251,0.9538865104976251,0.31213348121094026,0.0,0,1,0,1,0.31213348121094026,0.0
6923,29,204,42,115,110,1,1823.675,44,864.7719999999998,MORE,148,782,930,3,2,-5.0,-0.4687042303372438,5.0,-0.6984302957695783,-0.3989590542167881,-0.0643518106637624,225,115,110,1,1.2964267863185297,1.3655839802978638,1.170500554541026,0.42337489773551096,0.10775815997010826,0.10775815997010826,1.170500554541026,1.3655839802978638,0,1,0,2,1.3655839802978638,1.170500554541026
6924,29,205,53,103,110,1,1672.41,54,1370.8239999999996,MORE,162,664,826,3,2,7.0,0.6561859224721414,7.0,-0.34921514788478913,-0.1001133207210667,-0.3593754349590874,213,103,110,0,1.0570864565366473,0.8973837584814532,1.170500554541026,0.42337489773551096,0.12492100683679218,0.12492100683679218,1.170500554541026,0.8973837584814532,0,1,1,2,1.170500554541026,0.8973837584814532
6925,29,206,26,90,80,0,1573.302,34,1192.54,MORE,-550,952,402,2,1,-10.0,-0.9374084606744876,10.0,0.17460757394239454,-0.6978047877125094,-0.5526732986860643,170,90,80,1,0.19945027481823535,0.3901668515136753,0.0,-0.6932182391493525,-0.7479323480974182,0.7479323480974182,0.0,0.3901668515136753,0,0,0,1,0.3901668515136753,0.0
6926,29,207,35,80,72,0,2313.555,14,1602.015,MORE,-296,1106,810,4,1,-8.0,-0.7499267685395902,8.0,-0.17460757394239454,-1.295496254703952,0.8910983798614345,152,80,72,1,-0.1595602198545883,0.0,-0.31213348121094026,1.5399680346203743,-0.43654926923043863,0.43654926923043863,-0.31213348121094026,0.0,0,1,0,1,0.0,-0.31213348121094026
6927,29,208,28,93,80,0,1861.73,64,713.712,MORE,-392,1152,760,2,2,-13.0,-1.218630998876834,13.0,0.6984302957695783,0.19873241277465464,0.009869747677946664,173,93,80,1,0.25928535726370594,0.5072169069677779,0.0,-0.6932182391493525,-0.5542373620305568,0.5542373620305568,0.0,0.5072169069677779,0,0,0,1,0.5072169069677779,0.0
6928,29,209,26,80,90,1,1401.1729999999998,84,1933.053,MORE,1320,328,1648,1,2,10.0,0.9374084606744876,10.0,0.17460757394239454,0.7964238797660974,-0.8883895676599186,170,80,90,0,0.19945027481823535,0.0,0.3901668515136753,-1.809811376034216,1.5445336262382185,1.5445336262382185,0.3901668515136753,0.0,1,0,1,1,0.3901668515136753,0.0
6929,29,210,25,88,80,0,1163.805,94,1777.9520000000002,MORE,1152,626,1778,2,2,-8.0,-0.7499267685395902,8.0,-0.17460757394239454,1.0952696132618187,-1.351346415917828,168,88,80,1,0.1595602198545883,0.31213348121094026,0.0,-0.6932182391493525,1.3385794638380115,1.3385794638380115,0.0,0.31213348121094026,1,0,1,1,0.31213348121094026,0.0
6930,29,211,36,80,70,0,1564.929,64,1060.629,MORE,-124,992,868,2,2,-10.0,-0.9374084606744876,10.0,0.17460757394239454,0.19873241277465464,-0.5690037968596319,150,80,70,1,-0.19945027481823535,0.0,-0.3901668515136753,-0.6932182391493525,-0.2256914362968934,0.2256914362968934,-0.3901668515136753,0.0,0,0,0,1,0.0,-0.3901668515136753
6931,29,212,28,80,93,1,1641.945,84,1353.545,MORE,1292,632,1924,3,2,13.0,1.218630998876834,13.0,0.6984302957695783,0.7964238797660974,-0.4187936395282682,173,80,93,0,0.25928535726370594,0.0,0.5072169069677779,0.42337489773551096,1.5102079325048507,1.5102079325048507,0.5072169069677779,0.0,1,1,1,1,0.5072169069677779,0.0
6932,29,213,21,82,80,1,1844.862,54,676.605,MORE,220,600,820,2,2,-2.0,-0.18748169213489754,2.0,-1.222253017596762,-0.1001133207210667,-0.023029194540104627,162,82,80,1,0.03989005496364707,0.07803337030273506,0.0,-0.6932182391493525,0.19602422957019694,0.19602422957019694,0.0,0.07803337030273506,0,0,1,1,0.07803337030273506,0.0
6933,29,214,19,50,41,0,2734.389,14,1539.662,MORE,-382,1438,1056,4,1,-9.0,-0.8436676146070391,9.0,0.0,-1.295496254703952,1.7118829097044186,91,50,41,1,-1.376206896245824,-1.170500554541026,-1.5216507209033339,1.5399680346203743,-0.5419781856972112,0.5419781856972112,-1.5216507209033339,-1.170500554541026,0,1,0,0,-1.170500554541026,-1.5216507209033339
6934,29,215,56,96,110,1,1743.563,84,1524.671,MORE,1190,662,1852,3,2,14.0,1.3123718449442827,14.0,0.8730378697119728,0.7964238797660974,-0.2206003320636041,206,96,110,0,0.9174712641638826,0.6242669624218805,1.170500554541026,0.42337489773551096,1.385164333904725,1.385164333904725,1.170500554541026,0.6242669624218805,1,1,1,2,1.170500554541026,0.6242669624218805
6935,29,216,23,80,85,1,1723.655,24,716.1419999999998,MORE,202,632,834,3,2,5.0,0.4687042303372438,5.0,-0.6984302957695783,-0.9966505212082308,-0.2594284172946316,165,80,85,0,0.09972513740911768,0.0,0.19508342575683765,0.42337489773551096,0.17395771217017478,0.17395771217017478,0.19508342575683765,0.0,0,0,1,1,0.19508342575683765,0.0
6936,29,217,10,60,50,0,2192.043,0,735.488,MORE,-624,1400,776,4,1,-10.0,-0.9374084606744876,10.0,0.17460757394239454,-1.7138802815979617,0.6541042924296196,110,60,50,1,-0.9972513740911768,-0.7803337030273506,-1.170500554541026,1.5399680346203743,-0.838650252964176,0.838650252964176,-1.170500554541026,-0.7803337030273506,0,1,0,0,-0.7803337030273506,-1.170500554541026
6937,29,218,19,41,50,1,1701.65,44,779.4810000000001,MORE,316,578,894,3,2,9.0,0.8436676146070391,9.0,0.0,-0.3989590542167881,-0.30234644097901725,91,41,50,0,-1.376206896245824,-1.5216507209033339,-1.170500554541026,0.42337489773551096,0.3137123223703152,0.3137123223703152,-1.170500554541026,-1.5216507209033339,0,1,1,0,-1.5216507209033339,-1.170500554541026
6938,29,219,56,110,96,0,1354.553,74,1395.011,MORE,288,878,1166,2,2,-14.0,-1.3123718449442827,14.0,0.8730378697119728,0.49757814627037605,-0.979316096365488,206,110,96,1,0.9174712641638826,1.170500554541026,0.6242669624218805,-0.6932182391493525,0.27938662863694735,0.27938662863694735,0.6242669624218805,1.170500554541026,1,0,1,2,1.170500554541026,0.6242669624218805
6939,29,220,35,72,80,1,1624.1070000000002,84,813.2689999999999,MORE,814,576,1390,3,2,8.0,0.7499267685395902,8.0,-0.17460757394239454,0.7964238797660974,-0.4535844464576962,152,72,80,0,-0.1595602198545883,-0.31213348121094026,0.0,0.42337489773551096,0.9242193037709285,0.9242193037709285,0.0,-0.31213348121094026,1,1,1,1,-0.31213348121094026,0.0
6940,29,221,11,49,50,1,1996.508,4,628.203,MORE,-18,1048,1030,3,1,1.0,0.09374084606744876,1.0,-1.3968605915391563,-1.5943419881996734,0.2727375230078337,99,49,50,0,-1.2166466763912356,-1.2095172396923934,-1.170500554541026,0.42337489773551096,-0.09574416716342951,0.09574416716342951,-1.170500554541026,-1.2095172396923934,0,1,0,0,-1.2095172396923934,-1.170500554541026
6941,29,222,17,43,50,1,1863.742,84,1393.378,MORE,1320,598,1918,2,2,7.0,0.6561859224721414,7.0,-0.34921514788478913,0.7964238797660974,0.01379390417206082,93,43,50,0,-1.3363168412821769,-1.4436173506005987,-1.170500554541026,-0.6932182391493525,1.5445336262382185,1.5445336262382185,-1.170500554541026,-1.4436173506005987,1,0,1,0,-1.4436173506005987,-1.170500554541026
6942,29,223,1,51,50,0,2024.489,44,1154.244,MORE,-906,1356,450,2,1,-1.0,-0.09374084606744876,1.0,-1.3968605915391563,-0.3989590542167881,0.3273109936150957,101,51,50,1,-1.1767566214275886,-1.1314838693896585,-1.170500554541026,-0.6932182391493525,-1.1843590255645233,1.1843590255645233,-1.170500554541026,-1.1314838693896585,0,0,0,0,-1.1314838693896585,-1.170500554541026
6943,29,224,41,112,110,1,2003.266,64,1449.402,MORE,118,828,946,3,2,-2.0,-0.18748169213489754,2.0,-1.222253017596762,0.19873241277465464,0.2859181639557583,222,112,110,1,1.2365917038730592,1.248533924843761,1.170500554541026,0.42337489773551096,0.0709806309700713,0.0709806309700713,1.170500554541026,1.248533924843761,1,1,0,2,1.248533924843761,1.170500554541026
6944,29,225,20,40,50,1,1060.139,100,736.398,MORE,1110,286,1396,1,2,10.0,0.9374084606744876,10.0,0.17460757394239454,1.2745770533592515,-1.5535340934122863,90,40,50,0,-1.3961519237276474,-1.5606674060547012,-1.170500554541026,-1.809811376034216,1.28709092323796,1.28709092323796,-1.170500554541026,-1.5606674060547012,1,0,1,0,-1.5606674060547012,-1.170500554541026
6945,29,226,1,50,51,1,1146.89,100,1121.888,MORE,1254,372,1626,1,2,1.0,0.09374084606744876,1.0,-1.3968605915391563,1.2745770533592515,-1.3843370258074617,101,50,51,0,-1.1767566214275886,-1.170500554541026,-1.1314838693896585,-1.809811376034216,1.4636230624381372,1.4636230624381372,-1.1314838693896585,-1.170500554541026,1,0,1,0,-1.170500554541026,-1.1314838693896585
6946,29,227,23,85,80,0,1286.04,64,1939.192,MORE,-384,772,388,2,1,-5.0,-0.4687042303372438,5.0,-0.6984302957695783,0.19873241277465464,-1.11294220664444,165,85,80,1,0.09972513740911768,0.19508342575683765,0.0,-0.6932182391493525,-0.5444300209638804,0.5444300209638804,0.0,0.19508342575683765,1,0,0,1,0.19508342575683765,0.0
6947,29,228,11,50,49,1,1779.419,74,1498.56,MORE,50,860,910,3,2,-1.0,-0.09374084606744876,1.0,-1.3968605915391563,0.49757814627037605,-0.1506676505263471,99,50,49,1,-1.2166466763912356,-1.170500554541026,-1.2095172396923934,0.42337489773551096,-0.012381768096679109,0.012381768096679109,-1.2095172396923934,-1.170500554541026,1,1,0,0,-1.170500554541026,-1.2095172396923934
6948,29,229,17,50,43,0,1254.557,94,682.84,MORE,-76,872,796,2,2,-7.0,-0.6561859224721414,7.0,-0.34921514788478913,1.0952696132618187,-1.1743458939725708,93,50,43,1,-1.3363168412821769,-1.170500554541026,-1.4436173506005987,-0.6932182391493525,-0.16684738989683429,0.16684738989683429,-1.4436173506005987,-1.170500554541026,1,0,0,0,-1.170500554541026,-1.4436173506005987
6949,29,230,21,80,82,1,1897.761,44,1183.904,MORE,200,674,874,3,2,2.0,0.18748169213489754,2.0,-1.222253017596762,-0.3989590542167881,0.08014374501364792,162,80,82,0,0.03989005496364707,0.0,0.07803337030273506,0.42337489773551096,0.17150587690350566,0.17150587690350566,0.07803337030273506,0.0,0,1,1,1,0.07803337030273506,0.0
6950,29,231,10,50,60,1,1935.818,54,1351.48,MORE,328,710,1038,3,2,10.0,0.9374084606744876,10.0,0.17460757394239454,-0.1001133207210667,0.15436920410733912,110,50,60,0,-0.9972513740911768,-1.170500554541026,-0.7803337030273506,0.42337489773551096,0.3284233339703299,0.3284233339703299,-0.7803337030273506,-1.170500554541026,0,1,1,0,-1.170500554541026,-0.7803337030273506
6951,29,232,3,53,50,0,2163.385,44,1139.782,MORE,-118,988,870,2,1,-3.0,-0.28122253820234633,3.0,-1.0476454436543674,-0.3989590542167881,0.5982104172763759,103,53,50,1,-1.1368665664639415,-1.0534504990869233,-1.170500554541026,-0.6932182391493525,-0.21833593049688602,0.21833593049688602,-1.170500554541026,-1.0534504990869233,0,0,0,0,-1.0534504990869233,-1.170500554541026
6952,29,233,45,122,110,0,1407.781,4,2647.601,MORE,-1092,2038,946,3,1,-12.0,-1.124890152809385,12.0,0.5238227218271837,-1.5943419881996734,-0.8755014831106603,232,122,110,1,1.4360419786912946,1.6387007763574364,1.170500554541026,0.42337489773551096,-1.4123797053647522,1.4123797053647522,1.170500554541026,1.6387007763574364,0,1,0,2,1.6387007763574364,1.170500554541026
6953,29,234,38,67,80,1,2491.682,34,1002.053,MORE,240,1160,1400,3,2,13.0,1.218630998876834,13.0,0.6984302957695783,-0.6978047877125094,1.2385130040299692,147,67,80,0,-0.25928535726370594,-0.5072169069677779,0.0,0.42337489773551096,0.22054258223688825,0.22054258223688825,0.0,-0.5072169069677779,0,1,1,1,-0.5072169069677779,0.0
6954,29,235,38,80,67,0,1636.52,94,1967.345,MORE,950,1216,2166,3,2,-13.0,-1.218630998876834,13.0,0.6984302957695783,1.0952696132618187,-0.4293744292800424,147,80,67,1,-0.25928535726370594,0.0,-0.5072169069677779,0.42337489773551096,1.0909441019044293,1.0909441019044293,-0.5072169069677779,0.0,1,1,1,1,0.0,-0.5072169069677779
6955,29,236,36,70,80,1,1823.604,54,1022.83,MORE,364,804,1168,3,2,10.0,0.9374084606744876,10.0,0.17460757394239454,-0.1001133207210667,-0.06449028735913108,150,70,80,0,-0.19945027481823535,-0.3901668515136753,0.0,0.42337489773551096,0.3725563687703743,0.3725563687703743,0.0,-0.3901668515136753,0,0,1,1,-0.3901668515136753,0.0
6956,29,237,45,110,122,1,2083.126,84,1421.189,MORE,1380,798,2178,3,2,12.0,1.124890152809385,12.0,0.5238227218271837,0.7964238797660974,0.4416751906058407,232,110,122,0,1.4360419786912946,1.170500554541026,1.6387007763574364,0.42337489773551096,1.6180886842382924,1.6180886842382924,1.6387007763574364,1.170500554541026,1,0,1,2,1.6387007763574364,1.170500554541026
6957,29,238,42,110,115,0,2784.636,94,1152.032,MORE,-364,1876,1512,5,2,5.0,0.4687042303372438,5.0,-0.6984302957695783,1.0952696132618187,1.8098834521297464,225,110,115,0,1.2964267863185297,1.170500554541026,1.3655839802978638,2.656561171505238,-0.519911668297189,0.519911668297189,1.3655839802978638,1.170500554541026,1,1,0,2,1.3655839802978638,1.170500554541026
6958,29,239,41,110,112,0,1742.896,54,1056.797,MORE,-574,1156,582,2,2,2.0,0.18748169213489754,2.0,-1.222253017596762,-0.1001133207210667,-0.22190123284967506,222,110,112,0,1.2365917038730592,1.170500554541026,1.248533924843761,-0.6932182391493525,-0.7773543712974477,0.7773543712974477,1.248533924843761,1.170500554541026,0,0,0,2,1.248533924843761,1.170500554541026
6959,29,240,53,110,103,0,1344.178,44,961.552,MORE,-470,832,362,2,1,-7.0,-0.6561859224721414,7.0,-0.34921514788478913,-0.3989590542167881,-0.9995512472732592,213,110,103,1,1.0570864565366473,1.170500554541026,0.8973837584814532,-0.6932182391493525,-0.6498589374306529,0.6498589374306529,0.8973837584814532,1.170500554541026,0,0,0,2,1.170500554541026,0.8973837584814532
6960,30,1,49,110,131,1,4680.924,70,1340.744,MORE,1530,1438,2968,3,2,21.0,1.9685577674164243,21.0,2.0952908873087353,0.6903531997257663,1.5227325489626509,241,110,131,0,1.6155472260277064,1.170500554541026,1.9898509427197442,0.36934918946432316,2.416076671148972,2.416076671148972,1.9898509427197442,1.170500554541026,1,1,1,2,1.9898509427197442,1.170500554541026
6961,30,2,13,47,50,1,4996.805,60,879.5239999999999,MORE,-834,2784,1950,3,2,3.0,0.28122253820234633,3.0,-1.0476454436543674,0.2698334841567715,1.7395854619596798,97,47,50,0,-1.2565367313548828,-1.2875506099951286,-1.170500554541026,0.36934918946432316,-0.8094522011346196,0.8094522011346196,-1.170500554541026,-1.2875506099951286,1,1,0,0,-1.2875506099951286,-1.170500554541026
6962,30,3,16,50,44,0,2664.6420000000007,20,396.99,MORE,-1474,2194,720,3,1,-6.0,-0.5624450764046927,6.0,-0.5238227218271837,-1.4122453781192073,0.13855108466604954,94,50,44,1,-1.3163718138003533,-1.170500554541026,-1.4046006654492311,0.36934918946432316,-1.6826918281487897,1.6826918281487897,-1.4046006654492311,-1.170500554541026,0,1,0,0,-1.170500554541026,-1.4046006654492311
6963,30,4,7,57,50,0,6709.106,70,1058.756,MORE,-2694,4466,1772,4,1,-7.0,-0.6561859224721414,7.0,-0.34921514788478913,0.6903531997257663,2.91508338610746,107,57,50,1,-1.0570864565366473,-0.8973837584814532,-1.170500554541026,1.2056115052326017,-3.3473048671445516,3.3473048671445516,-1.170500554541026,-0.8973837584814532,1,1,0,0,-0.8973837584814532,-1.170500554541026
6964,30,5,18,42,50,1,5125.906,50,1501.679,MORE,-2806,4030,1224,3,1,8.0,0.7499267685395902,8.0,-0.17460757394239454,-0.1506862314122232,1.8282135463358509,92,42,50,0,-1.3562618687640005,-1.4826340357519663,-1.170500554541026,0.36934918946432316,-3.5001218018720315,3.5001218018720315,-1.170500554541026,-1.4826340357519663,0,1,0,0,-1.4826340357519663,-1.170500554541026
6965,30,6,51,108,110,1,5155.294,70,1163.376,MORE,732,2302,3034,3,2,2.0,0.18748169213489754,2.0,-1.222253017596762,0.6903531997257663,1.8483884647613236,218,108,110,0,1.156811593945765,1.092467184238291,1.170500554541026,0.36934918946432316,1.3272560112156784,1.3272560112156784,1.170500554541026,1.092467184238291,1,1,1,2,1.170500554541026,1.092467184238291
6966,30,7,31,78,80,1,7063.925,70,1614.652,MORE,-1782,4140,2358,5,2,2.0,0.18748169213489754,2.0,-1.222253017596762,0.6903531997257663,3.1586673108661283,158,78,80,0,-0.03989005496364707,-0.07803337030273506,0.0,2.04187382100088,-2.1029383986493593,2.1029383986493593,0.0,-0.07803337030273506,1,1,0,1,-0.07803337030273506,0.0
6967,30,8,58,110,92,0,3646.841,70,1044.561,MORE,-1028,2276,1248,2,2,-18.0,-1.6873352292140782,18.0,1.571468165481551,0.6903531997257663,0.8128325840052575,202,110,92,1,0.8376911542365885,1.170500554541026,0.4682002218164104,-0.4669131263039553,-1.0741529630732898,1.0741529630732898,0.4682002218164104,1.170500554541026,1,0,0,2,1.170500554541026,0.4682002218164104
6968,30,9,12,50,48,1,2330.007,70,1950.45,MORE,-286,1420,1134,2,1,-2.0,-0.18748169213489754,2.0,-1.222253017596762,0.6903531997257663,-0.0911764853389866,98,50,48,1,-1.2365917038730592,-1.170500554541026,-1.248533924843761,-0.4669131263039553,-0.061740770503736254,0.061740770503736254,-1.248533924843761,-1.170500554541026,1,0,0,0,-1.170500554541026,-1.248533924843761
6969,30,10,54,110,101,0,2651.306,70,1317.083,MORE,-810,1670,860,2,1,-9.0,-0.8436676146070391,9.0,0.0,0.6903531997257663,0.1293958950606965,211,110,101,1,1.0171964015730004,1.170500554541026,0.8193503881787182,-0.4669131263039553,-0.7767057151215881,0.7767057151215881,0.8193503881787182,1.170500554541026,1,0,0,2,1.170500554541026,0.8193503881787182
6970,30,11,14,46,50,0,3232.755,20,2647.913,MORE,-642,2452,1810,3,1,4.0,0.3749633842697951,4.0,-0.8730378697119728,-1.4122453781192073,0.5285617499529164,96,46,50,0,-1.2764817588367063,-1.3265672951464962,-1.170500554541026,0.36934918946432316,-0.5474803130303685,0.5474803130303685,-1.170500554541026,-1.3265672951464962,0,1,0,0,-1.3265672951464962,-1.170500554541026
6971,30,12,22,80,83,1,8080.816,40,2489.405,MORE,1150,2924,4074,4,2,3.0,0.28122253820234633,3.0,-1.0476454436543674,-0.571205946981218,3.856764934814581,163,80,83,0,0.05983508244547061,0.0,0.1170500554541026,1.2056115052326017,1.8975906426093083,1.8975906426093083,0.1170500554541026,0.0,0,1,1,1,0.1170500554541026,0.0
6972,30,13,6,50,56,1,2981.293,70,839.227,MORE,102,1318,1420,3,2,6.0,0.5624450764046927,6.0,-0.5238227218271837,0.6903531997257663,0.3559326041414912,106,50,56,0,-1.077031484018471,-1.170500554541026,-0.9364004436328208,0.36934918946432316,0.46766075337360447,0.46766075337360447,-0.9364004436328208,-1.170500554541026,1,1,1,0,-1.170500554541026,-0.9364004436328208
6973,30,14,13,50,47,1,4144.639,30,1754.295,MORE,818,1472,2290,5,2,-3.0,-0.28122253820234633,3.0,-1.0476454436543674,-0.9917256625502128,1.154571866786099,97,50,47,1,-1.2565367313548828,-1.170500554541026,-1.2875506099951286,2.04187382100088,1.4445975860957074,1.4445975860957074,-1.2875506099951286,-1.170500554541026,0,1,1,0,-1.170500554541026,-1.2875506099951286
6974,30,15,46,110,124,1,11431.608,30,1072.76,MORE,1278,4448,5726,4,1,14.0,1.3123718449442827,14.0,0.8730378697119728,-0.9917256625502128,6.157090076393655,234,110,124,0,1.4759320336549415,1.170500554541026,1.7167341466601715,1.2056115052326017,2.0722385680121422,2.0722385680121422,1.7167341466601715,1.170500554541026,0,1,1,2,1.7167341466601715,1.170500554541026
6975,30,16,27,91,80,0,2894.35,30,1226.732,MORE,-422,1492,1070,2,2,-11.0,-1.0311493067419364,11.0,0.34921514788478913,-0.9917256625502128,0.2962460677094149,171,91,80,1,0.21939530230005888,0.4291835366650429,0.0,-0.4669131263039553,-0.24730419124424743,0.24730419124424743,0.0,0.4291835366650429,0,0,0,1,0.4291835366650429,0.0
6976,30,17,40,64,80,1,1524.3829999999996,70,1208.102,MORE,246,546,792,1,2,16.0,1.4998535370791803,16.0,1.222253017596762,0.6903531997257663,-0.6442389081511162,144,64,80,0,-0.3191204397091766,-0.6242669624218805,0.0,-1.3031754420722337,0.6641396694517927,0.6641396694517927,0.0,-0.6242669624218805,1,0,1,1,-0.6242669624218805,0.0
6977,30,18,22,83,80,0,2271.368,70,1036.521,MORE,-856,1588,732,2,2,-3.0,-0.28122253820234633,3.0,-1.0476454436543674,0.6903531997257663,-0.1314322714268893,163,83,80,1,0.05983508244547061,0.1170500554541026,0.0,-0.4669131263039553,-0.8394698133132317,0.8394698133132317,0.0,0.1170500554541026,1,0,0,1,0.1170500554541026,0.0
6978,30,19,54,101,110,1,2265.397,60,1760.691,MORE,430,824,1254,1,2,9.0,0.8436676146070391,9.0,0.0,0.2698334841567715,-0.1355313743913134,211,101,110,0,1.0171964015730004,0.8193503881787182,1.170500554541026,-1.3031754420722337,0.9151960622183667,0.9151960622183667,1.170500554541026,0.8193503881787182,1,0,1,2,1.170500554541026,0.8193503881787182
6979,30,20,6,56,50,0,3294.158,80,1458.224,MORE,-324,1780,1456,5,2,-6.0,-0.5624450764046927,6.0,-0.5238227218271837,1.110872915294761,0.570715027347747,106,56,50,1,-1.077031484018471,-0.9364004436328208,-1.170500554541026,2.04187382100088,-0.11358937335770261,0.11358937335770261,-1.170500554541026,-0.9364004436328208,1,1,0,0,-0.9364004436328208,-1.170500554541026
6980,30,21,18,50,42,0,2488.621,60,1152.711,MORE,-1152,1776,624,2,1,-8.0,-0.7499267685395902,8.0,-0.17460757394239454,0.2698334841567715,0.01771233020265948,92,50,42,1,-1.3562618687640005,-1.170500554541026,-1.4826340357519663,-0.4669131263039553,-1.2433431408072853,1.2433431408072853,-1.4826340357519663,-1.170500554541026,1,0,0,0,-1.170500554541026,-1.4826340357519663
6981,30,22,43,110,117,1,3996.445,60,1366.809,MORE,1150,1656,2806,3,2,7.0,0.6561859224721414,7.0,-0.34921514788478913,0.2698334841567715,1.0528364012510345,227,110,117,0,1.3363168412821769,1.170500554541026,1.4436173506005987,0.36934918946432316,1.8975906426093083,1.8975906426093083,1.4436173506005987,1.170500554541026,1,1,1,2,1.4436173506005987,1.170500554541026
6982,30,23,32,77,80,0,4653.274,50,1251.456,MORE,-1106,2516,1410,2,1,3.0,0.28122253820234633,3.0,-1.0476454436543674,-0.1506862314122232,1.5037507708741689,157,77,80,0,-0.05983508244547061,-0.1170500554541026,0.0,-0.4669131263039553,-1.180579042615642,1.180579042615642,0.0,-0.1170500554541026,0,1,0,1,-0.1170500554541026,0.0
6983,30,24,27,80,91,1,2125.698,80,1068.142,MORE,342,1238,1580,3,2,11.0,1.0311493067419364,11.0,0.34921514788478913,1.110872915294761,-0.2314350061158297,171,80,91,0,0.21939530230005888,0.0,0.4291835366650429,0.36934918946432316,0.7951256135039183,0.7951256135039183,0.4291835366650429,0.0,1,1,1,1,0.4291835366650429,0.0
6984,30,25,16,44,50,1,1427.708,80,879.592,MORE,1034,428,1462,1,2,6.0,0.5624450764046927,6.0,-0.5238227218271837,1.110872915294761,-0.7106064812688018,94,44,50,0,-1.3163718138003533,-1.4046006654492311,-1.170500554541026,-1.3031754420722337,1.73931596021299,1.73931596021299,-1.170500554541026,-1.4046006654492311,1,0,1,0,-1.4046006654492311,-1.170500554541026
6985,30,26,7,50,57,1,4625.55,20,965.623,MORE,-1368,3184,1816,5,1,7.0,0.6561859224721414,7.0,-0.34921514788478913,-1.4122453781192073,1.4847181916436054,107,50,57,0,-1.0570864565366473,-1.170500554541026,-0.8973837584814532,2.04187382100088,-1.5380615149245678,1.5380615149245678,-0.8973837584814532,-1.170500554541026,0,1,0,0,-1.170500554541026,-0.8973837584814532
6986,30,27,14,50,46,0,7677.2,40,1249.97,MORE,-1298,3806,2508,5,1,-4.0,-0.3749633842697951,4.0,-0.8730378697119728,-0.571205946981218,3.5796817758648234,96,50,46,1,-1.2764817588367063,-1.170500554541026,-1.3265672951464962,2.04187382100088,-1.442550930719893,1.442550930719893,-1.3265672951464962,-1.170500554541026,0,1,0,0,-1.170500554541026,-1.3265672951464962
6987,30,28,51,110,108,1,4418.189,0,1818.327,MORE,-1538,3402,1864,3,1,-2.0,-0.18748169213489754,2.0,-1.222253017596762,-2.2532848092571967,1.3423644670068693,218,110,108,1,1.156811593945765,1.170500554541026,1.092467184238291,0.36934918946432316,-1.7700157908502068,1.7700157908502068,1.092467184238291,1.170500554541026,0,1,0,2,1.170500554541026,1.092467184238291
6988,30,29,50,133,110,0,2149.966,50,1139.646,MORE,-978,1580,602,2,1,-23.0,-2.1560394595513217,23.0,2.444506035193524,-0.1506862314122232,-0.21477497752084646,243,133,110,1,1.6554372809913533,2.0678843130224793,1.170500554541026,-0.4669131263039553,-1.0059311172128078,1.0059311172128078,1.170500554541026,2.0678843130224793,0,1,0,2,2.0678843130224793,1.170500554541026
6989,30,30,49,131,110,0,4008.059,40,772.262,MORE,-928,2342,1414,4,1,-21.0,-1.9685577674164243,21.0,2.0952908873087353,-0.571205946981218,1.0608094345501171,241,131,110,1,1.6155472260277064,1.9898509427197442,1.170500554541026,1.2056115052326017,-0.9377092713523257,0.9377092713523257,1.170500554541026,1.9898509427197442,0,1,0,2,1.9898509427197442,1.170500554541026
6990,30,31,47,126,110,0,8436.837,20,1636.576,MORE,1530,2750,4280,6,1,-16.0,-1.4998535370791803,16.0,1.222253017596762,-1.4122453781192073,4.101174034881109,236,126,110,1,1.5158220886185887,1.7947675169629065,1.170500554541026,2.8781361367691587,2.416076671148972,2.416076671148972,1.170500554541026,1.7947675169629065,0,1,1,2,1.7947675169629065,1.170500554541026
6991,30,32,50,110,133,1,3645.965,40,1157.277,MORE,122,1694,1816,3,2,23.0,2.1560394595513217,23.0,2.444506035193524,-0.571205946981218,0.8122312083233224,243,110,133,0,1.6554372809913533,1.170500554541026,2.0678843130224793,0.36934918946432316,0.4949494917177973,0.4949494917177973,2.0678843130224793,1.170500554541026,0,1,1,2,2.0678843130224793,1.170500554541026
6992,30,33,47,110,126,1,3643.086,70,795.0360000000002,MORE,-816,1922,1106,1,2,16.0,1.4998535370791803,16.0,1.222253017596762,0.6903531997257663,0.8102547692955919,236,110,126,0,1.5158220886185887,1.170500554541026,1.7947675169629065,-1.3031754420722337,-0.784892336624846,0.784892336624846,1.7947675169629065,1.170500554541026,1,0,0,2,1.7947675169629065,1.170500554541026
6993,30,34,12,48,50,1,2815.281,50,505.629,MORE,390,1076,1466,3,2,2.0,0.18748169213489754,2.0,-1.222253017596762,-0.1506862314122232,0.24196504739555605,98,48,50,0,-1.2365917038730592,-1.248533924843761,-1.170500554541026,0.36934918946432316,0.860618585529981,0.860618585529981,-1.170500554541026,-1.248533924843761,0,1,1,0,-1.248533924843761,-1.170500554541026
6994,30,35,32,80,77,0,6715.91,70,643.909,MORE,-3566,4940,1374,2,1,-3.0,-0.28122253820234633,3.0,-1.0476454436543674,0.6903531997257663,2.9197543451712584,157,80,77,1,-0.05983508244547061,0.0,-0.1170500554541026,-0.4669131263039553,-4.5370938589513585,4.5370938589513585,-0.1170500554541026,0.0,1,0,0,1,0.0,-0.1170500554541026
6995,30,36,43,117,110,0,1956.108,60,1130.256,MORE,-588,1142,554,2,1,-7.0,-0.6561859224721414,7.0,-0.34921514788478913,0.2698334841567715,-0.34785886673158706,227,117,110,1,1.3363168412821769,1.4436173506005987,1.170500554541026,-0.4669131263039553,-0.47380071950104785,0.47380071950104785,1.170500554541026,1.4436173506005987,1,0,0,2,1.4436173506005987,1.170500554541026
6996,30,37,40,80,64,0,2144.529,80,991.187,MORE,-290,980,690,2,1,-16.0,-1.4998535370791803,16.0,1.222253017596762,1.110872915294761,-0.2185074884599812,144,80,64,1,-0.3191204397091766,0.0,-0.6242669624218805,-0.4669131263039553,-0.06719851817257481,0.06719851817257481,-0.6242669624218805,0.0,1,0,0,1,0.0,-0.6242669624218805
6997,30,38,31,80,78,1,7202.473000000001,40,400.699,MORE,368,3100,3468,5,2,-2.0,-0.18748169213489754,2.0,-1.222253017596762,-0.571205946981218,3.2537807788807047,158,80,78,1,-0.03989005496364707,0.0,-0.07803337030273506,2.04187382100088,0.830600973351369,0.830600973351369,-0.07803337030273506,0.0,0,1,1,1,0.0,-0.07803337030273506
6998,30,39,46,124,110,0,5203.542,50,1377.568,MORE,990,2142,3132,4,2,-14.0,-1.3123718449442827,14.0,0.8730378697119728,-0.1506862314122232,1.881510809398325,234,124,110,1,1.4759320336549415,1.7167341466601715,1.170500554541026,1.2056115052326017,1.6792807358557658,1.6792807358557658,1.170500554541026,1.7167341466601715,0,1,1,2,1.7167341466601715,1.170500554541026
6999,30,40,58,92,110,1,5757.076999999998,20,497.089,MORE,-56,2758,2702,3,2,18.0,1.6873352292140782,18.0,1.571468165481551,-1.4122453781192073,2.2615136496951767,202,92,110,0,0.8376911542365885,0.4682002218164104,1.170500554541026,0.36934918946432316,0.2520797204544812,0.2520797204544812,1.170500554541026,0.4682002218164104,0,1,1,2,1.170500554541026,0.4682002218164104
7000,30,41,49,110,131,0,2622.621,60,1071.357,LESS,-772,1546,774,4,1,21.0,1.9685577674164243,21.0,2.0952908873087353,0.2698334841567715,0.1097035874849963,241,110,131,1,1.6155472260277064,1.170500554541026,1.9898509427197442,1.2056115052326017,-0.7248571122676217,0.7248571122676217,1.9898509427197442,1.170500554541026,0,1,0,2,1.9898509427197442,1.170500554541026
7001,30,42,13,47,50,0,1759.82,40,984.233,LESS,-612,1188,576,2,1,3.0,0.28122253820234633,3.0,-1.0476454436543674,-0.571205946981218,-0.4826109556079701,97,47,50,1,-1.2565367313548828,-1.2875506099951286,-1.170500554541026,-0.4669131263039553,-0.5065472055140792,0.5065472055140792,-1.170500554541026,-1.2875506099951286,0,0,0,0,-1.2875506099951286,-1.170500554541026
7002,30,43,16,50,44,0,1569.966,40,336.569,LESS,-632,1034,402,2,1,-6.0,-0.5624450764046927,6.0,-0.5238227218271837,-0.571205946981218,-0.612946091130961,94,50,44,0,-1.3163718138003533,-1.170500554541026,-1.4046006654492311,-0.4669131263039553,-0.533835943858272,0.533835943858272,-1.4046006654492311,-1.170500554541026,0,0,0,0,-1.170500554541026,-1.4046006654492311
7003,30,44,7,57,50,0,1263.868,60,922.557,LESS,-366,730,364,2,1,-7.0,-0.6561859224721414,7.0,-0.34921514788478913,0.2698334841567715,-0.8230829558444591,107,57,50,0,-1.0570864565366473,-0.8973837584814532,-1.170500554541026,-0.4669131263039553,-0.17089572388050753,0.17089572388050753,-1.170500554541026,-0.8973837584814532,1,0,1,0,-0.8973837584814532,-1.170500554541026
7004,30,45,18,42,50,0,1502.927,40,498.105,LESS,-778,1118,340,2,1,8.0,0.7499267685395902,8.0,-0.17460757394239454,-0.571205946981218,-0.6589684933470101,92,42,50,1,-1.3562618687640005,-1.4826340357519663,-1.170500554541026,-0.4669131263039553,-0.7330437337708796,0.7330437337708796,-1.170500554541026,-1.4826340357519663,0,0,0,0,-1.4826340357519663,-1.170500554541026
7005,30,46,51,108,110,1,1721.158,20,1987.585,LESS,394,944,1338,3,1,2.0,0.18748169213489754,2.0,-1.222253017596762,-1.4122453781192073,-0.5091524928396844,218,108,110,1,1.156811593945765,1.092467184238291,1.170500554541026,0.36934918946432316,0.8660763331988196,0.8660763331988196,1.170500554541026,1.092467184238291,0,1,1,2,1.170500554541026,1.092467184238291
7006,30,47,31,78,80,0,1360.625,80,1444.977,LESS,-410,824,414,2,2,2.0,0.18748169213489754,2.0,-1.222253017596762,1.110872915294761,-0.7566590895693316,158,78,80,1,-0.03989005496364707,-0.07803337030273506,0.0,-0.4669131263039553,-0.23093094823773175,0.23093094823773175,0.0,-0.07803337030273506,1,0,1,1,-0.07803337030273506,0.0
7007,30,48,58,110,92,1,3261.429,60,964.579,LESS,386,1252,1638,5,2,-18.0,-1.6873352292140782,18.0,1.571468165481551,0.2698334841567715,0.5482465060074965,202,110,92,0,0.8376911542365885,1.170500554541026,0.4682002218164104,2.04187382100088,0.8551608378611425,0.8551608378611425,0.4682002218164104,1.170500554541026,1,1,1,2,1.170500554541026,0.4682002218164104
7008,30,49,12,50,48,0,1543.6270000000004,50,1581.937,LESS,-554,1030,476,2,1,-2.0,-0.18748169213489754,2.0,-1.222253017596762,-0.1506862314122232,-0.6310278652023,98,50,48,0,-1.2365917038730592,-1.170500554541026,-1.248533924843761,-0.4669131263039553,-0.42740986431592004,0.42740986431592004,-1.248533924843761,-1.170500554541026,0,0,0,0,-1.170500554541026,-1.248533924843761
7009,30,50,54,110,101,1,1838.463,80,1370.4489999999996,LESS,-316,1262,946,3,1,-9.0,-0.8436676146070391,9.0,0.0,1.110872915294761,-0.42862238511203865,211,110,101,0,1.0171964015730004,1.170500554541026,0.8193503881787182,0.36934918946432316,-0.10267387802002549,0.10267387802002549,0.8193503881787182,1.170500554541026,1,1,1,2,1.170500554541026,0.8193503881787182
7010,30,51,14,46,50,0,1697.884,100,1395.773,LESS,218,1046,1264,2,2,4.0,0.3749633842697951,4.0,-0.8730378697119728,1.9519123464327504,-0.5251301385261702,96,46,50,1,-1.2764817588367063,-1.3265672951464962,-1.170500554541026,-0.4669131263039553,0.6259354357699228,0.6259354357699228,-1.170500554541026,-1.3265672951464962,1,0,1,0,-1.3265672951464962,-1.170500554541026
7011,30,52,22,80,83,0,2697.758,60,1156.228,LESS,-1444,1978,534,2,1,3.0,0.28122253820234633,3.0,-1.0476454436543674,0.2698334841567715,0.1612852822493464,163,80,83,1,0.05983508244547061,0.0,0.1170500554541026,-0.4669131263039553,-1.6417587206325006,1.6417587206325006,0.1170500554541026,0.0,0,0,0,1,0.1170500554541026,0.0
7012,30,53,6,50,56,0,1293.9,90,1278.999,LESS,164,910,1074,2,2,6.0,0.5624450764046927,6.0,-0.5238227218271837,1.5313926308637555,-0.8024659301824952,106,50,56,1,-1.077031484018471,-1.170500554541026,-0.9364004436328208,-0.4669131263039553,0.5522558422406022,0.5522558422406022,-0.9364004436328208,-1.170500554541026,1,0,1,0,-1.170500554541026,-0.9364004436328208
7013,30,54,13,50,47,0,1246.186,80,792.416,LESS,-506,854,348,2,2,-3.0,-0.28122253820234633,3.0,-1.0476454436543674,1.110872915294761,-0.8352216827942074,97,50,47,0,-1.2565367313548828,-1.170500554541026,-1.2875506099951286,-0.4669131263039553,-0.3619168922898573,0.3619168922898573,-1.2875506099951286,-1.170500554541026,1,0,0,0,-1.170500554541026,-1.2875506099951286
7014,30,55,46,110,124,0,1392.368,70,880.078,LESS,-818,1134,316,2,1,14.0,1.3123718449442827,14.0,0.8730378697119728,0.6903531997257663,-0.7348674591222181,234,110,124,1,1.4759320336549415,1.170500554541026,1.7167341466601715,-0.4669131263039553,-0.7876212104592653,0.7876212104592653,1.7167341466601715,1.170500554541026,1,0,0,2,1.7167341466601715,1.170500554541026
7015,30,56,27,91,80,0,2027.396,20,766.716,LESS,-558,1260,702,4,1,-11.0,-1.0311493067419364,11.0,0.34921514788478913,-1.4122453781192073,-0.2989195178573839,171,91,80,0,0.21939530230005888,0.4291835366650429,0.0,1.2056115052326017,-0.4328676119847586,0.4328676119847586,0.0,0.4291835366650429,0,1,0,1,0.4291835366650429,0.0
7016,30,57,40,64,80,0,1788.23,90,1732.003,LESS,-728,1534,806,2,2,16.0,1.4998535370791803,16.0,1.222253017596762,1.5313926308637555,-0.4631074360602746,144,64,80,1,-0.3191204397091766,-0.6242669624218805,0.0,-0.4669131263039553,-0.6648218879103975,0.6648218879103975,0.0,-0.6242669624218805,1,0,0,1,-0.6242669624218805,0.0
7017,30,58,22,83,80,0,1729.763,60,608.321,LESS,-794,1212,418,3,2,-3.0,-0.28122253820234633,3.0,-1.0476454436543674,0.2698334841567715,-0.5032451438179343,163,83,80,0,0.05983508244547061,0.1170500554541026,0.0,0.36934918946432316,-0.7548747244462339,0.7548747244462339,0.0,0.1170500554541026,0,1,0,1,0.1170500554541026,0.0
7018,30,59,54,101,110,0,2108.115,50,913.716,LESS,-1064,1506,442,2,1,9.0,0.8436676146070391,9.0,0.0,-0.1506862314122232,-0.2435057693754964,211,101,110,1,1.0171964015730004,0.8193503881787182,1.170500554541026,-0.4669131263039553,-1.1232726920928369,1.1232726920928369,1.170500554541026,0.8193503881787182,0,0,0,2,1.170500554541026,0.8193503881787182
7019,30,60,6,56,50,0,1544.911,50,1972.063,LESS,-384,798,414,2,1,-6.0,-0.5624450764046927,6.0,-0.5238227218271837,-0.1506862314122232,-0.6301463967369978,106,56,50,0,-1.077031484018471,-0.9364004436328208,-1.170500554541026,-0.4669131263039553,-0.19545558839028107,0.19545558839028107,-1.170500554541026,-0.9364004436328208,0,0,1,0,-0.9364004436328208,-1.170500554541026
7020,30,61,18,50,42,1,2638.9709999999995,50,1257.372,LESS,348,1008,1356,3,2,-8.0,-0.7499267685395902,8.0,-0.17460757394239454,-0.1506862314122232,0.12092789387728105,92,50,42,0,-1.3562618687640005,-1.170500554541026,-1.4826340357519663,0.36934918946432316,0.8033122350071762,0.8033122350071762,-1.4826340357519663,-1.170500554541026,0,1,1,0,-1.170500554541026,-1.4826340357519663
7021,30,62,43,110,117,0,2949.097,60,1521.223,LESS,-138,1836,1698,2,2,7.0,0.6561859224721414,7.0,-0.34921514788478913,0.2698334841567715,0.3338299883246097,227,110,117,1,1.3363168412821769,1.170500554541026,1.4436173506005987,-0.4669131263039553,0.14019589324329063,0.14019589324329063,1.4436173506005987,1.170500554541026,0,0,1,2,1.4436173506005987,1.170500554541026
7022,30,63,32,77,80,0,1586.052,70,1706.996,LESS,-988,1436,448,2,1,3.0,0.28122253820234633,3.0,-1.0476454436543674,0.6903531997257663,-0.6019030212455605,157,77,80,1,-0.05983508244547061,-0.1170500554541026,0.0,-0.4669131263039553,-1.0195754863849043,1.0195754863849043,0.0,-0.1170500554541026,1,1,0,1,-0.1170500554541026,0.0
7023,30,64,27,80,91,0,1955.23,50,1037.708,LESS,-718,1244,526,2,1,11.0,1.0311493067419364,11.0,0.34921514788478913,-0.1506862314122232,-0.3484616154173624,171,80,91,1,0.21939530230005888,0.0,0.4291835366650429,-0.4669131263039553,-0.6511775187383012,0.6511775187383012,0.4291835366650429,0.0,0,1,0,1,0.4291835366650429,0.0
7024,30,65,16,44,50,0,1639.167,70,1036.549,LESS,-708,1200,492,2,1,6.0,0.5624450764046927,6.0,-0.5238227218271837,0.6903531997257663,-0.5654394717638342,94,44,50,1,-1.3163718138003533,-1.4046006654492311,-1.170500554541026,-0.4669131263039553,-0.6375331495662048,0.6375331495662048,-1.170500554541026,-1.4046006654492311,1,1,0,0,-1.4046006654492311,-1.170500554541026
7025,30,66,7,50,57,0,2058.719,80,638.609,LESS,-652,1526,874,2,2,7.0,0.6561859224721414,7.0,-0.34921514788478913,1.110872915294761,-0.2774162182166776,107,50,57,1,-1.0570864565366473,-1.170500554541026,-0.8973837584814532,-0.4669131263039553,-0.5611246822024648,0.5611246822024648,-0.8973837584814532,-1.170500554541026,1,1,0,0,-1.170500554541026,-0.8973837584814532
7026,30,67,14,50,46,0,2469.654,60,1073.386,LESS,-788,1406,618,2,1,-4.0,-0.3749633842697951,4.0,-0.8730378697119728,0.2698334841567715,0.004691448285688651,96,50,46,0,-1.2764817588367063,-1.170500554541026,-1.3265672951464962,-0.4669131263039553,-0.746688102942976,0.746688102942976,-1.3265672951464962,-1.170500554541026,0,1,0,0,-1.170500554541026,-1.3265672951464962
7027,30,68,51,110,108,0,1890.788,70,1325.277,LESS,-764,1296,532,2,1,-2.0,-0.18748169213489754,2.0,-1.222253017596762,0.6903531997257663,-0.3927011721471261,218,110,108,0,1.156811593945765,1.170500554541026,1.092467184238291,-0.4669131263039553,-0.7139416169299446,0.7139416169299446,1.092467184238291,1.170500554541026,1,1,0,2,1.170500554541026,1.092467184238291
7028,30,69,50,133,110,1,2168.348,60,1456.734,LESS,60,906,966,3,2,-23.0,-2.1560394595513217,23.0,2.444506035193524,0.2698334841567715,-0.20215569922708584,243,133,110,0,1.6554372809913533,2.0678843130224793,1.170500554541026,0.36934918946432316,0.41035440285079955,0.41035440285079955,1.170500554541026,2.0678843130224793,1,1,1,2,2.0678843130224793,1.170500554541026
7029,30,70,49,131,110,1,2051.107,20,989.346,LESS,-536,1530,994,3,1,-21.0,-1.9685577674164243,21.0,2.0952908873087353,-1.4122453781192073,-0.2826418708318504,241,131,110,0,1.6155472260277064,1.9898509427197442,1.170500554541026,0.36934918946432316,-0.4028499998061465,0.4028499998061465,1.170500554541026,1.9898509427197442,0,1,0,2,1.9898509427197442,1.170500554541026
7030,30,71,47,126,110,1,4226.391,20,926.331,LESS,-108,1926,1818,5,1,-16.0,-1.4998535370791803,16.0,1.222253017596762,-1.4122453781192073,1.210694771751364,236,126,110,0,1.5158220886185887,1.7947675169629065,1.170500554541026,2.04187382100088,0.18112900075957986,0.18112900075957986,1.170500554541026,1.7947675169629065,0,1,1,2,1.7947675169629065,1.170500554541026
7031,30,72,50,110,133,0,1854.214,70,1118.573,LESS,-770,1408,638,2,1,23.0,2.1560394595513217,23.0,2.444506035193524,0.6903531997257663,-0.41780929336984396,243,110,133,1,1.6554372809913533,1.170500554541026,2.0678843130224793,-0.4669131263039553,-0.7221282384332025,0.7221282384332025,2.0678843130224793,1.170500554541026,1,1,0,2,2.0678843130224793,1.170500554541026
7032,30,73,47,110,126,0,1945.727,40,1130.429,LESS,-786,1356,570,2,1,16.0,1.4998535370791803,16.0,1.222253017596762,-0.571205946981218,-0.35498544316328795,236,110,126,1,1.5158220886185887,1.170500554541026,1.7947675169629065,-0.4669131263039553,-0.7439592291085567,0.7439592291085567,1.7947675169629065,1.170500554541026,0,1,0,2,1.7947675169629065,1.170500554541026
7033,30,74,12,48,50,0,1464.471,80,1822.278,LESS,-388,846,458,2,2,2.0,0.18748169213489754,2.0,-1.222253017596762,1.110872915294761,-0.6853686111832007,98,48,50,1,-1.2365917038730592,-1.248533924843761,-1.170500554541026,-0.4669131263039553,-0.20091333605911962,0.20091333605911962,-1.170500554541026,-1.248533924843761,1,0,1,0,-1.248533924843761,-1.170500554541026
7034,30,75,32,80,77,0,1580.989,70,1162.892,LESS,-218,1010,792,2,1,-3.0,-0.28122253820234633,3.0,-1.0476454436543674,0.6903531997257663,-0.6053787804666086,157,80,77,0,-0.05983508244547061,0.0,-0.1170500554541026,-0.4669131263039553,0.031040939866519332,0.031040939866519332,-0.1170500554541026,0.0,1,0,1,1,0.0,-0.1170500554541026
7035,30,76,43,117,110,0,3685.552,20,869.4989999999998,LESS,-898,2184,1286,4,1,-7.0,-0.6561859224721414,7.0,-0.34921514788478913,-1.4122453781192073,0.8394077598310528,227,117,110,0,1.3363168412821769,1.4436173506005987,1.170500554541026,1.2056115052326017,-0.8967761638360365,0.8967761638360365,1.170500554541026,1.4436173506005987,0,1,0,2,1.4436173506005987,1.170500554541026
7036,30,77,40,80,64,0,1675.531,70,1205.819,LESS,-528,892,364,2,1,-16.0,-1.4998535370791803,16.0,1.222253017596762,0.6903531997257663,-0.5404755159443201,144,80,64,0,-0.3191204397091766,0.0,-0.6242669624218805,-0.4669131263039553,-0.3919345044684694,0.3919345044684694,-0.6242669624218805,0.0,1,0,0,1,0.0,-0.6242669624218805
7037,30,78,31,80,78,0,1582.438,10,699.42,LESS,-1272,1672,400,2,1,-2.0,-0.18748169213489754,2.0,-1.222253017596762,-1.8327650936882018,-0.6043840391845033,158,80,78,0,-0.03989005496364707,0.0,-0.07803337030273506,-0.4669131263039553,-1.4070755708724423,1.4070755708724423,-0.07803337030273506,0.0,0,0,0,1,0.0,-0.07803337030273506
7038,30,79,46,124,110,0,2956.206,30,565.827,LESS,-656,1728,1072,4,1,-14.0,-1.3123718449442827,14.0,0.8730378697119728,-0.9917256625502128,0.3387103304740137,234,124,110,0,1.4759320336549415,1.7167341466601715,1.170500554541026,1.2056115052326017,-0.5665824298713035,0.5665824298713035,1.170500554541026,1.7167341466601715,0,1,0,2,1.7167341466601715,1.170500554541026
7039,30,80,58,92,110,0,1566.142,70,588.672,LESS,-738,1128,390,2,1,18.0,1.6873352292140782,18.0,1.571468165481551,0.6903531997257663,-0.6155712744731076,202,92,110,1,0.8376911542365885,0.4682002218164104,1.170500554541026,-0.4669131263039553,-0.678466257082494,0.678466257082494,1.170500554541026,0.4682002218164104,1,0,0,2,1.170500554541026,0.4682002218164104
7040,30,81,48,128,110,0,1599.6429999999998,80,798.7669999999998,MORE,86,890,976,2,2,-18.0,-1.6873352292140782,18.0,1.571468165481551,1.110872915294761,-0.5925727736506036,238,128,110,1,1.5557121435822359,1.8728008872656416,1.170500554541026,-0.4669131263039553,0.4458297626982502,0.4458297626982502,1.170500554541026,1.8728008872656416,1,0,1,2,1.8728008872656416,1.170500554541026
7041,30,82,8,50,58,1,2116.739,20,1639.429,MORE,54,976,1030,3,1,8.0,0.7499267685395902,8.0,-0.17460757394239454,-1.4122453781192073,-0.2375853768172658,108,50,58,0,-1.0371414290548238,-1.170500554541026,-0.8583670733300858,0.36934918946432316,0.40216778134754166,0.40216778134754166,-0.8583670733300858,-1.170500554541026,0,1,1,0,-1.170500554541026,-0.8583670733300858
7042,30,83,4,54,50,1,3931.016,80,875.459,MORE,1184,1460,2644,5,2,-4.0,-0.3749633842697951,4.0,-0.8730378697119728,1.110872915294761,1.0079192671262134,104,54,50,1,-1.116921538982118,-1.0144338139355558,-1.170500554541026,2.04187382100088,1.943981497794436,1.943981497794436,-1.170500554541026,-1.0144338139355558,1,1,1,0,-1.0144338139355558,-1.170500554541026
7043,30,84,37,80,69,0,1644.6070000000002,60,1045.546,MORE,-482,986,504,2,1,-11.0,-1.0311493067419364,11.0,0.34921514788478913,0.2698334841567715,-0.5617049013189391,149,80,69,1,-0.21939530230005888,0.0,-0.4291835366650429,-0.4669131263039553,-0.32917040627682587,0.32917040627682587,-0.4291835366650429,0.0,1,1,0,1,0.0,-0.4291835366650429
7044,30,85,52,105,110,0,1523.874,40,704.3480000000002,MORE,-302,876,574,2,2,5.0,0.4687042303372438,5.0,-0.6984302957695783,-0.571205946981218,-0.6445883376284047,215,105,110,0,1.0969765115002945,0.9754171287841883,1.170500554541026,-0.4669131263039553,-0.08357176117909051,0.08357176117909051,1.170500554541026,0.9754171287841883,0,0,0,2,1.170500554541026,0.9754171287841883
7045,30,86,5,55,50,1,1139.515,90,979.513,MORE,744,458,1202,1,2,-5.0,-0.4687042303372438,5.0,-0.6984302957695783,1.5313926308637555,-0.9084515291043876,105,55,50,1,-1.0969765115002945,-0.9754171287841883,-1.170500554541026,-1.3031754420722337,1.343629254222194,1.343629254222194,-1.170500554541026,-0.9754171287841883,1,0,1,0,-0.9754171287841883,-1.170500554541026
7046,30,87,30,96,80,0,2213.43,50,988.002,MORE,-828,1666,838,3,1,-16.0,-1.4998535370791803,16.0,1.222253017596762,-0.1506862314122232,-0.17120681966885973,176,96,80,1,0.3191204397091766,0.6242669624218805,0.0,0.36934918946432316,-0.8012655796313617,0.8012655796313617,0.0,0.6242669624218805,0,1,0,1,0.6242669624218805,0.0
7047,30,88,33,80,75,0,1556.253,70,960.941,MORE,-676,1142,466,2,1,-5.0,-0.4687042303372438,5.0,-0.6984302957695783,0.6903531997257663,-0.6223600919601602,155,80,75,1,-0.09972513740911768,0.0,-0.19508342575683765,-0.4669131263039553,-0.5938711682154962,0.5938711682154962,-0.19508342575683765,0.0,1,1,0,1,0.0,-0.19508342575683765
7048,30,89,48,110,128,1,1981.274,80,1744.3470000000002,MORE,688,898,1586,3,2,18.0,1.6873352292140782,18.0,1.571468165481551,1.110872915294761,-0.33058235941242825,238,110,128,0,1.5557121435822359,1.170500554541026,1.8728008872656416,0.36934918946432316,1.2672207868584542,1.2672207868584542,1.8728008872656416,1.170500554541026,1,1,1,2,1.8728008872656416,1.170500554541026
7049,30,90,9,59,50,1,1845.04,20,1216.266,MORE,-238,1234,996,3,1,-9.0,-0.8436676146070391,9.0,0.0,-1.4122453781192073,-0.42410726198408394,109,59,50,1,-1.0171964015730004,-0.8193503881787182,-1.170500554541026,0.36934918946432316,0.003752201522326513,0.003752201522326513,-1.170500554541026,-0.8193503881787182,0,1,0,0,-0.8193503881787182,-1.170500554541026
7050,30,91,44,110,119,1,2286.256,10,1375.535,MORE,-644,1956,1312,3,1,9.0,0.8436676146070391,9.0,0.0,-1.8327650936882018,-0.1212116308416697,229,110,119,0,1.376206896245824,1.170500554541026,1.5216507209033339,0.36934918946432316,-0.5502091868647877,0.5502091868647877,1.5216507209033339,1.170500554541026,0,1,0,2,1.5216507209033339,1.170500554541026
7051,30,92,2,52,50,1,1161.042,30,1271.683,MORE,-296,914,618,1,2,-2.0,-0.18748169213489754,2.0,-1.222253017596762,-0.9917256625502128,-0.8936732022721722,102,52,50,1,-1.156811593945765,-1.092467184238291,-1.170500554541026,-1.3031754420722337,-0.07538513967583267,0.07538513967583267,-1.170500554541026,-1.092467184238291,0,0,0,0,-1.092467184238291,-1.170500554541026
7052,30,93,8,58,50,0,2561.6220000000008,60,1045.305,MORE,-466,1486,1020,4,1,-8.0,-0.7499267685395902,8.0,-0.17460757394239454,0.2698334841567715,0.067827656865853,108,58,50,1,-1.0371414290548238,-0.8583670733300858,-1.170500554541026,1.2056115052326017,-0.30733941560147165,0.30733941560147165,-1.170500554541026,-0.8583670733300858,1,1,0,0,-0.8583670733300858,-1.170500554541026
7053,30,94,44,119,110,0,3953.939,30,1654.493,MORE,-172,1894,1722,2,1,-9.0,-0.8436676146070391,9.0,0.0,-0.9917256625502128,1.023655950638773,229,119,110,1,1.376206896245824,1.5216507209033339,1.170500554541026,-0.4669131263039553,0.09380503805816282,0.09380503805816282,1.170500554541026,1.5216507209033339,0,0,0,2,1.5216507209033339,1.170500554541026
7054,30,95,34,74,80,1,2041.792,60,478.292,MORE,200,904,1104,3,2,6.0,0.5624450764046927,6.0,-0.5238227218271837,0.2698334841567715,-0.2890366362168129,154,74,80,0,-0.11967016489094122,-0.2341001109082052,0.0,0.36934918946432316,0.6013755712601493,0.6013755712601493,0.0,-0.2341001109082052,1,1,1,1,-0.2341001109082052,0.0
7055,30,96,24,86,80,0,2881.9440000000004,60,464.059,MORE,-300,1440,1140,4,1,-6.0,-0.5624450764046927,6.0,-0.5238227218271837,0.2698334841567715,0.28772932488967884,166,86,80,1,0.11967016489094122,0.2341001109082052,0.0,1.2056115052326017,-0.08084288734467122,0.08084288734467122,0.0,0.2341001109082052,1,1,0,1,0.2341001109082052,0.0
7056,30,97,39,66,80,1,1194.765,40,893.6439999999999,MORE,-26,896,870,1,1,14.0,1.3123718449442827,14.0,0.8730378697119728,-0.571205946981218,-0.870522298023424,146,66,80,0,-0.2792303847455295,-0.5462335921191455,0.0,-1.3031754420722337,0.2930128279707704,0.2930128279707704,0.0,-0.5462335921191455,0,0,1,1,-0.5462335921191455,0.0
7057,30,98,9,50,59,1,1735.61,20,1210.22,MORE,510,816,1326,1,1,9.0,0.8436676146070391,9.0,0.0,-1.4122453781192073,-0.4992311670915924,109,50,59,0,-1.0171964015730004,-1.170500554541026,-0.8193503881787182,-1.3031754420722337,1.024351015595138,1.024351015595138,-0.8193503881787182,-1.170500554541026,0,0,1,0,-1.170500554541026,-0.8193503881787182
7058,30,99,57,94,110,1,1946.147,30,1057.596,MORE,342,886,1228,1,2,16.0,1.4998535370791803,16.0,1.222253017596762,-0.9917256625502128,-0.3546971123568808,204,94,110,0,0.8775812092002355,0.5462335921191455,1.170500554541026,-1.3031754420722337,0.7951256135039183,0.7951256135039183,1.170500554541026,0.5462335921191455,0,0,1,2,1.170500554541026,0.5462335921191455
7059,30,100,60,110,87,0,2152.195,30,1354.231,MORE,-1094,1652,558,2,1,-23.0,-2.1560394595513217,23.0,2.444506035193524,-0.9917256625502128,-0.21324476474112736,197,110,87,1,0.7379660168274708,1.170500554541026,0.27311679605957273,-0.4669131263039553,-1.1642057996091262,1.1642057996091262,0.27311679605957273,1.170500554541026,0,0,0,2,1.170500554541026,0.27311679605957273
7060,30,101,33,75,80,1,1246.367,50,885.355,MORE,242,680,922,1,2,5.0,0.4687042303372438,5.0,-0.6984302957695783,-0.1506862314122232,-0.8350974259466842,155,75,80,0,-0.09972513740911768,-0.19508342575683765,0.0,-1.3031754420722337,0.6586819217829541,0.6586819217829541,0.0,-0.19508342575683765,0,0,1,1,-0.19508342575683765,0.0
7061,30,102,15,50,45,0,3708.225,20,1197.695,MORE,-882,2302,1420,4,1,-5.0,-0.4687042303372438,5.0,-0.6984302957695783,-1.4122453781192073,0.8549728178636079,95,50,45,1,-1.2964267863185297,-1.170500554541026,-1.3655839802978638,1.2056115052326017,-0.8749451731606823,0.8749451731606823,-1.3655839802978638,-1.170500554541026,0,1,0,0,-1.170500554541026,-1.3655839802978638
7062,30,103,59,89,110,1,2636.322,80,1220.038,MORE,824,1182,2006,3,2,21.0,1.9685577674164243,21.0,2.0952908873087353,1.110872915294761,0.11910935029115526,199,89,110,0,0.7778560717911179,0.3511501663623078,1.170500554541026,0.36934918946432316,1.4527842075989652,1.4527842075989652,1.170500554541026,0.3511501663623078,1,1,1,2,1.170500554541026,0.3511501663623078
7063,30,104,29,80,94,1,2813.348,50,1294.3010000000004,MORE,310,1002,1312,3,2,14.0,1.3123718449442827,14.0,0.8730378697119728,-0.1506862314122232,0.2406380391841623,174,80,94,0,0.2792303847455295,0.0,0.5462335921191455,0.36934918946432316,0.7514636321532098,0.7514636321532098,0.5462335921191455,0.0,0,1,1,1,0.5462335921191455,0.0
7064,30,105,55,110,98,1,1866.035,50,1532.909,MORE,-134,1210,1076,2,1,-12.0,-1.124890152809385,12.0,0.5238227218271837,-0.1506862314122232,-0.4096941541733178,208,110,98,1,0.9573613191275298,1.170500554541026,0.7023003327246156,-0.4669131263039553,0.14565364091212918,0.14565364091212918,0.7023003327246156,1.170500554541026,0,0,0,2,1.170500554541026,0.7023003327246156
7065,30,106,29,94,80,0,2551.49,10,1029.501,MORE,-1548,2158,610,2,1,-14.0,-1.3123718449442827,14.0,0.8730378697119728,-1.8327650936882018,0.06087201941223564,174,94,80,1,0.2792303847455295,0.5462335921191455,0.0,-0.4669131263039553,-1.7836601600223032,1.7836601600223032,0.0,0.5462335921191455,0,0,0,1,0.5462335921191455,0.0
7066,30,107,57,110,94,0,2176.205,90,844.607,MORE,-894,1732,838,2,2,-16.0,-1.4998535370791803,16.0,1.222253017596762,1.5313926308637555,-0.19676185364150886,204,110,94,1,0.8775812092002355,1.170500554541026,0.5462335921191455,-0.4669131263039553,-0.891318416167198,0.891318416167198,0.5462335921191455,1.170500554541026,1,0,0,2,1.170500554541026,0.5462335921191455
7067,30,108,39,80,66,1,2625.664,0,1110.012,MORE,-518,1926,1408,3,1,-14.0,-1.3123718449442827,14.0,0.8730378697119728,-2.2532848092571967,0.11179261282760944,146,80,66,1,-0.2792303847455295,0.0,-0.5462335921191455,0.36934918946432316,-0.37829013529637295,0.37829013529637295,-0.5462335921191455,0.0,0,1,0,1,0.0,-0.5462335921191455
7068,30,109,4,50,54,1,1778.5379999999998,70,885.763,MORE,-14,786,772,3,2,4.0,0.3749633842697951,4.0,-0.8730378697119728,0.6903531997257663,-0.4697610126690838,104,50,54,0,-1.116921538982118,-1.170500554541026,-1.0144338139355558,0.36934918946432316,0.3093860709772861,0.3093860709772861,-1.0144338139355558,-1.170500554541026,1,1,1,0,-1.170500554541026,-1.0144338139355558
7069,30,110,55,98,110,1,2022.268,60,1400.07,MORE,62,910,972,1,2,12.0,1.124890152809385,12.0,0.5238227218271837,0.2698334841567715,-0.3024398997032333,208,98,110,0,0.9573613191275298,0.7023003327246156,1.170500554541026,-1.3031754420722337,0.4130832766852188,0.4130832766852188,1.170500554541026,0.7023003327246156,1,0,1,2,1.170500554541026,0.7023003327246156
7070,30,111,2,50,52,1,4227.507000000001,70,1122.365,MORE,1578,340,1918,1,2,2.0,0.18748169213489754,2.0,-1.222253017596762,0.6903531997257663,1.2114609078941048,102,50,52,0,-1.156811593945765,-1.170500554541026,-1.092467184238291,-1.3031754420722337,2.4815696431750345,2.4815696431750345,-1.092467184238291,-1.170500554541026,1,0,1,0,-1.170500554541026,-1.092467184238291
7071,30,112,59,110,89,0,1816.041,10,1086.622,MORE,-1030,1408,378,2,1,-21.0,-1.9685577674164243,21.0,2.0952908873087353,-1.8327650936882018,-0.4440151311626697,199,110,89,1,0.7778560717911179,1.170500554541026,0.3511501663623078,-0.4669131263039553,-1.0768818369077091,1.0768818369077091,0.3511501663623078,1.170500554541026,0,0,0,2,1.170500554541026,0.3511501663623078
7072,30,113,60,87,110,1,2079.825,20,1566.875,MORE,-754,1912,1158,3,1,23.0,2.1560394595513217,23.0,2.444506035193524,-1.4122453781192073,-0.2629269086927897,197,87,110,0,0.7379660168274708,0.27311679605957273,1.170500554541026,0.36934918946432316,-0.7002972477578483,0.7002972477578483,1.170500554541026,0.27311679605957273,0,1,0,2,1.170500554541026,0.27311679605957273
7073,30,114,52,110,105,1,2516.327,30,1525.794,MORE,434,1168,1602,3,2,-5.0,-0.4687042303372438,5.0,-0.6984302957695783,-0.9917256625502128,0.036732552398662736,215,110,105,1,1.0969765115002945,1.170500554541026,0.9754171287841883,0.36934918946432316,0.9206538098872052,0.9206538098872052,0.9754171287841883,1.170500554541026,0,1,1,2,1.170500554541026,0.9754171287841883
7074,30,115,30,80,96,1,2061.501,40,1225.458,MORE,328,952,1280,3,2,16.0,1.4998535370791803,16.0,1.222253017596762,-0.571205946981218,-0.2755063698751889,176,80,96,0,0.3191204397091766,0.0,0.6242669624218805,0.36934918946432316,0.7760234966629833,0.7760234966629833,0.6242669624218805,0.0,0,1,1,1,0.6242669624218805,0.0
7075,30,116,24,80,86,1,2488.583,60,1574.908,MORE,108,1404,1512,3,1,6.0,0.5624450764046927,6.0,-0.5238227218271837,0.2698334841567715,0.017686243129698808,166,80,86,0,0.11967016489094122,0.0,0.2341001109082052,0.36934918946432316,0.4758473748768623,0.4758473748768623,0.2341001109082052,0.0,1,1,1,1,0.2341001109082052,0.0
7076,30,117,5,50,55,1,2200.586,60,907.501,MORE,470,764,1234,3,2,5.0,0.4687042303372438,5.0,-0.6984302957695783,0.2698334841567715,-0.18002425032956376,105,50,55,0,-1.0969765115002945,-1.170500554541026,-0.9754171287841883,0.36934918946432316,0.9697735389067523,0.9697735389067523,-0.9754171287841883,-1.170500554541026,0,1,1,0,-1.170500554541026,-0.9754171287841883
7077,30,118,34,80,74,1,3023.51,50,1458.154,MORE,670,1092,1762,3,2,-6.0,-0.5624450764046927,6.0,-0.5238227218271837,-0.1506862314122232,0.38491465569886746,154,80,74,1,-0.11967016489094122,0.0,-0.2341001109082052,0.36934918946432316,1.2426609223486806,1.2426609223486806,-0.2341001109082052,0.0,0,1,1,1,0.0,-0.2341001109082052
7078,30,119,15,45,50,1,1094.31,80,1230.205,MORE,314,370,684,1,2,5.0,0.4687042303372438,5.0,-0.6984302957695783,1.110872915294761,-0.939484848398776,95,45,50,0,-1.2964267863185297,-1.3655839802978638,-1.170500554541026,-1.3031754420722337,0.7569213798220483,0.7569213798220483,-1.170500554541026,-1.3655839802978638,1,0,1,0,-1.3655839802978638,-1.170500554541026
7079,30,120,37,69,80,1,1324.394,60,1215.026,MORE,450,554,1004,0,2,11.0,1.0311493067419364,11.0,0.34921514788478913,0.2698334841567715,-0.7815317406334835,149,69,80,0,-0.21939530230005888,-0.4291835366650429,0.0,-2.139437757840512,0.9424848005625596,0.9424848005625596,0.0,-0.4291835366650429,0,0,1,1,-0.4291835366650429,0.0
7080,30,121,48,128,110,0,1603.795,80,991.231,LESS,-336,980,644,3,2,-18.0,-1.6873352292140782,18.0,1.571468165481551,1.110872915294761,-0.5897224176786909,238,128,110,0,1.5557121435822359,1.8728008872656416,1.170500554541026,0.36934918946432316,-0.1299626163642183,0.1299626163642183,1.170500554541026,1.8728008872656416,1,1,1,2,1.8728008872656416,1.170500554541026
7081,30,122,8,50,58,0,1323.22,80,1907.615,LESS,-878,1230,352,2,2,8.0,0.7499267685395902,8.0,-0.17460757394239454,1.110872915294761,-0.7823376938875839,108,50,58,1,-1.0371414290548238,-1.170500554541026,-0.8583670733300858,-0.4669131263039553,-0.8694874254918438,0.8694874254918438,-0.8583670733300858,-1.170500554541026,1,0,0,0,-1.170500554541026,-0.8583670733300858
7082,30,123,4,54,50,1,3588.383,10,1054.513,LESS,386,1638,2024,5,1,-4.0,-0.3749633842697951,4.0,-0.8730378697119728,-1.8327650936882018,0.7727010547648779,104,54,50,0,-1.116921538982118,-1.0144338139355558,-1.170500554541026,2.04187382100088,0.8551608378611425,0.8551608378611425,-1.170500554541026,-1.0144338139355558,0,1,1,0,-1.0144338139355558,-1.170500554541026
7083,30,124,37,80,69,0,2471.817,10,2057.479,LESS,-1062,1954,892,4,1,-11.0,-1.0311493067419364,11.0,0.34921514788478913,-1.8327650936882018,0.006176351938686379,149,80,69,0,-0.21939530230005888,0.0,-0.4291835366650429,1.2056115052326017,-1.1205438182584178,1.1205438182584178,-0.4291835366650429,0.0,0,1,0,1,0.0,-0.4291835366650429
7084,30,125,52,105,110,0,1571.333,90,749.3539999999998,LESS,-280,1204,924,2,2,5.0,0.4687042303372438,5.0,-0.6984302957695783,1.5313926308637555,-0.6120076430062971,215,105,110,1,1.0969765115002945,0.9754171287841883,1.170500554541026,-0.4669131263039553,-0.05355414900047841,0.05355414900047841,1.170500554541026,0.9754171287841883,1,0,1,2,1.170500554541026,0.9754171287841883
7085,30,126,5,55,50,0,1910.577,60,876.135,LESS,-602,1116,514,2,1,-5.0,-0.4687042303372438,5.0,-0.6984302957695783,0.2698334841567715,-0.3791159856519011,105,55,50,0,-1.0969765115002945,-0.9754171287841883,-1.170500554541026,-0.4669131263039553,-0.4929028363419828,0.4929028363419828,-1.170500554541026,-0.9754171287841883,1,0,0,0,-0.9754171287841883,-1.170500554541026
7086,30,127,30,96,80,1,2766.492,70,820.11,LESS,370,1384,1754,3,2,-16.0,-1.4998535370791803,16.0,1.222253017596762,0.6903531997257663,0.20847130521982526,176,96,80,0,0.3191204397091766,0.6242669624218805,0.0,0.36934918946432316,0.8333298471857883,0.8333298471857883,0.0,0.6242669624218805,1,1,1,1,0.6242669624218805,0.0
7087,30,128,33,80,75,0,4175.806,20,2374.344,LESS,-678,2540,1862,4,1,-5.0,-0.4687042303372438,5.0,-0.6984302957695783,-1.4122453781192073,1.1759680721272818,155,80,75,0,-0.09972513740911768,0.0,-0.19508342575683765,1.2056115052326017,-0.5966000420499156,0.5966000420499156,-0.19508342575683765,0.0,0,1,0,1,0.0,-0.19508342575683765
7088,30,129,48,110,128,0,1537.506,20,1462.313,LESS,-486,976,490,2,1,18.0,1.6873352292140782,18.0,1.571468165481551,-1.4122453781192073,-0.6352299434547269,238,110,128,1,1.5557121435822359,1.170500554541026,1.8728008872656416,-0.4669131263039553,-0.3346281539456645,0.3346281539456645,1.8728008872656416,1.170500554541026,0,0,0,2,1.8728008872656416,1.170500554541026
7089,30,130,9,59,50,0,3805.577,50,1296.98,LESS,-494,2006,1512,6,1,-9.0,-0.8436676146070391,9.0,0.0,-0.1506862314122232,0.921805152781146,109,59,50,0,-1.0171964015730004,-0.8193503881787182,-1.170500554541026,2.8781361367691587,-0.3455436492833416,0.3455436492833416,-1.170500554541026,-0.8193503881787182,0,1,0,0,-0.8193503881787182,-1.170500554541026
7090,30,131,44,110,119,0,1168.33,70,1157.44,LESS,-564,978,414,2,1,9.0,0.8436676146070391,9.0,0.0,0.6903531997257663,-0.8886699762790851,229,110,119,1,1.376206896245824,1.170500554541026,1.5216507209033339,-0.4669131263039553,-0.4410542334880165,0.4410542334880165,1.5216507209033339,1.170500554541026,1,0,0,2,1.5216507209033339,1.170500554541026
7091,30,132,2,52,50,0,1065.975,70,1043.984,LESS,-474,828,354,2,1,-2.0,-0.18748169213489754,2.0,-1.222253017596762,0.6903531997257663,-0.95893688030247,102,52,50,0,-1.156811593945765,-1.092467184238291,-1.170500554541026,-0.4669131263039553,-0.31825491093914876,0.31825491093914876,-1.170500554541026,-1.092467184238291,1,0,1,0,-1.092467184238291,-1.170500554541026
7092,30,133,8,58,50,1,2202.548,80,948.779,LESS,0,1106,1106,5,2,-8.0,-0.7499267685395902,8.0,-0.17460757394239454,1.110872915294761,-0.17867733356248955,108,58,50,0,-1.0371414290548238,-0.8583670733300858,-1.170500554541026,2.04187382100088,0.3284881878182211,0.3284881878182211,-1.170500554541026,-0.8583670733300858,1,1,1,0,-0.8583670733300858,-1.170500554541026
7093,30,134,44,119,110,0,2837.009,80,1484.855,LESS,-502,1560,1058,4,2,-9.0,-0.8436676146070391,9.0,0.0,1.110872915294761,0.25688136111369503,229,119,110,0,1.376206896245824,1.5216507209033339,1.170500554541026,1.2056115052326017,-0.3564591446210187,0.3564591446210187,1.170500554541026,1.5216507209033339,1,1,0,2,1.5216507209033339,1.170500554541026
7094,30,135,34,74,80,1,3346.425,70,1324.359,LESS,1084,968,2052,3,2,6.0,0.5624450764046927,6.0,-0.5238227218271837,0.6903531997257663,0.6065964232012987,154,74,80,1,-0.11967016489094122,-0.2341001109082052,0.0,0.36934918946432316,1.807537806073472,1.807537806073472,0.0,-0.2341001109082052,1,1,1,1,-0.2341001109082052,0.0
7095,30,136,24,86,80,0,1614.761,80,1763.838,LESS,-738,1196,458,2,1,-6.0,-0.5624450764046927,6.0,-0.5238227218271837,1.110872915294761,-0.5821942376237798,166,86,80,0,0.11967016489094122,0.2341001109082052,0.0,-0.4669131263039553,-0.678466257082494,0.678466257082494,0.0,0.2341001109082052,1,0,0,1,0.2341001109082052,0.0
7096,30,137,39,66,80,0,1683.858,80,1457.7679999999998,LESS,-480,914,434,1,2,14.0,1.3123718449442827,14.0,0.8730378697119728,1.110872915294761,-0.5347590144563348,146,66,80,1,-0.2792303847455295,-0.5462335921191455,0.0,-1.3031754420722337,-0.3264415324424066,0.3264415324424066,0.0,-0.5462335921191455,1,0,0,1,-0.5462335921191455,0.0
7097,30,138,9,50,59,0,1578.828,70,1233.758,LESS,758,862,1620,2,1,9.0,0.8436676146070391,9.0,0.0,0.6903531997257663,-0.6068623111157664,109,50,59,1,-1.0171964015730004,-1.170500554541026,-0.8193503881787182,-0.4669131263039553,1.362731371063129,1.362731371063129,-0.8193503881787182,-1.170500554541026,1,0,1,0,-1.170500554541026,-0.8193503881787182
7098,30,139,57,94,110,0,3319.557,50,1146.079,LESS,-564,1756,1192,4,1,16.0,1.4998535370791803,16.0,1.222253017596762,-0.1506862314122232,0.5881514896142699,204,94,110,1,0.8775812092002355,0.5462335921191455,1.170500554541026,1.2056115052326017,-0.4410542334880165,0.4410542334880165,1.170500554541026,0.5462335921191455,0,1,0,2,1.170500554541026,0.5462335921191455
7099,30,140,60,110,87,1,2298.089,40,2064.845,LESS,82,970,1052,4,1,-23.0,-2.1560394595513217,23.0,2.444506035193524,-0.571205946981218,-0.1130882536221033,197,110,87,0,0.7379660168274708,1.170500554541026,0.27311679605957273,1.2056115052326017,0.44037201502941165,0.44037201502941165,0.27311679605957273,1.170500554541026,0,1,1,2,1.170500554541026,0.27311679605957273
7100,30,141,33,75,80,0,1907.883,30,1042.429,LESS,-774,1246,472,2,1,5.0,0.4687042303372438,5.0,-0.6984302957695783,-0.9917256625502128,-0.380965421824428,155,75,80,1,-0.09972513740911768,-0.19508342575683765,0.0,-0.4669131263039553,-0.7275859861020411,0.7275859861020411,0.0,-0.19508342575683765,0,0,0,1,-0.19508342575683765,0.0
7101,30,142,15,50,45,0,4006.024,10,1375.225,LESS,-912,2636,1724,4,1,-5.0,-0.4687042303372438,5.0,-0.6984302957695783,-1.8327650936882018,1.059412403142881,95,50,45,0,-1.2964267863185297,-1.170500554541026,-1.3655839802978638,1.2056115052326017,-0.9158782806769715,0.9158782806769715,-1.3655839802978638,-1.170500554541026,0,1,0,0,-1.170500554541026,-1.3655839802978638
7102,30,143,59,89,110,0,2118.075,50,447.314,LESS,-722,1366,644,1,1,21.0,1.9685577674164243,21.0,2.0952908873087353,-0.1506862314122232,-0.23666821025212265,199,89,110,1,0.7778560717911179,0.3511501663623078,1.170500554541026,-1.3031754420722337,-0.6566352664071398,0.6566352664071398,1.170500554541026,0.3511501663623078,0,0,0,2,1.170500554541026,0.3511501663623078
7103,30,144,29,80,94,0,4360.044,10,1431.235,LESS,-1086,2668,1582,6,1,14.0,1.3123718449442827,14.0,0.8730378697119728,-1.8327650936882018,1.302447812867455,174,80,94,1,0.2792303847455295,0.0,0.5462335921191455,2.8781361367691587,-1.153290304271449,1.153290304271449,0.5462335921191455,0.0,0,1,0,1,0.5462335921191455,0.0
7104,30,145,55,110,98,1,2469.076,30,1166.668,LESS,-150,1410,1260,3,2,-12.0,-1.124890152809385,12.0,0.5238227218271837,-0.9917256625502128,0.004294650175918588,208,110,98,0,0.9573613191275298,1.170500554541026,0.7023003327246156,0.36934918946432316,0.12382265023677493,0.12382265023677493,0.7023003327246156,1.170500554541026,0,1,1,2,1.170500554541026,0.7023003327246156
7105,30,146,29,94,80,1,2419.886,50,640.763,LESS,422,888,1310,3,2,-14.0,-1.3123718449442827,14.0,0.8730378697119728,-0.1506862314122232,-0.029474379269739268,174,94,80,0,0.2792303847455295,0.5462335921191455,0.0,0.36934918946432316,0.9042805668806896,0.9042805668806896,0.0,0.5462335921191455,0,1,1,1,0.5462335921191455,0.0
7106,30,147,57,110,94,1,5145.442,20,1776.128,LESS,-252,2494,2242,5,1,-16.0,-1.4998535370791803,16.0,1.222253017596762,-1.4122453781192073,1.841625047845312,204,110,94,0,0.8775812092002355,1.170500554541026,0.5462335921191455,2.04187382100088,-0.015349915318608461,0.015349915318608461,0.5462335921191455,1.170500554541026,0,1,1,2,1.170500554541026,0.5462335921191455
7107,30,148,39,80,66,0,5647.618,10,1839.032,LESS,-1204,3406,2202,4,1,-14.0,-1.3123718449442827,14.0,0.8730378697119728,-1.8327650936882018,2.186369836031989,146,80,66,0,-0.2792303847455295,0.0,-0.5462335921191455,1.2056115052326017,-1.3142938605021868,1.3142938605021868,-0.5462335921191455,0.0,0,1,0,1,0.0,-0.5462335921191455
7108,30,149,4,50,54,0,1214.361,90,1131.361,LESS,-64,856,792,2,2,4.0,0.3749633842697951,4.0,-0.8730378697119728,1.5313926308637555,-0.8570696063987623,104,50,54,1,-1.116921538982118,-1.170500554541026,-1.0144338139355558,-0.4669131263039553,0.24116422511680405,0.24116422511680405,-1.0144338139355558,-1.170500554541026,1,0,1,0,-1.170500554541026,-1.0144338139355558
7109,30,150,55,98,110,0,1420.7379999999996,70,1227.0510000000004,LESS,-286,928,642,3,2,12.0,1.124890152809385,12.0,0.5238227218271837,0.6903531997257663,-0.7153913996513236,208,98,110,1,0.9573613191275298,0.7023003327246156,1.170500554541026,0.36934918946432316,-0.061740770503736254,0.061740770503736254,1.170500554541026,0.7023003327246156,1,1,1,2,1.170500554541026,0.7023003327246156
7110,30,151,2,50,52,0,1675.888,40,1772.432,LESS,-826,1258,432,2,1,2.0,0.18748169213489754,2.0,-1.222253017596762,-0.571205946981218,-0.5402304347588739,102,50,52,1,-1.156811593945765,-1.170500554541026,-1.092467184238291,-0.4669131263039553,-0.7985367057969424,0.7985367057969424,-1.092467184238291,-1.170500554541026,0,0,0,0,-1.170500554541026,-1.092467184238291
7111,30,152,59,110,89,1,1319.379,70,1585.122,LESS,348,542,890,1,2,-21.0,-1.9685577674164243,21.0,2.0952908873087353,0.6903531997257663,-0.784974547762371,199,110,89,0,0.7778560717911179,1.170500554541026,0.3511501663623078,-1.3031754420722337,0.8033122350071762,0.8033122350071762,0.3511501663623078,1.170500554541026,1,0,1,2,1.170500554541026,0.3511501663623078
7112,30,153,60,87,110,0,1349.761,40,1273.114,LESS,-232,768,536,2,1,23.0,2.1560394595513217,23.0,2.444506035193524,-0.571205946981218,-0.7641172464284011,197,87,110,1,0.7379660168274708,0.27311679605957273,1.170500554541026,-0.4669131263039553,0.011938823025584359,0.011938823025584359,1.170500554541026,0.27311679605957273,0,0,1,2,1.170500554541026,0.27311679605957273
7113,30,154,52,110,105,0,2184.928,60,1257.46,LESS,-1166,1664,498,2,1,-5.0,-0.4687042303372438,5.0,-0.6984302957695783,0.2698334841567715,-0.19077349739319674,215,110,105,0,1.0969765115002945,1.170500554541026,0.9754171287841883,-0.4669131263039553,-1.2624452576482204,1.2624452576482204,0.9754171287841883,1.170500554541026,0,0,0,2,1.170500554541026,0.9754171287841883
7114,30,155,30,80,96,0,1432.667,70,1181.602,LESS,-508,958,450,2,1,16.0,1.4998535370791803,16.0,1.222253017596762,0.6903531997257663,-0.7072021182474354,176,80,96,1,0.3191204397091766,0.0,0.6242669624218805,-0.4669131263039553,-0.36464576612427657,0.36464576612427657,0.6242669624218805,0.0,1,0,0,1,0.6242669624218805,0.0
7115,30,156,24,80,86,0,1191.866,80,1577.858,LESS,-380,916,536,2,1,6.0,0.5624450764046927,6.0,-0.5238227218271837,1.110872915294761,-0.8725124670895547,166,80,86,1,0.11967016489094122,0.0,0.2341001109082052,-0.4669131263039553,-0.18999784072144252,0.18999784072144252,0.2341001109082052,0.0,1,0,1,1,0.2341001109082052,0.0
7116,30,157,5,50,55,0,1463.003,70,1643.564,LESS,-388,862,474,2,1,5.0,0.4687042303372438,5.0,-0.6984302957695783,0.6903531997257663,-0.6863763960017863,105,50,55,1,-1.0969765115002945,-1.170500554541026,-0.9754171287841883,-0.4669131263039553,-0.20091333605911962,0.20091333605911962,-0.9754171287841883,-1.170500554541026,1,1,1,0,-1.170500554541026,-0.9754171287841883
7117,30,158,34,80,74,0,1513.214,70,764.295,LESS,-730,1174,444,2,1,-6.0,-0.5624450764046927,6.0,-0.5238227218271837,0.6903531997257663,-0.6519064480957907,154,80,74,0,-0.11967016489094122,0.0,-0.2341001109082052,-0.4669131263039553,-0.6675507617448169,0.6675507617448169,-0.2341001109082052,0.0,1,0,0,1,0.0,-0.2341001109082052
7118,30,159,15,45,50,0,1299.286,70,1240.0,LESS,328,786,1114,2,2,5.0,0.4687042303372438,5.0,-0.6984302957695783,0.6903531997257663,-0.7987684308412812,95,45,50,1,-1.2964267863185297,-1.3655839802978638,-1.170500554541026,-0.4669131263039553,0.7760234966629833,0.7760234966629833,-1.170500554541026,-1.3655839802978638,1,0,1,0,-1.3655839802978638,-1.170500554541026
7119,30,160,37,69,80,0,1350.305,60,757.122,LESS,-428,826,398,2,1,11.0,1.0311493067419364,11.0,0.34921514788478913,0.2698334841567715,-0.7637437893839115,149,69,80,1,-0.21939530230005888,-0.4291835366650429,0.0,-0.4669131263039553,-0.2554908127475053,0.2554908127475053,0.0,-0.4291835366650429,0,0,1,1,-0.4291835366650429,0.0
7120,30,161,3,50,53,1,3843.156,30,1143.494,MORE,-210,1604,1394,5,1,3.0,0.28122253820234633,3.0,-1.0476454436543674,-0.9917256625502128,0.947603208433481,103,50,53,0,-1.1368665664639415,-1.170500554541026,-1.0534504990869233,2.04187382100088,0.04195643520419646,0.04195643520419646,-1.0534504990869233,-1.170500554541026,0,1,0,0,-1.170500554541026,-1.0534504990869233
7121,30,162,20,50,40,0,2618.833,40,1060.268,MORE,-530,1454,924,4,1,-10.0,-0.9374084606744876,10.0,0.17460757394239454,-0.571205946981218,0.10710311821197024,90,50,40,1,-1.3961519237276474,-1.170500554541026,-1.5606674060547012,1.2056115052326017,-0.39466337830288867,0.39466337830288867,-1.5606674060547012,-1.170500554541026,0,1,0,0,-1.170500554541026,-1.5606674060547012
7122,30,163,25,80,88,1,1985.126,60,908.487,MORE,-106,1074,968,3,2,8.0,0.7499267685395902,8.0,-0.17460757394239454,0.2698334841567715,-0.32793795401652104,168,80,88,0,0.1595602198545883,0.0,0.31213348121094026,0.36934918946432316,0.18385787459399913,0.18385787459399913,0.31213348121094026,0.0,1,1,0,1,0.31213348121094026,0.0
7123,30,164,42,115,110,0,1415.111,60,932.993,MORE,-618,1090,472,2,1,-5.0,-0.4687042303372438,5.0,-0.6984302957695783,0.2698334841567715,-0.7192543459552614,225,115,110,1,1.2964267863185297,1.3655839802978638,1.170500554541026,-0.4669131263039553,-0.514733827017337,0.514733827017337,1.170500554541026,1.3655839802978638,1,0,0,2,1.3655839802978638,1.170500554541026
7124,30,165,53,103,110,1,2119.5170000000007,70,1436.276,MORE,210,978,1188,3,2,7.0,0.6561859224721414,7.0,-0.34921514788478913,0.6903531997257663,-0.23567827448345685,213,103,110,0,1.0570864565366473,0.8973837584814532,1.170500554541026,0.36934918946432316,0.6150199404322457,0.6150199404322457,1.170500554541026,0.8973837584814532,1,1,1,2,1.170500554541026,0.8973837584814532
7125,30,166,26,90,80,1,3178.614,70,825.0,MORE,746,1274,2020,5,2,-10.0,-0.9374084606744876,10.0,0.17460757394239454,0.6903531997257663,0.4913938495012522,170,90,80,1,0.19945027481823535,0.3901668515136753,0.0,2.04187382100088,1.3463581280566133,1.3463581280566133,0.0,0.3901668515136753,1,1,1,1,0.3901668515136753,0.0
7126,30,167,35,80,72,1,1363.2979999999998,60,1030.086,MORE,288,618,906,1,1,-8.0,-0.7499267685395902,8.0,-0.17460757394239454,0.2698334841567715,-0.7548240699371251,152,80,72,1,-0.1595602198545883,0.0,-0.31213348121094026,-1.3031754420722337,0.7214460199745977,0.7214460199745977,-0.31213348121094026,0.0,1,0,1,1,0.0,-0.31213348121094026
7127,30,168,28,93,80,0,1475.193,60,1307.735,MORE,-616,1100,484,2,1,-13.0,-1.218630998876834,13.0,0.6984302957695783,0.2698334841567715,-0.6780079375967737,173,93,80,1,0.25928535726370594,0.5072169069677779,0.0,-0.4669131263039553,-0.5120049531829178,0.5120049531829178,0.0,0.5072169069677779,0,0,0,1,0.5072169069677779,0.0
7128,30,169,26,80,90,1,1567.0279999999998,60,1088.898,MORE,528,742,1270,1,2,10.0,0.9374084606744876,10.0,0.17460757394239454,0.2698334841567715,-0.6149630337719724,170,80,90,0,0.19945027481823535,0.0,0.3901668515136753,-1.3031754420722337,1.0489108801049116,1.0489108801049116,0.3901668515136753,0.0,0,0,1,1,0.3901668515136753,0.0
7129,30,170,25,88,80,0,1515.305,70,1064.207,MORE,-864,1310,446,2,1,-8.0,-0.7499267685395902,8.0,-0.17460757394239454,0.6903531997257663,-0.6504709725810341,168,88,80,1,0.1595602198545883,0.31213348121094026,0.0,-0.4669131263039553,-0.8503853086509088,0.8503853086509088,0.0,0.31213348121094026,1,0,0,1,0.31213348121094026,0.0
7130,30,171,36,80,70,0,1637.805,70,849.7919999999998,MORE,-522,1114,592,2,1,-10.0,-0.9374084606744876,10.0,0.17460757394239454,0.6903531997257663,-0.5663744873788978,150,80,70,1,-0.19945027481823535,0.0,-0.3901668515136753,-0.4669131263039553,-0.3837478829652115,0.3837478829652115,-0.3901668515136753,0.0,1,0,0,1,0.0,-0.3901668515136753
7131,30,172,28,80,93,1,2005.049,60,1133.646,MORE,-78,1176,1098,1,2,13.0,1.218630998876834,13.0,0.6984302957695783,0.2698334841567715,-0.3142607762640136,173,80,93,0,0.25928535726370594,0.0,0.5072169069677779,-1.3031754420722337,0.22206210827586909,0.22206210827586909,0.5072169069677779,0.0,0,0,0,1,0.5072169069677779,0.0
7132,30,173,21,82,80,1,1340.078,70,1016.172,MORE,230,622,852,1,2,-2.0,-0.18748169213489754,2.0,-1.222253017596762,0.6903531997257663,-0.77076464451993,162,82,80,1,0.03989005496364707,0.07803337030273506,0.0,-1.3031754420722337,0.6423086787764385,0.6423086787764385,0.0,0.07803337030273506,1,0,1,1,0.07803337030273506,0.0
7133,30,174,19,50,41,0,1613.2620000000004,70,1111.502,MORE,-588,1118,530,2,1,-9.0,-0.8436676146070391,9.0,0.0,0.6903531997257663,-0.5832233040018856,91,50,41,1,-1.376206896245824,-1.170500554541026,-1.5216507209033339,-0.4669131263039553,-0.47380071950104785,0.47380071950104785,-1.5216507209033339,-1.170500554541026,1,0,0,0,-1.170500554541026,-1.5216507209033339
7134,30,175,56,96,110,1,1794.529,60,1018.511,MORE,596,756,1352,1,2,14.0,1.3123718449442827,14.0,0.8730378697119728,0.2698334841567715,-0.4587831604660848,206,96,110,0,0.9174712641638826,0.6242669624218805,1.170500554541026,-1.3031754420722337,1.1416925904751671,1.1416925904751671,1.170500554541026,0.6242669624218805,0,0,1,2,1.170500554541026,0.6242669624218805
7135,30,176,23,80,85,1,2032.982,70,993.129,MORE,-288,1046,758,1,2,5.0,0.4687042303372438,5.0,-0.6984302957695783,0.6903531997257663,-0.2950847181321665,165,80,85,0,0.09972513740911768,0.0,0.19508342575683765,-1.3031754420722337,-0.06446964433815554,0.06446964433815554,0.19508342575683765,0.0,1,0,0,1,0.19508342575683765,0.0
7136,30,177,10,60,50,1,2459.925,40,1245.625,MORE,208,1148,1356,3,1,-10.0,-0.9374084606744876,10.0,0.17460757394239454,-0.571205946981218,-0.001987528894160885,110,60,50,1,-0.9972513740911768,-0.7803337030273506,-1.170500554541026,0.36934918946432316,0.6122910665978264,0.6122910665978264,-1.170500554541026,-0.7803337030273506,0,1,1,0,-0.7803337030273506,-1.170500554541026
7137,30,178,19,41,50,1,2123.6,90,820.933,MORE,988,490,1478,1,2,9.0,0.8436676146070391,9.0,0.0,1.5313926308637555,-0.23287528714402625,91,41,50,0,-1.376206896245824,-1.5216507209033339,-1.170500554541026,-1.3031754420722337,1.6765518620213464,1.6765518620213464,-1.170500554541026,-1.5216507209033339,1,0,1,0,-1.5216507209033339,-1.170500554541026
7138,30,179,56,110,96,0,2061.373,0,1199.118,MORE,-1334,1942,608,2,1,-14.0,-1.3123718449442827,14.0,0.8730378697119728,-2.2532848092571967,-0.2755942421209513,206,110,96,1,0.9174712641638826,1.170500554541026,0.6242669624218805,-0.4669131263039553,-1.49167065973944,1.49167065973944,0.6242669624218805,1.170500554541026,0,0,0,2,1.170500554541026,0.6242669624218805
7139,30,180,35,72,80,1,1303.593,70,845.9780000000002,MORE,676,508,1184,1,2,8.0,0.7499267685395902,8.0,-0.17460757394239454,0.6903531997257663,-0.7958116670717662,152,72,80,0,-0.1595602198545883,-0.31213348121094026,0.0,-1.3031754420722337,1.2508475438519384,1.2508475438519384,0.0,-0.31213348121094026,1,0,1,1,-0.31213348121094026,0.0
7140,30,181,11,49,50,1,1128.022,70,1311.686,MORE,488,424,912,1,2,1.0,0.09374084606744876,1.0,-1.3968605915391563,0.6903531997257663,-0.916341495671148,99,49,50,0,-1.2166466763912356,-1.2095172396923934,-1.170500554541026,-1.3031754420722337,0.9943334034165259,0.9943334034165259,-1.170500554541026,-1.2095172396923934,1,0,1,0,-1.2095172396923934,-1.170500554541026
7141,30,182,17,43,50,1,1167.204,70,1013.759,MORE,436,456,892,1,2,7.0,0.6561859224721414,7.0,-0.34921514788478913,0.6903531997257663,-0.8894429774410247,93,43,50,0,-1.3363168412821769,-1.4436173506005987,-1.170500554541026,-1.3031754420722337,0.9233826837216246,0.9233826837216246,-1.170500554541026,-1.4436173506005987,1,0,1,0,-1.4436173506005987,-1.170500554541026
7142,30,183,1,51,50,1,2388.657,70,1132.643,MORE,244,950,1194,3,2,-1.0,-0.09374084606744876,1.0,-1.3968605915391563,0.6903531997257663,-0.050913147729963734,101,51,50,1,-1.1767566214275886,-1.1314838693896585,-1.170500554541026,0.36934918946432316,0.6614107956173735,0.6614107956173735,-1.170500554541026,-1.1314838693896585,1,1,1,0,-1.1314838693896585,-1.170500554541026
7143,30,184,41,112,110,1,1491.197,50,1636.046,MORE,-270,860,590,1,1,-2.0,-0.18748169213489754,2.0,-1.222253017596762,-0.1506862314122232,-0.6670211608688147,222,112,110,1,1.2365917038730592,1.248533924843761,1.170500554541026,-1.3031754420722337,-0.039909779828382,0.039909779828382,1.170500554541026,1.248533924843761,0,0,0,2,1.248533924843761,1.170500554541026
7144,30,185,20,40,50,1,1295.26,10,883.7669999999998,MORE,-308,1036,728,1,1,10.0,0.9374084606744876,10.0,0.17460757394239454,-1.8327650936882018,-0.8015322875712716,90,40,50,0,-1.3961519237276474,-1.5606674060547012,-1.170500554541026,-1.3031754420722337,-0.09175838268234836,0.09175838268234836,-1.170500554541026,-1.5606674060547012,0,0,0,0,-1.5606674060547012,-1.170500554541026
7145,30,186,1,50,51,1,1321.192,40,1411.731,MORE,-124,820,696,3,2,1.0,0.09374084606744876,1.0,-1.3968605915391563,-0.571205946981218,-0.7837299197813793,101,50,51,0,-1.1767566214275886,-1.170500554541026,-1.1314838693896585,0.36934918946432316,0.1592980100842256,0.1592980100842256,-1.1314838693896585,-1.170500554541026,0,1,0,0,-1.170500554541026,-1.1314838693896585
7146,30,187,23,85,80,0,2679.099,20,1351.941,MORE,-1032,2002,970,4,1,-5.0,-0.4687042303372438,5.0,-0.6984302957695783,-1.4122453781192073,0.14847584292374127,165,85,80,1,0.09972513740911768,0.19508342575683765,0.0,1.2056115052326017,-1.0796107107421284,1.0796107107421284,0.0,0.19508342575683765,0,1,0,1,0.19508342575683765,0.0
7147,30,188,11,50,49,1,1085.844,30,1034.224,MORE,586,428,1014,1,2,-1.0,-0.09374084606744876,1.0,-1.3968605915391563,-0.9917256625502128,-0.9452967736536436,99,50,49,1,-1.2166466763912356,-1.170500554541026,-1.2095172396923934,-1.3031754420722337,1.1280482213030707,1.1280482213030707,-1.2095172396923934,-1.170500554541026,0,0,1,0,-1.170500554541026,-1.2095172396923934
7148,30,189,17,50,43,1,1613.271,50,944.328,MORE,564,292,856,1,2,-7.0,-0.6561859224721414,7.0,-0.34921514788478913,-0.1506862314122232,-0.5832171254846058,93,50,43,1,-1.3363168412821769,-1.170500554541026,-1.4436173506005987,-1.3031754420722337,1.0980306091244585,1.0980306091244585,-1.4436173506005987,-1.170500554541026,0,0,1,0,-1.170500554541026,-1.4436173506005987
7149,30,190,21,80,82,1,1137.866,60,1060.023,MORE,-192,702,510,2,1,2.0,0.18748169213489754,2.0,-1.222253017596762,0.2698334841567715,-0.9095835707704965,162,80,82,0,0.03989005496364707,0.0,0.07803337030273506,-0.4669131263039553,0.06651629971397,0.06651629971397,0.07803337030273506,0.0,0,0,0,1,0.07803337030273506,0.0
7150,30,191,10,50,60,1,1864.358,70,787.507,MORE,920,480,1400,1,2,10.0,0.9374084606744876,10.0,0.17460757394239454,0.6903531997257663,-0.4108454178931871,110,50,60,0,-0.9972513740911768,-1.170500554541026,-0.7803337030273506,-1.3031754420722337,1.5837701516510907,1.5837701516510907,-0.7803337030273506,-1.170500554541026,1,0,1,0,-1.170500554541026,-0.7803337030273506
7151,30,192,3,53,50,1,1023.655,60,944.602,MORE,416,304,720,1,2,-3.0,-0.28122253820234633,3.0,-1.0476454436543674,0.2698334841567715,-0.9879896415576079,103,53,50,1,-1.1368665664639415,-1.0534504990869233,-1.170500554541026,-1.3031754420722337,0.8960939453774317,0.8960939453774317,-1.170500554541026,-1.0534504990869233,0,0,1,0,-1.0534504990869233,-1.170500554541026
7152,30,193,45,122,110,0,3151.754000000001,90,1554.26,MORE,-828,2178,1350,4,2,-12.0,-1.124890152809385,12.0,0.5238227218271837,1.5313926308637555,0.4729544079295843,232,122,110,1,1.4360419786912946,1.6387007763574364,1.170500554541026,1.2056115052326017,-0.8012655796313617,0.8012655796313617,1.170500554541026,1.6387007763574364,1,1,0,2,1.6387007763574364,1.170500554541026
7153,30,194,38,67,80,1,1274.345,90,826.757,MORE,856,424,1280,1,2,13.0,1.218630998876834,13.0,0.6984302957695783,1.5313926308637555,-0.8158904752284363,147,67,80,0,-0.25928535726370594,-0.5072169069677779,0.0,-1.3031754420722337,1.4964461889496739,1.4964461889496739,0.0,-0.5072169069677779,1,0,1,1,-0.5072169069677779,0.0
7154,30,195,38,80,67,0,1855.381,80,981.758,MORE,-82,1348,1266,2,2,-13.0,-1.218630998876834,13.0,0.6984302957695783,1.110872915294761,-0.4170081456291835,147,80,67,1,-0.25928535726370594,0.0,-0.5072169069677779,-0.4669131263039553,0.2166043606070305,0.2166043606070305,-0.5072169069677779,0.0,1,0,0,1,0.0,-0.5072169069677779
7155,30,196,36,70,80,1,2353.3160000000007,60,1385.0279999999998,MORE,1468,574,2042,2,2,10.0,0.9374084606744876,10.0,0.17460757394239454,0.2698334841567715,-0.07517481208529966,150,70,80,0,-0.19945027481823535,-0.3901668515136753,0.0,-0.4669131263039553,2.331481582281974,2.331481582281974,0.0,-0.3901668515136753,0,0,1,1,-0.3901668515136753,0.0
7156,30,197,45,110,122,1,1601.665,70,732.4580000000002,MORE,336,658,994,1,2,12.0,1.124890152809385,12.0,0.5238227218271837,0.6903531997257663,-0.5911846667683281,232,110,122,0,1.4360419786912946,1.170500554541026,1.6387007763574364,-1.3031754420722337,0.7869389920006604,0.7869389920006604,1.6387007763574364,1.170500554541026,1,0,1,2,1.6387007763574364,1.170500554541026
7157,30,198,42,110,115,1,2335.574,70,1319.983,MORE,16,1260,1276,3,2,5.0,0.4687042303372438,5.0,-0.6984302957695783,0.6903531997257663,-0.08735472915024951,225,110,115,0,1.2964267863185297,1.170500554541026,1.3655839802978638,0.36934918946432316,0.3503191784935753,0.3503191784935753,1.3655839802978638,1.170500554541026,1,1,1,2,1.3655839802978638,1.170500554541026
7158,30,199,41,110,112,1,1638.986,70,1773.668,MORE,-342,1140,798,1,1,2.0,0.18748169213489754,2.0,-1.222253017596762,0.6903531997257663,-0.5655637286113573,222,110,112,0,1.2365917038730592,1.170500554541026,1.248533924843761,-1.3031754420722337,-0.13814923786747615,0.13814923786747615,1.248533924843761,1.170500554541026,1,0,0,2,1.248533924843761,1.170500554541026
7159,30,200,53,110,103,1,1278.711,60,1233.505,MORE,172,718,890,1,2,-7.0,-0.6561859224721414,7.0,-0.34921514788478913,0.2698334841567715,-0.8128932078456401,213,110,103,1,1.0570864565366473,1.170500554541026,0.8973837584814532,-1.3031754420722337,0.5631713375782793,0.5631713375782793,0.8973837584814532,1.170500554541026,1,0,1,2,1.170500554541026,0.8973837584814532
7160,30,201,3,50,53,0,4951.973,10,1227.55,LESS,-1476,3060,1584,5,1,3.0,0.28122253820234633,3.0,-1.0476454436543674,-1.8327650936882018,1.7088082078814577,103,50,53,1,-1.1368665664639415,-1.170500554541026,-1.0534504990869233,2.04187382100088,-1.685420701983209,1.685420701983209,-1.0534504990869233,-1.170500554541026,0,1,0,0,-1.170500554541026,-1.0534504990869233
7161,30,202,20,50,40,1,1892.671,20,1437.194,LESS,-292,1256,964,3,1,-10.0,-0.9374084606744876,10.0,0.17460757394239454,-1.4122453781192073,-0.3914084890317333,90,50,40,0,-1.3961519237276474,-1.170500554541026,-1.5606674060547012,0.36934918946432316,-0.0699273920069941,0.0699273920069941,-1.5606674060547012,-1.170500554541026,0,1,1,0,-1.170500554541026,-1.5606674060547012
7162,30,203,25,80,88,1,1307.743,20,1442.38,LESS,-330,1248,918,2,1,8.0,0.7499267685395902,8.0,-0.17460757394239454,-1.4122453781192073,-0.7929626841036939,168,80,88,1,0.1595602198545883,0.0,0.31213348121094026,-0.4669131263039553,-0.12177599486096045,0.12177599486096045,0.31213348121094026,0.0,0,0,1,1,0.31213348121094026,0.0
7163,30,204,42,115,110,1,3760.532,10,1741.168,LESS,-606,2580,1974,5,1,-5.0,-0.4687042303372438,5.0,-0.6984302957695783,-1.8327650936882018,0.8908816737939603,225,115,110,0,1.2964267863185297,1.3655839802978638,1.170500554541026,2.04187382100088,-0.4983605840108214,0.4983605840108214,1.170500554541026,1.3655839802978638,0,1,0,2,1.3655839802978638,1.170500554541026
7164,30,205,53,103,110,1,1488.636,10,869.572,LESS,-610,1348,738,3,1,7.0,0.6561859224721414,7.0,-0.34921514788478913,-1.8327650936882018,-0.6687792922859793,213,103,110,1,1.0570864565366473,0.8973837584814532,1.170500554541026,0.36934918946432316,-0.50381833167966,0.50381833167966,1.170500554541026,0.8973837584814532,0,1,0,2,1.170500554541026,0.8973837584814532
7165,30,206,26,90,80,1,2358.702,70,1169.579,LESS,474,1050,1524,3,2,-10.0,-0.9374084606744876,10.0,0.17460757394239454,0.6903531997257663,-0.07147731274408607,170,90,80,0,0.19945027481823535,0.3901668515136753,0.0,0.36934918946432316,0.9752312865755909,0.9752312865755909,0.0,0.3901668515136753,1,1,1,1,0.3901668515136753,0.0
7166,30,207,35,80,72,1,3096.968,10,1218.605,LESS,-312,1910,1598,3,1,-8.0,-0.7499267685395902,8.0,-0.17460757394239454,-1.8327650936882018,0.43534371373950825,152,80,72,0,-0.1595602198545883,0.0,-0.31213348121094026,0.36934918946432316,-0.09721613035118692,0.09721613035118692,-0.31213348121094026,0.0,0,1,1,1,0.0,-0.31213348121094026
7167,30,208,28,93,80,1,1104.932,60,809.487,LESS,320,474,794,1,2,-13.0,-1.218630998876834,13.0,0.6984302957695783,0.2698334841567715,-0.9321928250043506,173,93,80,0,0.25928535726370594,0.5072169069677779,0.0,-1.3031754420722337,0.7651080013253062,0.7651080013253062,0.0,0.5072169069677779,1,0,1,1,0.5072169069677779,0.0
7168,30,209,26,80,90,0,1242.689,90,814.938,LESS,-174,772,598,2,2,10.0,0.9374084606744876,10.0,0.17460757394239454,1.5313926308637555,-0.8376223800085083,170,80,90,1,0.19945027481823535,0.0,0.3901668515136753,-0.4669131263039553,0.09107616422374354,0.09107616422374354,0.3901668515136753,0.0,1,0,1,1,0.3901668515136753,0.0
7169,30,210,25,88,80,0,1565.027,60,998.198,LESS,-78,1050,972,3,2,-8.0,-0.7499267685395902,8.0,-0.17460757394239454,0.2698334841567715,-0.616336724113927,168,88,80,0,0.1595602198545883,0.31213348121094026,0.0,0.36934918946432316,0.22206210827586909,0.22206210827586909,0.0,0.31213348121094026,0,1,1,1,0.31213348121094026,0.0
7170,30,211,36,80,70,1,2800.238,70,904.672,LESS,872,856,1728,3,2,-10.0,-0.9374084606744876,10.0,0.17460757394239454,0.6903531997257663,0.2316379990127336,150,80,70,0,-0.19945027481823535,0.0,-0.3901668515136753,0.36934918946432316,1.518277179625028,1.518277179625028,-0.3901668515136753,0.0,1,1,1,1,0.0,-0.3901668515136753
7171,30,212,28,80,93,0,1284.573,100,1392.116,LESS,440,920,1360,2,2,13.0,1.218630998876834,13.0,0.6984302957695783,1.9519123464327504,-0.8088689335904978,173,80,93,1,0.25928535726370594,0.0,0.5072169069677779,-0.4669131263039553,0.9288404313904631,0.9288404313904631,0.5072169069677779,0.0,1,1,1,1,0.5072169069677779,0.0
7172,30,213,21,82,80,1,2681.524000000001,10,1344.9520000000002,LESS,-1016,2336,1320,5,1,-2.0,-0.18748169213489754,2.0,-1.222253017596762,-1.8327650936882018,0.150140610079784,162,82,80,0,0.03989005496364707,0.07803337030273506,0.0,2.04187382100088,-1.0577797200667742,1.0577797200667742,0.0,0.07803337030273506,0,1,0,1,0.07803337030273506,0.0
7173,30,214,19,50,41,1,3887.457,70,1216.661,LESS,-152,1932,1780,5,2,-9.0,-0.8436676146070391,9.0,0.0,0.6903531997257663,0.9780159299921736,91,50,41,0,-1.376206896245824,-1.170500554541026,-1.5216507209033339,2.04187382100088,0.12109377640235564,0.12109377640235564,-1.5216507209033339,-1.170500554541026,1,1,1,0,-1.170500554541026,-1.5216507209033339
7174,30,215,56,96,110,0,2981.58,20,973.016,LESS,-1136,2094,958,2,1,14.0,1.3123718449442827,14.0,0.8730378697119728,-1.4122453781192073,0.3561296301925361,206,96,110,1,0.9174712641638826,0.6242669624218805,1.170500554541026,-0.4669131263039553,-1.221512150131931,1.221512150131931,1.170500554541026,0.6242669624218805,0,0,0,2,1.170500554541026,0.6242669624218805
7175,30,216,23,80,85,0,1766.287,70,442.709,LESS,-608,1096,488,2,1,5.0,0.4687042303372438,5.0,-0.6984302957695783,0.6903531997257663,-0.4781713476912173,165,80,85,1,0.09972513740911768,0.0,0.19508342575683765,-0.4669131263039553,-0.5010894578452406,0.5010894578452406,0.19508342575683765,0.0,1,0,0,1,0.19508342575683765,0.0
7176,30,217,10,60,50,1,3680.474,90,802.1,LESS,1258,1350,2608,3,2,-10.0,-0.9374084606744876,10.0,0.17460757394239454,1.5313926308637555,0.8359217030812042,110,60,50,0,-0.9972513740911768,-0.7803337030273506,-1.170500554541026,0.36934918946432316,2.0449498296679494,2.0449498296679494,-1.170500554541026,-0.7803337030273506,1,1,1,0,-0.7803337030273506,-1.170500554541026
7177,30,218,19,41,50,0,1529.816,70,1676.671,LESS,-506,918,412,2,1,9.0,0.8436676146070391,9.0,0.0,0.6903531997257663,-0.6405091432196611,91,41,50,1,-1.376206896245824,-1.5216507209033339,-1.170500554541026,-0.4669131263039553,-0.3619168922898573,0.3619168922898573,-1.170500554541026,-1.5216507209033339,1,0,0,0,-1.5216507209033339,-1.170500554541026
7178,30,219,56,110,96,1,1301.982,70,885.393,LESS,652,594,1246,1,2,-14.0,-1.3123718449442827,14.0,0.8730378697119728,0.6903531997257663,-0.7969176216649143,206,110,96,0,0.9174712641638826,1.170500554541026,0.6242669624218805,-1.3031754420722337,1.218101057838907,1.218101057838907,0.6242669624218805,1.170500554541026,1,0,1,2,1.170500554541026,0.6242669624218805
7179,30,220,35,72,80,0,2182.417,80,1342.682,LESS,-652,1240,588,2,1,8.0,0.7499267685395902,8.0,-0.17460757394239454,1.110872915294761,-0.19249730371436047,152,72,80,1,-0.1595602198545883,-0.31213348121094026,0.0,-0.4669131263039553,-0.5611246822024648,0.5611246822024648,0.0,-0.31213348121094026,1,0,0,1,-0.31213348121094026,0.0
7180,30,221,11,49,50,1,4965.714,90,813.191,LESS,290,2438,2728,5,2,1.0,0.09374084606744876,1.0,-1.3968605915391563,1.5313926308637555,1.7182414307644172,99,49,50,1,-1.2166466763912356,-1.2095172396923934,-1.170500554541026,2.04187382100088,0.724174893809017,0.724174893809017,-1.170500554541026,-1.2095172396923934,1,1,1,0,-1.2095172396923934,-1.170500554541026
7181,30,222,17,43,50,0,1465.364,70,1329.93,LESS,-450,858,408,2,1,7.0,0.6561859224721414,7.0,-0.34921514788478913,0.6903531997257663,-0.6847555649686251,93,43,50,1,-1.3363168412821769,-1.4436173506005987,-1.170500554541026,-0.4669131263039553,-0.2855084249261174,0.2855084249261174,-1.170500554541026,-1.4436173506005987,1,0,1,0,-1.4436173506005987,-1.170500554541026
7182,30,223,1,51,50,1,2571.036,70,970.081,LESS,1436,1030,2466,3,2,-1.0,-0.09374084606744876,1.0,-1.3968605915391563,0.6903531997257663,0.0742903859408967,101,51,50,0,-1.1767566214275886,-1.1314838693896585,-1.170500554541026,0.36934918946432316,2.2878196009312655,2.2878196009312655,-1.170500554541026,-1.1314838693896585,1,1,1,0,-1.1314838693896585,-1.170500554541026
7183,30,224,41,112,110,0,2076.659,60,786.132,LESS,-728,1300,572,2,1,-2.0,-0.18748169213489754,2.0,-1.222253017596762,0.2698334841567715,-0.2651003737715647,222,112,110,0,1.2365917038730592,1.248533924843761,1.170500554541026,-0.4669131263039553,-0.6648218879103975,0.6648218879103975,1.170500554541026,1.248533924843761,0,0,0,2,1.248533924843761,1.170500554541026
7184,30,225,20,40,50,0,1933.268,90,820.576,LESS,-142,1444,1302,3,2,10.0,0.9374084606744876,10.0,0.17460757394239454,1.5313926308637555,-0.3635385705847853,90,40,50,1,-1.3961519237276474,-1.5606674060547012,-1.170500554541026,0.36934918946432316,0.13473814557445205,0.13473814557445205,-1.170500554541026,-1.5606674060547012,1,1,1,0,-1.5606674060547012,-1.170500554541026
7185,30,226,1,50,51,0,1267.656,30,1021.401,LESS,-110,788,678,2,1,1.0,0.09374084606744876,1.0,-1.3968605915391563,-0.9917256625502128,-0.820482486571433,101,50,51,1,-1.1767566214275886,-1.170500554541026,-1.1314838693896585,-0.4669131263039553,0.17840012692516055,0.17840012692516055,-1.1314838693896585,-1.170500554541026,0,0,1,0,-1.170500554541026,-1.1314838693896585
7186,30,227,23,85,80,1,1443.931,80,1377.263,LESS,522,506,1028,1,2,-5.0,-0.4687042303372438,5.0,-0.6984302957695783,1.110872915294761,-0.6994693606203588,165,85,80,0,0.09972513740911768,0.19508342575683765,0.0,-1.3031754420722337,1.0407242586016536,1.0407242586016536,0.0,0.19508342575683765,1,0,1,1,0.19508342575683765,0.0
7187,30,228,11,50,49,1,2438.279,50,1387.191,LESS,-76,1552,1476,1,2,-1.0,-0.09374084606744876,1.0,-1.3968605915391563,-0.1506862314122232,-0.016847549454858494,99,50,49,0,-1.2166466763912356,-1.170500554541026,-1.2095172396923934,-1.3031754420722337,0.22479098211028836,0.22479098211028836,-1.2095172396923934,-1.170500554541026,0,0,1,0,-1.170500554541026,-1.2095172396923934
7188,30,229,17,50,43,1,2751.097,60,1324.45,LESS,214,1452,1666,3,1,-7.0,-0.6561859224721414,7.0,-0.34921514788478913,0.2698334841567715,0.19790260816115687,93,50,43,0,-1.3363168412821769,-1.170500554541026,-1.4436173506005987,0.36934918946432316,0.6204776881010843,0.6204776881010843,-1.4436173506005987,-1.170500554541026,1,1,1,0,-1.170500554541026,-1.4436173506005987
7189,30,230,21,80,82,0,1564.7220000000002,10,1165.874,LESS,-98,848,750,3,1,2.0,0.18748169213489754,2.0,-1.222253017596762,-1.8327650936882018,-0.6165461071995323,162,80,82,1,0.03989005496364707,0.0,0.07803337030273506,0.36934918946432316,0.19477336993167627,0.19477336993167627,0.07803337030273506,0.0,0,1,1,1,0.07803337030273506,0.0
7190,30,231,10,50,60,0,2352.118,20,902.811,LESS,-12,1100,1088,4,1,10.0,0.9374084606744876,10.0,0.17460757394239454,-1.4122453781192073,-0.0759972413854811,110,50,60,1,-0.9972513740911768,-1.170500554541026,-0.7803337030273506,1.2056115052326017,0.3121149448117054,0.3121149448117054,-0.7803337030273506,-1.170500554541026,0,1,1,0,-1.170500554541026,-0.7803337030273506
7191,30,232,3,53,50,0,1822.72,40,697.059,LESS,-528,1224,696,2,1,-3.0,-0.28122253820234633,3.0,-1.0476454436543674,-0.571205946981218,-0.4394299848388732,103,53,50,0,-1.1368665664639415,-1.0534504990869233,-1.170500554541026,-0.4669131263039553,-0.3919345044684694,0.3919345044684694,-1.170500554541026,-1.0534504990869233,0,0,0,0,-1.0534504990869233,-1.170500554541026
7192,30,233,45,122,110,0,1442.999,30,660.623,LESS,-422,990,568,2,1,-12.0,-1.124890152809385,12.0,0.5238227218271837,-0.9917256625502128,-0.7001091804098151,232,122,110,0,1.4360419786912946,1.6387007763574364,1.170500554541026,-0.4669131263039553,-0.24730419124424743,0.24730419124424743,1.170500554541026,1.6387007763574364,0,0,1,2,1.6387007763574364,1.170500554541026
7193,30,234,38,67,80,0,1255.61,20,1240.169,LESS,-1150,1554,404,2,1,13.0,1.218630998876834,13.0,0.6984302957695783,-1.4122453781192073,-0.8287520886999631,147,67,80,1,-0.25928535726370594,-0.5072169069677779,0.0,-0.4669131263039553,-1.2406142669728661,1.2406142669728661,0.0,-0.5072169069677779,0,0,0,1,-0.5072169069677779,0.0
7194,30,235,38,80,67,1,2348.812,30,1537.596,LESS,128,1190,1318,3,1,-13.0,-1.218630998876834,13.0,0.6984302957695783,-0.9917256625502128,-0.07826681673305877,147,80,67,0,-0.25928535726370594,0.0,-0.5072169069677779,0.36934918946432316,0.5031361132210551,0.5031361132210551,-0.5072169069677779,0.0,0,1,1,1,0.0,-0.5072169069677779
7195,30,236,36,70,80,0,1643.121,30,1305.859,LESS,-636,1254,618,2,1,10.0,0.9374084606744876,10.0,0.17460757394239454,-0.9917256625502128,-0.5627250431720852,150,70,80,1,-0.19945027481823535,-0.3901668515136753,0.0,-0.4669131263039553,-0.5392936915271106,0.5392936915271106,0.0,-0.3901668515136753,0,1,0,1,-0.3901668515136753,0.0
7196,30,237,45,110,122,0,1182.747,60,1325.32,LESS,-342,822,480,2,1,12.0,1.124890152809385,12.0,0.5238227218271837,0.2698334841567715,-0.8787726780981936,232,110,122,1,1.4360419786912946,1.170500554541026,1.6387007763574364,-0.4669131263039553,-0.13814923786747615,0.13814923786747615,1.6387007763574364,1.170500554541026,1,0,1,2,1.6387007763574364,1.170500554541026
7197,30,238,42,110,115,0,1408.4779999999996,70,1535.7020000000002,LESS,-536,1012,476,2,1,5.0,0.4687042303372438,5.0,-0.6984302957695783,0.6903531997257663,-0.7238079131907375,225,110,115,1,1.2964267863185297,1.170500554541026,1.3655839802978638,-0.4669131263039553,-0.4028499998061465,0.4028499998061465,1.3655839802978638,1.170500554541026,1,0,0,2,1.3655839802978638,1.170500554541026
7198,30,239,41,110,112,0,1268.188,70,1022.02,LESS,-642,984,342,2,1,2.0,0.18748169213489754,2.0,-1.222253017596762,0.6903531997257663,-0.8201172675499836,222,110,112,1,1.2365917038730592,1.170500554541026,1.248533924843761,-0.4669131263039553,-0.5474803130303685,0.5474803130303685,1.248533924843761,1.170500554541026,1,0,0,2,1.248533924843761,1.170500554541026
7199,30,240,53,110,103,0,2633.434,30,1285.419,LESS,-188,1246,1058,4,1,-7.0,-0.6561859224721414,7.0,-0.34921514788478913,-0.9917256625502128,0.11712673274614492,213,110,103,0,1.0570864565366473,1.170500554541026,0.8973837584814532,1.2056115052326017,0.07197404738280856,0.07197404738280856,0.8973837584814532,1.170500554541026,0,1,1,2,1.170500554541026,0.8973837584814532
7200,31,1,49,110,131,0,6096.335999999998,94,1724.289,LESS,1366,1876,3242,6,2,21.0,1.9685577674164243,21.0,2.0952908873087353,1.6729527362319292,4.0499666116556385,241,110,131,1,1.6155472260277064,1.170500554541026,1.9898509427197442,3.477303043244411,1.5337570803486018,1.5337570803486018,1.9898509427197442,1.170500554541026,1,1,1,2,1.9898509427197442,1.170500554541026
7201,31,2,13,47,50,0,2154.377,74,2444.0170000000007,LESS,-1034,1718,684,1,1,3.0,0.28122253820234633,3.0,-1.0476454436543674,0.8224789876708977,0.05952134865092895,97,47,50,1,-1.2565367313548828,-1.2875506099951286,-1.170500554541026,-0.9951124464590114,-1.4737325988348977,1.4737325988348977,-1.170500554541026,-1.2875506099951286,1,0,0,0,-1.2875506099951286,-1.170500554541026
7202,31,3,16,50,44,0,2968.935,4,3000.168,LESS,190,1656,1846,2,1,-6.0,-0.5624450764046927,6.0,-0.5238227218271837,-2.1541791322927133,0.8840984466224178,94,50,44,0,-1.3163718138003533,-1.170500554541026,-1.4046006654492311,-0.10062934851832685,0.060087137548686984,0.060087137548686984,-1.4046006654492311,-1.170500554541026,0,0,1,0,-1.170500554541026,-1.4046006654492311
7203,31,4,7,57,50,0,4781.326,84,216.927,LESS,-528,2352,1824,4,2,-7.0,-0.6561859224721414,7.0,-0.34921514788478913,1.2477158619514137,2.718781932843957,107,57,50,0,-1.0570864565366473,-0.8973837584814532,-1.170500554541026,1.6883368473630422,-0.8396535248070433,0.8396535248070433,-1.170500554541026,-0.8973837584814532,1,1,0,0,-0.8973837584814532,-1.170500554541026
7204,31,5,18,42,50,1,1575.279,0,1969.083,LESS,-564,1492,928,1,1,8.0,0.7499267685395902,8.0,-0.17460757394239454,-2.324273882004919,-0.5266995813271612,92,42,50,1,-1.3562618687640005,-1.4826340357519663,-1.170500554541026,-0.9951124464590114,-0.8847658699947957,0.8847658699947957,-1.170500554541026,-1.4826340357519663,0,0,0,0,-1.4826340357519663,-1.170500554541026
7205,31,6,51,108,110,0,2038.495,100,2044.215,LESS,138,1108,1246,2,2,2.0,0.18748169213489754,2.0,-1.222253017596762,1.9280948608002384,-0.05778600486733755,218,108,110,1,1.156811593945765,1.092467184238291,1.170500554541026,-0.10062934851832685,-0.005075138833622169,0.005075138833622169,1.170500554541026,1.092467184238291,1,0,0,2,1.170500554541026,1.092467184238291
7206,31,7,31,78,80,1,2003.743,34,1693.878,LESS,-6,864,858,1,2,2.0,0.18748169213489754,2.0,-1.222253017596762,-0.8784685094511654,-0.09296545594228267,158,78,80,1,-0.03989005496364707,-0.07803337030273506,0.0,-0.9951124464590114,-0.18552451958463215,0.18552451958463215,0.0,-0.07803337030273506,0,0,0,1,-0.07803337030273506,0.0
7207,31,8,58,110,92,1,2588.606,74,2316.71,LESS,-124,1500,1376,4,1,-18.0,-1.6873352292140782,18.0,1.571468165481551,0.8224789876708977,0.4990913837804861,202,110,92,0,0.8376911542365885,1.170500554541026,0.4682002218164104,1.6883368473630422,-0.33339276214448754,0.33339276214448754,0.4682002218164104,1.170500554541026,1,1,0,2,1.170500554541026,0.4682002218164104
7208,31,9,12,50,48,0,1709.4029999999998,100,1992.511,LESS,222,1020,1242,2,2,-2.0,-0.18748169213489754,2.0,-1.222253017596762,1.9280948608002384,-0.3909258504346677,98,50,48,0,-1.2365917038730592,-1.170500554541026,-1.248533924843761,-0.10062934851832685,0.10018699993780031,0.10018699993780031,-1.248533924843761,-1.170500554541026,1,0,1,0,-1.170500554541026,-1.248533924843761
7209,31,10,54,110,101,0,5923.665,84,1228.147,LESS,-860,2126,1266,5,2,-9.0,-0.8436676146070391,9.0,0.0,1.2477158619514137,3.875171751027135,211,110,101,0,1.0171964015730004,1.170500554541026,0.8193503881787182,2.5828199453037266,-1.255689597094094,1.255689597094094,0.8193503881787182,1.170500554541026,1,1,0,2,1.170500554541026,0.8193503881787182
7210,31,11,14,46,50,1,1410.3770000000004,64,2156.356,LESS,60,704,764,2,1,4.0,0.3749633842697951,4.0,-0.8730378697119728,0.3972421133903819,-0.6936298829259352,96,46,50,1,-1.2764817588367063,-1.3265672951464962,-1.170500554541026,-0.10062934851832685,-0.1028185534070859,0.1028185534070859,-1.170500554541026,-1.3265672951464962,1,0,0,0,-1.3265672951464962,-1.170500554541026
7211,31,12,22,80,83,0,1544.886,84,1254.027,LESS,-86,906,820,2,2,3.0,0.28122253820234633,3.0,-1.0476454436543674,1.2477158619514137,-0.5574664165171017,163,80,83,1,0.05983508244547061,0.0,0.1170500554541026,-0.10062934851832685,-0.28577417555741547,0.28577417555741547,0.1170500554541026,0.0,1,0,0,1,0.1170500554541026,0.0
7212,31,13,6,50,56,0,1265.558,24,1884.415,LESS,-420,792,372,2,1,6.0,0.5624450764046927,6.0,-0.5238227218271837,-1.3037053837316812,-0.8402301627723469,106,50,56,1,-1.077031484018471,-1.170500554541026,-0.9364004436328208,-0.10062934851832685,-0.7043164892437858,0.7043164892437858,-0.9364004436328208,-1.170500554541026,0,0,0,0,-1.170500554541026,-0.9364004436328208
7213,31,14,13,50,47,0,1523.132,94,1398.565,LESS,114,938,1052,2,2,-3.0,-0.28122253820234633,3.0,-1.0476454436543674,1.6729527362319292,-0.5794879916403853,97,50,47,0,-1.2565367313548828,-1.170500554541026,-1.2875506099951286,-0.10062934851832685,-0.03515003562545717,0.03515003562545717,-1.2875506099951286,-1.170500554541026,1,0,0,0,-1.170500554541026,-1.2875506099951286
7214,31,15,46,110,124,0,1942.804,64,1669.446,LESS,-1410,1784,374,2,1,14.0,1.3123718449442827,14.0,0.8730378697119728,0.3972421133903819,-0.1546540082286569,234,110,124,1,1.4759320336549415,1.170500554541026,1.7167341466601715,-0.10062934851832685,-1.9449059819069794,1.9449059819069794,1.7167341466601715,1.170500554541026,1,0,0,2,1.7167341466601715,1.170500554541026
7215,31,16,27,91,80,1,1891.699,94,1269.127,LESS,-2,1202,1200,3,2,-11.0,-1.0311493067419364,11.0,0.34921514788478913,1.6729527362319292,-0.20638760189765648,171,91,80,0,0.21939530230005888,0.4291835366650429,0.0,0.7938537494223578,-0.18051203678599298,0.18051203678599298,0.0,0.4291835366650429,1,1,0,1,0.4291835366650429,0.0
7216,31,17,40,64,80,1,1478.435,54,2104.749,LESS,-1398,1606,208,2,1,16.0,1.4998535370791803,16.0,1.222253017596762,-0.027994760890133873,-0.6247347666374166,144,64,80,1,-0.3191204397091766,-0.6242669624218805,0.0,-0.10062934851832685,-1.929868533511062,1.929868533511062,0.0,-0.6242669624218805,1,1,0,1,-0.6242669624218805,0.0
7217,31,18,22,83,80,0,2422.093,94,230.546,LESS,-510,1072,562,4,1,-3.0,-0.28122253820234633,3.0,-1.0476454436543674,1.6729527362319292,0.3305302668133373,163,83,80,0,0.05983508244547061,0.1170500554541026,0.0,1.6883368473630422,-0.8170973522131669,0.8170973522131669,0.0,0.1170500554541026,1,1,0,1,0.1170500554541026,0.0
7218,31,19,54,101,110,0,3354.148,4,6358.91,LESS,-230,734,504,0,1,9.0,0.8436676146070391,9.0,0.0,-2.1541791322927133,1.2740495828716367,211,101,110,1,1.0171964015730004,0.8193503881787182,1.170500554541026,-1.889595544399696,-0.46622355630842544,0.46622355630842544,1.170500554541026,0.8193503881787182,0,0,0,2,1.170500554541026,0.8193503881787182
7219,31,20,6,56,50,1,2758.789,74,1273.989,LESS,-538,1422,884,3,2,-6.0,-0.5624450764046927,6.0,-0.5238227218271837,0.8224789876708977,0.6713676419033968,106,56,50,0,-1.077031484018471,-0.9364004436328208,-1.170500554541026,0.7938537494223578,-0.8521847318036412,0.8521847318036412,-1.170500554541026,-0.9364004436328208,1,1,0,0,-0.9364004436328208,-1.170500554541026
7220,31,21,18,50,42,1,2038.497,74,1552.106,LESS,160,1070,1230,3,2,-8.0,-0.7499267685395902,8.0,-0.17460757394239454,0.8224789876708977,-0.057783980267252476,92,50,42,0,-1.3562618687640005,-1.170500554541026,-1.4826340357519663,0.7938537494223578,0.022493516558893242,0.022493516558893242,-1.4826340357519663,-1.170500554541026,1,1,1,0,-1.170500554541026,-1.4826340357519663
7221,31,22,43,110,117,0,1830.465,44,1718.457,LESS,226,976,1202,2,2,7.0,0.6561859224721414,7.0,-0.34921514788478913,-0.4532316351706496,-0.2683747826965514,227,110,117,1,1.3363168412821769,1.170500554541026,1.4436173506005987,-0.10062934851832685,0.10519948273643948,0.10519948273643948,1.4436173506005987,1.170500554541026,0,1,1,2,1.4436173506005987,1.170500554541026
7222,31,23,32,77,80,0,1524.358,84,1232.263,LESS,-246,860,614,2,2,3.0,0.28122253820234633,3.0,-1.0476454436543674,1.2477158619514137,-0.5782469117883515,157,77,80,1,-0.05983508244547061,-0.1170500554541026,0.0,-0.10062934851832685,-0.4862734875029821,0.4862734875029821,0.0,-0.1170500554541026,1,1,0,1,-0.1170500554541026,0.0
7223,31,24,27,80,91,0,1563.865,94,1134.964,LESS,282,876,1158,2,2,11.0,1.0311493067419364,11.0,0.34921514788478913,1.6729527362319292,-0.5382539740115945,171,80,91,1,0.21939530230005888,0.0,0.4291835366650429,-0.10062934851832685,0.1753742419173878,0.1753742419173878,0.4291835366650429,0.0,1,1,1,1,0.4291835366650429,0.0
7224,31,25,16,44,50,0,1462.32,84,1714.4489999999996,LESS,-124,872,748,2,2,6.0,0.5624450764046927,6.0,-0.5238227218271837,1.2477158619514137,-0.6410479818213697,94,44,50,1,-1.3163718138003533,-1.4046006654492311,-1.170500554541026,-0.10062934851832685,-0.33339276214448754,0.33339276214448754,-1.170500554541026,-1.4046006654492311,1,1,0,0,-1.4046006654492311,-1.170500554541026
7225,31,26,7,50,57,0,1475.7220000000002,84,1781.441,LESS,-90,804,714,2,2,7.0,0.6561859224721414,7.0,-0.34921514788478913,1.2477158619514137,-0.6274811366525614,107,50,57,1,-1.0570864565366473,-1.170500554541026,-0.8973837584814532,-0.10062934851832685,-0.2907866583560546,0.2907866583560546,-0.8973837584814532,-1.170500554541026,1,1,0,0,-1.170500554541026,-0.8973837584814532
7226,31,27,14,50,46,0,2483.344,74,1827.818,LESS,-702,1004,302,2,1,-4.0,-0.3749633842697951,4.0,-0.8730378697119728,0.8224789876708977,0.3925346567129538,96,50,46,0,-1.2764817588367063,-1.170500554541026,-1.3265672951464962,-0.10062934851832685,-1.0576965265478468,1.0576965265478468,-1.3265672951464962,-1.170500554541026,1,1,0,0,-1.170500554541026,-1.3265672951464962
7227,31,28,51,110,108,0,1105.658,4,1880.462,LESS,-1868,2142,274,2,1,-2.0,-0.18748169213489754,2.0,-1.222253017596762,-2.1541791322927133,-1.0020969395588264,218,110,108,0,1.156811593945765,1.170500554541026,1.092467184238291,-0.10062934851832685,-2.5188352623511636,2.5188352623511636,1.092467184238291,1.170500554541026,0,1,0,2,1.170500554541026,1.092467184238291
7228,31,29,50,133,110,0,2386.711,54,1100.474,LESS,-1226,1654,428,2,1,-23.0,-2.1560394595513217,23.0,2.444506035193524,-0.027994760890133873,0.2947130667116536,243,133,110,0,1.6554372809913533,2.0678843130224793,1.170500554541026,-0.10062934851832685,-1.7143317731695777,1.7143317731695777,1.170500554541026,2.0678843130224793,1,1,0,2,2.0678843130224793,1.170500554541026
7229,31,30,49,131,110,1,1200.033,44,1244.015,LESS,62,584,646,1,1,-21.0,-1.9685577674164243,21.0,2.0952908873087353,-0.4532316351706496,-0.9065611230533605,241,131,110,0,1.6155472260277064,1.9898509427197442,1.170500554541026,-0.9951124464590114,-0.10031231200776632,0.10031231200776632,1.170500554541026,1.9898509427197442,0,0,0,2,1.9898509427197442,1.170500554541026
7230,31,31,47,126,110,1,1258.244,14,1562.55,LESS,-830,1570,740,1,1,-16.0,-1.4998535370791803,16.0,1.222253017596762,-1.7289422580121967,-0.8476341252827679,236,126,110,0,1.5158220886185887,1.7947675169629065,1.170500554541026,-0.9951124464590114,-1.2180959761043002,1.2180959761043002,1.170500554541026,1.7947675169629065,0,0,0,2,1.7947675169629065,1.170500554541026
7231,31,32,50,110,133,1,1657.223,24,433.541,LESS,-486,1160,674,2,1,23.0,2.1560394595513217,23.0,2.444506035193524,-1.3037053837316812,-0.4437476666492922,243,110,133,1,1.6554372809913533,1.170500554541026,2.0678843130224793,-0.10062934851832685,-0.787022455421332,0.787022455421332,2.0678843130224793,1.170500554541026,0,0,0,2,2.0678843130224793,1.170500554541026
7232,31,33,47,110,126,1,2445.093,54,4247.123,LESS,-2082,2328,246,1,2,16.0,1.4998535370791803,16.0,1.222253017596762,-0.027994760890133873,0.3538131677895038,236,110,126,1,1.5158220886185887,1.170500554541026,1.7947675169629065,-0.9951124464590114,-2.7870030920783595,2.7870030920783595,1.7947675169629065,1.170500554541026,1,0,0,2,1.7947675169629065,1.170500554541026
7233,31,34,12,48,50,0,1654.7820000000004,64,2275.75,LESS,-658,1086,428,2,1,2.0,0.18748169213489754,2.0,-1.222253017596762,0.3972421133903819,-0.4462186910528928,98,48,50,1,-1.2365917038730592,-1.248533924843761,-1.170500554541026,-0.10062934851832685,-1.002559215762816,1.002559215762816,-1.170500554541026,-1.248533924843761,1,0,0,0,-1.248533924843761,-1.170500554541026
7234,31,35,32,80,77,1,1409.967,24,1010.512,LESS,410,642,1052,2,1,-3.0,-0.28122253820234633,3.0,-1.0476454436543674,-1.3037053837316812,-0.6940449259433368,157,80,77,0,-0.05983508244547061,0.0,-0.1170500554541026,-0.10062934851832685,0.3357736914738411,0.3357736914738411,-0.1170500554541026,0.0,0,0,1,1,0.0,-0.1170500554541026
7235,31,36,43,117,110,1,1320.501,4,2155.555,LESS,-1230,1972,742,1,1,-7.0,-0.6561859224721414,7.0,-0.34921514788478913,-2.1541791322927133,-0.7846113615404549,227,117,110,0,1.3363168412821769,1.4436173506005987,1.170500554541026,-0.9951124464590114,-1.7193442559682168,1.7193442559682168,1.170500554541026,1.4436173506005987,0,0,0,2,1.4436173506005987,1.170500554541026
7236,31,37,40,80,64,1,4470.013,64,2018.936,LESS,-110,1488,1378,4,1,-16.0,-1.4998535370791803,16.0,1.222253017596762,0.3972421133903819,2.403639769731204,144,80,64,0,-0.3191204397091766,0.0,-0.6242669624218805,1.6883368473630422,-0.31584907234925047,0.31584907234925047,-0.6242669624218805,0.0,1,1,0,1,0.0,-0.6242669624218805
7237,31,38,31,80,78,1,1087.963,44,1304.561,LESS,186,346,532,1,2,-2.0,-0.18748169213489754,2.0,-1.222253017596762,-0.4532316351706496,-1.020009588809838,158,80,78,0,-0.03989005496364707,0.0,-0.07803337030273506,-0.9951124464590114,0.05507465475004782,0.05507465475004782,-0.07803337030273506,0.0,0,0,1,1,0.0,-0.07803337030273506
7238,31,39,46,124,110,1,1599.5320000000004,44,1394.322,LESS,458,834,1292,1,1,-14.0,-1.3123718449442827,14.0,0.8730378697119728,-0.4532316351706496,-0.5021482683978145,234,124,110,0,1.4759320336549415,1.7167341466601715,1.170500554541026,-0.9951124464590114,0.3959234850575111,0.3959234850575111,1.170500554541026,1.7167341466601715,0,0,1,2,1.7167341466601715,1.170500554541026
7239,31,40,58,92,110,0,1193.386,74,1690.255,LESS,278,284,562,1,2,18.0,1.6873352292140782,18.0,1.571468165481551,0.8224789876708977,-0.9132898814354724,202,92,110,1,0.8376911542365885,0.4682002218164104,1.170500554541026,-0.9951124464590114,0.17036175911874862,0.17036175911874862,1.170500554541026,0.4682002218164104,1,0,1,2,1.170500554541026,0.4682002218164104
7240,31,41,49,110,131,1,2046.481,64,1734.241,MORE,194,426,620,2,2,21.0,1.9685577674164243,21.0,2.0952908873087353,0.3972421133903819,-0.049701776728395465,241,110,131,0,1.6155472260277064,1.170500554541026,1.9898509427197442,-0.10062934851832685,0.06509962034732615,0.06509962034732615,1.9898509427197442,1.170500554541026,1,0,0,2,1.9898509427197442,1.170500554541026
7241,31,42,13,47,50,1,2236.711,64,1403.979,MORE,174,810,984,3,1,3.0,0.28122253820234633,3.0,-1.0476454436543674,0.3972421133903819,0.14286806034535024,97,47,50,0,-1.2565367313548828,-1.2875506099951286,-1.170500554541026,0.7938537494223578,0.04003720635413032,0.04003720635413032,-1.170500554541026,-1.2875506099951286,1,1,0,0,-1.2875506099951286,-1.170500554541026
7242,31,43,16,50,44,1,3024.71,64,1474.2679999999998,MORE,1102,1008,2110,4,2,-6.0,-0.5624450764046927,6.0,-0.5238227218271837,0.3972421133903819,0.9405594814896217,94,50,44,1,-1.3163718138003533,-1.170500554541026,-1.4046006654492311,1.6883368473630422,1.202933215638417,1.202933215638417,-1.4046006654492311,-1.170500554541026,1,1,1,0,-1.170500554541026,-1.4046006654492311
7243,31,44,7,57,50,0,3844.919,84,1583.795,MORE,1764,990,2754,2,2,-7.0,-0.6561859224721414,7.0,-0.34921514788478913,1.2477158619514137,1.77085708700095,107,57,50,1,-1.0570864565366473,-0.8973837584814532,-1.170500554541026,-0.10062934851832685,2.032499118813199,2.032499118813199,-1.170500554541026,-0.8973837584814532,1,1,1,0,-0.8973837584814532,-1.170500554541026
7244,31,45,18,42,50,1,1426.509,74,1383.307,MORE,-228,896,668,1,1,8.0,0.7499267685395902,8.0,-0.17460757394239454,0.8224789876708977,-0.6772994586412611,92,42,50,0,-1.3562618687640005,-1.4826340357519663,-1.170500554541026,-0.9951124464590114,-0.46371731490910584,0.46371731490910584,-1.170500554541026,-1.4826340357519663,1,0,0,0,-1.4826340357519663,-1.170500554541026
7245,31,46,51,108,110,0,1620.875,84,1406.21,MORE,-164,944,780,2,2,2.0,0.18748169213489754,2.0,-1.222253017596762,1.2477158619514137,-0.4805427485919748,218,108,110,0,1.156811593945765,1.092467184238291,1.170500554541026,-0.10062934851832685,-0.3835175901308792,0.3835175901308792,1.170500554541026,1.092467184238291,1,1,0,2,1.170500554541026,1.092467184238291
7246,31,47,31,78,80,1,1745.47,84,1845.382,MORE,524,698,1222,2,2,2.0,0.18748169213489754,2.0,-1.222253017596762,1.2477158619514137,-0.354415224803911,158,78,80,0,-0.03989005496364707,-0.07803337030273506,0.0,-0.10062934851832685,0.47862945123505735,0.47862945123505735,0.0,-0.07803337030273506,1,1,1,1,-0.07803337030273506,0.0
7247,31,48,58,110,92,0,1190.6,14,2177.181,MORE,-1900,1900,0,0,1,-18.0,-1.6873352292140782,18.0,1.571468165481551,-1.7289422580121967,-0.9161101493537159,202,110,92,1,0.8376911542365885,1.170500554541026,0.4682002218164104,-1.889595544399696,-2.558935124740277,2.558935124740277,0.4682002218164104,1.170500554541026,0,0,0,2,1.170500554541026,0.4682002218164104
7248,31,49,12,50,48,1,3212.1020000000008,0,1413.754,MORE,-796,1812,1016,2,1,-2.0,-0.18748169213489754,2.0,-1.222253017596762,-2.324273882004919,1.130256411042918,98,50,48,1,-1.2365917038730592,-1.170500554541026,-1.248533924843761,-0.10062934851832685,-1.1754898723158673,1.1754898723158673,-1.248533924843761,-1.170500554541026,0,1,0,0,-1.170500554541026,-1.248533924843761
7249,31,50,54,110,101,0,2959.508,64,1448.902,MORE,588,662,1250,0,1,-9.0,-0.8436676146070391,9.0,0.0,0.3972421133903819,0.8745554941223167,211,110,101,1,1.0171964015730004,1.170500554541026,0.8193503881787182,-1.889595544399696,0.558829176013284,0.558829176013284,0.8193503881787182,1.170500554541026,1,0,1,2,1.170500554541026,0.8193503881787182
7250,31,51,14,46,50,0,1523.935,74,1538.1729999999998,MORE,-384,1000,616,4,1,4.0,0.3749633842697951,4.0,-0.8730378697119728,0.8224789876708977,-0.5786751147063045,96,46,50,0,-1.2764817588367063,-1.3265672951464962,-1.170500554541026,1.6883368473630422,-0.6592041440560332,0.6592041440560332,-1.170500554541026,-1.3265672951464962,1,1,0,0,-1.3265672951464962,-1.170500554541026
7251,31,52,22,80,83,0,1927.057,100,1321.45,MORE,134,1302,1436,2,2,3.0,0.28122253820234633,3.0,-1.0476454436543674,1.9280948608002384,-0.1705946969969915,163,80,83,0,0.05983508244547061,0.0,0.1170500554541026,-0.10062934851832685,-0.010087621632261335,0.010087621632261335,0.1170500554541026,0.0,1,1,0,1,0.1170500554541026,0.0
7252,31,53,6,50,56,1,1272.036,24,1398.091,MORE,112,664,776,2,1,6.0,0.5624450764046927,6.0,-0.5238227218271837,-1.3037053837316812,-0.8336724830974074,106,50,56,0,-1.077031484018471,-1.170500554541026,-0.9364004436328208,-0.10062934851832685,-0.037656277024776745,0.037656277024776745,-0.9364004436328208,-1.170500554541026,0,1,0,0,-1.170500554541026,-0.9364004436328208
7253,31,54,13,50,47,1,1950.257,44,1065.561,MORE,-22,1264,1242,4,1,-3.0,-0.28122253820234633,3.0,-1.0476454436543674,-0.4532316351706496,-0.14710933601233656,97,50,47,1,-1.2565367313548828,-1.170500554541026,-1.2875506099951286,1.6883368473630422,-0.20557445077918882,0.20557445077918882,-1.2875506099951286,-1.170500554541026,0,1,0,0,-1.170500554541026,-1.2875506099951286
7254,31,55,46,110,124,0,1776.7579999999996,24,3488.986,MORE,80,760,840,1,1,14.0,1.3123718449442827,14.0,0.8730378697119728,-1.3037053837316812,-0.32274238107598546,234,110,124,0,1.4759320336549415,1.170500554541026,1.7167341466601715,-0.9951124464590114,-0.07775613941389008,0.07775613941389008,1.7167341466601715,1.170500554541026,0,0,0,2,1.7167341466601715,1.170500554541026
7255,31,56,27,91,80,1,2118.587,94,1431.1229999999996,MORE,-214,1256,1042,1,2,-11.0,-1.0311493067419364,11.0,0.34921514788478913,1.6729527362319292,0.023291130131929,171,91,80,1,0.21939530230005888,0.4291835366650429,0.0,-0.9951124464590114,-0.44617362511386877,0.44617362511386877,0.0,0.4291835366650429,1,0,0,1,0.4291835366650429,0.0
7256,31,57,40,64,80,1,2151.961,14,2352.802,MORE,-1402,2188,786,1,1,16.0,1.4998535370791803,16.0,1.222253017596762,-1.7289422580121967,0.05707563174838885,144,64,80,0,-0.3191204397091766,-0.6242669624218805,0.0,-0.9951124464590114,-1.934881016309701,1.934881016309701,0.0,-0.6242669624218805,0,0,0,1,-0.6242669624218805,0.0
7257,31,58,22,83,80,1,2131.123,24,1823.334,MORE,-1198,2336,1138,3,1,-3.0,-0.28122253820234633,3.0,-1.0476454436543674,-1.3037053837316812,0.03598132346398225,163,83,80,1,0.05983508244547061,0.1170500554541026,0.0,0.7938537494223578,-1.6792443935791035,1.6792443935791035,0.0,0.1170500554541026,0,1,0,1,0.1170500554541026,0.0
7258,31,59,54,101,110,0,1442.031,94,911.157,MORE,-96,1004,908,2,2,9.0,0.8436676146070391,9.0,0.0,1.6729527362319292,-0.6615865373824759,211,101,110,0,1.0171964015730004,0.8193503881787182,1.170500554541026,-0.10062934851832685,-0.2983053825540134,0.2983053825540134,1.170500554541026,0.8193503881787182,1,1,0,2,1.170500554541026,0.8193503881787182
7259,31,60,6,56,50,1,1087.621,24,744.581,MORE,450,206,656,2,2,-6.0,-0.5624450764046927,6.0,-0.5238227218271837,-1.3037053837316812,-1.020355795424353,106,56,50,1,-1.077031484018471,-0.9364004436328208,-1.170500554541026,-0.10062934851832685,0.3858985194602328,0.3858985194602328,-1.170500554541026,-0.9364004436328208,0,1,1,0,-0.9364004436328208,-1.170500554541026
7260,31,61,18,50,42,0,1829.536,64,480.973,MORE,-684,1120,436,2,1,-8.0,-0.7499267685395902,8.0,-0.17460757394239454,0.3972421133903819,-0.2693152094359799,92,50,42,1,-1.3562618687640005,-1.170500554541026,-1.4826340357519663,-0.10062934851832685,-1.0351403539539707,1.0351403539539707,-1.4826340357519663,-1.170500554541026,1,1,0,0,-1.170500554541026,-1.4826340357519663
7261,31,62,43,110,117,0,4417.099,4,362.968,MORE,-2228,2668,440,2,1,7.0,0.6561859224721414,7.0,-0.34921514788478913,-2.1541791322927133,2.3500749252854267,227,110,117,0,1.3363168412821769,1.170500554541026,1.4436173506005987,-0.10062934851832685,-2.969958714228689,2.969958714228689,1.4436173506005987,1.170500554541026,0,1,0,2,1.4436173506005987,1.170500554541026
7262,31,63,32,77,80,1,3178.266,84,2285.828,MORE,-988,1884,896,3,2,3.0,0.28122253820234633,3.0,-1.0476454436543674,1.2477158619514137,1.0960042268068488,157,77,80,0,-0.05983508244547061,-0.1170500554541026,0.0,0.7938537494223578,-1.4160890466505474,1.4160890466505474,0.0,-0.1170500554541026,1,1,0,1,-0.1170500554541026,0.0
7263,31,64,27,80,91,1,2173.146,64,1451.537,MORE,450,730,1180,3,2,11.0,1.0311493067419364,11.0,0.34921514788478913,0.3972421133903819,0.0785212081475235,171,80,91,0,0.21939530230005888,0.0,0.4291835366650429,0.7938537494223578,0.3858985194602328,0.3858985194602328,0.4291835366650429,0.0,1,1,1,1,0.4291835366650429,0.0
7264,31,65,16,44,50,0,1870.593,84,2243.7270000000008,MORE,-598,1132,534,2,2,6.0,0.5624450764046927,6.0,-0.5238227218271837,1.2477158619514137,-0.2277532065934378,94,44,50,0,-1.3163718138003533,-1.4046006654492311,-1.170500554541026,-0.10062934851832685,-0.9273719737832287,0.9273719737832287,-1.170500554541026,-1.4046006654492311,1,1,0,0,-1.4046006654492311,-1.170500554541026
7265,31,66,7,50,57,1,1109.357,0,1495.852,MORE,-310,1026,716,1,1,7.0,0.6561859224721414,7.0,-0.34921514788478913,-2.324273882004919,-0.9983524417018332,107,50,57,0,-1.0570864565366473,-1.170500554541026,-0.8973837584814532,-0.9951124464590114,-0.5664732122812087,0.5664732122812087,-0.8973837584814532,-1.170500554541026,0,0,0,0,-1.170500554541026,-0.8973837584814532
7266,31,67,14,50,46,1,1249.849,64,1537.63,MORE,62,556,618,1,1,-4.0,-0.3749633842697951,4.0,-0.8730378697119728,0.3972421133903819,-0.8561323841390687,96,50,46,1,-1.2764817588367063,-1.170500554541026,-1.3265672951464962,-0.9951124464590114,-0.10031231200776632,0.10031231200776632,-1.3265672951464962,-1.170500554541026,1,0,0,0,-1.170500554541026,-1.3265672951464962
7267,31,68,51,110,108,0,1289.757,84,1673.507,MORE,86,598,684,1,2,-2.0,-0.18748169213489754,2.0,-1.222253017596762,1.2477158619514137,-0.8157335140452923,218,110,108,1,1.156811593945765,1.170500554541026,1.092467184238291,-0.9951124464590114,-0.07023741521593133,0.07023741521593133,1.092467184238291,1.170500554541026,1,0,0,2,1.170500554541026,1.092467184238291
7268,31,69,50,133,110,0,1585.083,94,1024.264,MORE,42,880,922,3,2,-23.0,-2.1560394595513217,23.0,2.444506035193524,1.6729527362319292,-0.5167749917110596,243,133,110,1,1.6554372809913533,2.0678843130224793,1.170500554541026,0.7938537494223578,-0.12537472600096214,0.12537472600096214,1.170500554541026,2.0678843130224793,1,1,0,2,2.0678843130224793,1.170500554541026
7269,31,70,49,131,110,0,2762.928,84,1115.5839999999996,MORE,-1286,1908,622,2,2,-21.0,-1.9685577674164243,21.0,2.0952908873087353,1.2477158619514137,0.675557551779064,241,131,110,1,1.6155472260277064,1.9898509427197442,1.170500554541026,-0.10062934851832685,-1.7895190151491651,1.7895190151491651,1.170500554541026,1.9898509427197442,1,1,0,2,1.9898509427197442,1.170500554541026
7270,31,71,47,126,110,0,1259.648,14,1251.34,MORE,-2158,2290,132,2,1,-16.0,-1.4998535370791803,16.0,1.222253017596762,-1.7289422580121967,-0.8462128560231793,236,126,110,1,1.5158220886185887,1.7947675169629065,1.170500554541026,-0.10062934851832685,-2.8822402652525034,2.8822402652525034,1.170500554541026,1.7947675169629065,0,1,0,2,1.7947675169629065,1.170500554541026
7271,31,72,50,110,133,1,2027.291,64,1489.523,MORE,-190,1108,918,3,1,23.0,2.1560394595513217,23.0,2.444506035193524,0.3972421133903819,-0.06912781454285792,243,110,133,0,1.6554372809913533,1.170500554541026,2.0678843130224793,0.7938537494223578,-0.41609872832203376,0.41609872832203376,2.0678843130224793,1.170500554541026,1,1,0,2,2.0678843130224793,1.170500554541026
7272,31,73,47,110,126,0,2076.894,74,1974.014,MORE,-1174,1542,368,1,1,16.0,1.4998535370791803,16.0,1.222253017596762,0.8224789876708977,-0.01891469553760645,236,110,126,0,1.5158220886185887,1.170500554541026,1.7947675169629065,-0.9951124464590114,-1.6491694967872685,1.6491694967872685,1.7947675169629065,1.170500554541026,1,0,0,2,1.7947675169629065,1.170500554541026
7273,31,74,12,48,50,1,1295.768,24,876.299,MORE,-504,1168,664,2,1,2.0,0.18748169213489754,2.0,-1.222253017596762,-1.3037053837316812,-0.8096485784901734,98,48,50,0,-1.2365917038730592,-1.248533924843761,-1.170500554541026,-0.10062934851832685,-0.8095786280152082,0.8095786280152082,-1.170500554541026,-1.248533924843761,0,1,0,0,-1.248533924843761,-1.170500554541026
7274,31,75,32,80,77,1,1066.374,54,416.915,MORE,-8,650,642,2,1,-3.0,-0.28122253820234633,3.0,-1.0476454436543674,-0.027994760890133873,-1.0418641344261186,157,80,77,1,-0.05983508244547061,0.0,-0.1170500554541026,-0.10062934851832685,-0.18803076098395172,0.18803076098395172,-0.1170500554541026,0.0,1,1,0,1,0.0,-0.1170500554541026
7275,31,76,43,117,110,1,1178.0410000000004,14,1680.792,MORE,-960,1534,574,1,1,-7.0,-0.6561859224721414,7.0,-0.34921514788478913,-1.7289422580121967,-0.9288236255867448,227,117,110,1,1.3363168412821769,1.4436173506005987,1.170500554541026,-0.9951124464590114,-1.381001667060073,1.381001667060073,1.170500554541026,1.4436173506005987,0,0,0,2,1.4436173506005987,1.170500554541026
7276,31,77,40,80,64,1,1214.255,84,1093.03,MORE,536,382,918,1,2,-16.0,-1.4998535370791803,16.0,1.222253017596762,1.2477158619514137,-0.8921641918497498,144,80,64,1,-0.3191204397091766,0.0,-0.6242669624218805,-0.9951124464590114,0.4936668996309748,0.4936668996309748,-0.6242669624218805,0.0,1,0,1,1,0.0,-0.6242669624218805
7277,31,78,31,80,78,0,1412.381,74,366.314,MORE,-574,1018,444,2,1,-2.0,-0.18748169213489754,2.0,-1.222253017596762,0.8224789876708977,-0.6916012336408818,158,80,78,1,-0.03989005496364707,0.0,-0.07803337030273506,-0.10062934851832685,-0.8972970769913936,0.8972970769913936,-0.07803337030273506,0.0,1,1,0,1,0.0,-0.07803337030273506
7278,31,79,46,124,110,1,1585.852,100,751.084,MORE,1280,396,1676,1,2,-14.0,-1.3123718449442827,14.0,0.8730378697119728,1.9280948608002384,-0.5159965329784216,234,124,110,1,1.4759320336549415,1.7167341466601715,1.170500554541026,-0.9951124464590114,1.4259887001778597,1.4259887001778597,1.170500554541026,1.7167341466601715,1,0,1,2,1.7167341466601715,1.170500554541026
7279,31,80,58,92,110,1,2359.707000000001,44,1421.9260000000004,MORE,630,746,1376,3,1,18.0,1.6873352292140782,18.0,1.571468165481551,-0.4532316351706496,0.2673769163655502,202,92,110,0,0.8376911542365885,0.4682002218164104,1.170500554541026,0.7938537494223578,0.6114602453989952,0.6114602453989952,1.170500554541026,0.4682002218164104,0,1,1,2,1.170500554541026,0.4682002218164104
7280,31,81,48,128,110,1,2478.231,44,2731.317,LESS,1654,446,2100,1,2,-18.0,-1.6873352292140782,18.0,1.571468165481551,-0.4532316351706496,0.3873587665959479,238,128,110,0,1.5557121435822359,1.8728008872656416,1.170500554541026,-0.9951124464590114,1.8946558418506219,1.8946558418506219,1.170500554541026,1.8728008872656416,0,0,1,2,1.8728008872656416,1.170500554541026
7281,31,82,8,50,58,1,3630.775,64,1637.3470000000002,LESS,1358,900,2258,3,2,8.0,0.7499267685395902,8.0,-0.17460757394239454,0.3972421133903819,1.554079106712246,108,50,58,1,-1.0371414290548238,-1.170500554541026,-0.8583670733300858,0.7938537494223578,1.5237321147513234,1.5237321147513234,-0.8583670733300858,-1.170500554541026,1,1,1,0,-1.170500554541026,-0.8583670733300858
7282,31,83,4,54,50,1,3216.84,74,1756.09,LESS,558,1294,1852,3,2,-4.0,-0.3749633842697951,4.0,-0.8730378697119728,0.8224789876708977,1.1350526886440075,104,54,50,0,-1.116921538982118,-1.0144338139355558,-1.170500554541026,0.7938537494223578,0.5212355550234903,0.5212355550234903,-1.170500554541026,-1.0144338139355558,1,1,1,0,-1.0144338139355558,-1.170500554541026
7283,31,84,37,80,69,1,1907.178,24,1492.739,LESS,240,774,1014,1,1,-11.0,-1.0311493067419364,11.0,0.34921514788478913,-1.3037053837316812,-0.1907182095406964,149,80,69,0,-0.21939530230005888,0.0,-0.4291835366650429,-0.9951124464590114,0.12274317253167656,0.12274317253167656,-0.4291835366650429,0.0,0,0,1,1,0.0,-0.4291835366650429
7284,31,85,52,105,110,0,1991.615,84,986.088,LESS,-52,1048,996,2,2,5.0,0.4687042303372438,5.0,-0.6984302957695783,1.2477158619514137,-0.10524263085701943,215,105,110,1,1.0969765115002945,0.9754171287841883,1.170500554541026,-0.10062934851832685,-0.24316807176898256,0.24316807176898256,1.170500554541026,0.9754171287841883,1,1,0,2,1.170500554541026,0.9754171287841883
7285,31,86,5,55,50,1,2330.754,54,1532.34,LESS,-36,1138,1102,3,1,-5.0,-0.4687042303372438,5.0,-0.6984302957695783,-0.027994760890133873,0.2380677932367255,105,55,50,0,-1.0969765115002945,-0.9754171287841883,-1.170500554541026,0.7938537494223578,-0.2231181405744259,0.2231181405744259,-1.170500554541026,-0.9754171287841883,1,1,0,0,-0.9754171287841883,-1.170500554541026
7286,31,87,30,96,80,0,1832.629,54,1826.341,LESS,-830,1388,558,4,1,-16.0,-1.4998535370791803,16.0,1.222253017596762,-0.027994760890133873,-0.2661841654047069,176,96,80,0,0.3191204397091766,0.6242669624218805,0.0,1.6883368473630422,-1.2180959761043002,1.2180959761043002,0.0,0.6242669624218805,1,1,0,1,0.6242669624218805,0.0
7287,31,88,33,80,75,0,2459.485,64,1412.6570000000004,LESS,-978,1606,628,3,2,-5.0,-0.4687042303372438,5.0,-0.6984302957695783,0.3972421133903819,0.3683821900003297,155,80,75,0,-0.09972513740911768,0.0,-0.19508342575683765,0.7938537494223578,-1.4035578396539494,1.4035578396539494,-0.19508342575683765,0.0,1,1,0,1,0.0,-0.19508342575683765
7288,31,89,48,110,128,1,1614.519,44,1558.729,LESS,610,446,1056,1,2,18.0,1.6873352292140782,18.0,1.571468165481551,-0.4532316351706496,-0.4869769276617363,238,110,128,1,1.5557121435822359,1.170500554541026,1.8728008872656416,-0.9951124464590114,0.5863978314057994,0.5863978314057994,1.8728008872656416,1.170500554541026,0,0,1,2,1.8728008872656416,1.170500554541026
7289,31,90,9,59,50,1,1643.889,54,1573.608,LESS,566,404,970,1,2,-9.0,-0.8436676146070391,9.0,0.0,-0.027994760890133873,-0.4572456754152142,109,59,50,0,-1.0171964015730004,-0.8193503881787182,-1.170500554541026,-0.9951124464590114,0.5312605206207686,0.5312605206207686,-1.170500554541026,-0.8193503881787182,1,0,1,0,-0.8193503881787182,-1.170500554541026
7290,31,91,44,110,119,0,1259.359,54,3592.21,LESS,-1304,1304,0,0,1,9.0,0.8436676146070391,9.0,0.0,-0.027994760890133873,-0.8465054107354448,229,110,119,1,1.376206896245824,1.170500554541026,1.5216507209033339,-1.889595544399696,-1.8120751877430414,1.8120751877430414,1.5216507209033339,1.170500554541026,1,0,0,2,1.5216507209033339,1.170500554541026
7291,31,92,2,52,50,1,2539.209,44,3091.18,LESS,430,872,1302,3,2,-2.0,-0.18748169213489754,2.0,-1.222253017596762,-0.4532316351706496,0.4490867985839772,102,52,50,0,-1.156811593945765,-1.092467184238291,-1.170500554541026,0.7938537494223578,0.3608361054670369,0.3608361054670369,-1.170500554541026,-1.092467184238291,0,1,1,0,-1.092467184238291,-1.170500554541026
7292,31,93,8,58,50,1,1201.458,74,1660.733,LESS,268,492,760,2,1,-8.0,-0.7499267685395902,8.0,-0.17460757394239454,0.8224789876708977,-0.9051185954928804,108,58,50,0,-1.0371414290548238,-0.8583670733300858,-1.170500554541026,-0.10062934851832685,0.15783055212215072,0.15783055212215072,-1.170500554541026,-0.8583670733300858,1,1,1,0,-0.8583670733300858,-1.170500554541026
7293,31,94,44,119,110,0,1862.208,84,1528.726,LESS,-326,1136,810,1,2,-9.0,-0.8436676146070391,9.0,0.0,1.2477158619514137,-0.2362413424493141,229,119,110,0,1.376206896245824,1.5216507209033339,1.170500554541026,-0.9951124464590114,-0.5865231434757654,0.5865231434757654,1.170500554541026,1.5216507209033339,1,0,0,2,1.5216507209033339,1.170500554541026
7294,31,95,34,74,80,1,2162.554,94,2749.836,LESS,1914,762,2676,3,2,6.0,0.5624450764046927,6.0,-0.5238227218271837,1.6729527362319292,0.0677989260979775,154,74,80,1,-0.11967016489094122,-0.2341001109082052,0.0,0.7938537494223578,2.2204672237621677,2.2204672237621677,0.0,-0.2341001109082052,1,1,1,1,-0.2341001109082052,0.0
7295,31,96,24,86,80,1,3274.205,54,1884.486,LESS,-114,1668,1554,3,1,-6.0,-0.5624450764046927,6.0,-0.5238227218271837,-0.027994760890133873,1.193123280578694,166,86,80,0,0.11967016489094122,0.2341001109082052,0.0,0.7938537494223578,-0.3208615551478896,0.3208615551478896,0.0,0.2341001109082052,0,1,0,1,0.2341001109082052,0.0
7296,31,97,39,66,80,1,3553.158,54,2124.151,LESS,72,1652,1724,3,1,14.0,1.3123718449442827,14.0,0.8730378697119728,-0.027994760890133873,1.4755074143180231,146,66,80,1,-0.2792303847455295,-0.5462335921191455,0.0,0.7938537494223578,-0.08778110501116841,0.08778110501116841,0.0,-0.5462335921191455,0,1,0,1,-0.5462335921191455,0.0
7297,31,98,9,50,59,1,1751.274,84,1328.795,LESS,1014,730,1744,1,2,9.0,0.8436676146070391,9.0,0.0,1.2477158619514137,-0.34853983535757765,109,50,59,1,-1.0171964015730004,-1.170500554541026,-0.8193503881787182,-0.9951124464590114,1.0926585940683553,1.0926585940683553,-0.8193503881787182,-1.170500554541026,1,0,1,0,-1.170500554541026,-0.8193503881787182
7298,31,99,57,94,110,1,1665.866,24,2824.762,LESS,322,578,900,1,2,16.0,1.4998535370791803,16.0,1.222253017596762,-1.3037053837316812,-0.4349983573824658,204,94,110,1,0.8775812092002355,0.5462335921191455,1.170500554541026,-0.9951124464590114,0.22549906990377946,0.22549906990377946,1.170500554541026,0.5462335921191455,0,0,1,2,1.170500554541026,0.5462335921191455
7299,31,100,60,110,87,1,2211.919,54,1740.269,LESS,-600,1304,704,3,2,-23.0,-2.1560394595513217,23.0,2.444506035193524,-0.027994760890133873,0.1177711176931277,197,110,87,0,0.7379660168274708,1.170500554541026,0.27311679605957273,0.7938537494223578,-0.9298782151825482,0.9298782151825482,0.27311679605957273,1.170500554541026,0,1,0,2,1.170500554541026,0.27311679605957273
7300,31,101,33,75,80,1,2514.2670000000007,74,2599.371,LESS,1332,876,2208,3,2,5.0,0.4687042303372438,5.0,-0.6984302957695783,0.8224789876708977,0.4238380109253891,155,75,80,1,-0.09972513740911768,-0.19508342575683765,0.0,0.7938537494223578,1.491150976560169,1.491150976560169,0.0,-0.19508342575683765,1,1,1,1,-0.19508342575683765,0.0
7301,31,102,15,50,45,1,1678.705,74,1709.933,LESS,1256,358,1614,1,2,-5.0,-0.4687042303372438,5.0,-0.6984302957695783,0.8224789876708977,-0.4220014371375527,95,50,45,0,-1.2964267863185297,-1.170500554541026,-1.3655839802978638,-0.9951124464590114,1.3959138033860248,1.3959138033860248,-1.3655839802978638,-1.170500554541026,1,0,1,0,-1.170500554541026,-1.3655839802978638
7302,31,103,59,89,110,1,1581.779,24,1920.065,LESS,344,478,822,1,2,21.0,1.9685577674164243,21.0,2.0952908873087353,-1.3037053837316812,-0.5201196310512881,199,89,110,1,0.7778560717911179,0.3511501663623078,1.170500554541026,-0.9951124464590114,0.2530677252962949,0.2530677252962949,1.170500554541026,0.3511501663623078,0,0,1,2,1.170500554541026,0.3511501663623078
7303,31,104,29,80,94,1,1039.137,84,1099.012,LESS,1056,350,1406,1,2,14.0,1.3123718449442827,14.0,0.8730378697119728,1.2477158619514137,-1.0694361506821122,174,80,94,1,0.2792303847455295,0.0,0.5462335921191455,-0.9951124464590114,1.1452896634540666,1.1452896634540666,0.5462335921191455,0.0,1,0,1,1,0.5462335921191455,0.0
7304,31,105,55,110,98,1,1370.4979999999996,34,1709.6760000000004,LESS,-410,566,156,1,2,-12.0,-1.124890152809385,12.0,0.5238227218271837,-0.8784685094511654,-0.7339993963184814,208,110,98,0,0.9573613191275298,1.170500554541026,0.7023003327246156,-0.9951124464590114,-0.6917852822471878,0.6917852822471878,0.7023003327246156,1.170500554541026,0,0,0,2,1.170500554541026,0.7023003327246156
7305,31,106,29,94,80,1,1347.276,84,1719.396,LESS,310,424,734,1,2,-14.0,-1.3123718449442827,14.0,0.8730378697119728,1.2477158619514137,-0.7575070279040697,174,94,80,0,0.2792303847455295,0.5462335921191455,0.0,-0.9951124464590114,0.21046162150786196,0.21046162150786196,0.0,0.5462335921191455,1,0,1,1,0.5462335921191455,0.0
7306,31,107,57,110,94,1,1443.886,14,1267.435,LESS,-678,1440,762,1,1,-16.0,-1.4998535370791803,16.0,1.222253017596762,-1.7289422580121967,-0.659708720803746,204,110,94,0,0.8775812092002355,1.170500554541026,0.5462335921191455,-0.9951124464590114,-1.027621629756012,1.027621629756012,0.5462335921191455,1.170500554541026,0,0,0,2,1.170500554541026,0.5462335921191455
7307,31,108,39,80,66,1,2595.885,84,1240.882,LESS,1298,792,2090,3,2,-14.0,-1.3123718449442827,14.0,0.8730378697119728,1.2477158619514137,0.5064599157894216,146,80,66,0,-0.2792303847455295,0.0,-0.5462335921191455,0.7938537494223578,1.448544872771736,1.448544872771736,-0.5462335921191455,0.0,1,1,1,1,0.0,-0.5462335921191455
7308,31,109,4,50,54,1,5622.241999999998,74,1323.8339999999996,LESS,2090,1382,3472,5,1,4.0,0.3749633842697951,4.0,-0.8730378697119728,0.8224789876708977,3.570041235334131,104,50,54,1,-1.116921538982118,-1.170500554541026,-1.0144338139355558,2.5828199453037266,2.441016466902291,2.441016466902291,-1.0144338139355558,-1.170500554541026,1,1,1,0,-1.170500554541026,-1.0144338139355558
7309,31,110,55,98,110,0,6046.188,94,1114.746,LESS,-2072,3918,1846,5,2,12.0,1.124890152809385,12.0,0.5238227218271837,1.6729527362319292,3.9992017891272575,208,98,110,1,0.9573613191275298,0.7023003327246156,1.170500554541026,2.5828199453037266,-2.7744718850817613,2.7744718850817613,1.170500554541026,0.7023003327246156,1,1,0,2,1.170500554541026,0.7023003327246156
7310,31,111,2,50,52,1,2570.55,64,1673.121,LESS,-896,1582,686,3,2,2.0,0.18748169213489754,2.0,-1.222253017596762,0.3972421133903819,0.4808132942141529,102,50,52,1,-1.156811593945765,-1.170500554541026,-1.092467184238291,0.7938537494223578,-1.3008019422818464,1.3008019422818464,-1.092467184238291,-1.170500554541026,1,1,0,0,-1.170500554541026,-1.092467184238291
7311,31,112,59,110,89,0,2418.286,74,2242.774,LESS,-1168,1872,704,2,2,-21.0,-1.9685577674164243,21.0,2.0952908873087353,0.8224789876708977,0.3266764405517607,199,110,89,0,0.7778560717911179,1.170500554541026,0.3511501663623078,-0.10062934851832685,-1.6416507725893097,1.6416507725893097,0.3511501663623078,1.170500554541026,1,0,0,2,1.170500554541026,0.3511501663623078
7312,31,113,60,87,110,1,1731.159,84,1333.434,LESS,1026,622,1648,2,2,23.0,2.1560394595513217,23.0,2.444506035193524,1.2477158619514137,-0.3689022507112987,197,87,110,1,0.7379660168274708,0.27311679605957273,1.170500554541026,-0.10062934851832685,1.1076960424642728,1.1076960424642728,1.170500554541026,0.27311679605957273,1,0,1,2,1.170500554541026,0.27311679605957273
7313,31,114,52,110,105,1,2514.337,44,1650.046,LESS,408,932,1340,4,1,-5.0,-0.4687042303372438,5.0,-0.6984302957695783,-0.4532316351706496,0.42390887192835935,215,110,105,0,1.0969765115002945,1.170500554541026,0.9754171287841883,1.6883368473630422,0.3332674500745215,0.3332674500745215,0.9754171287841883,1.170500554541026,0,1,1,2,1.170500554541026,0.9754171287841883
7314,31,115,30,80,96,1,2020.323,84,1218.005,LESS,920,524,1444,3,2,16.0,1.4998535370791803,16.0,1.222253017596762,1.2477158619514137,-0.07618152123859377,176,80,96,1,0.3191204397091766,0.0,0.6242669624218805,0.7938537494223578,0.9748652483003348,0.9748652483003348,0.6242669624218805,0.0,1,1,1,1,0.6242669624218805,0.0
7315,31,116,24,80,86,1,2360.902,54,2115.795,LESS,312,1000,1312,3,1,6.0,0.5624450764046927,6.0,-0.5238227218271837,-0.027994760890133873,0.2685866149162677,166,80,86,1,0.11967016489094122,0.0,0.2341001109082052,0.7938537494223578,0.21296786290718156,0.21296786290718156,0.2341001109082052,0.0,0,1,1,1,0.2341001109082052,0.0
7316,31,117,5,50,55,1,4348.162,74,2069.7960000000007,LESS,1742,990,2732,2,2,5.0,0.4687042303372438,5.0,-0.6984302957695783,0.8224789876708977,2.2802899972596014,105,50,55,1,-1.0969765115002945,-1.170500554541026,-0.9754171287841883,-0.10062934851832685,2.0049304634206835,2.0049304634206835,-0.9754171287841883,-1.170500554541026,1,0,1,0,-1.170500554541026,-0.9754171287841883
7317,31,118,34,80,74,0,4003.413,84,3196.5,LESS,-428,2730,2302,3,2,-6.0,-0.5624450764046927,6.0,-0.5238227218271837,1.2477158619514137,1.931300569927756,154,80,74,0,-0.11967016489094122,0.0,-0.2341001109082052,0.7938537494223578,-0.714341454841064,0.714341454841064,-0.2341001109082052,0.0,1,1,0,1,0.0,-0.2341001109082052
7318,31,119,15,45,50,1,2135.754,34,2366.272,LESS,-384,1228,844,1,1,5.0,0.4687042303372438,5.0,-0.6984302957695783,-0.8784685094511654,0.04066928496053111,95,45,50,1,-1.2964267863185297,-1.3655839802978638,-1.170500554541026,-0.9951124464590114,-0.6592041440560332,0.6592041440560332,-1.170500554541026,-1.3655839802978638,0,0,0,0,-1.3655839802978638,-1.170500554541026
7319,31,120,37,69,80,1,1656.707,44,2724.905,LESS,470,482,952,1,1,11.0,1.0311493067419364,11.0,0.34921514788478913,-0.4532316351706496,-0.44427001347119216,149,69,80,1,-0.21939530230005888,-0.4291835366650429,0.0,-0.9951124464590114,0.4109609334534286,0.4109609334534286,0.0,-0.4291835366650429,0,0,1,1,-0.4291835366650429,0.0
7320,31,121,48,128,110,1,1700.431,84,1522.019,MORE,1042,502,1544,1,2,-18.0,-1.6873352292140782,18.0,1.571468165481551,1.2477158619514137,-0.4000082064154573,238,128,110,1,1.5557121435822359,1.8728008872656416,1.170500554541026,-0.9951124464590114,1.1277459736588293,1.1277459736588293,1.170500554541026,1.8728008872656416,1,0,1,2,1.8728008872656416,1.170500554541026
7321,31,122,8,50,58,1,2545.678,94,1309.8010000000004,MORE,1052,926,1978,3,2,8.0,0.7499267685395902,8.0,-0.17460757394239454,1.6729527362319292,0.4556353675585347,108,50,58,0,-1.0371414290548238,-1.170500554541026,-0.8583670733300858,0.7938537494223578,1.1402771806554273,1.1402771806554273,-0.8583670733300858,-1.170500554541026,1,1,1,0,-1.170500554541026,-0.8583670733300858
7322,31,123,4,54,50,0,1723.5179999999998,34,1308.477,MORE,-584,988,404,2,1,-4.0,-0.3749633842697951,4.0,-0.8730378697119728,-0.8784685094511654,-0.3766372353355985,104,54,50,1,-1.116921538982118,-1.0144338139355558,-1.170500554541026,-0.10062934851832685,-0.9098282839879915,0.9098282839879915,-1.170500554541026,-1.0144338139355558,0,1,0,0,-1.0144338139355558,-1.170500554541026
7323,31,124,37,80,69,0,1938.131,94,1183.495,MORE,178,946,1124,2,2,-11.0,-1.0311493067419364,11.0,0.34921514788478913,1.6729527362319292,-0.15938448632698848,149,80,69,1,-0.21939530230005888,0.0,-0.4291835366650429,-0.10062934851832685,0.04504968915276949,0.04504968915276949,-0.4291835366650429,0.0,1,1,0,1,0.0,-0.4291835366650429
7324,31,125,52,105,110,0,1608.8729999999996,24,1938.147,MORE,-896,1270,374,2,1,5.0,0.4687042303372438,5.0,-0.6984302957695783,-1.3037053837316812,-0.4926923737013644,215,105,110,0,1.0969765115002945,0.9754171287841883,1.170500554541026,-0.10062934851832685,-1.3008019422818464,1.3008019422818464,1.170500554541026,0.9754171287841883,0,1,0,2,1.170500554541026,0.9754171287841883
7325,31,126,5,55,50,1,2489.76,74,1673.85,MORE,1532,886,2418,4,2,-5.0,-0.4687042303372438,5.0,-0.6984302957695783,0.8224789876708977,0.39902957378526205,105,55,50,1,-1.0969765115002945,-0.9754171287841883,-1.170500554541026,1.6883368473630422,1.7417751164921271,1.7417751164921271,-1.170500554541026,-0.9754171287841883,1,1,1,0,-0.9754171287841883,-1.170500554541026
7326,31,127,30,96,80,1,2881.211,84,1288.886,MORE,470,556,1026,0,2,-16.0,-1.4998535370791803,16.0,1.222253017596762,1.2477158619514137,0.7952954376992336,176,96,80,1,0.3191204397091766,0.6242669624218805,0.0,-1.889595544399696,0.4109609334534286,0.4109609334534286,0.0,0.6242669624218805,1,0,1,1,0.6242669624218805,0.0
7327,31,128,33,80,75,1,4924.426,14,2782.553,MORE,-542,3000,2458,5,1,-5.0,-0.4687042303372438,5.0,-0.6984302957695783,-1.7289422580121967,2.863642068917411,155,80,75,1,-0.09972513740911768,0.0,-0.19508342575683765,2.5828199453037266,-0.8571972146022803,0.8571972146022803,-0.19508342575683765,0.0,0,1,0,1,0.0,-0.19508342575683765
7328,31,129,48,110,128,1,1630.531,54,2260.851,MORE,414,458,872,1,2,18.0,1.6873352292140782,18.0,1.571468165481551,-0.027994760890133873,-0.4707679793821547,238,110,128,0,1.5557121435822359,1.170500554541026,1.8728008872656416,-0.9951124464590114,0.34078617427248026,0.34078617427248026,1.8728008872656416,1.170500554541026,1,0,1,2,1.8728008872656416,1.170500554541026
7329,31,130,9,59,50,1,2828.653,4,4708.48,MORE,-2314,3626,1312,4,1,-9.0,-0.8436676146070391,9.0,0.0,-2.1541791322927133,0.7420909720685658,109,59,50,1,-1.0171964015730004,-0.8193503881787182,-1.170500554541026,1.6883368473630422,-3.0777270943994313,3.0777270943994313,-1.170500554541026,-0.8193503881787182,0,1,0,0,-0.8193503881787182,-1.170500554541026
7330,31,131,44,110,119,0,3040.661,64,1107.353,MORE,-1060,1752,692,4,1,9.0,0.8436676146070391,9.0,0.0,0.3972421133903819,0.9567066794666144,229,110,119,0,1.376206896245824,1.170500554541026,1.5216507209033339,1.6883368473630422,-1.5063137370260522,1.5063137370260522,1.5216507209033339,1.170500554541026,1,1,0,2,1.5216507209033339,1.170500554541026
7331,31,132,2,52,50,1,1704.2479999999996,94,1158.096,MORE,1024,516,1540,1,2,-2.0,-0.18748169213489754,2.0,-1.222253017596762,1.6729527362319292,-0.3961442571534565,102,52,50,1,-1.156811593945765,-1.092467184238291,-1.170500554541026,-0.9951124464590114,1.1051898010649532,1.1051898010649532,-1.170500554541026,-1.092467184238291,1,0,1,0,-1.092467184238291,-1.170500554541026
7332,31,133,8,58,50,1,3277.723,74,2481.5460000000007,MORE,1206,1474,2680,4,2,-8.0,-0.7499267685395902,8.0,-0.17460757394239454,0.8224789876708977,1.196684552128005,108,58,50,1,-1.0371414290548238,-0.8583670733300858,-1.170500554541026,1.6883368473630422,1.3332577684030351,1.3332577684030351,-1.170500554541026,-0.8583670733300858,1,1,1,0,-0.8583670733300858,-1.170500554541026
7333,31,134,44,119,110,1,2535.052,64,1667.395,MORE,1398,376,1774,3,2,-9.0,-0.8436676146070391,9.0,0.0,0.3972421133903819,0.444878667307546,229,119,110,1,1.376206896245824,1.5216507209033339,1.170500554541026,0.7938537494223578,1.5738569427377151,1.5738569427377151,1.170500554541026,1.5216507209033339,1,1,1,2,1.5216507209033339,1.170500554541026
7334,31,135,34,74,80,1,1534.388,54,3266.905,MORE,1184,404,1588,1,2,6.0,0.5624450764046927,6.0,-0.5238227218271837,-0.027994760890133873,-0.5680935423626581,154,74,80,0,-0.11967016489094122,-0.2341001109082052,0.0,-0.9951124464590114,1.3056891130105197,1.3056891130105197,0.0,-0.2341001109082052,1,0,1,1,-0.2341001109082052,0.0
7335,31,136,24,86,80,1,2725.4590000000007,54,3374.159,MORE,260,1006,1266,2,2,-6.0,-0.5624450764046927,6.0,-0.5238227218271837,-0.027994760890133873,0.6376276814888048,166,86,80,1,0.11967016489094122,0.2341001109082052,0.0,-0.10062934851832685,0.14780558652487238,0.14780558652487238,0.0,0.2341001109082052,1,1,0,1,0.2341001109082052,0.0
7336,31,137,39,66,80,1,1716.417,54,3313.311,MORE,202,866,1068,1,1,14.0,1.3123718449442827,14.0,0.8730378697119728,-0.027994760890133873,-0.3838255779369792,146,66,80,0,-0.2792303847455295,-0.5462335921191455,0.0,-0.9951124464590114,0.07512458594460449,0.07512458594460449,0.0,-0.5462335921191455,1,0,0,1,-0.5462335921191455,0.0
7337,31,138,9,50,59,1,1381.101,54,1862.262,MORE,822,464,1286,2,2,9.0,0.8436676146070391,9.0,0.0,-0.027994760890133873,-0.7232659789684681,109,50,59,0,-1.0171964015730004,-1.170500554541026,-0.8193503881787182,-0.10062934851832685,0.8520594197336753,0.8520594197336753,-0.8193503881787182,-1.170500554541026,1,1,1,0,-1.170500554541026,-0.8193503881787182
7338,31,139,57,94,110,1,2890.798,54,1433.622,MORE,990,730,1720,3,2,16.0,1.4998535370791803,16.0,1.222253017596762,-0.027994760890133873,0.8050003582061253,204,94,110,0,0.8775812092002355,0.5462335921191455,1.170500554541026,0.7938537494223578,1.0625836972765201,1.0625836972765201,1.170500554541026,0.5462335921191455,1,1,1,2,1.170500554541026,0.5462335921191455
7339,31,140,60,110,87,1,3064.658,54,1780.18,MORE,682,1046,1728,2,2,-23.0,-2.1560394595513217,23.0,2.444506035193524,-0.027994760890133873,0.9809988435850954,197,110,87,1,0.7379660168274708,1.170500554541026,0.27311679605957273,-0.10062934851832685,0.6766225217813044,0.6766225217813044,0.27311679605957273,1.170500554541026,1,1,1,2,1.170500554541026,0.27311679605957273
7340,31,141,33,75,80,1,1215.564,54,2305.735,MORE,598,336,934,1,2,5.0,0.4687042303372438,5.0,-0.6984302957695783,-0.027994760890133873,-0.8908390910941932,155,75,80,0,-0.09972513740911768,-0.19508342575683765,0.0,-0.9951124464590114,0.5713603830098819,0.5713603830098819,0.0,-0.19508342575683765,1,0,1,1,-0.19508342575683765,0.0
7341,31,142,15,50,45,1,2814.2290000000007,44,1881.25,MORE,610,920,1530,3,1,-5.0,-0.4687042303372438,5.0,-0.6984302957695783,-0.4532316351706496,0.7274895562563829,95,50,45,1,-1.2964267863185297,-1.170500554541026,-1.3655839802978638,0.7938537494223578,0.5863978314057994,0.5863978314057994,-1.3655839802978638,-1.170500554541026,0,1,1,0,-1.170500554541026,-1.3655839802978638
7342,31,143,59,89,110,1,1324.575,44,2027.252,MORE,482,424,906,1,1,21.0,1.9685577674164243,21.0,2.0952908873087353,-0.4532316351706496,-0.7804872511675459,199,89,110,0,0.7778560717911179,0.3511501663623078,1.170500554541026,-0.9951124464590114,0.4259983818493461,0.4259983818493461,1.170500554541026,0.3511501663623078,0,0,1,2,1.170500554541026,0.3511501663623078
7343,31,144,29,80,94,1,1363.289,64,1476.994,MORE,404,440,844,1,1,14.0,1.3123718449442827,14.0,0.8730378697119728,0.3972421133903819,-0.7412970673244456,174,80,94,0,0.2792303847455295,0.0,0.5462335921191455,-0.9951124464590114,0.3282549672758824,0.3282549672758824,0.5462335921191455,0.0,1,0,1,1,0.5462335921191455,0.0
7344,31,145,55,110,98,0,2571.519,54,1509.1629999999998,MORE,1254,482,1736,1,2,-12.0,-1.124890152809385,12.0,0.5238227218271837,-0.027994760890133873,0.4817942129552789,208,110,98,1,0.9573613191275298,1.170500554541026,0.7023003327246156,-0.9951124464590114,1.3934075619867052,1.3934075619867052,0.7023003327246156,1.170500554541026,1,0,1,2,1.170500554541026,0.7023003327246156
7345,31,146,29,94,80,1,3230.725,64,1987.5,MORE,508,1334,1842,2,2,-14.0,-1.3123718449442827,14.0,0.8730378697119728,0.3972421133903819,1.149108474733315,174,94,80,1,0.2792303847455295,0.5462335921191455,0.0,-0.10062934851832685,0.4585795200405007,0.4585795200405007,0.0,0.5462335921191455,1,0,1,1,0.5462335921191455,0.0
7346,31,147,57,110,94,1,1543.955,44,929.812,MORE,132,512,644,1,2,-16.0,-1.4998535370791803,16.0,1.222253017596762,-0.4532316351706496,-0.5584088678566153,204,110,94,1,0.8775812092002355,1.170500554541026,0.5462335921191455,-0.9951124464590114,-0.012593863031580919,0.012593863031580919,0.5462335921191455,1.170500554541026,0,0,0,2,1.170500554541026,0.5462335921191455
7347,31,148,39,80,66,1,1026.346,4,1065.859,MORE,-656,1254,598,1,1,-14.0,-1.3123718449442827,14.0,0.8730378697119728,-2.1541791322927133,-1.0823844805249878,146,80,66,1,-0.2792303847455295,0.0,-0.5462335921191455,-0.9951124464590114,-1.0000529743634965,1.0000529743634965,-0.5462335921191455,0.0,0,0,0,1,0.0,-0.5462335921191455
7348,31,149,4,50,54,1,1128.411,64,397.924,MORE,390,184,574,1,2,4.0,0.3749633842697951,4.0,-0.8730378697119728,0.3972421133903819,-0.9790640766931428,104,50,54,0,-1.116921538982118,-1.170500554541026,-1.0144338139355558,-0.9951124464590114,0.3107112774806453,0.3107112774806453,-1.0144338139355558,-1.170500554541026,1,0,1,0,-1.170500554541026,-1.0144338139355558
7349,31,150,55,98,110,1,1180.675,14,1747.581,MORE,-598,1176,578,2,1,12.0,1.124890152809385,12.0,0.5238227218271837,-1.7289422580121967,-0.9261572272749532,208,98,110,0,0.9573613191275298,0.7023003327246156,1.170500554541026,-0.10062934851832685,-0.9273719737832287,0.9273719737832287,1.170500554541026,0.7023003327246156,0,0,0,2,1.170500554541026,0.7023003327246156
7350,31,151,2,50,52,1,1149.003,54,684.258,MORE,-76,596,520,2,1,2.0,0.18748169213489754,2.0,-1.222253017596762,-0.027994760890133873,-0.9582187942191768,102,50,52,0,-1.156811593945765,-1.170500554541026,-1.092467184238291,-0.10062934851832685,-0.27324296856081753,0.27324296856081753,-1.092467184238291,-1.170500554541026,0,0,0,0,-1.170500554541026,-1.092467184238291
7351,31,152,59,110,89,0,1034.981,34,363.176,MORE,-500,692,192,1,2,-21.0,-1.9685577674164243,21.0,2.0952908873087353,-0.8784685094511654,-1.073643269658501,199,110,89,1,0.7778560717911179,1.170500554541026,0.3511501663623078,-0.9951124464590114,-0.8045661452165691,0.8045661452165691,0.3511501663623078,1.170500554541026,0,0,0,2,1.170500554541026,0.3511501663623078
7352,31,153,60,87,110,1,1136.212,54,2165.033,MORE,494,212,706,1,2,23.0,2.1560394595513217,23.0,2.444506035193524,-0.027994760890133873,-0.9711671240620527,197,87,110,0,0.7379660168274708,0.27311679605957273,1.170500554541026,-0.9951124464590114,0.4410358302452636,0.4410358302452636,1.170500554541026,0.27311679605957273,1,0,1,2,1.170500554541026,0.27311679605957273
7353,31,154,52,110,105,1,1160.751,94,1320.8629999999996,MORE,1446,244,1690,1,2,-5.0,-0.4687042303372438,5.0,-0.6984302957695783,1.6729527362319292,-0.9463262933205681,215,110,105,1,1.0969765115002945,1.170500554541026,0.9754171287841883,-0.9951124464590114,1.634006736321385,1.634006736321385,0.9754171287841883,1.170500554541026,1,0,1,2,1.170500554541026,0.9754171287841883
7354,31,155,30,80,96,1,1221.925,54,2205.026,MORE,688,240,928,1,2,16.0,1.4998535370791803,16.0,1.222253017596762,-0.027994760890133873,-0.8843998505242197,176,80,96,0,0.3191204397091766,0.0,0.6242669624218805,-0.9951124464590114,0.6841412459792632,0.6841412459792632,0.6242669624218805,0.0,0,0,1,1,0.6242669624218805,0.0
7355,31,156,24,80,86,1,1204.328,44,2298.878,MORE,332,324,656,1,2,6.0,0.5624450764046927,6.0,-0.5238227218271837,-0.4532316351706496,-0.902213294371072,166,80,86,0,0.11967016489094122,0.0,0.2341001109082052,-0.9951124464590114,0.23803027690037737,0.23803027690037737,0.2341001109082052,0.0,0,0,1,1,0.2341001109082052,0.0
7356,31,157,5,50,55,1,1241.488,44,2645.068,MORE,236,262,498,1,2,5.0,0.4687042303372438,5.0,-0.6984302957695783,-0.4532316351706496,-0.8645962247939263,105,50,55,0,-1.0969765115002945,-1.170500554541026,-0.9754171287841883,-0.9951124464590114,0.1177306897330374,0.1177306897330374,-0.9754171287841883,-1.170500554541026,0,0,0,0,-1.170500554541026,-0.9754171287841883
7357,31,158,34,80,74,1,4448.339,34,1542.329,MORE,2302,802,3104,3,2,-6.0,-0.5624450764046927,6.0,-0.5238227218271837,-0.8784685094511654,2.3816991786113157,154,80,74,1,-0.11967016489094122,0.0,-0.2341001109082052,0.7938537494223578,2.7066780552301664,2.7066780552301664,-0.2341001109082052,0.0,0,1,1,1,0.0,-0.2341001109082052
7358,31,159,15,45,50,1,1159.256,24,675.8939999999999,MORE,308,362,670,1,1,5.0,0.4687042303372438,5.0,-0.6984302957695783,-1.3037053837316812,-0.9478396818840188,95,45,50,0,-1.2964267863185297,-1.3655839802978638,-1.170500554541026,-0.9951124464590114,0.2079553801085424,0.2079553801085424,-1.170500554541026,-1.3655839802978638,0,0,1,0,-1.3655839802978638,-1.170500554541026
7359,31,160,37,69,80,1,2752.659,44,1613.382,MORE,1140,556,1696,1,1,11.0,1.0311493067419364,11.0,0.34921514788478913,-0.4532316351706496,0.6651622426432271,149,69,80,0,-0.21939530230005888,-0.4291835366650429,0.0,-0.9951124464590114,1.250551802225489,1.250551802225489,0.0,-0.4291835366650429,0,0,1,1,-0.4291835366650429,0.0
7360,31,161,3,50,53,1,3781.584,64,1438.205,LESS,348,762,1110,3,2,3.0,0.28122253820234633,3.0,-1.0476454436543674,0.3972421133903819,1.7067430638128849,103,50,53,1,-1.1368665664639415,-1.170500554541026,-1.0534504990869233,0.7938537494223578,0.25808020809493404,0.25808020809493404,-1.0534504990869233,-1.170500554541026,1,1,1,0,-1.170500554541026,-1.0534504990869233
7361,31,162,20,50,40,1,1458.75,84,2576.076,LESS,370,622,992,2,2,-10.0,-0.9374084606744876,10.0,0.17460757394239454,1.2477158619514137,-0.6446618929728877,90,50,40,0,-1.3961519237276474,-1.170500554541026,-1.5606674060547012,-0.10062934851832685,0.28564886348744944,0.28564886348744944,-1.5606674060547012,-1.170500554541026,1,0,1,0,-1.170500554541026,-1.5606674060547012
7362,31,163,25,80,88,1,2584.8520000000008,54,913.615,LESS,106,1046,1152,3,2,8.0,0.7499267685395902,8.0,-0.17460757394239454,-0.027994760890133873,0.4952912094211594,168,80,88,1,0.1595602198545883,0.0,0.31213348121094026,0.7938537494223578,-0.045175001222735496,0.045175001222735496,0.31213348121094026,0.0,0,1,0,1,0.31213348121094026,0.0
7363,31,164,42,115,110,1,1880.184,64,2023.332,LESS,552,680,1232,2,1,-5.0,-0.4687042303372438,5.0,-0.6984302957695783,0.3972421133903819,-0.21804423688637647,225,115,110,0,1.2964267863185297,1.3655839802978638,1.170500554541026,-0.10062934851832685,0.5137168308255315,0.5137168308255315,1.170500554541026,1.3655839802978638,1,1,1,2,1.3655839802978638,1.170500554541026
7364,31,165,53,103,110,1,2231.882,34,1411.744,LESS,548,800,1348,3,2,7.0,0.6561859224721414,7.0,-0.34921514788478913,-0.8784685094511654,0.13797966344039803,213,103,110,1,1.0570864565366473,0.8973837584814532,1.170500554541026,0.7938537494223578,0.5087043480268924,0.5087043480268924,1.170500554541026,0.8973837584814532,0,1,1,2,1.170500554541026,0.8973837584814532
7365,31,166,26,90,80,1,1874.35,64,1861.517,LESS,1178,52,1230,1,2,-10.0,-0.9374084606744876,10.0,0.17460757394239454,0.3972421133903819,-0.2239499953339833,170,90,80,0,0.19945027481823535,0.3901668515136753,0.0,-0.9951124464590114,1.298170388812561,1.298170388812561,0.0,0.3901668515136753,1,0,1,1,0.3901668515136753,0.0
7366,31,167,35,80,72,1,3635.247,44,1437.6429999999998,LESS,314,1322,1636,5,1,-8.0,-0.7499267685395902,8.0,-0.17460757394239454,-0.4532316351706496,1.5586061125020465,152,80,72,0,-0.1595602198545883,0.0,-0.31213348121094026,2.5828199453037266,0.21547410430650113,0.21547410430650113,-0.31213348121094026,0.0,0,1,1,1,0.0,-0.31213348121094026
7367,31,168,28,93,80,1,3591.681,54,1231.336,LESS,142,1014,1156,3,2,-13.0,-1.218630998876834,13.0,0.6984302957695783,-0.027994760890133873,1.5145042488530176,173,93,80,0,0.25928535726370594,0.5072169069677779,0.0,0.7938537494223578,-6.265603498300382e-05,6.265603498300382e-05,0.0,0.5072169069677779,0,1,0,1,0.5072169069677779,0.0
7368,31,169,26,80,90,1,3609.961,44,2199.809,LESS,984,1198,2182,2,1,10.0,0.9374084606744876,10.0,0.17460757394239454,-0.4532316351706496,1.5330090936288574,170,80,90,1,0.19945027481823535,0.0,0.3901668515136753,-0.10062934851832685,1.0550649730785615,1.0550649730785615,0.3901668515136753,0.0,0,1,1,1,0.3901668515136753,0.0
7369,31,170,25,88,80,1,1058.188,44,2117.712,LESS,94,492,586,2,1,-8.0,-0.7499267685395902,8.0,-0.17460757394239454,-0.4532316351706496,-1.050150822573549,168,88,80,0,0.1595602198545883,0.31213348121094026,0.0,-0.10062934851832685,-0.060212449618653,0.060212449618653,0.0,0.31213348121094026,0,0,0,1,0.31213348121094026,0.0
7370,31,171,36,80,70,1,1874.048,44,1431.54,LESS,530,586,1116,3,2,-10.0,-0.9374084606744876,10.0,0.17460757394239454,-0.4532316351706496,-0.2242557099468007,150,80,70,0,-0.19945027481823535,0.0,-0.3901668515136753,0.7938537494223578,0.4861481754330161,0.4861481754330161,-0.3901668515136753,0.0,0,1,1,1,0.0,-0.3901668515136753
7371,31,172,28,80,93,0,4384.535,74,658.822,LESS,1206,1424,2630,3,2,13.0,1.218630998876834,13.0,0.6984302957695783,0.8224789876708977,2.3171103867033445,173,80,93,1,0.25928535726370594,0.0,0.5072169069677779,0.7938537494223578,1.3332577684030351,1.3332577684030351,0.5072169069677779,0.0,1,1,1,1,0.5072169069677779,0.0
7372,31,173,21,82,80,1,1214.507,64,1932.232,LESS,1030,208,1238,1,2,-2.0,-0.18748169213489754,2.0,-1.222253017596762,0.3972421133903819,-0.8919090922390545,162,82,80,0,0.03989005496364707,0.07803337030273506,0.0,-0.9951124464590114,1.1127085252629119,1.1127085252629119,0.0,0.07803337030273506,1,0,1,1,0.07803337030273506,0.0
7373,31,174,19,50,41,1,1271.033,54,1337.079,LESS,328,280,608,1,2,-9.0,-0.8436676146070391,9.0,0.0,-0.027994760890133873,-0.8346878200399769,91,50,41,0,-1.376206896245824,-1.170500554541026,-1.5216507209033339,-0.9951124464590114,0.2330177941017382,0.2330177941017382,-1.5216507209033339,-1.170500554541026,0,0,1,0,-1.170500554541026,-1.5216507209033339
7374,31,175,56,96,110,1,2715.3390000000004,64,1578.955,LESS,624,798,1422,3,2,14.0,1.3123718449442827,14.0,0.8730378697119728,0.3972421133903819,0.6273832050592911,206,96,110,1,0.9174712641638826,0.6242669624218805,1.170500554541026,0.7938537494223578,0.6039415212010365,0.6039415212010365,1.170500554541026,0.6242669624218805,1,1,1,2,1.170500554541026,0.6242669624218805
7375,31,176,23,80,85,1,1162.259,54,1302.05,LESS,-82,764,682,1,1,5.0,0.4687042303372438,5.0,-0.6984302957695783,-0.027994760890133873,-0.9447997448565651,165,80,85,1,0.09972513740911768,0.0,0.19508342575683765,-0.9951124464590114,-0.28076169275877627,0.28076169275877627,0.19508342575683765,0.0,0,0,0,1,0.19508342575683765,0.0
7376,31,177,10,60,50,1,1627.316,54,2469.394,LESS,662,368,1030,1,1,-10.0,-0.9374084606744876,10.0,0.17460757394239454,-0.027994760890133873,-0.4740225240186057,110,60,50,0,-0.9972513740911768,-0.7803337030273506,-1.170500554541026,-0.9951124464590114,0.6515601077881087,0.6515601077881087,-1.170500554541026,-0.7803337030273506,0,0,1,0,-0.7803337030273506,-1.170500554541026
7377,31,178,19,41,50,1,1088.588,54,2406.373,LESS,-16,662,646,2,1,9.0,0.8436676146070391,9.0,0.0,-0.027994760890133873,-1.0193769012833116,91,41,50,1,-1.376206896245824,-1.5216507209033339,-1.170500554541026,-0.10062934851832685,-0.19805572658123005,0.19805572658123005,-1.170500554541026,-1.5216507209033339,0,0,0,0,-1.5216507209033339,-1.170500554541026
7378,31,179,56,110,96,1,1152.4,44,1280.894,LESS,-90,868,778,2,1,-14.0,-1.3123718449442827,14.0,0.8730378697119728,-0.4532316351706496,-0.9547800109750012,206,110,96,0,0.9174712641638826,1.170500554541026,0.6242669624218805,-0.10062934851832685,-0.2907866583560546,0.2907866583560546,0.6242669624218805,1.170500554541026,0,0,0,2,1.170500554541026,0.6242669624218805
7379,31,180,35,72,80,1,1769.507,54,624.628,LESS,500,578,1078,1,2,8.0,0.7499267685395902,8.0,-0.17460757394239454,-0.027994760890133873,-0.3300825686837321,152,72,80,1,-0.1595602198545883,-0.31213348121094026,0.0,-0.9951124464590114,0.44855455444322234,0.44855455444322234,0.0,-0.31213348121094026,0,0,1,1,-0.31213348121094026,0.0
7380,31,181,11,49,50,1,2095.48,44,1541.504,LESS,752,786,1538,2,1,1.0,0.09374084606744876,1.0,-1.3968605915391563,-0.4532316351706496,-0.00010008694877878014,99,49,50,1,-1.2166466763912356,-1.2095172396923934,-1.170500554541026,-0.10062934851832685,0.7643409707574899,0.7643409707574899,-1.170500554541026,-1.2095172396923934,0,1,1,0,-1.2095172396923934,-1.170500554541026
7381,31,182,17,43,50,1,1013.983,24,643.087,LESS,270,604,874,2,1,7.0,0.6561859224721414,7.0,-0.34921514788478913,-1.3037053837316812,-1.0948995459496986,93,43,50,1,-1.3363168412821769,-1.4436173506005987,-1.170500554541026,-0.10062934851832685,0.16033679352147032,0.16033679352147032,-1.170500554541026,-1.4436173506005987,0,1,1,0,-1.4436173506005987,-1.170500554541026
7382,31,183,1,51,50,1,2985.9790000000007,44,635.918,LESS,682,836,1518,3,2,-1.0,-0.09374084606744876,1.0,-1.3968605915391563,-0.4532316351706496,0.9013520885458004,101,51,50,0,-1.1767566214275886,-1.1314838693896585,-1.170500554541026,0.7938537494223578,0.6766225217813044,0.6766225217813044,-1.170500554541026,-1.1314838693896585,0,1,1,0,-1.1314838693896585,-1.170500554541026
7383,31,184,41,112,110,1,1527.625,24,2403.344,LESS,-814,1552,738,2,1,-2.0,-0.18748169213489754,2.0,-1.222253017596762,-1.3037053837316812,-0.5749397275496934,222,112,110,0,1.2365917038730592,1.248533924843761,1.170500554541026,-0.10062934851832685,-1.1980460449097436,1.1980460449097436,1.170500554541026,1.248533924843761,0,1,0,2,1.248533924843761,1.170500554541026
7384,31,185,20,40,50,0,1651.023,74,2584.6710000000007,LESS,-838,1640,802,2,2,10.0,0.9374084606744876,10.0,0.17460757394239454,0.8224789876708977,-0.4500239269124328,90,40,50,1,-1.3961519237276474,-1.5606674060547012,-1.170500554541026,-0.10062934851832685,-1.2281209417015786,1.2281209417015786,-1.170500554541026,-1.5606674060547012,1,1,0,0,-1.5606674060547012,-1.170500554541026
7385,31,186,1,50,51,1,1963.991,34,1635.121,LESS,500,686,1186,4,1,1.0,0.09374084606744876,1.0,-1.3968605915391563,-0.8784685094511654,-0.13320640722943788,101,50,51,1,-1.1767566214275886,-1.170500554541026,-1.1314838693896585,1.6883368473630422,0.44855455444322234,0.44855455444322234,-1.1314838693896585,-1.170500554541026,0,1,1,0,-1.170500554541026,-1.1314838693896585
7386,31,187,23,85,80,1,1478.497,64,1538.219,LESS,638,400,1038,1,1,-5.0,-0.4687042303372438,5.0,-0.6984302957695783,0.3972421133903819,-0.6246720040347851,165,85,80,0,0.09972513740911768,0.19508342575683765,0.0,-0.9951124464590114,0.6214852109962735,0.6214852109962735,0.0,0.19508342575683765,1,0,1,1,0.19508342575683765,0.0
7387,31,188,11,50,49,0,1790.611,54,1786.8729999999996,LESS,-894,1280,386,3,1,-1.0,-0.09374084606744876,1.0,-1.3968605915391563,-0.027994760890133873,-0.3087189885880356,99,50,49,0,-1.2166466763912356,-1.170500554541026,-1.2095172396923934,0.7938537494223578,-1.2982957008825269,1.2982957008825269,-1.2095172396923934,-1.170500554541026,0,1,0,0,-1.170500554541026,-1.2095172396923934
7388,31,189,17,50,43,1,1371.453,54,1241.945,LESS,-32,620,588,1,2,-7.0,-0.6561859224721414,7.0,-0.34921514788478913,-0.027994760890133873,-0.7330326497779489,93,50,43,0,-1.3363168412821769,-1.170500554541026,-1.4436173506005987,-0.9951124464590114,-0.21810565777578672,0.21810565777578672,-1.4436173506005987,-1.170500554541026,0,0,0,0,-1.170500554541026,-1.4436173506005987
7389,31,190,21,80,82,1,2858.395,44,1115.785,LESS,482,644,1126,2,1,2.0,0.18748169213489754,2.0,-1.222253017596762,-0.4532316351706496,0.7721987999308767,162,80,82,1,0.03989005496364707,0.0,0.07803337030273506,-0.10062934851832685,0.4259983818493461,0.4259983818493461,0.07803337030273506,0.0,0,1,1,1,0.07803337030273506,0.0
7390,31,191,10,50,60,1,1692.7220000000002,44,1428.783,LESS,702,522,1224,1,1,10.0,0.9374084606744876,10.0,0.17460757394239454,-0.4532316351706496,-0.4078120274426426,110,50,60,1,-0.9972513740911768,-1.170500554541026,-0.7803337030273506,-0.9951124464590114,0.7016849357745003,0.7016849357745003,-0.7803337030273506,-1.170500554541026,0,0,1,0,-1.170500554541026,-0.7803337030273506
7391,31,192,3,53,50,1,1104.283,44,1300.499,LESS,386,336,722,1,2,-3.0,-0.28122253820234633,3.0,-1.0476454436543674,-0.4532316351706496,-1.003488852117184,103,53,50,0,-1.1368665664639415,-1.0534504990869233,-1.170500554541026,-0.9951124464590114,0.3056987946820061,0.3056987946820061,-1.170500554541026,-1.0534504990869233,0,0,1,0,-1.0534504990869233,-1.170500554541026
7392,31,193,45,122,110,0,1540.489,54,2133.739,LESS,-470,1132,662,2,2,-12.0,-1.124890152809385,12.0,0.5238227218271837,-0.027994760890133873,-0.5619174998037192,232,122,110,0,1.4360419786912946,1.6387007763574364,1.170500554541026,-0.10062934851832685,-0.7669725242267753,0.7669725242267753,1.170500554541026,1.6387007763574364,0,1,0,2,1.6387007763574364,1.170500554541026
7393,31,194,38,67,80,0,2075.597,54,3825.304,LESS,-76,888,812,3,2,13.0,1.218630998876834,13.0,0.6984302957695783,-0.027994760890133873,-0.020227648692653317,147,67,80,1,-0.25928535726370594,-0.5072169069677779,0.0,0.7938537494223578,-0.27324296856081753,0.27324296856081753,0.0,-0.5072169069677779,0,1,0,1,-0.5072169069677779,0.0
7394,31,195,38,80,67,1,1490.401,44,2205.347,LESS,806,146,952,1,2,-13.0,-1.218630998876834,13.0,0.6984302957695783,-0.4532316351706496,-0.6126215843295552,147,80,67,0,-0.25928535726370594,0.0,-0.5072169069677779,-0.9951124464590114,0.8320094885391186,0.8320094885391186,-0.5072169069677779,0.0,0,0,1,1,0.0,-0.5072169069677779
7395,31,196,36,70,80,1,1018.253,44,2266.5,LESS,154,462,616,2,1,10.0,0.9374084606744876,10.0,0.17460757394239454,-0.4532316351706496,-1.090577024768471,150,70,80,1,-0.19945027481823535,-0.3901668515136753,0.0,-0.10062934851832685,0.014974792360934493,0.014974792360934493,0.0,-0.3901668515136753,0,0,0,1,-0.3901668515136753,0.0
7396,31,197,45,110,122,1,1569.109,44,1622.499,LESS,1396,0,1396,0,2,12.0,1.124890152809385,12.0,0.5238227218271837,-0.4532316351706496,-0.5329454725890286,232,110,122,1,1.4360419786912946,1.170500554541026,1.6387007763574364,-1.889595544399696,1.5713507013383956,1.5713507013383956,1.6387007763574364,1.170500554541026,0,0,1,2,1.6387007763574364,1.170500554541026
7397,31,198,42,110,115,1,1296.545,54,1706.777,LESS,650,324,974,1,2,5.0,0.4687042303372438,5.0,-0.6984302957695783,-0.027994760890133873,-0.8088620213571959,225,110,115,1,1.2964267863185297,1.170500554541026,1.3655839802978638,-0.9951124464590114,0.6365226593921911,0.6365226593921911,1.3655839802978638,1.170500554541026,0,0,1,2,1.3655839802978638,1.170500554541026
7398,31,199,41,110,112,0,1447.445,54,2180.66,LESS,120,910,1030,2,2,2.0,0.18748169213489754,2.0,-1.222253017596762,-0.027994760890133873,-0.6561059449526948,222,110,112,1,1.2365917038730592,1.170500554541026,1.248533924843761,-0.10062934851832685,-0.027631311427498417,0.027631311427498417,1.248533924843761,1.170500554541026,0,0,0,2,1.248533924843761,1.170500554541026
7399,31,200,53,110,103,1,1812.507,44,4579.828,LESS,276,652,928,3,2,-7.0,-0.6561859224721414,7.0,-0.34921514788478913,-0.4532316351706496,-0.28655366685872513,213,110,103,0,1.0570864565366473,1.170500554541026,0.8973837584814532,0.7938537494223578,0.16785551771942905,0.16785551771942905,0.8973837584814532,1.170500554541026,0,1,1,2,1.170500554541026,0.8973837584814532
7400,31,201,3,50,53,0,2169.698,94,1159.687,MORE,344,774,1118,2,2,3.0,0.28122253820234633,3.0,-1.0476454436543674,1.6729527362319292,0.07503079760118309,103,50,53,0,-1.1368665664639415,-1.170500554541026,-1.0534504990869233,-0.10062934851832685,0.2530677252962949,0.2530677252962949,-1.0534504990869233,-1.170500554541026,1,0,1,0,-1.170500554541026,-1.0534504990869233
7401,31,202,20,50,40,1,1977.078,44,2137.641,MORE,704,474,1178,1,1,-10.0,-0.9374084606744876,10.0,0.17460757394239454,-0.4532316351706496,-0.11995843657399916,90,50,40,1,-1.3961519237276474,-1.170500554541026,-1.5606674060547012,-0.9951124464590114,0.7041911771738198,0.7041911771738198,-1.5606674060547012,-1.170500554541026,0,0,1,0,-1.170500554541026,-1.5606674060547012
7402,31,203,25,80,88,1,2680.485,44,2307.861,MORE,-280,1292,1012,5,2,8.0,0.7499267685395902,8.0,-0.17460757394239454,-0.4532316351706496,0.5921004993800166,168,80,88,0,0.1595602198545883,0.0,0.31213348121094026,2.5828199453037266,-0.528879591291415,0.528879591291415,0.31213348121094026,0.0,0,1,0,1,0.31213348121094026,0.0
7403,31,204,42,115,110,0,1689.904,44,1983.594,MORE,-668,1028,360,2,1,-5.0,-0.4687042303372438,5.0,-0.6984302957695783,-0.4532316351706496,-0.4106646889622445,225,115,110,1,1.2964267863185297,1.3655839802978638,1.170500554541026,-0.10062934851832685,-1.015090422759414,1.015090422759414,1.170500554541026,1.3655839802978638,0,0,0,2,1.3655839802978638,1.170500554541026
7404,31,205,53,103,110,1,2395.99,44,1566.685,MORE,748,604,1352,2,1,7.0,0.6561859224721414,7.0,-0.34921514788478913,-0.4532316351706496,0.3041061988054731,213,103,110,0,1.0570864565366473,0.8973837584814532,1.170500554541026,-0.10062934851832685,0.7593284879588507,0.7593284879588507,1.170500554541026,0.8973837584814532,0,0,1,2,1.170500554541026,0.8973837584814532
7405,31,206,26,90,80,1,1078.112,54,2272.433,MORE,434,366,800,1,2,-10.0,-0.9374084606744876,10.0,0.17460757394239454,-0.027994760890133873,-1.029981756527934,170,90,80,1,0.19945027481823535,0.3901668515136753,0.0,-0.9951124464590114,0.3658485882656761,0.3658485882656761,0.0,0.3901668515136753,1,0,1,1,0.3901668515136753,0.0
7406,31,207,35,80,72,1,1638.964,44,2179.038,MORE,116,700,816,2,2,-8.0,-0.7499267685395902,8.0,-0.17460757394239454,-0.4532316351706496,-0.4622312531242411,152,80,72,1,-0.1595602198545883,0.0,-0.31213348121094026,-0.10062934851832685,-0.032643794226137585,0.032643794226137585,-0.31213348121094026,0.0,0,0,0,1,0.0,-0.31213348121094026
7407,31,208,28,93,80,0,2425.11,44,620.58,MORE,1138,556,1694,2,1,-13.0,-1.218630998876834,13.0,0.6984302957695783,-0.4532316351706496,0.33358437604138513,173,93,80,1,0.25928535726370594,0.5072169069677779,0.0,-0.10062934851832685,1.2480455608261694,1.2480455608261694,0.0,0.5072169069677779,0,0,1,1,0.5072169069677779,0.0
7408,31,209,26,80,90,1,3053.119,54,1290.714,MORE,1164,980,2144,4,1,10.0,0.9374084606744876,10.0,0.17460757394239454,-0.027994760890133873,0.9693179133953572,170,80,90,0,0.19945027481823535,0.0,0.3901668515136753,1.6883368473630422,1.280626699017324,1.280626699017324,0.3901668515136753,0.0,1,1,1,1,0.3901668515136753,0.0
7409,31,210,25,88,80,1,2378.541,54,1376.5379999999998,MORE,368,828,1196,3,1,-8.0,-0.7499267685395902,8.0,-0.17460757394239454,-0.027994760890133873,0.28644257536490264,168,88,80,1,0.1595602198545883,0.31213348121094026,0.0,0.7938537494223578,0.28314262208812985,0.28314262208812985,0.0,0.31213348121094026,1,1,1,1,0.31213348121094026,0.0
7410,31,211,36,80,70,1,1820.964,54,2451.562,MORE,76,878,954,4,1,-10.0,-0.9374084606744876,10.0,0.17460757394239454,-0.027994760890133873,-0.2779926453997931,150,80,70,1,-0.19945027481823535,0.0,-0.3901668515136753,1.6883368473630422,-0.08276862221252924,0.08276862221252924,-0.3901668515136753,0.0,1,1,0,1,0.0,-0.3901668515136753
7411,31,212,28,80,93,1,1896.834,64,1689.256,MORE,806,230,1036,1,2,13.0,1.218630998876834,13.0,0.6984302957695783,0.3972421133903819,-0.2011894411797167,173,80,93,0,0.25928535726370594,0.0,0.5072169069677779,-0.9951124464590114,0.8320094885391186,0.8320094885391186,0.5072169069677779,0.0,1,0,1,1,0.5072169069677779,0.0
7412,31,213,21,82,80,1,1562.6529999999998,44,2734.387,MORE,-82,752,670,3,1,-2.0,-0.18748169213489754,2.0,-1.222253017596762,-0.4532316351706496,-0.5394808816630344,162,82,80,1,0.03989005496364707,0.07803337030273506,0.0,0.7938537494223578,-0.28076169275877627,0.28076169275877627,0.0,0.07803337030273506,0,1,0,1,0.07803337030273506,0.0
7413,31,214,19,50,41,1,2232.199,44,3625.286,MORE,454,1004,1458,3,1,-9.0,-0.8436676146070391,9.0,0.0,-0.4532316351706496,0.13830056255385212,91,50,41,1,-1.376206896245824,-1.170500554541026,-1.5216507209033339,0.7938537494223578,0.39091100225887193,0.39091100225887193,-1.5216507209033339,-1.170500554541026,0,1,1,0,-1.170500554541026,-1.5216507209033339
7414,31,215,56,96,110,1,1626.247,54,2309.897,MORE,1204,346,1550,2,2,14.0,1.3123718449442827,14.0,0.8730378697119728,-0.027994760890133873,-0.4751046727639762,206,96,110,0,0.9174712641638826,0.6242669624218805,1.170500554541026,-0.10062934851832685,1.3307515270037156,1.3307515270037156,1.170500554541026,0.6242669624218805,1,0,1,2,1.170500554541026,0.6242669624218805
7415,31,216,23,80,85,1,1787.486,54,2498.89,MORE,766,526,1292,3,2,5.0,0.4687042303372438,5.0,-0.6984302957695783,-0.027994760890133873,-0.3118824262206669,165,80,85,0,0.09972513740911768,0.0,0.19508342575683765,0.7938537494223578,0.781884660552727,0.781884660552727,0.19508342575683765,0.0,1,1,1,1,0.19508342575683765,0.0
7416,31,217,10,60,50,1,2021.066,44,1292.068,MORE,306,580,886,3,2,-10.0,-0.9374084606744876,10.0,0.17460757394239454,-0.4532316351706496,-0.07542938230705942,110,60,50,1,-0.9972513740911768,-0.7803337030273506,-1.170500554541026,0.7938537494223578,0.2054491387092228,0.2054491387092228,-1.170500554541026,-0.7803337030273506,0,1,1,0,-0.7803337030273506,-1.170500554541026
7417,31,218,19,41,50,1,1680.161,44,2214.799,MORE,574,480,1054,2,2,9.0,0.8436676146070391,9.0,0.0,-0.4532316351706496,-0.420527528275757,91,41,50,0,-1.376206896245824,-1.5216507209033339,-1.170500554541026,-0.10062934851832685,0.541285486218047,0.541285486218047,-1.170500554541026,-1.5216507209033339,0,0,1,0,-1.5216507209033339,-1.170500554541026
7418,31,219,56,110,96,1,1178.393,54,2253.193,MORE,310,440,750,2,1,-14.0,-1.3123718449442827,14.0,0.8730378697119728,-0.027994760890133873,-0.9284672959718056,206,110,96,1,0.9174712641638826,1.170500554541026,0.6242669624218805,-0.10062934851832685,0.21046162150786196,0.21046162150786196,0.6242669624218805,1.170500554541026,1,0,1,2,1.170500554541026,0.6242669624218805
7419,31,220,35,72,80,1,1764.579,44,3543.277,MORE,6,742,748,2,1,8.0,0.7499267685395902,8.0,-0.17460757394239454,-0.4532316351706496,-0.3350711832928865,152,72,80,0,-0.1595602198545883,-0.31213348121094026,0.0,-0.10062934851832685,-0.17048707118871465,0.17048707118871465,0.0,-0.31213348121094026,0,0,0,1,-0.31213348121094026,0.0
7420,31,221,11,49,50,1,1244.851,44,2681.766,MORE,-280,714,434,1,2,1.0,0.09374084606744876,1.0,-1.3968605915391563,-0.4532316351706496,-0.8611918597511937,99,49,50,0,-1.2166466763912356,-1.2095172396923934,-1.170500554541026,-0.9951124464590114,-0.528879591291415,0.528879591291415,-1.170500554541026,-1.2095172396923934,0,0,0,0,-1.2095172396923934,-1.170500554541026
7421,31,222,17,43,50,1,1755.465,44,2717.859000000001,MORE,1164,298,1462,2,2,7.0,0.6561859224721414,7.0,-0.34921514788478913,-0.4532316351706496,-0.3442972858797031,93,43,50,0,-1.3363168412821769,-1.4436173506005987,-1.170500554541026,-0.10062934851832685,1.280626699017324,1.280626699017324,-1.170500554541026,-1.4436173506005987,0,0,1,0,-1.4436173506005987,-1.170500554541026
7422,31,223,1,51,50,1,2110.961,44,1556.023,MORE,220,834,1054,3,1,-1.0,-0.09374084606744876,1.0,-1.3968605915391563,-0.4532316351706496,0.015571330008265931,101,51,50,1,-1.1767566214275886,-1.1314838693896585,-1.170500554541026,0.7938537494223578,0.09768075853848072,0.09768075853848072,-1.170500554541026,-1.1314838693896585,0,1,0,0,-1.1314838693896585,-1.170500554541026
7423,31,224,41,112,110,1,1266.829,54,1812.481,MORE,-188,624,436,2,1,-2.0,-0.18748169213489754,2.0,-1.222253017596762,-0.027994760890133873,-0.8389435294184031,222,112,110,1,1.2365917038730592,1.248533924843761,1.170500554541026,-0.10062934851832685,-0.41359248692271416,0.41359248692271416,1.170500554541026,1.248533924843761,1,0,0,2,1.248533924843761,1.170500554541026
7424,31,225,20,40,50,1,1621.5279999999998,44,2203.84,MORE,462,340,802,1,2,10.0,0.9374084606744876,10.0,0.17460757394239454,-0.4532316351706496,-0.4798817166642604,90,40,50,0,-1.3961519237276474,-1.5606674060547012,-1.170500554541026,-0.9951124464590114,0.40093596785615027,0.40093596785615027,-1.170500554541026,-1.5606674060547012,0,0,1,0,-1.5606674060547012,-1.170500554541026
7425,31,226,1,50,51,1,1313.044,44,2651.37,MORE,814,132,946,2,2,1.0,0.09374084606744876,1.0,-1.3968605915391563,-0.4532316351706496,-0.7921600829569448,101,50,51,0,-1.1767566214275886,-1.170500554541026,-1.1314838693896585,-0.10062934851832685,0.842034454136397,0.842034454136397,-1.1314838693896585,-1.170500554541026,0,0,1,0,-1.170500554541026,-1.1314838693896585
7426,31,227,23,85,80,1,1223.26,44,887.059,MORE,366,514,880,2,1,-5.0,-0.4687042303372438,5.0,-0.6984302957695783,-0.4532316351706496,-0.8830484299675595,165,85,80,1,0.09972513740911768,0.19508342575683765,0.0,-0.10062934851832685,0.2806363806888103,0.2806363806888103,0.0,0.19508342575683765,0,0,1,1,0.19508342575683765,0.0
7427,31,228,11,50,49,1,1626.206,54,2593.653,MORE,-22,596,574,3,2,-1.0,-0.09374084606744876,1.0,-1.3968605915391563,-0.027994760890133873,-0.4751461770657165,99,50,49,1,-1.2166466763912356,-1.170500554541026,-1.2095172396923934,0.7938537494223578,-0.20557445077918882,0.20557445077918882,-1.2095172396923934,-1.170500554541026,0,1,0,0,-1.170500554541026,-1.2095172396923934
7428,31,229,17,50,43,1,2068.631,44,2804.994,MORE,502,612,1114,3,2,-7.0,-0.6561859224721414,7.0,-0.34921514788478913,-0.4532316351706496,-0.0272793307883048,93,50,43,1,-1.3363168412821769,-1.170500554541026,-1.4436173506005987,0.7938537494223578,0.45106079584254194,0.45106079584254194,-1.4436173506005987,-1.170500554541026,0,1,1,0,-1.170500554541026,-1.4436173506005987
7429,31,230,21,80,82,1,1876.425,54,434.473,MORE,142,612,754,3,2,2.0,0.18748169213489754,2.0,-1.222253017596762,-0.027994760890133873,-0.22184947274591604,162,80,82,0,0.03989005496364707,0.0,0.07803337030273506,0.7938537494223578,-6.265603498300382e-05,6.265603498300382e-05,0.07803337030273506,0.0,0,1,0,1,0.07803337030273506,0.0
7430,31,231,10,50,60,1,2716.013,44,2761.66,MORE,1278,296,1574,1,2,10.0,0.9374084606744876,10.0,0.17460757394239454,-0.4532316351706496,0.6280654952878966,110,50,60,0,-0.9972513740911768,-1.170500554541026,-0.7803337030273506,-0.9951124464590114,1.4234824587785402,1.4234824587785402,-0.7803337030273506,-1.170500554541026,0,0,1,0,-1.170500554541026,-0.7803337030273506
7431,31,232,3,53,50,1,1954.329,44,2717.103,MORE,578,634,1212,3,2,-3.0,-0.28122253820234633,3.0,-1.0476454436543674,-0.4532316351706496,-0.14298725023951275,103,53,50,1,-1.1368665664639415,-1.0534504990869233,-1.170500554541026,0.7938537494223578,0.546297969016686,0.546297969016686,-1.170500554541026,-1.0534504990869233,0,1,1,0,-1.0534504990869233,-1.170500554541026
7432,31,233,45,122,110,1,2078.482,44,1842.911,MORE,120,742,862,3,2,-12.0,-1.124890152809385,12.0,0.5238227218271837,-0.4532316351706496,-0.017307163070208322,232,122,110,1,1.4360419786912946,1.6387007763574364,1.170500554541026,0.7938537494223578,-0.027631311427498417,0.027631311427498417,1.170500554541026,1.6387007763574364,0,1,0,2,1.6387007763574364,1.170500554541026
7433,31,234,38,67,80,1,1497.953,24,2030.88,MORE,364,620,984,2,1,13.0,1.218630998876834,13.0,0.6984302957695783,-1.3037053837316812,-0.6049766944090331,147,67,80,0,-0.25928535726370594,-0.5072169069677779,0.0,-0.10062934851832685,0.2781301392894907,0.2781301392894907,0.0,-0.5072169069677779,0,0,1,1,-0.5072169069677779,0.0
7434,31,235,38,80,67,1,1716.746,34,1467.7320000000002,MORE,232,442,674,3,2,-13.0,-1.218630998876834,13.0,0.6984302957695783,-0.8784685094511654,-0.3834925312230156,147,80,67,1,-0.25928535726370594,0.0,-0.5072169069677779,0.7938537494223578,0.11271820693439823,0.11271820693439823,-0.5072169069677779,0.0,0,1,0,1,0.0,-0.5072169069677779
7435,31,236,36,70,80,1,6313.167,44,1707.2479999999996,MORE,838,1042,1880,4,1,10.0,0.9374084606744876,10.0,0.17460757394239454,-0.4532316351706496,4.269464642158388,150,70,80,0,-0.19945027481823535,-0.3901668515136753,0.0,1.6883368473630422,0.8721093509282319,0.8721093509282319,0.0,-0.3901668515136753,0,1,1,1,-0.3901668515136753,0.0
7436,31,237,45,110,122,0,1684.1570000000004,44,1310.59,MORE,-492,888,396,2,1,12.0,1.124890152809385,12.0,0.5238227218271837,-0.4532316351706496,-0.4164823773061584,232,110,122,0,1.4360419786912946,1.170500554541026,1.6387007763574364,-0.10062934851832685,-0.7945411796192907,0.7945411796192907,1.6387007763574364,1.170500554541026,0,0,0,2,1.6387007763574364,1.170500554541026
7437,31,238,42,110,115,1,4731.989000000001,34,1228.898,MORE,602,852,1454,4,2,5.0,0.4687042303372438,5.0,-0.6984302957695783,-0.8784685094511654,2.6688380856499965,225,110,115,0,1.2964267863185297,1.170500554541026,1.3655839802978638,1.6883368473630422,0.5763728658085211,0.5763728658085211,1.3655839802978638,1.170500554541026,0,1,1,2,1.3655839802978638,1.170500554541026
7438,31,239,41,110,112,1,2697.963,0,1360.531,MORE,546,1118,1664,1,1,2.0,0.18748169213489754,2.0,-1.222253017596762,-2.324273882004919,0.6097934795218184,222,110,112,0,1.2365917038730592,1.170500554541026,1.248533924843761,-0.9951124464590114,0.5061981066275727,0.5061981066275727,1.248533924843761,1.170500554541026,0,0,1,2,1.248533924843761,1.170500554541026
7439,31,240,53,110,103,1,2765.381,64,1587.889,MORE,-440,1294,854,5,1,-7.0,-0.6561859224721414,7.0,-0.34921514788478913,0.3972421133903819,0.6780407237831743,213,110,103,1,1.0570864565366473,1.170500554541026,0.8973837584814532,2.5828199453037266,-0.7293789032369816,0.7293789032369816,0.8973837584814532,1.170500554541026,1,1,0,2,1.170500554541026,0.8973837584814532
7440,32,1,49,110,131,0,4973.7840000000015,64,2175.703,LESS,-1702,3196,1494,4,1,21.0,1.9685577674164243,21.0,2.0952908873087353,-0.5925599706165483,1.1729873605049734,241,110,131,1,1.6155472260277064,1.170500554541026,1.9898509427197442,1.365512642767376,-1.7076209070509443,1.7076209070509443,1.9898509427197442,1.170500554541026,0,1,0,2,1.9898509427197442,1.170500554541026
7441,32,2,13,47,50,0,2447.307,84,954.965,LESS,-190,1474,1284,2,2,3.0,0.28122253820234633,3.0,-1.0476454436543674,0.7828210056694449,-0.7778957093493258,97,47,50,1,-1.2565367313548828,-1.2875506099951286,-1.170500554541026,-0.4602424227711771,0.1599543634452783,0.1599543634452783,-1.170500554541026,-1.2875506099951286,1,1,1,0,-1.2875506099951286,-1.170500554541026
7442,32,3,16,50,44,0,2449.867,84,1976.785,LESS,-454,1606,1152,2,2,-6.0,-0.5624450764046927,6.0,-0.5238227218271837,0.7828210056694449,-0.7759189406477592,94,50,44,0,-1.3163718138003533,-1.170500554541026,-1.4046006654492311,-0.4602424227711771,-0.16613020759374467,0.16613020759374467,-1.4046006654492311,-1.170500554541026,1,1,1,0,-1.170500554541026,-1.4046006654492311
7443,32,4,7,57,50,1,2613.994,74,2174.999,LESS,154,1032,1186,3,2,-7.0,-0.6561859224721414,7.0,-0.34921514788478913,0.09513051752644833,-0.6491841294438669,107,57,50,0,-1.0570864565366473,-0.8973837584814532,-1.170500554541026,0.4526351099980994,0.5848524408597628,0.5848524408597628,-1.170500554541026,-0.8973837584814532,1,1,1,0,-0.8973837584814532,-1.170500554541026
7444,32,5,18,42,50,0,2133.02,94,1246.103,LESS,-360,1454,1094,2,2,8.0,0.7499267685395902,8.0,-0.17460757394239454,1.4705114938124415,-1.0205803597044636,92,42,50,1,-1.3562618687640005,-1.4826340357519663,-1.170500554541026,-0.4602424227711771,-0.050024337602577386,0.050024337602577386,-1.170500554541026,-1.4826340357519663,1,0,1,0,-1.4826340357519663,-1.170500554541026
7445,32,6,51,108,110,0,3913.398,24,2654.5840000000007,LESS,-1818,3314,1496,4,1,2.0,0.18748169213489754,2.0,-1.222253017596762,-3.3433219231885345,0.3541835103569126,218,108,110,1,1.156811593945765,1.092467184238291,1.170500554541026,1.365512642767376,-1.8509004912953633,1.8509004912953633,1.170500554541026,1.092467184238291,0,1,0,2,1.170500554541026,1.092467184238291
7446,32,7,31,78,80,0,3603.907,44,2643.1890000000008,LESS,-760,2026,1266,4,1,2.0,0.18748169213489754,2.0,-1.222253017596762,-1.9679409469025413,0.11520221261611525,158,78,80,1,-0.03989005496364707,-0.07803337030273506,0.0,1.365512642767376,-0.544091869479885,0.544091869479885,0.0,-0.07803337030273506,0,1,0,1,-0.07803337030273506,0.0
7447,32,8,58,110,92,0,9125.077,14,3568.1220000000008,LESS,-3080,5512,2432,6,1,-18.0,-1.6873352292140782,18.0,1.571468165481551,-4.031012411331531,4.3785131704389855,202,110,92,0,0.8376911542365885,1.170500554541026,0.4682002218164104,3.191267708305929,-3.409683554368269,3.409683554368269,0.4682002218164104,1.170500554541026,0,1,0,2,1.170500554541026,0.4682002218164104
7448,32,9,12,50,48,0,4338.833,54,2663.55,LESS,-1064,2602,1538,4,1,-2.0,-0.18748169213489754,2.0,-1.222253017596762,-1.280250458759545,0.6826938980720837,98,50,48,0,-1.2365917038730592,-1.170500554541026,-1.248533924843761,1.365512642767376,-0.9195831937066387,0.9195831937066387,-1.248533924843761,-1.170500554541026,0,1,0,0,-1.170500554541026,-1.248533924843761
7449,32,10,54,110,101,1,7992.463000000002,54,2609.988,LESS,384,3264,3648,4,2,-9.0,-0.8436676146070391,9.0,0.0,-1.280250458759545,3.5039366445968936,211,110,101,0,1.0171964015730004,1.170500554541026,0.8193503881787182,1.365512642767376,0.8689412716892146,0.8689412716892146,0.8193503881787182,1.170500554541026,0,1,1,2,1.170500554541026,0.8193503881787182
7450,32,11,14,46,50,1,7006.809,44,2277.437,LESS,-1258,3716,2458,6,1,4.0,0.3749633842697951,4.0,-0.8730378697119728,-1.9679409469025413,2.7428389970290863,96,46,50,1,-1.2764817588367063,-1.3265672951464962,-1.170500554541026,3.191267708305929,-1.1592059466671327,1.1592059466671327,-1.170500554541026,-1.3265672951464962,0,1,0,0,-1.3265672951464962,-1.170500554541026
7451,32,12,22,80,83,0,3355.692,64,1744.517,LESS,-456,1378,922,1,2,3.0,0.28122253820234633,3.0,-1.0476454436543674,-0.5925599706165483,-0.07646327303203622,163,80,83,1,0.05983508244547061,0.0,0.1170500554541026,-1.3731199555404536,-0.1686005452531312,0.1686005452531312,0.1170500554541026,0.0,0,0,1,1,0.1170500554541026,0.0
7452,32,13,6,50,56,0,3626.428,44,2978.235,LESS,-1172,2004,832,2,2,6.0,0.5624450764046927,6.0,-0.5238227218271837,-1.9679409469025413,0.13259237196297974,106,50,56,1,-1.077031484018471,-1.170500554541026,-0.9364004436328208,-0.4602424227711771,-1.0529814273135116,1.0529814273135116,-0.9364004436328208,-1.170500554541026,0,1,0,0,-1.170500554541026,-0.9364004436328208
7453,32,14,13,50,47,1,3624.866,54,2705.8520000000008,LESS,494,1082,1576,3,2,-3.0,-0.28122253820234633,3.0,-1.0476454436543674,-1.280250458759545,0.13138623418491474,97,50,47,0,-1.2565367313548828,-1.170500554541026,-1.2875506099951286,0.4526351099980994,1.0048098429554742,1.0048098429554742,-1.2875506099951286,-1.170500554541026,0,1,1,0,-1.170500554541026,-1.2875506099951286
7454,32,15,46,110,124,0,2910.647,64,2740.0890000000004,LESS,-340,1292,952,2,1,14.0,1.3123718449442827,14.0,0.8730378697119728,-0.5925599706165483,-0.4201160178713149,234,110,124,1,1.4759320336549415,1.170500554541026,1.7167341466601715,-0.4602424227711771,-0.02532096100871201,0.02532096100871201,1.7167341466601715,1.170500554541026,0,0,1,2,1.7167341466601715,1.170500554541026
7455,32,16,27,91,80,1,4485.889,64,4283.776,LESS,-982,2344,1362,3,2,-11.0,-1.0311493067419364,11.0,0.34921514788478913,-0.5925599706165483,0.7962469051726805,171,91,80,0,0.21939530230005888,0.4291835366650429,0.0,0.4526351099980994,-0.8182993496717906,0.8182993496717906,0.0,0.4291835366650429,0,1,0,1,0.4291835366650429,0.0
7456,32,17,40,64,80,0,3688.215,44,2646.054,LESS,-990,2146,1156,4,1,16.0,1.4998535370791803,16.0,1.222253017596762,-1.9679409469025413,0.18030276562066516,144,64,80,1,-0.3191204397091766,-0.6242669624218805,0.0,1.365512642767376,-0.8281807003093368,0.8281807003093368,0.0,-0.6242669624218805,0,1,0,1,-0.6242669624218805,0.0
7457,32,18,22,83,80,0,4392.83,74,1921.136,LESS,-66,1998,1932,1,2,-3.0,-0.28122253820234633,3.0,-1.0476454436543674,0.09513051752644833,0.7243890463449251,163,83,80,0,0.05983508244547061,0.1170500554541026,0.0,-1.3731199555404536,0.31311529832724366,0.31311529832724366,0.0,0.1170500554541026,0,0,1,1,0.1170500554541026,0.0
7458,32,19,54,101,110,0,3815.968,74,2548.105,LESS,-450,1908,1458,2,2,9.0,0.8436676146070391,9.0,0.0,0.09513051752644833,0.27895047340628737,211,101,110,1,1.0171964015730004,0.8193503881787182,1.170500554541026,-0.4602424227711771,-0.1611895322749716,0.1611895322749716,1.170500554541026,0.8193503881787182,0,0,1,2,1.170500554541026,0.8193503881787182
7459,32,20,6,56,50,1,4269.464,84,2030.166,LESS,296,2084,2380,3,2,-6.0,-0.5624450764046927,6.0,-0.5238227218271837,0.7828210056694449,0.6291288714865568,106,56,50,0,-1.077031484018471,-0.9364004436328208,-1.170500554541026,0.4526351099980994,0.760246414676207,0.760246414676207,-1.170500554541026,-0.9364004436328208,1,1,1,0,-0.9364004436328208,-1.170500554541026
7460,32,21,18,50,42,1,7251.211999999998,74,2396.932,LESS,-1850,3956,2106,3,2,-8.0,-0.7499267685395902,8.0,-0.17460757394239454,0.09513051752644833,2.9315609505325604,92,50,42,0,-1.3562618687640005,-1.170500554541026,-1.4826340357519663,0.4526351099980994,-1.890425893845548,1.890425893845548,-1.4826340357519663,-1.170500554541026,1,1,0,0,-1.170500554541026,-1.4826340357519663
7461,32,22,43,110,117,0,6089.505,64,1733.096,LESS,-242,2786,2544,3,2,7.0,0.6561859224721414,7.0,-0.34921514788478913,-0.5925599706165483,2.034519529442551,227,110,117,1,1.3363168412821769,1.170500554541026,1.4436173506005987,0.4526351099980994,0.09572558430122834,0.09572558430122834,1.4436173506005987,1.170500554541026,0,1,1,2,1.4436173506005987,1.170500554541026
7462,32,23,32,77,80,1,6634.553000000001,64,2408.467,LESS,-560,3228,2668,3,1,3.0,0.28122253820234633,3.0,-1.0476454436543674,-0.5925599706165483,2.455392118212584,157,77,80,1,-0.05983508244547061,-0.1170500554541026,0.0,0.4526351099980994,-0.29705810354123113,0.29705810354123113,0.0,-0.1170500554541026,0,1,0,1,-0.1170500554541026,0.0
7463,32,24,27,80,91,0,5592.339,24,1500.6029999999996,LESS,-1682,3374,1692,4,1,11.0,1.0311493067419364,11.0,0.34921514788478913,-3.3433219231885345,1.650620237144548,171,80,91,1,0.21939530230005888,0.0,0.4291835366650429,1.365512642767376,-1.6829175304570787,1.6829175304570787,0.4291835366650429,0.0,0,1,0,1,0.4291835366650429,0.0
7464,32,25,16,44,50,0,7972.491,64,1955.274,LESS,-1564,4028,2464,2,2,6.0,0.5624450764046927,6.0,-0.5238227218271837,-0.5925599706165483,3.4885147600235795,94,44,50,1,-1.3163718138003533,-1.4046006654492311,-1.170500554541026,-0.4602424227711771,-1.537167608553273,1.537167608553273,-1.170500554541026,-1.4046006654492311,0,0,0,0,-1.4046006654492311,-1.170500554541026
7465,32,26,7,50,57,0,4657.252,54,1726.473,LESS,-762,2250,1488,2,1,7.0,0.6561859224721414,7.0,-0.34921514788478913,-1.280250458759545,0.928569176659594,107,50,57,1,-1.0570864565366473,-1.170500554541026,-0.8973837584814532,-0.4602424227711771,-0.5465622071392715,0.5465622071392715,-0.8973837584814532,-1.170500554541026,0,0,0,0,-1.170500554541026,-0.8973837584814532
7466,32,27,14,50,46,0,4748.323,64,1592.345,LESS,-298,2044,1746,2,2,-4.0,-0.3749633842697951,4.0,-0.8730378697119728,-0.5925599706165483,0.9988919510425393,96,50,46,0,-1.2764817588367063,-1.170500554541026,-1.3265672951464962,-0.4602424227711771,0.02655612983840528,0.02655612983840528,-1.3265672951464962,-1.170500554541026,0,0,1,0,-1.170500554541026,-1.3265672951464962
7467,32,28,51,110,108,1,4865.221,44,3382.449,LESS,-480,2698,2218,3,2,-2.0,-0.18748169213489754,2.0,-1.222253017596762,-1.9679409469025413,1.0891576962283558,218,110,108,0,1.156811593945765,1.170500554541026,1.092467184238291,0.4526351099980994,-0.19824459716576964,0.19824459716576964,1.092467184238291,1.170500554541026,0,1,1,2,1.170500554541026,1.092467184238291
7468,32,29,50,133,110,1,2766.3190000000004,84,1404.503,LESS,340,1316,1656,1,2,-23.0,-2.1560394595513217,23.0,2.444506035193524,0.7828210056694449,-0.5315625308243044,243,133,110,0,1.6554372809913533,2.0678843130224793,1.170500554541026,-1.3731199555404536,0.8145938431827108,0.8145938431827108,1.170500554541026,2.0678843130224793,1,0,1,2,2.0678843130224793,1.170500554541026
7469,32,30,49,131,110,1,6360.724,64,1975.509,LESS,-16,2724,2708,3,2,-21.0,-1.9685577674164243,21.0,2.0952908873087353,-0.5925599706165483,2.243948135094933,241,131,110,0,1.6155472260277064,1.9898509427197442,1.170500554541026,0.4526351099980994,0.3748737398119071,0.3748737398119071,1.170500554541026,1.9898509427197442,0,1,1,2,1.9898509427197442,1.170500554541026
7470,32,31,47,126,110,1,2372.35,74,3909.816,LESS,-328,1350,1022,1,2,-16.0,-1.4998535370791803,16.0,1.222253017596762,0.09513051752644833,-0.8357756513662404,236,126,110,0,1.5158220886185887,1.7947675169629065,1.170500554541026,-1.3731199555404536,-0.010498935052392785,0.010498935052392785,1.170500554541026,1.7947675169629065,1,0,1,2,1.7947675169629065,1.170500554541026
7471,32,32,50,110,133,0,3719.128,94,1115.8239999999996,LESS,-694,2132,1438,1,2,23.0,2.1560394595513217,23.0,2.444506035193524,1.4705114938124415,0.2041730198673517,243,110,133,1,1.6554372809913533,1.170500554541026,2.0678843130224793,-1.3731199555404536,-0.46257072672012917,0.46257072672012917,2.0678843130224793,1.170500554541026,1,0,0,2,2.0678843130224793,1.170500554541026
7472,32,33,47,110,126,0,2716.71,84,2620.619,LESS,-1146,1852,706,2,2,16.0,1.4998535370791803,16.0,1.222253017596762,0.7828210056694449,-0.5698693739946173,236,110,126,1,1.5158220886185887,1.170500554541026,1.7947675169629065,-0.4602424227711771,-1.0208670377414868,1.0208670377414868,1.7947675169629065,1.170500554541026,1,0,0,2,1.7947675169629065,1.170500554541026
7473,32,34,12,48,50,0,2358.278,90,3610.059,LESS,1702,1744,3446,3,2,2.0,0.18748169213489754,2.0,-1.222253017596762,1.1954352985552428,-0.8466417018226625,98,48,50,1,-1.2365917038730592,-1.248533924843761,-1.170500554541026,0.4526351099980994,2.4968937892249428,2.4968937892249428,-1.170500554541026,-1.248533924843761,1,1,1,0,-1.248533924843761,-1.170500554541026
7474,32,35,32,80,77,1,4822.752,64,1797.668,LESS,-74,2016,1942,3,2,-3.0,-0.28122253820234633,3.0,-1.0476454436543674,-0.5925599706165483,1.056364184514756,157,80,77,0,-0.05983508244547061,0.0,-0.1170500554541026,0.4526351099980994,0.3032339476896975,0.3032339476896975,-0.1170500554541026,0.0,0,1,1,1,0.0,-0.1170500554541026
7475,32,36,43,117,110,1,3126.044000000001,74,1377.253,LESS,-336,1092,756,1,2,-7.0,-0.6561859224721414,7.0,-0.34921514788478913,0.09513051752644833,-0.25379178036691336,227,117,110,0,1.3363168412821769,1.4436173506005987,1.170500554541026,-1.3731199555404536,-0.020380285689938937,0.020380285689938937,1.170500554541026,1.4436173506005987,1,0,1,2,1.4436173506005987,1.170500554541026
7476,32,37,40,80,64,1,3600.869,84,2163.836,LESS,124,1348,1472,3,2,-16.0,-1.4998535370791803,16.0,1.222253017596762,0.7828210056694449,0.11285634413355343,144,80,64,0,-0.3191204397091766,0.0,-0.6242669624218805,0.4526351099980994,0.5477973759689647,0.5477973759689647,-0.6242669624218805,0.0,1,1,1,1,0.0,-0.6242669624218805
7477,32,38,31,80,78,0,3107.19,74,3710.233,LESS,-1164,2410,1246,2,2,-2.0,-0.18748169213489754,2.0,-1.222253017596762,0.09513051752644833,-0.2683503729838397,158,80,78,0,-0.03989005496364707,0.0,-0.07803337030273506,-0.4602424227711771,-1.0431000766759655,1.0431000766759655,-0.07803337030273506,0.0,1,0,0,1,0.0,-0.07803337030273506
7478,32,39,46,124,110,0,4655.17,74,3188.095,LESS,-2562,4044,1482,4,2,-14.0,-1.3123718449442827,14.0,0.8730378697119728,0.09513051752644833,0.926961507739023,234,124,110,0,1.4759320336549415,1.7167341466601715,1.170500554541026,1.365512642767376,-2.7698661005871554,2.7698661005871554,1.170500554541026,1.7167341466601715,0,1,0,2,1.7167341466601715,1.170500554541026
7479,32,40,58,92,110,0,5102.729,64,2194.097,LESS,-816,2720,1904,6,2,18.0,1.6873352292140782,18.0,1.571468165481551,-0.5925599706165483,1.2725555012172618,202,92,110,1,0.8376911542365885,0.4682002218164104,1.170500554541026,3.191267708305929,-0.6132613239427079,0.6132613239427079,1.170500554541026,0.4682002218164104,0,1,0,2,1.170500554541026,0.4682002218164104
7480,32,41,49,110,131,1,2169.981,84,833.951,MORE,30,818,848,1,2,21.0,1.9685577674164243,21.0,2.0952908873087353,0.7828210056694449,-0.9920399894003266,241,110,131,0,1.6155472260277064,1.170500554541026,1.9898509427197442,-1.3731199555404536,0.4316915059777975,0.4316915059777975,1.9898509427197442,1.170500554541026,1,0,1,2,1.9898509427197442,1.170500554541026
7481,32,42,13,47,50,1,1525.6529999999998,94,2346.117,MORE,1654,614,2268,2,2,3.0,0.28122253820234633,3.0,-1.0476454436543674,1.4705114938124415,-1.4895741393779756,97,47,50,0,-1.2565367313548828,-1.2875506099951286,-1.170500554541026,-0.4602424227711771,2.437605685399666,2.437605685399666,-1.170500554541026,-1.2875506099951286,1,0,1,0,-1.2875506099951286,-1.170500554541026
7482,32,43,16,50,44,0,3527.272,84,1122.704,MORE,-200,1870,1670,4,2,-6.0,-0.5624450764046927,6.0,-0.5238227218271837,0.7828210056694449,0.05602656048934563,94,50,44,1,-1.3163718138003533,-1.170500554541026,-1.4046006654492311,1.365512642767376,0.14760267514834563,0.14760267514834563,-1.4046006654492311,-1.170500554541026,1,1,0,0,-1.170500554541026,-1.4046006654492311
7483,32,44,7,57,50,0,2587.509,94,2106.536,MORE,214,1764,1978,2,2,-7.0,-0.6561859224721414,7.0,-0.34921514788478913,1.4705114938124415,-0.6696351915770632,107,57,50,1,-1.0570864565366473,-0.8973837584814532,-1.170500554541026,-0.4602424227711771,0.6589625706413589,0.6589625706413589,-1.170500554541026,-0.8973837584814532,1,0,1,0,-0.8973837584814532,-1.170500554541026
7484,32,45,18,42,50,1,2460.559,94,2201.973,MORE,1426,1078,2504,3,2,8.0,0.7499267685395902,8.0,-0.17460757394239454,1.4705114938124415,-0.767662842617624,92,42,50,0,-1.3562618687640005,-1.4826340357519663,-1.170500554541026,0.4526351099980994,2.155987192229601,2.155987192229601,-1.170500554541026,-1.4826340357519663,1,1,1,0,-1.4826340357519663,-1.170500554541026
7485,32,46,51,108,110,0,3924.869,74,1524.486,MORE,716,1716,2432,2,2,2.0,0.18748169213489754,2.0,-1.222253017596762,0.09513051752644833,0.3630411329255324,218,108,110,0,1.156811593945765,1.092467184238291,1.170500554541026,-0.4602424227711771,1.2790173231473798,1.2790173231473798,1.170500554541026,1.092467184238291,0,0,1,2,1.170500554541026,1.092467184238291
7486,32,47,31,78,80,0,4416.136,84,1440.56,MORE,-262,2560,2298,4,2,2.0,0.18748169213489754,2.0,-1.222253017596762,0.7828210056694449,0.7423853632819187,158,78,80,0,-0.03989005496364707,-0.07803337030273506,0.0,1.365512642767376,0.07102220770736296,0.07102220770736296,0.0,-0.07803337030273506,1,1,0,1,-0.07803337030273506,0.0
7487,32,48,58,110,92,0,3099.2470000000008,84,1309.475,MORE,16,1576,1592,2,2,-18.0,-1.6873352292140782,18.0,1.571468165481551,0.7828210056694449,-0.2744837611856129,202,110,92,1,0.8376911542365885,1.170500554541026,0.4682002218164104,-0.4602424227711771,0.4143991423620917,0.4143991423620917,0.4682002218164104,1.170500554541026,1,0,1,2,1.170500554541026,0.4682002218164104
7488,32,49,12,50,48,1,1738.83,94,1059.186,MORE,634,602,1236,1,2,-2.0,-0.18748169213489754,2.0,-1.222253017596762,1.4705114938124415,-1.3249641309819642,98,50,48,1,-1.2365917038730592,-1.170500554541026,-1.248533924843761,-1.3731199555404536,1.1777334791125318,1.1777334791125318,-1.248533924843761,-1.170500554541026,1,0,1,0,-1.170500554541026,-1.248533924843761
7489,32,50,54,110,101,1,3090.735,74,2805.0640000000008,MORE,-394,1648,1254,3,2,-9.0,-0.8436676146070391,9.0,0.0,0.09513051752644833,-0.2810565171183212,211,110,101,1,1.0171964015730004,1.170500554541026,0.8193503881787182,0.4526351099980994,-0.09202007781214853,0.09202007781214853,0.8193503881787182,1.170500554541026,0,1,0,2,1.170500554541026,0.8193503881787182
7490,32,51,14,46,50,1,1568.167,100,2473.385,MORE,1606,628,2234,1,2,4.0,0.3749633842697951,4.0,-0.8730378697119728,1.8831257866982396,-1.4567458797770432,96,46,50,0,-1.2764817588367063,-1.3265672951464962,-1.170500554541026,-1.3731199555404536,2.378317581574389,2.378317581574389,-1.170500554541026,-1.3265672951464962,1,0,1,0,-1.3265672951464962,-1.170500554541026
7491,32,52,22,80,83,1,2744.58,94,1163.462,MORE,326,1222,1548,3,2,3.0,0.28122253820234633,3.0,-1.0476454436543674,1.4705114938124415,-0.5483488491068629,163,80,83,0,0.05983508244547061,0.0,0.1170500554541026,0.4526351099980994,0.797301479567005,0.797301479567005,0.1170500554541026,0.0,1,1,1,1,0.1170500554541026,0.0
7492,32,53,6,50,56,1,1720.1529999999998,84,950.554,MORE,-92,736,644,1,2,6.0,0.5624450764046927,6.0,-0.5238227218271837,0.7828210056694449,-1.3393860485753837,106,50,56,0,-1.077031484018471,-1.170500554541026,-0.9364004436328208,-1.3731199555404536,0.28100090875521866,0.28100090875521866,-0.9364004436328208,-1.170500554541026,1,0,0,0,-1.170500554541026,-0.9364004436328208
7493,32,54,13,50,47,0,3698.014,74,2387.6620000000007,MORE,-684,2088,1404,4,2,-3.0,-0.28122253820234633,3.0,-1.0476454436543674,0.09513051752644833,0.1878693111310744,97,50,47,1,-1.2565367313548828,-1.170500554541026,-1.2875506099951286,1.365512642767376,-0.4502190384231965,0.4502190384231965,-1.2875506099951286,-1.170500554541026,0,1,0,0,-1.170500554541026,-1.2875506099951286
7494,32,55,46,110,124,1,3143.8520000000008,94,958.289,MORE,752,1340,2092,3,2,14.0,1.3123718449442827,14.0,0.8730378697119728,1.4705114938124415,-0.2400408830866431,234,110,124,0,1.4759320336549415,1.170500554541026,1.7167341466601715,0.4526351099980994,1.3234834010163377,1.3234834010163377,1.7167341466601715,1.170500554541026,1,1,1,2,1.7167341466601715,1.170500554541026
7495,32,56,27,91,80,0,2448.685,84,1489.995,MORE,254,1296,1550,2,2,-11.0,-1.0311493067419364,11.0,0.34921514788478913,0.7828210056694449,-0.7768316518216858,171,91,80,1,0.21939530230005888,0.4291835366650429,0.0,-0.4602424227711771,0.7083693238290897,0.7083693238290897,0.0,0.4291835366650429,1,0,1,1,0.4291835366650429,0.0
7496,32,57,40,64,80,1,1909.725,84,1263.838,MORE,980,648,1628,1,2,16.0,1.4998535370791803,16.0,1.222253017596762,0.7828210056694449,-1.193003237523306,144,64,80,0,-0.3191204397091766,-0.6242669624218805,0.0,-1.3731199555404536,1.6051018941864028,1.6051018941864028,0.0,-0.6242669624218805,1,0,1,1,-0.6242669624218805,0.0
7497,32,58,22,83,80,1,2104.962,94,822.077,MORE,364,746,1110,1,2,-3.0,-0.28122253820234633,3.0,-1.0476454436543674,1.4705114938124415,-1.0422460535437392,163,83,80,1,0.05983508244547061,0.1170500554541026,0.0,-1.3731199555404536,0.8442378950953493,0.8442378950953493,0.0,0.1170500554541026,1,0,1,1,0.1170500554541026,0.0
7498,32,59,54,101,110,1,2030.587,94,2565.478,MORE,252,1194,1446,1,2,9.0,0.8436676146070391,9.0,0.0,1.4705114938124415,-1.099676589551157,211,101,110,0,1.0171964015730004,0.8193503881787182,1.170500554541026,-1.3731199555404536,0.7058989861697031,0.7058989861697031,1.170500554541026,0.8193503881787182,1,0,1,2,1.170500554541026,0.8193503881787182
7499,32,60,6,56,50,0,3106.985,64,1894.216,MORE,-368,1510,1142,4,1,-6.0,-0.5624450764046927,6.0,-0.5238227218271837,-0.5925599706165483,-0.2685086689150198,106,56,50,1,-1.077031484018471,-0.9364004436328208,-1.170500554541026,1.365512642767376,-0.05990568824012354,0.05990568824012354,-1.170500554541026,-0.9364004436328208,0,1,0,0,-0.9364004436328208,-1.170500554541026
7500,32,61,18,50,42,0,5378.982,54,1620.2879999999998,MORE,-3274,4062,788,2,1,-8.0,-0.7499267685395902,8.0,-0.17460757394239454,-1.280250458759545,1.4858712371992076,92,50,42,1,-1.3562618687640005,-1.170500554541026,-1.4826340357519663,-0.4602424227711771,-3.6493063073287626,3.6493063073287626,-1.4826340357519663,-1.170500554541026,0,0,0,0,-1.170500554541026,-1.4826340357519663
7501,32,62,43,110,117,1,5366.847,44,1245.106,MORE,502,1948,2450,2,2,7.0,0.6561859224721414,7.0,-0.34921514788478913,-1.9679409469025413,1.476500890248619,227,110,117,0,1.3363168412821769,1.170500554541026,1.4436173506005987,-0.4602424227711771,1.0146911935930203,1.0146911935930203,1.4436173506005987,1.170500554541026,0,0,1,2,1.4436173506005987,1.170500554541026
7502,32,63,32,77,80,1,4671.012,64,2382.869,MORE,-480,2172,1692,3,2,3.0,0.28122253820234633,3.0,-1.0476454436543674,-0.5925599706165483,0.9391943084305121,157,77,80,0,-0.05983508244547061,-0.1170500554541026,0.0,0.4526351099980994,-0.19824459716576964,0.19824459716576964,0.0,-0.1170500554541026,0,1,0,1,-0.1170500554541026,0.0
7503,32,64,27,80,91,1,3127.647,74,1088.833,MORE,230,1386,1616,3,2,11.0,1.0311493067419364,11.0,0.34921514788478913,0.09513051752644833,-0.2525539834026129,171,80,91,0,0.21939530230005888,0.0,0.4291835366650429,0.4526351099980994,0.6787252719164513,0.6787252719164513,0.4291835366650429,0.0,0,1,1,1,0.4291835366650429,0.0
7504,32,65,16,44,50,1,3024.109000000001,84,1632.273,MORE,1098,1070,2168,3,2,6.0,0.5624450764046927,6.0,-0.5238227218271837,0.7828210056694449,-0.3325034669271305,94,44,50,0,-1.3163718138003533,-1.4046006654492311,-1.170500554541026,0.4526351099980994,1.7508518160902087,1.7508518160902087,-1.170500554541026,-1.4046006654492311,1,1,1,0,-1.4046006654492311,-1.170500554541026
7505,32,66,7,50,57,1,1621.382,74,2063.463,MORE,308,542,850,1,2,7.0,0.6561859224721414,7.0,-0.34921514788478913,0.09513051752644833,-1.4156545725685084,107,50,57,0,-1.0570864565366473,-1.170500554541026,-0.8973837584814532,-1.3731199555404536,0.7750684406325262,0.7750684406325262,-0.8973837584814532,-1.170500554541026,1,0,1,0,-1.170500554541026,-0.8973837584814532
7506,32,67,14,50,46,0,3252.851,64,2367.995,MORE,-976,2072,1096,4,1,-4.0,-0.3749633842697951,4.0,-0.8730378697119728,-0.5925599706165483,-0.15587455039054204,96,50,46,1,-1.2764817588367063,-1.170500554541026,-1.3265672951464962,1.365512642767376,-0.810888336693631,0.810888336693631,-1.3265672951464962,-1.170500554541026,0,1,0,0,-1.170500554541026,-1.3265672951464962
7507,32,68,51,110,108,1,5723.203,64,1283.53,MORE,-188,2856,2668,6,2,-2.0,-0.18748169213489754,2.0,-1.222253017596762,-0.5925599706165483,1.751670182207738,218,110,108,1,1.156811593945765,1.170500554541026,1.092467184238291,3.191267708305929,0.16242470110466486,0.16242470110466486,1.092467184238291,1.170500554541026,0,1,0,2,1.170500554541026,1.092467184238291
7508,32,69,50,133,110,0,2111.826,94,1160.924,MORE,-206,1722,1516,3,2,-23.0,-2.1560394595513217,23.0,2.444506035193524,1.4705114938124415,-1.0369458424626647,243,133,110,1,1.6554372809913533,2.0678843130224793,1.170500554541026,0.4526351099980994,0.14019166217018603,0.14019166217018603,1.170500554541026,2.0678843130224793,1,1,0,2,2.0678843130224793,1.170500554541026
7509,32,70,49,131,110,0,3406.429,74,1205.411,MORE,-1130,2220,1090,2,2,-21.0,-1.9685577674164243,21.0,2.0952908873087353,0.09513051752644833,-0.037285416152595945,241,131,110,1,1.6155472260277064,1.9898509427197442,1.170500554541026,-0.4602424227711771,-1.0011043364663943,1.0011043364663943,1.170500554541026,1.9898509427197442,1,0,0,2,1.9898509427197442,1.170500554541026
7510,32,71,47,126,110,0,4654.883,74,1304.188,MORE,-980,2654,1674,4,1,-16.0,-1.4998535370791803,16.0,1.222253017596762,0.09513051752644833,0.9267398934353708,236,126,110,1,1.5158220886185887,1.7947675169629065,1.170500554541026,1.365512642767376,-0.8158290120124041,0.8158290120124041,1.170500554541026,1.7947675169629065,1,1,0,2,1.7947675169629065,1.170500554541026
7511,32,72,50,110,133,1,3102.309,74,1741.8529999999996,MORE,-172,1344,1172,3,2,23.0,2.1560394595513217,23.0,2.444506035193524,0.09513051752644833,-0.27211936049647434,243,110,133,0,1.6554372809913533,1.170500554541026,2.0678843130224793,0.4526351099980994,0.18218740237975717,0.18218740237975717,2.0678843130224793,1.170500554541026,1,1,0,2,2.0678843130224793,1.170500554541026
7512,32,73,47,110,126,1,4252.069,84,1057.244,MORE,332,1984,2316,3,2,16.0,1.4998535370791803,16.0,1.222253017596762,0.7828210056694449,0.6156968825944693,236,110,126,0,1.5158220886185887,1.170500554541026,1.7947675169629065,0.4526351099980994,0.8047124925451646,0.8047124925451646,1.7947675169629065,1.170500554541026,1,1,1,2,1.7947675169629065,1.170500554541026
7513,32,74,12,48,50,1,1644.53,84,1457.629,MORE,402,494,896,1,2,2.0,0.18748169213489754,2.0,-1.222253017596762,0.7828210056694449,-1.3977802593248148,98,48,50,0,-1.2365917038730592,-1.248533924843761,-1.170500554541026,-1.3731199555404536,0.8911743106236935,0.8911743106236935,-1.170500554541026,-1.248533924843761,1,0,1,0,-1.248533924843761,-1.170500554541026
7514,32,75,32,80,77,1,3659.592,64,1567.2279999999996,MORE,270,1358,1628,3,2,-3.0,-0.28122253820234633,3.0,-1.0476454436543674,-0.5925599706165483,0.15820079275155147,157,80,77,1,-0.05983508244547061,0.0,-0.1170500554541026,0.4526351099980994,0.728132025104182,0.728132025104182,-0.1170500554541026,0.0,0,1,1,1,0.0,-0.1170500554541026
7515,32,76,43,117,110,1,5479.013000000001,74,1045.352,MORE,-180,2704,2524,5,2,-7.0,-0.6561859224721414,7.0,-0.34921514788478913,0.09513051752644833,1.5631127020376356,227,117,110,1,1.3363168412821769,1.4436173506005987,1.170500554541026,2.2783901755366527,0.172306051742211,0.172306051742211,1.170500554541026,1.4436173506005987,1,1,0,2,1.4436173506005987,1.170500554541026
7516,32,77,40,80,64,1,4699.088,64,2109.769,MORE,-782,2342,1560,3,2,-16.0,-1.4998535370791803,16.0,1.222253017596762,-0.5925599706165483,0.9608739014247208,144,80,64,1,-0.3191204397091766,0.0,-0.6242669624218805,0.4526351099980994,-0.5712655837331369,0.5712655837331369,-0.6242669624218805,0.0,0,1,0,1,0.0,-0.6242669624218805
7517,32,78,31,80,78,1,5455.37,44,900.21,MORE,102,2538,2640,2,2,-2.0,-0.18748169213489754,2.0,-1.222253017596762,-1.9679409469025413,1.5448561620332868,158,80,78,1,-0.03989005496364707,0.0,-0.07803337030273506,-0.4602424227711771,0.5206236617157128,0.5206236617157128,-0.07803337030273506,0.0,0,0,1,1,0.0,-0.07803337030273506
7518,32,79,46,124,110,0,4432.944,64,1628.764,MORE,-70,2156,2086,4,2,-14.0,-1.3123718449442827,14.0,0.8730378697119728,-0.5925599706165483,0.7553640852881396,234,124,110,1,1.4759320336549415,1.7167341466601715,1.170500554541026,1.365512642767376,0.3081746230084706,0.3081746230084706,1.170500554541026,1.7167341466601715,0,1,1,2,1.7167341466601715,1.170500554541026
7519,32,80,58,92,110,1,4477.63,74,1978.029,MORE,346,2106,2452,3,2,18.0,1.6873352292140782,18.0,1.571468165481551,0.09513051752644833,0.7898695095843072,202,92,110,0,0.8376911542365885,0.4682002218164104,1.170500554541026,0.4526351099980994,0.8220048561608704,0.8220048561608704,1.170500554541026,0.4682002218164104,1,1,1,2,1.170500554541026,0.4682002218164104
7520,32,81,48,128,110,1,2847.501,64,1541.226,LESS,-74,1014,940,1,2,-18.0,-1.6873352292140782,18.0,1.571468165481551,-0.5925599706165483,-0.4688757977264329,238,128,110,0,1.5557121435822359,1.8728008872656416,1.170500554541026,-1.3731199555404536,0.3032339476896975,0.3032339476896975,1.170500554541026,1.8728008872656416,0,0,1,2,1.8728008872656416,1.170500554541026
7521,32,82,8,50,58,0,3332.761,74,824.206,LESS,-222,1302,1080,4,2,8.0,0.7499267685395902,8.0,-0.17460757394239454,0.09513051752644833,-0.09417002424126117,108,50,58,1,-1.0371414290548238,-1.170500554541026,-0.8583670733300858,1.365512642767376,0.12042896089509371,0.12042896089509371,-0.8583670733300858,-1.170500554541026,1,1,1,0,-1.170500554541026,-0.8583670733300858
7522,32,83,4,54,50,1,2604.903,84,1404.54,LESS,-110,1270,1160,3,2,-4.0,-0.3749633842697951,4.0,-0.8730378697119728,0.7828210056694449,-0.6562039748602495,104,54,50,0,-1.116921538982118,-1.0144338139355558,-1.170500554541026,0.4526351099980994,0.25876786982073985,0.25876786982073985,-1.170500554541026,-1.0144338139355558,1,1,1,0,-1.0144338139355558,-1.170500554541026
7523,32,84,37,80,69,1,3215.97,44,1631.292,LESS,234,1018,1252,3,1,-11.0,-1.0311493067419364,11.0,0.34921514788478913,-1.9679409469025413,-0.18435314667275515,149,80,69,0,-0.21939530230005888,0.0,-0.4291835366650429,0.4526351099980994,0.6836659472352243,0.6836659472352243,-0.4291835366650429,0.0,0,1,1,1,0.0,-0.4291835366650429
7524,32,85,52,105,110,0,2411.776,44,1311.1129999999996,LESS,-524,1244,720,2,1,5.0,0.4687042303372438,5.0,-0.6984302957695783,-1.9679409469025413,-0.805331869011572,215,105,110,1,1.0969765115002945,0.9754171287841883,1.170500554541026,-0.4602424227711771,-0.25259202567227346,0.25259202567227346,1.170500554541026,0.9754171287841883,0,0,0,2,1.170500554541026,0.9754171287841883
7525,32,86,5,55,50,1,2901.321,54,1354.464,LESS,-218,1292,1074,3,2,-5.0,-0.4687042303372438,5.0,-0.6984302957695783,-1.280250458759545,-0.4273173244770988,105,55,50,0,-1.0969765115002945,-0.9754171287841883,-1.170500554541026,0.4526351099980994,0.1253696362138668,0.1253696362138668,-1.170500554541026,-0.9754171287841883,0,1,1,0,-0.9754171287841883,-1.170500554541026
7526,32,87,30,96,80,1,4724.710999999998,64,1746.155,LESS,-248,2168,1920,5,1,-16.0,-1.4998535370791803,16.0,1.222253017596762,-0.5925599706165483,0.9806593484716852,176,96,80,0,0.3191204397091766,0.6242669624218805,0.0,2.2783901755366527,0.08831457132306872,0.08831457132306872,0.0,0.6242669624218805,0,1,1,1,0.6242669624218805,0.0
7527,32,88,33,80,75,1,4137.106,64,2985.6040000000007,LESS,-484,1998,1514,3,2,-5.0,-0.4687042303372438,5.0,-0.6984302957695783,-0.5925599706165483,0.5269252965639369,155,80,75,0,-0.09972513740911768,0.0,-0.19508342575683765,0.4526351099980994,-0.20318527248454274,0.20318527248454274,-0.19508342575683765,0.0,0,1,1,1,0.0,-0.19508342575683765
7528,32,89,48,110,128,0,3240.717,74,1897.16,LESS,-1696,2414,718,2,2,18.0,1.6873352292140782,18.0,1.571468165481551,0.09513051752644833,-0.16524412516585646,238,110,128,1,1.5557121435822359,1.170500554541026,1.8728008872656416,-0.4602424227711771,-1.7002098940727846,1.7002098940727846,1.8728008872656416,1.170500554541026,1,0,0,2,1.8728008872656416,1.170500554541026
7529,32,90,9,59,50,1,2971.405,74,1092.204,LESS,-28,1298,1270,3,2,-9.0,-0.8436676146070391,9.0,0.0,0.09513051752644833,-0.3732001925706262,109,59,50,0,-1.0171964015730004,-0.8193503881787182,-1.170500554541026,0.4526351099980994,0.3600517138555879,0.3600517138555879,-1.170500554541026,-0.8193503881787182,1,1,1,0,-0.8193503881787182,-1.170500554541026
7530,32,91,44,110,119,0,2404.123,94,1785.312,LESS,-590,1910,1320,2,2,9.0,0.8436676146070391,9.0,0.0,1.4705114938124415,-0.8112413263838714,229,110,119,1,1.376206896245824,1.170500554541026,1.5216507209033339,-0.4602424227711771,-0.3341131684320292,0.3341131684320292,1.5216507209033339,1.170500554541026,1,0,0,2,1.5216507209033339,1.170500554541026
7531,32,92,2,52,50,0,2843.715,84,1444.194,LESS,30,1498,1528,2,1,-2.0,-0.18748169213489754,2.0,-1.222253017596762,0.7828210056694449,-0.4717992533139837,102,52,50,0,-1.156811593945765,-1.092467184238291,-1.170500554541026,-0.4602424227711771,0.4316915059777975,0.4316915059777975,-1.170500554541026,-1.092467184238291,1,0,1,0,-1.092467184238291,-1.170500554541026
7532,32,93,8,58,50,0,3737.71,74,1441.265,LESS,-980,2340,1360,4,1,-8.0,-0.7499267685395902,8.0,-0.17460757394239454,0.09513051752644833,0.218521580809736,108,58,50,0,-1.0371414290548238,-0.8583670733300858,-1.170500554541026,1.365512642767376,-0.8158290120124041,0.8158290120124041,-1.170500554541026,-0.8583670733300858,1,1,0,0,-0.8583670733300858,-1.170500554541026
7533,32,94,44,119,110,0,2425.805,84,1122.151,LESS,-536,1674,1138,2,2,-9.0,-0.8436676146070391,9.0,0.0,0.7828210056694449,-0.7944990220919342,229,119,110,0,1.376206896245824,1.5216507209033339,1.170500554541026,-0.4602424227711771,-0.2674140516285927,0.2674140516285927,1.170500554541026,1.5216507209033339,1,0,0,2,1.5216507209033339,1.170500554541026
7534,32,95,34,74,80,0,2122.435,84,1845.587,LESS,-174,854,680,2,2,6.0,0.5624450764046927,6.0,-0.5238227218271837,0.7828210056694449,-1.0287538349802756,154,74,80,1,-0.11967016489094122,-0.2341001109082052,0.0,-0.4602424227711771,0.1797170647203706,0.1797170647203706,0.0,-0.2341001109082052,1,0,1,1,-0.2341001109082052,0.0
7535,32,96,24,86,80,1,3350.1040000000007,84,1517.777,LESS,426,1626,2052,3,2,-6.0,-0.5624450764046927,6.0,-0.5238227218271837,0.7828210056694449,-0.08077818846342327,166,86,80,0,0.11967016489094122,0.2341001109082052,0.0,0.4526351099980994,0.920818362536332,0.920818362536332,0.0,0.2341001109082052,1,1,1,1,0.2341001109082052,0.0
7536,32,97,39,66,80,0,2141.798,74,1749.244,LESS,-590,1160,570,2,2,14.0,1.3123718449442827,14.0,0.8730378697119728,0.09513051752644833,-1.0138022051488589,146,66,80,1,-0.2792303847455295,-0.5462335921191455,0.0,-0.4602424227711771,-0.3341131684320292,0.3341131684320292,0.0,-0.5462335921191455,1,0,0,1,-0.5462335921191455,0.0
7537,32,98,9,50,59,0,2095.6620000000007,74,1557.601,LESS,-614,1334,720,2,2,9.0,0.8436676146070391,9.0,0.0,0.09513051752644833,-1.0494272835923977,109,50,59,1,-1.0171964015730004,-1.170500554541026,-0.8193503881787182,-0.4602424227711771,-0.3637572203446677,0.3637572203446677,-0.8193503881787182,-1.170500554541026,1,0,0,0,-1.170500554541026,-0.8193503881787182
7538,32,99,57,94,110,0,2333.478,74,840.9960000000002,LESS,-944,1530,586,2,1,16.0,1.4998535370791803,16.0,1.222253017596762,0.09513051752644833,-0.8657916486190854,204,94,110,1,0.8775812092002355,0.5462335921191455,1.170500554541026,-0.4602424227711771,-0.7713629341434464,0.7713629341434464,1.170500554541026,0.5462335921191455,1,0,0,2,1.170500554541026,0.5462335921191455
7539,32,100,60,110,87,1,3182.332000000001,64,1770.378,LESS,256,1264,1520,3,2,-23.0,-2.1560394595513217,23.0,2.444506035193524,-0.5925599706165483,-0.21032757854122533,197,110,87,0,0.7379660168274708,1.170500554541026,0.27311679605957273,0.4526351099980994,0.7108396614884762,0.7108396614884762,0.27311679605957273,1.170500554541026,0,1,1,2,1.170500554541026,0.27311679605957273
7540,32,101,33,75,80,0,3580.692,44,1966.37,LESS,-926,2032,1106,4,1,5.0,0.4687042303372438,5.0,-0.6984302957695783,-1.9679409469025413,0.09727616362906023,155,75,80,1,-0.09972513740911768,-0.19508342575683765,0.0,1.365512642767376,-0.7491298952089676,0.7491298952089676,0.0,-0.19508342575683765,0,1,0,1,-0.19508342575683765,0.0
7541,32,102,15,50,45,1,2275.55,64,1964.59,LESS,-72,956,884,3,2,-5.0,-0.4687042303372438,5.0,-0.6984302957695783,-0.5925599706165483,-0.9105222178942142,95,50,45,0,-1.2964267863185297,-1.170500554541026,-1.3655839802978638,0.4526351099980994,0.30570428534908406,0.30570428534908406,-1.3655839802978638,-1.170500554541026,0,1,1,0,-1.170500554541026,-1.3655839802978638
7542,32,103,59,89,110,0,2015.739,74,1374.3370000000002,LESS,-538,1268,730,2,2,21.0,1.9685577674164243,21.0,2.0952908873087353,0.09513051752644833,-1.1111418480202415,199,89,110,1,0.7778560717911179,0.3511501663623078,1.170500554541026,-0.4602424227711771,-0.26988438928797925,0.26988438928797925,1.170500554541026,0.3511501663623078,1,0,0,2,1.170500554541026,0.3511501663623078
7543,32,104,29,80,94,0,2166.149,84,1671.016,LESS,-124,1616,1492,2,2,14.0,1.3123718449442827,14.0,0.8730378697119728,0.7828210056694449,-0.9949989650504838,174,80,94,1,0.2792303847455295,0.0,0.5462335921191455,-0.4602424227711771,0.24147550620503405,0.24147550620503405,0.5462335921191455,0.0,1,0,1,1,0.5462335921191455,0.0
7544,32,105,55,110,98,1,3133.713,84,1070.496,LESS,526,1316,1842,3,2,-12.0,-1.124890152809385,12.0,0.5238227218271837,0.7828210056694449,-0.2478699681902296,208,110,98,0,0.9573613191275298,1.170500554541026,0.7023003327246156,0.4526351099980994,1.0443352455056587,1.0443352455056587,0.7023003327246156,1.170500554541026,1,1,1,2,1.170500554541026,0.7023003327246156
7545,32,106,29,94,80,1,3932.812,64,1303.1,LESS,-790,1708,918,2,1,-14.0,-1.3123718449442827,14.0,0.8730378697119728,-0.5925599706165483,0.36917452112730587,174,94,80,0,0.2792303847455295,0.5462335921191455,0.0,-0.4602424227711771,-0.581146934370683,0.581146934370683,0.0,0.5462335921191455,0,0,0,1,0.5462335921191455,0.0
7546,32,107,57,110,94,0,2562.549,44,1799.88,LESS,-1268,1846,578,2,1,-16.0,-1.4998535370791803,16.0,1.222253017596762,-1.9679409469025413,-0.6889086864173342,204,110,94,0,0.8775812092002355,1.170500554541026,0.5462335921191455,-0.4602424227711771,-1.1715576349640655,1.1715576349640655,0.5462335921191455,1.170500554541026,0,0,0,2,1.170500554541026,0.5462335921191455
7547,32,108,39,80,66,1,2873.384,74,2150.216,LESS,-6,1286,1280,3,2,-14.0,-1.3123718449442827,14.0,0.8730378697119728,0.09513051752644833,-0.4488895851082145,146,80,66,0,-0.2792303847455295,0.0,-0.5462335921191455,0.4526351099980994,0.3872254281088398,0.3872254281088398,-0.5462335921191455,0.0,1,1,1,1,0.0,-0.5462335921191455
7548,32,109,4,50,54,0,2038.064,74,1144.884,LESS,-1072,1294,222,2,1,4.0,0.3749633842697951,4.0,-0.8730378697119728,0.09513051752644833,-1.0939030350270904,104,50,54,1,-1.116921538982118,-1.170500554541026,-1.0144338139355558,-0.4602424227711771,-0.9294645443441848,0.9294645443441848,-1.0144338139355558,-1.170500554541026,1,0,0,0,-1.170500554541026,-1.0144338139355558
7549,32,110,55,98,110,0,1876.256,54,3099.144,LESS,-898,1346,448,2,2,12.0,1.124890152809385,12.0,0.5238227218271837,-1.280250458759545,-1.2188471717704623,208,98,110,1,0.9573613191275298,0.7023003327246156,1.170500554541026,-0.4602424227711771,-0.7145451679775561,0.7145451679775561,1.170500554541026,0.7023003327246156,0,0,0,2,1.170500554541026,0.7023003327246156
7550,32,111,2,50,52,0,2247.133,84,1023.333,LESS,-420,1456,1036,2,1,2.0,0.18748169213489754,2.0,-1.222253017596762,0.7828210056694449,-0.932465122656874,102,50,52,1,-1.156811593945765,-1.170500554541026,-1.092467184238291,-0.4602424227711771,-0.12413446738417352,0.12413446738417352,-1.092467184238291,-1.170500554541026,1,0,1,0,-1.170500554541026,-1.092467184238291
7551,32,112,59,110,89,1,2840.683,94,2382.184,LESS,1908,940,2848,1,2,-21.0,-1.9685577674164243,21.0,2.0952908873087353,1.4705114938124415,-0.4741404887449013,199,110,89,0,0.7778560717911179,1.170500554541026,0.3511501663623078,-1.3731199555404536,2.7513385681417564,2.7513385681417564,0.3511501663623078,1.170500554541026,1,0,1,2,1.170500554541026,0.3511501663623078
7552,32,113,60,87,110,0,2125.6710000000007,84,927.948,LESS,-720,1256,536,2,2,23.0,2.1560394595513217,23.0,2.444506035193524,0.7828210056694449,-1.0262550757934514,197,87,110,1,0.7379660168274708,0.27311679605957273,1.170500554541026,-0.4602424227711771,-0.49468511629215417,0.49468511629215417,1.170500554541026,0.27311679605957273,1,0,0,2,1.170500554541026,0.27311679605957273
7553,32,114,52,110,105,0,2495.896,74,2398.888,LESS,-1042,1648,606,2,1,-5.0,-0.4687042303372438,5.0,-0.6984302957695783,0.09513051752644833,-0.7403764849585432,215,110,105,0,1.0969765115002945,1.170500554541026,0.9754171287841883,-0.4602424227711771,-0.8924094794533868,0.8924094794533868,0.9754171287841883,1.170500554541026,0,0,0,2,1.170500554541026,0.9754171287841883
7554,32,115,30,80,96,0,2116.409,84,1358.142,LESS,-1106,1508,402,2,1,16.0,1.4998535370791803,16.0,1.222253017596762,0.7828210056694449,-1.033406963181697,176,80,96,1,0.3191204397091766,0.0,0.6242669624218805,-0.4602424227711771,-0.971460284553756,0.971460284553756,0.6242669624218805,0.0,1,1,0,1,0.6242669624218805,0.0
7555,32,116,24,80,86,0,2303.77,84,1498.206,LESS,-948,1404,456,2,1,6.0,0.5624450764046927,6.0,-0.5238227218271837,0.7828210056694449,-0.8887314316605426,166,80,86,1,0.11967016489094122,0.0,0.2341001109082052,-0.4602424227711771,-0.7763036094622194,0.7763036094622194,0.2341001109082052,0.0,1,0,0,1,0.2341001109082052,0.0
7556,32,117,5,50,55,0,1693.304,100,1914.62,LESS,1448,706,2154,3,2,5.0,0.4687042303372438,5.0,-0.6984302957695783,1.8831257866982396,-1.3601181825083333,105,50,55,1,-1.0969765115002945,-1.170500554541026,-0.9754171287841883,0.4526351099980994,2.1831609064828528,2.1831609064828528,-0.9754171287841883,-1.170500554541026,1,1,1,0,-1.170500554541026,-0.9754171287841883
7557,32,118,34,80,74,0,2734.911,64,1356.177,LESS,-782,1310,528,2,1,-6.0,-0.5624450764046927,6.0,-0.5238227218271837,-0.5925599706165483,-0.5558150118316456,154,80,74,0,-0.11967016489094122,0.0,-0.2341001109082052,-0.4602424227711771,-0.5712655837331369,0.5712655837331369,-0.2341001109082052,0.0,0,0,0,1,0.0,-0.2341001109082052
7558,32,119,15,45,50,0,1791.831,94,1005.524,LESS,-174,1032,858,2,2,5.0,0.4687042303372438,5.0,-0.6984302957695783,1.4705114938124415,-1.2840380692820763,95,45,50,1,-1.2964267863185297,-1.3655839802978638,-1.170500554541026,-0.4602424227711771,0.1797170647203706,0.1797170647203706,-1.170500554541026,-1.3655839802978638,1,0,1,0,-1.3655839802978638,-1.170500554541026
7559,32,120,37,69,80,0,2076.221,44,1909.938,LESS,-854,1314,460,2,1,11.0,1.0311493067419364,11.0,0.34921514788478913,-1.9679409469025413,-1.0644391430951907,149,69,80,1,-0.21939530230005888,-0.4291835366650429,0.0,-0.4602424227711771,-0.6601977394710522,0.6601977394710522,0.0,-0.4291835366650429,0,0,0,1,-0.4291835366650429,0.0
7560,32,121,48,128,110,0,2352.167,74,1654.561,MORE,-1002,1878,876,2,2,-18.0,-1.6873352292140782,18.0,1.571468165481551,0.09513051752644833,-0.8513604649223778,238,128,110,1,1.5557121435822359,1.8728008872656416,1.170500554541026,-0.4602424227711771,-0.843002726265656,0.843002726265656,1.170500554541026,1.8728008872656416,1,0,0,2,1.8728008872656416,1.170500554541026
7561,32,122,8,50,58,1,1890.006,84,2020.737,MORE,880,548,1428,1,2,8.0,0.7499267685395902,8.0,-0.17460757394239454,0.7828210056694449,-1.2082297617522844,108,50,58,0,-1.0371414290548238,-1.170500554541026,-0.8583670733300858,-1.3731199555404536,1.481585011217076,1.481585011217076,-0.8583670733300858,-1.170500554541026,1,0,1,0,-1.170500554541026,-0.8583670733300858
7562,32,123,4,54,50,1,3024.1940000000004,84,1443.667,MORE,-300,1482,1182,3,2,-4.0,-0.3749633842697951,4.0,-0.8730378697119728,0.7828210056694449,-0.33243783202883664,104,54,50,1,-1.116921538982118,-1.0144338139355558,-1.170500554541026,0.4526351099980994,0.024085792179018743,0.024085792179018743,-1.170500554541026,-1.0144338139355558,1,1,0,0,-1.0144338139355558,-1.170500554541026
7563,32,124,37,80,69,1,2162.894,74,2335.754,MORE,296,892,1188,1,1,-11.0,-1.0311493067419364,11.0,0.34921514788478913,0.09513051752644833,-0.9975123955675144,149,80,69,1,-0.21939530230005888,0.0,-0.4291835366650429,-1.3731199555404536,0.760246414676207,0.760246414676207,-0.4291835366650429,0.0,1,0,1,1,0.0,-0.4291835366650429
7564,32,125,52,105,110,0,2391.499,84,2164.002,MORE,-656,1366,710,1,2,5.0,0.4687042303372438,5.0,-0.6984302957695783,0.7828210056694449,-0.8209892670434701,215,105,110,0,1.0969765115002945,0.9754171287841883,1.170500554541026,-1.3731199555404536,-0.41563431119178496,0.41563431119178496,1.170500554541026,0.9754171287841883,1,0,0,2,1.170500554541026,0.9754171287841883
7565,32,126,5,55,50,0,4366.9,54,1803.777,MORE,-2286,3156,870,2,1,-5.0,-0.4687042303372438,5.0,-0.6984302957695783,-1.280250458759545,0.7043665414888259,105,55,50,1,-1.0969765115002945,-0.9754171287841883,-1.170500554541026,-0.4602424227711771,-2.428959503591813,2.428959503591813,-1.170500554541026,-0.9754171287841883,0,1,0,0,-0.9754171287841883,-1.170500554541026
7566,32,127,30,96,80,0,2564.39,64,1862.432,MORE,-1052,1626,574,2,1,-16.0,-1.4998535370791803,16.0,1.222253017596762,-0.5925599706165483,-0.6874871117378095,176,96,80,1,0.3191204397091766,0.6242669624218805,0.0,-0.4602424227711771,-0.9047611677503195,0.9047611677503195,0.0,0.6242669624218805,0,1,0,1,0.6242669624218805,0.0
7567,32,128,33,80,75,1,2622.347,74,1455.229,MORE,-402,1158,756,1,2,-5.0,-0.4687042303372438,5.0,-0.6984302957695783,0.09513051752644833,-0.6427341493797329,155,80,75,1,-0.09972513740911768,0.0,-0.19508342575683765,-1.3731199555404536,-0.10190142844969469,0.10190142844969469,-0.19508342575683765,0.0,1,0,0,1,0.0,-0.19508342575683765
7568,32,129,48,110,128,1,1943.471,74,2289.78,MORE,-396,996,600,1,1,18.0,1.6873352292140782,18.0,1.571468165481551,0.09513051752644833,-1.1669454107252375,238,110,128,0,1.5557121435822359,1.170500554541026,1.8728008872656416,-1.3731199555404536,-0.09449041547153507,0.09449041547153507,1.8728008872656416,1.170500554541026,0,0,0,2,1.8728008872656416,1.170500554541026
7569,32,130,9,59,50,1,2889.177,64,1071.06,MORE,116,1088,1204,3,2,-9.0,-0.8436676146070391,9.0,0.0,-0.5925599706165483,-0.4366946210051536,109,59,50,1,-1.0171964015730004,-0.8193503881787182,-1.170500554541026,0.4526351099980994,0.5379160253314186,0.5379160253314186,-1.170500554541026,-0.8193503881787182,0,1,1,0,-0.8193503881787182,-1.170500554541026
7570,32,131,44,110,119,1,3451.02,74,997.198,MORE,-506,1718,1212,3,2,9.0,0.8436676146070391,9.0,0.0,0.09513051752644833,-0.002853348507462904,229,110,119,0,1.376206896245824,1.170500554541026,1.5216507209033339,0.4526351099980994,-0.23035898673779465,0.23035898673779465,1.5216507209033339,1.170500554541026,1,1,0,2,1.5216507209033339,1.170500554541026
7571,32,132,2,52,50,0,4240.37,64,1554.333,MORE,-714,2396,1682,4,1,-2.0,-0.18748169213489754,2.0,-1.222253017596762,-0.5925599706165483,0.6066632040633659,102,52,50,1,-1.156811593945765,-1.092467184238291,-1.170500554541026,1.365512642767376,-0.48727410331399457,0.48727410331399457,-1.170500554541026,-1.092467184238291,0,1,0,0,-1.092467184238291,-1.170500554541026
7572,32,133,8,58,50,0,3075.051,74,851.563,MORE,-1844,2436,592,2,1,-8.0,-0.7499267685395902,8.0,-0.17460757394239454,0.09513051752644833,-0.2931673141165109,108,58,50,1,-1.0371414290548238,-0.8583670733300858,-1.170500554541026,-0.4602424227711771,-1.8830148808673883,1.8830148808673883,-1.170500554541026,-0.8583670733300858,0,0,0,0,-0.8583670733300858,-1.170500554541026
7573,32,134,44,119,110,1,3467.656,64,1832.652,MORE,-140,1682,1542,3,1,-9.0,-0.8436676146070391,9.0,0.0,-0.5925599706165483,0.00999255935162152,229,119,110,1,1.376206896245824,1.5216507209033339,1.170500554541026,0.4526351099980994,0.22171280492994175,0.22171280492994175,1.170500554541026,1.5216507209033339,0,1,0,2,1.5216507209033339,1.170500554541026
7574,32,135,34,74,80,1,3618.222,74,1665.196,MORE,-364,1736,1372,3,2,6.0,0.5624450764046927,6.0,-0.5238227218271837,0.09513051752644833,0.12625590166413128,154,74,80,0,-0.11967016489094122,-0.2341001109082052,0.0,0.4526351099980994,-0.05496501292135046,0.05496501292135046,0.0,-0.2341001109082052,0,1,0,1,-0.2341001109082052,0.0
7575,32,136,24,86,80,1,2880.448,74,1531.529,MORE,-294,1434,1140,3,2,-6.0,-0.5624450764046927,6.0,-0.5238227218271837,0.09513051752644833,-0.4434349389723303,166,86,80,1,0.11967016489094122,0.2341001109082052,0.0,0.4526351099980994,0.031496805157178356,0.031496805157178356,0.0,0.2341001109082052,0,1,0,1,0.2341001109082052,0.0
7576,32,137,39,66,80,1,1817.517,84,1035.858,MORE,698,730,1428,1,2,14.0,1.3123718449442827,14.0,0.8730378697119728,0.7828210056694449,-1.264203975192845,146,66,80,0,-0.2792303847455295,-0.5462335921191455,0.0,-1.3731199555404536,1.2567842842129011,1.2567842842129011,0.0,-0.5462335921191455,1,0,1,1,-0.5462335921191455,0.0
7577,32,138,9,50,59,1,2805.364,74,1677.427,MORE,580,1042,1622,3,2,9.0,0.8436676146070391,9.0,0.0,0.09513051752644833,-0.5014129472490491,109,50,59,0,-1.0171964015730004,-1.170500554541026,-0.8193503881787182,0.4526351099980994,1.1110343623090952,1.1110343623090952,-0.8193503881787182,-1.170500554541026,0,1,1,0,-1.170500554541026,-0.8193503881787182
7578,32,139,57,94,110,1,3332.649000000001,84,1670.355,MORE,700,1456,2156,3,2,16.0,1.4998535370791803,16.0,1.222253017596762,0.7828210056694449,-0.09425650787195404,204,94,110,0,0.8775812092002355,0.5462335921191455,1.170500554541026,0.4526351099980994,1.2592546218722875,1.2592546218722875,1.170500554541026,0.5462335921191455,1,1,1,2,1.170500554541026,0.5462335921191455
7579,32,140,60,110,87,0,3075.65,94,939.408,MORE,-446,2010,1564,2,2,-23.0,-2.1560394595513217,23.0,2.444506035193524,1.4705114938124415,-0.2927047811273552,197,110,87,1,0.7379660168274708,1.170500554541026,0.27311679605957273,-0.4602424227711771,-0.1562488569561985,0.1562488569561985,0.27311679605957273,1.170500554541026,1,0,0,2,1.170500554541026,0.27311679605957273
7580,32,141,33,75,80,0,3745.706,84,1249.943,MORE,314,2016,2330,4,2,5.0,0.4687042303372438,5.0,-0.6984302957695783,0.7828210056694449,0.22469589430103445,155,75,80,0,-0.09972513740911768,-0.19508342575683765,0.0,1.365512642767376,0.7824794536106858,0.7824794536106858,0.0,-0.19508342575683765,1,1,1,1,-0.19508342575683765,0.0
7581,32,142,15,50,45,1,3500.502,54,1014.076,MORE,72,1454,1526,3,2,-5.0,-0.4687042303372438,5.0,-0.6984302957695783,-1.280250458759545,0.03535542840304541,95,50,45,1,-1.2964267863185297,-1.170500554541026,-1.3655839802978638,0.4526351099980994,0.48356859682491476,0.48356859682491476,-1.3655839802978638,-1.170500554541026,0,1,1,0,-1.170500554541026,-1.3655839802978638
7582,32,143,59,89,110,1,1909.953,84,1681.4029999999998,MORE,12,894,906,1,2,21.0,1.9685577674164243,21.0,2.0952908873087353,0.7828210056694449,-1.192827181560823,199,89,110,0,0.7778560717911179,0.3511501663623078,1.170500554541026,-1.3731199555404536,0.4094584670433186,0.4094584670433186,1.170500554541026,0.3511501663623078,1,0,1,2,1.170500554541026,0.3511501663623078
7583,32,144,29,80,94,1,2221.725,94,1796.138,MORE,1244,904,2148,1,2,14.0,1.3123718449442827,14.0,0.8730378697119728,1.4705114938124415,-0.9520845520199188,174,80,94,0,0.2792303847455295,0.0,0.5462335921191455,-1.3731199555404536,1.9311864652254258,1.9311864652254258,0.5462335921191455,0.0,1,0,1,1,0.5462335921191455,0.0
7584,32,145,55,110,98,1,3660.15,94,1064.165,MORE,596,1214,1810,3,2,-12.0,-1.124890152809385,12.0,0.5238227218271837,1.4705114938124415,0.15863166655447095,208,110,98,1,0.9573613191275298,1.170500554541026,0.7023003327246156,0.4526351099980994,1.1307970635841875,1.1307970635841875,0.7023003327246156,1.170500554541026,1,1,1,2,1.170500554541026,0.7023003327246156
7585,32,146,29,94,80,0,4733.189,64,1614.96,MORE,-202,1534,1332,3,1,-14.0,-1.3123718449442827,14.0,0.8730378697119728,-0.5925599706165483,0.9872058504450768,174,94,80,1,0.2792303847455295,0.5462335921191455,0.0,0.4526351099980994,0.1451323374889591,0.1451323374889591,0.0,0.5462335921191455,0,1,0,1,0.5462335921191455,0.0
7586,32,147,57,110,94,0,4532.641,84,1592.308,MORE,46,2236,2282,4,2,-16.0,-1.4998535370791803,16.0,1.222253017596762,0.7828210056694449,0.8323476435850339,204,110,94,1,0.8775812092002355,1.170500554541026,0.5462335921191455,1.365512642767376,0.45145420725288976,0.45145420725288976,0.5462335921191455,1.170500554541026,1,1,1,2,1.170500554541026,0.5462335921191455
7587,32,148,39,80,66,0,3310.778,64,1445.878,MORE,-370,1580,1210,4,1,-14.0,-1.3123718449442827,14.0,0.8730378697119728,-0.5925599706165483,-0.11114475329068746,146,80,66,1,-0.2792303847455295,0.0,-0.5462335921191455,1.365512642767376,-0.06237602589951008,0.06237602589951008,-0.5462335921191455,0.0,0,1,0,1,0.0,-0.5462335921191455
7588,32,149,4,50,54,1,2658.876,84,1990.541,MORE,76,1062,1138,3,2,4.0,0.3749633842697951,4.0,-0.8730378697119728,0.7828210056694449,-0.6145273587939855,104,50,54,0,-1.116921538982118,-1.170500554541026,-1.0144338139355558,0.4526351099980994,0.48850927214368783,0.48850927214368783,-1.0144338139355558,-1.170500554541026,1,1,1,0,-1.170500554541026,-1.0144338139355558
7589,32,150,55,98,110,0,3831.082,54,2190.114,MORE,38,1422,1460,1,1,12.0,1.124890152809385,12.0,0.5238227218271837,-1.280250458759545,0.2906211304982688,208,98,110,0,0.9573613191275298,0.7023003327246156,1.170500554541026,-1.3731199555404536,0.4415728566153436,0.4415728566153436,1.170500554541026,0.7023003327246156,0,0,1,2,1.170500554541026,0.7023003327246156
7590,32,151,2,50,52,1,3158.335,64,1197.865,MORE,-94,1498,1404,4,1,2.0,0.18748169213489754,2.0,-1.222253017596762,-0.5925599706165483,-0.2288574685925874,102,50,52,0,-1.156811593945765,-1.170500554541026,-1.092467184238291,1.365512642767376,0.2785305710958321,0.2785305710958321,-1.092467184238291,-1.170500554541026,0,1,0,0,-1.170500554541026,-1.092467184238291
7591,32,152,59,110,89,0,2740.618,74,1009.105,MORE,-1098,1872,774,2,1,-21.0,-1.9685577674164243,21.0,2.0952908873087353,0.09513051752644833,-0.5514082075426463,199,110,89,1,0.7778560717911179,1.170500554541026,0.3511501663623078,-0.4602424227711771,-0.9615789339162099,0.9615789339162099,0.3511501663623078,1.170500554541026,0,0,0,2,1.170500554541026,0.3511501663623078
7592,32,153,60,87,110,1,2287.1710000000007,94,1891.878,MORE,1168,734,1902,1,2,23.0,2.1560394595513217,23.0,2.444506035193524,1.4705114938124415,-0.9015487690344868,197,87,110,0,0.7379660168274708,0.27311679605957273,1.170500554541026,-1.3731199555404536,1.8373136341687375,1.8373136341687375,1.170500554541026,0.27311679605957273,1,0,1,2,1.170500554541026,0.27311679605957273
7593,32,154,52,110,105,1,3943.594,74,1586.269,MORE,316,1764,2080,3,2,-5.0,-0.4687042303372438,5.0,-0.6984302957695783,0.09513051752644833,0.3775001149321057,215,110,105,1,1.0969765115002945,1.170500554541026,0.9754171287841883,0.4526351099980994,0.7849497912700724,0.7849497912700724,0.9754171287841883,1.170500554541026,0,1,1,2,1.170500554541026,0.9754171287841883
7594,32,155,30,80,96,1,2154.936,84,1690.766,MORE,130,856,986,1,2,16.0,1.4998535370791803,16.0,1.222253017596762,0.7828210056694449,-1.0036573663983983,176,80,96,0,0.3191204397091766,0.0,0.6242669624218805,-1.3731199555404536,0.5552083889471243,0.5552083889471243,0.6242669624218805,0.0,1,0,1,1,0.6242669624218805,0.0
7595,32,156,24,80,86,1,4163.911,74,1566.447,MORE,744,1806,2550,5,2,6.0,0.5624450764046927,6.0,-0.5238227218271837,0.09513051752644833,0.5476234547848293,166,80,86,0,0.11967016489094122,0.0,0.2341001109082052,2.2783901755366527,1.3136020503787915,1.3136020503787915,0.2341001109082052,0.0,0,1,1,1,0.2341001109082052,0.0
7596,32,157,5,50,55,1,3020.9120000000007,54,1596.5479999999998,MORE,-88,1478,1390,4,1,5.0,0.4687042303372438,5.0,-0.6984302957695783,-1.280250458759545,-0.33497211127826626,105,50,55,0,-1.0969765115002945,-1.170500554541026,-0.9754171287841883,1.365512642767376,0.28594158407399173,0.28594158407399173,-0.9754171287841883,-1.170500554541026,0,1,1,0,-1.170500554541026,-0.9754171287841883
7597,32,158,34,80,74,1,3992.604,54,2258.951,MORE,-878,2634,1756,3,1,-6.0,-0.5624450764046927,6.0,-0.5238227218271837,-1.280250458759545,0.4153444251132625,154,80,74,1,-0.11967016489094122,0.0,-0.2341001109082052,0.4526351099980994,-0.6898417913836906,0.6898417913836906,-0.2341001109082052,0.0,0,1,0,1,0.0,-0.2341001109082052
7598,32,159,15,45,50,1,3372.336,64,1122.719,MORE,-194,1402,1208,3,2,5.0,0.4687042303372438,5.0,-0.6984302957695783,-0.5925599706165483,-0.06361118777075958,95,45,50,0,-1.2964267863185297,-1.3655839802978638,-1.170500554541026,0.4526351099980994,0.15501368812650523,0.15501368812650523,-1.170500554541026,-1.3655839802978638,0,1,0,0,-1.3655839802978638,-1.170500554541026
7599,32,160,37,69,80,1,2535.258,94,1065.564,MORE,166,1142,1308,1,2,11.0,1.0311493067419364,11.0,0.34921514788478913,1.4705114938124415,-0.7099821218214143,149,69,80,0,-0.21939530230005888,-0.4291835366650429,0.0,-1.3731199555404536,0.599674466816082,0.599674466816082,0.0,-0.4291835366650429,1,0,1,1,-0.4291835366650429,0.0
7600,32,161,3,50,53,0,2613.993,54,1221.106,LESS,-324,1016,692,2,1,3.0,0.28122253820234633,3.0,-1.0476454436543674,-1.280250458759545,-0.6491849016191411,103,50,53,1,-1.1368665664639415,-1.170500554541026,-1.0534504990869233,-0.4602424227711771,-0.0055582597336197095,0.0055582597336197095,-1.0534504990869233,-1.170500554541026,0,0,1,0,-1.170500554541026,-1.0534504990869233
7601,32,162,20,50,40,0,3252.3340000000007,74,2824.906,LESS,-1474,2318,844,2,2,-10.0,-0.9374084606744876,10.0,0.17460757394239454,0.09513051752644833,-0.15627376500722506,90,50,40,0,-1.3961519237276474,-1.170500554541026,-1.5606674060547012,-0.4602424227711771,-1.426002413880879,1.426002413880879,-1.5606674060547012,-1.170500554541026,0,0,0,0,-1.170500554541026,-1.5606674060547012
7602,32,163,25,80,88,0,2824.573,84,1397.241,LESS,-678,1826,1148,2,2,8.0,0.7499267685395902,8.0,-0.17460757394239454,0.7828210056694449,-0.4865802324098359,168,80,88,1,0.1595602198545883,0.0,0.31213348121094026,-0.4602424227711771,-0.4428080254450369,0.4428080254450369,0.31213348121094026,0.0,1,0,0,1,0.31213348121094026,0.0
7603,32,164,42,115,110,0,4964.001,74,2264.32,LESS,-1080,3164,2084,4,2,-5.0,-0.4687042303372438,5.0,-0.6984302957695783,0.09513051752644833,1.165433169798948,225,115,110,0,1.2964267863185297,1.3655839802978638,1.170500554541026,1.365512642767376,-0.9393458949817309,0.9393458949817309,1.170500554541026,1.3655839802978638,0,1,0,2,1.3655839802978638,1.170500554541026
7604,32,165,53,103,110,0,2466.865,74,1403.957,LESS,-1350,1942,592,2,1,7.0,0.6561859224721414,7.0,-0.34921514788478913,0.09513051752644833,-0.7627935053394693,213,103,110,1,1.0570864565366473,0.8973837584814532,1.170500554541026,-0.4602424227711771,-1.2728414789989135,1.2728414789989135,1.170500554541026,0.8973837584814532,0,0,0,2,1.170500554541026,0.8973837584814532
7605,32,166,26,90,80,0,3069.295,74,1345.1029999999996,LESS,-1260,2166,906,2,1,-10.0,-0.9374084606744876,10.0,0.17460757394239454,0.09513051752644833,-0.2976119549939386,170,90,80,0,0.19945027481823535,0.3901668515136753,0.0,-0.4602424227711771,-1.1616762843265194,1.1616762843265194,0.0,0.3901668515136753,0,0,0,1,0.3901668515136753,0.0
7606,32,167,35,80,72,1,2504.254,84,2651.558,LESS,258,1308,1566,2,2,-8.0,-0.7499267685395902,8.0,-0.17460757394239454,0.7828210056694449,-0.7339226440180392,152,80,72,0,-0.1595602198545883,0.0,-0.31213348121094026,-0.4602424227711771,0.7133099991478627,0.7133099991478627,-0.31213348121094026,0.0,1,0,1,1,0.0,-0.31213348121094026
7607,32,168,28,93,80,1,4963.509,94,1701.734,LESS,1348,1908,3256,3,2,-13.0,-1.218630998876834,13.0,0.6984302957695783,1.4705114938124415,1.1650532595641154,173,93,80,0,0.25928535726370594,0.5072169069677779,0.0,0.4526351099980994,2.059644023513526,2.059644023513526,0.0,0.5072169069677779,1,1,1,1,0.5072169069677779,0.0
7608,32,169,26,80,90,0,4152.402,74,1467.205,LESS,-1272,2510,1238,4,1,10.0,0.9374084606744876,10.0,0.17460757394239454,0.09513051752644833,0.5387364895557957,170,80,90,1,0.19945027481823535,0.0,0.3901668515136753,1.365512642767376,-1.1764983102828386,1.1764983102828386,0.3901668515136753,0.0,1,1,0,1,0.3901668515136753,0.0
7609,32,170,25,88,80,1,4223.139,74,1703.859,LESS,-936,2362,1426,4,1,-8.0,-0.7499267685395902,8.0,-0.17460757394239454,0.09513051752644833,0.5933578519162223,168,88,80,0,0.1595602198545883,0.31213348121094026,0.0,1.365512642767376,-0.7614815835059002,0.7614815835059002,0.0,0.31213348121094026,0,1,0,1,0.31213348121094026,0.0
7610,32,171,36,80,70,1,4826.068,64,1187.133,LESS,2,1830,1832,3,2,-10.0,-0.9374084606744876,10.0,0.17460757394239454,-0.5925599706165483,1.0589247177235035,150,80,70,0,-0.19945027481823535,0.0,-0.3901668515136753,0.4526351099980994,0.39710677874638595,0.39710677874638595,-0.3901668515136753,0.0,0,1,1,1,0.0,-0.3901668515136753
7611,32,172,28,80,93,0,3077.5490000000004,64,3265.703,LESS,-1226,2220,994,2,2,13.0,1.218630998876834,13.0,0.6984302957695783,-0.5925599706165483,-0.29123842028193525,173,80,93,1,0.25928535726370594,0.0,0.5072169069677779,-0.4602424227711771,-1.1196805441169482,1.1196805441169482,0.5072169069677779,0.0,0,0,0,1,0.5072169069677779,0.0
7612,32,173,21,82,80,0,3432.836,84,1214.437,LESS,-522,2054,1532,2,2,-2.0,-0.18748169213489754,2.0,-1.222253017596762,0.7828210056694449,-0.016894583690775847,162,82,80,0,0.03989005496364707,0.07803337030273506,0.0,-0.4602424227711771,-0.2501216880128869,0.2501216880128869,0.0,0.07803337030273506,1,0,1,1,0.07803337030273506,0.0
7613,32,174,19,50,41,1,2923.8140000000008,84,1724.254,LESS,644,1186,1830,3,2,-9.0,-0.8436676146070391,9.0,0.0,0.7828210056694449,-0.4099487860379069,91,50,41,0,-1.376206896245824,-1.170500554541026,-1.5216507209033339,0.4526351099980994,1.1900851674094646,1.1900851674094646,-1.5216507209033339,-1.170500554541026,1,1,1,0,-1.170500554541026,-1.5216507209033339
7614,32,175,56,96,110,0,5728.365,54,1968.002,LESS,-972,3002,2030,6,1,14.0,1.3123718449442827,14.0,0.8730378697119728,-1.280250458759545,1.7556561509723805,206,96,110,1,0.9174712641638826,0.6242669624218805,1.170500554541026,3.191267708305929,-0.805947661374858,0.805947661374858,1.170500554541026,0.6242669624218805,0,1,0,2,1.170500554541026,0.6242669624218805
7615,32,176,23,80,85,1,4850.2829999999985,74,2276.623,LESS,260,1882,2142,3,2,5.0,0.4687042303372438,5.0,-0.6984302957695783,0.09513051752644833,1.0776229419846064,165,80,85,1,0.09972513740911768,0.0,0.19508342575683765,0.4526351099980994,0.7157803368072493,0.7157803368072493,0.19508342575683765,0.0,0,1,1,1,0.19508342575683765,0.0
7616,32,177,10,60,50,1,3255.376,84,1997.786,LESS,874,1430,2304,3,2,-10.0,-0.9374084606744876,10.0,0.17460757394239454,0.7828210056694449,-0.15392480782356746,110,60,50,0,-0.9972513740911768,-0.7803337030273506,-1.170500554541026,0.4526351099980994,1.4741739982389164,1.4741739982389164,-1.170500554541026,-0.7803337030273506,1,1,1,0,-0.7803337030273506,-1.170500554541026
7617,32,178,19,41,50,0,2792.095,94,794.628,LESS,-920,1914,994,2,2,9.0,0.8436676146070391,9.0,0.0,1.4705114938124415,-0.5116589409604096,91,41,50,1,-1.376206896245824,-1.5216507209033339,-1.170500554541026,-0.4602424227711771,-0.741718882230808,0.741718882230808,-1.170500554541026,-1.5216507209033339,1,0,0,0,-1.5216507209033339,-1.170500554541026
7618,32,179,56,110,96,1,3506.5,74,883.3389999999998,LESS,-84,1660,1576,3,2,-14.0,-1.3123718449442827,14.0,0.8730378697119728,0.09513051752644833,0.039986935696793256,206,110,96,0,0.9174712641638826,1.170500554541026,0.6242669624218805,0.4526351099980994,0.2908822593927648,0.2908822593927648,0.6242669624218805,1.170500554541026,0,1,1,2,1.170500554541026,0.6242669624218805
7619,32,180,35,72,80,0,2462.956,84,1461.375,LESS,-614,1314,700,2,2,8.0,0.7499267685395902,8.0,-0.17460757394239454,0.7828210056694449,-0.7658119384857278,152,72,80,1,-0.1595602198545883,-0.31213348121094026,0.0,-0.4602424227711771,-0.3637572203446677,0.3637572203446677,0.0,-0.31213348121094026,1,0,0,1,-0.31213348121094026,0.0
7620,32,181,11,49,50,1,2762.168,84,2308.218,LESS,452,1442,1894,3,2,1.0,0.09374084606744876,1.0,-1.3968605915391563,0.7828210056694449,-0.5347678303868834,99,49,50,1,-1.2166466763912356,-1.2095172396923934,-1.170500554541026,0.4526351099980994,0.9529327521083569,0.9529327521083569,-1.170500554541026,-1.2095172396923934,1,1,1,0,-1.2095172396923934,-1.170500554541026
7621,32,182,17,43,50,0,2217.496,84,951.757,LESS,-1082,1776,694,2,2,7.0,0.6561859224721414,7.0,-0.34921514788478913,0.7828210056694449,-0.9553500812538732,93,43,50,1,-1.3363168412821769,-1.4436173506005987,-1.170500554541026,-0.4602424227711771,-0.9418162326411175,0.9418162326411175,-1.170500554541026,-1.4436173506005987,1,0,0,0,-1.4436173506005987,-1.170500554541026
7622,32,183,1,51,50,0,2119.951,84,1617.2779999999998,LESS,-14,1506,1492,2,2,-1.0,-0.09374084606744876,1.0,-1.3968605915391563,0.7828210056694449,-1.030671918361014,101,51,50,0,-1.1767566214275886,-1.1314838693896585,-1.170500554541026,-0.4602424227711771,0.3773440774712936,0.3773440774712936,-1.170500554541026,-1.1314838693896585,1,0,1,0,-1.1314838693896585,-1.170500554541026
7623,32,184,41,112,110,0,2815.246,74,1144.227,LESS,-890,1588,698,2,1,-2.0,-0.18748169213489754,2.0,-1.222253017596762,0.09513051752644833,-0.4937823111908937,222,112,110,0,1.2365917038730592,1.248533924843761,1.170500554541026,-0.4602424227711771,-0.7046638173400099,0.7046638173400099,1.170500554541026,1.248533924843761,1,0,0,2,1.248533924843761,1.170500554541026
7624,32,185,20,40,50,0,2350.208,94,905.688,LESS,-286,1446,1160,1,2,10.0,0.9374084606744876,10.0,0.17460757394239454,1.4705114938124415,-0.8528731562842403,90,40,50,1,-1.3961519237276474,-1.5606674060547012,-1.170500554541026,-1.3731199555404536,0.04137815579472451,0.04137815579472451,-1.170500554541026,-1.5606674060547012,1,0,1,0,-1.5606674060547012,-1.170500554541026
7625,32,186,1,50,51,0,1811.799,94,1126.082,LESS,-12,1216,1204,2,2,1.0,0.09374084606744876,1.0,-1.3968605915391563,1.4705114938124415,-1.2686192734098594,101,50,51,1,-1.1767566214275886,-1.170500554541026,-1.1314838693896585,-0.4602424227711771,0.37981441513068015,0.37981441513068015,-1.1314838693896585,-1.170500554541026,1,0,1,0,-1.170500554541026,-1.1314838693896585
7626,32,187,23,85,80,0,2669.652,74,2150.522,LESS,-1274,1804,530,2,1,-5.0,-0.4687042303372438,5.0,-0.6984302957695783,0.09513051752644833,-0.6062063980408301,165,85,80,0,0.09972513740911768,0.19508342575683765,0.0,-0.4602424227711771,-1.1789686479422252,1.1789686479422252,0.0,0.19508342575683765,1,0,0,1,0.19508342575683765,0.0
7627,32,188,11,50,49,0,2749.159,74,1262.91,LESS,-894,1852,958,2,2,-1.0,-0.09374084606744876,1.0,-1.3968605915391563,0.09513051752644833,-0.5448130585269909,99,50,49,0,-1.2166466763912356,-1.170500554541026,-1.2095172396923934,-0.4602424227711771,-0.709604492658783,0.709604492658783,-1.2095172396923934,-1.170500554541026,1,0,0,0,-1.170500554541026,-1.2095172396923934
7628,32,189,17,50,43,1,3320.006,64,2108.529,LESS,352,1302,1654,3,2,-7.0,-0.6561859224721414,7.0,-0.34921514788478913,-0.5925599706165483,-0.10401911986176032,93,50,43,0,-1.3363168412821769,-1.170500554541026,-1.4436173506005987,0.4526351099980994,0.82941586913903,0.82941586913903,-1.4436173506005987,-1.170500554541026,0,1,1,0,-1.170500554541026,-1.4436173506005987
7629,32,190,21,80,82,0,2410.983,64,2370.246,LESS,-822,1386,564,1,1,2.0,0.18748169213489754,2.0,-1.222253017596762,-0.5925599706165483,-0.805944204003893,162,80,82,1,0.03989005496364707,0.0,0.07803337030273506,-1.3731199555404536,-0.6206723369208677,0.6206723369208677,0.07803337030273506,0.0,0,0,0,1,0.07803337030273506,0.0
7630,32,191,10,50,60,0,2270.307,84,1851.293,LESS,-722,1246,524,2,1,10.0,0.9374084606744876,10.0,0.17460757394239454,0.7828210056694449,-0.9145707328560552,110,50,60,1,-0.9972513740911768,-1.170500554541026,-0.7803337030273506,-0.4602424227711771,-0.4971554539515407,0.4971554539515407,-0.7803337030273506,-1.170500554541026,1,1,0,0,-1.170500554541026,-0.7803337030273506
7631,32,192,3,53,50,0,6083.601,64,1596.4589999999996,LESS,-314,2290,1976,3,2,-3.0,-0.28122253820234633,3.0,-1.0476454436543674,-0.5925599706165483,2.0299606066245635,103,53,50,0,-1.1368665664639415,-1.0534504990869233,-1.170500554541026,0.4526351099980994,0.0067934285633129785,0.0067934285633129785,-1.170500554541026,-1.0534504990869233,0,1,1,0,-1.0534504990869233,-1.170500554541026
7632,32,193,45,122,110,1,3608.935,74,1400.0120000000004,LESS,108,1798,1906,2,2,-12.0,-1.124890152809385,12.0,0.5238227218271837,0.09513051752644833,0.11908470989403508,232,122,110,0,1.4360419786912946,1.6387007763574364,1.170500554541026,-0.4602424227711771,0.5280346746938724,0.5280346746938724,1.170500554541026,1.6387007763574364,1,0,1,2,1.6387007763574364,1.170500554541026
7633,32,194,38,67,80,0,2338.91,54,1329.2879999999998,LESS,-1110,1734,624,2,1,13.0,1.218630998876834,13.0,0.6984302957695783,-1.280250458759545,-0.8615971925304496,147,67,80,1,-0.25928535726370594,-0.5072169069677779,0.0,-0.4602424227711771,-0.9764009598725291,0.9764009598725291,0.0,-0.5072169069677779,0,0,0,1,-0.5072169069677779,0.0
7634,32,195,38,80,67,1,3836.239,84,2382.871,LESS,1628,1682,3310,3,2,-13.0,-1.218630998876834,13.0,0.6984302957695783,0.7828210056694449,0.29460323838654123,147,80,67,0,-0.25928535726370594,0.0,-0.5072169069677779,0.4526351099980994,2.405491295827641,2.405491295827641,-0.5072169069677779,0.0,1,1,1,1,0.0,-0.5072169069677779
7635,32,196,36,70,80,0,2278.55,74,1974.788,LESS,-564,1358,794,2,1,10.0,0.9374084606744876,10.0,0.17460757394239454,0.09513051752644833,-0.9082056920720664,150,70,80,1,-0.19945027481823535,-0.3901668515136753,0.0,-0.4602424227711771,-0.30199877886000426,0.30199877886000426,0.0,-0.3901668515136753,1,0,0,1,-0.3901668515136753,0.0
7636,32,197,45,110,122,0,5138.037,64,2911.8390000000004,LESS,-1924,3104,1180,4,1,12.0,1.124890152809385,12.0,0.5238227218271837,-0.5925599706165483,1.299819465793395,232,110,122,1,1.4360419786912946,1.170500554541026,1.6387007763574364,1.365512642767376,-1.98182838724285,1.98182838724285,1.6387007763574364,1.170500554541026,0,1,0,2,1.6387007763574364,1.170500554541026
7637,32,198,42,110,115,0,3721.075,54,2819.1240000000007,LESS,-2170,2822,652,1,1,5.0,0.4687042303372438,5.0,-0.6984302957695783,-1.280250458759545,0.20567644512592545,225,110,115,1,1.2964267863185297,1.170500554541026,1.3655839802978638,-1.3731199555404536,-2.2856799193473942,2.2856799193473942,1.3655839802978638,1.170500554541026,0,0,0,2,1.3655839802978638,1.170500554541026
7638,32,199,41,110,112,1,6363.511,44,3147.213,LESS,-420,2764,2344,4,2,2.0,0.18748169213489754,2.0,-1.222253017596762,-1.9679409469025413,2.2461001875837088,222,110,112,1,1.2365917038730592,1.170500554541026,1.248533924843761,1.365512642767376,-0.12413446738417352,0.12413446738417352,1.248533924843761,1.170500554541026,0,1,1,2,1.248533924843761,1.170500554541026
7639,32,200,53,110,103,0,5694.148,54,2397.092,LESS,194,2264,2458,3,1,-7.0,-0.6561859224721414,7.0,-0.34921514788478913,-1.280250458759545,1.729234629620235,213,110,103,0,1.0570864565366473,1.170500554541026,0.8973837584814532,0.4526351099980994,0.6342591940474935,0.6342591940474935,0.8973837584814532,1.170500554541026,0,1,1,2,1.170500554541026,0.8973837584814532
7640,32,201,3,50,53,0,2537.057,74,2401.5370000000007,MORE,-1748,2238,490,2,1,3.0,0.28122253820234633,3.0,-1.0476454436543674,0.09513051752644833,-0.7085929785033995,103,50,53,0,-1.1368665664639415,-1.170500554541026,-1.0534504990869233,-0.4602424227711771,-1.7644386732168345,1.7644386732168345,-1.0534504990869233,-1.170500554541026,0,0,0,0,-1.170500554541026,-1.0534504990869233
7641,32,202,20,50,40,0,2533.419,74,2363.078,MORE,-778,1680,902,2,2,-10.0,-0.9374084606744876,10.0,0.17460757394239454,0.09513051752644833,-0.7114021521503909,90,50,40,1,-1.3961519237276474,-1.170500554541026,-1.5606674060547012,-0.4602424227711771,-0.5663249084143638,0.5663249084143638,-1.5606674060547012,-1.170500554541026,1,0,0,0,-1.170500554541026,-1.5606674060547012
7642,32,203,25,80,88,1,3211.621,74,1934.07,MORE,110,1420,1530,3,2,8.0,0.7499267685395902,8.0,-0.17460757394239454,0.09513051752644833,-0.1877113369395954,168,80,88,0,0.1595602198545883,0.0,0.31213348121094026,0.4526351099980994,0.530505012353259,0.530505012353259,0.31213348121094026,0.0,1,1,1,1,0.31213348121094026,0.0
7643,32,204,42,115,110,1,2105.686,84,1898.676,MORE,872,814,1686,1,2,-5.0,-0.4687042303372438,5.0,-0.6984302957695783,0.7828210056694449,-1.0416869986453274,225,115,110,1,1.2964267863185297,1.3655839802978638,1.170500554541026,-1.3731199555404536,1.4717036605795297,1.4717036605795297,1.170500554541026,1.3655839802978638,1,0,1,2,1.3655839802978638,1.170500554541026
7644,32,205,53,103,110,1,2204.542,74,2156.395,MORE,404,876,1280,1,2,7.0,0.6561859224721414,7.0,-0.34921514788478913,0.09513051752644833,-0.9653528397539084,213,103,110,0,1.0570864565366473,0.8973837584814532,1.170500554541026,-1.3731199555404536,0.89364464828308,0.89364464828308,1.170500554541026,0.8973837584814532,0,0,1,2,1.170500554541026,0.8973837584814532
7645,32,206,26,90,80,0,4184.561,74,1920.586,MORE,-1322,2720,1398,4,1,-10.0,-0.9374084606744876,10.0,0.17460757394239454,0.09513051752644833,0.5635688741939474,170,90,80,1,0.19945027481823535,0.3901668515136753,0.0,1.365512642767376,-1.238256751767502,1.238256751767502,0.0,0.3901668515136753,0,1,0,1,0.3901668515136753,0.0
7646,32,207,35,80,72,1,4248.435,74,1739.723,MORE,356,1652,2008,2,2,-8.0,-0.7499267685395902,8.0,-0.17460757394239454,0.09513051752644833,0.612890797648574,152,80,72,1,-0.1595602198545883,0.0,-0.31213348121094026,-0.4602424227711771,0.8343565444578032,0.8343565444578032,-0.31213348121094026,0.0,0,0,1,1,0.0,-0.31213348121094026
7647,32,208,28,93,80,0,3635.295,64,1701.995,MORE,-440,1556,1116,2,1,-13.0,-1.218630998876834,13.0,0.6984302957695783,-0.5925599706165483,0.13943925011797514,173,93,80,1,0.25928535726370594,0.5072169069677779,0.0,-0.4602424227711771,-0.1488378439780389,0.1488378439780389,0.0,0.5072169069677779,0,0,0,1,0.5072169069677779,0.0
7648,32,209,26,80,90,1,4342.773,84,1002.775,MORE,464,1974,2438,3,2,10.0,0.9374084606744876,10.0,0.17460757394239454,0.7828210056694449,0.6857362686518383,170,80,90,0,0.19945027481823535,0.0,0.3901668515136753,0.4526351099980994,0.9677547780646761,0.9677547780646761,0.3901668515136753,0.0,1,1,1,1,0.3901668515136753,0.0
7649,32,210,25,88,80,0,4628.122,64,2160.836,MORE,-804,2360,1556,2,1,-8.0,-0.7499267685395902,8.0,-0.17460757394239454,-0.5925599706165483,0.9060757109265372,168,88,80,1,0.1595602198545883,0.31213348121094026,0.0,-0.4602424227711771,-0.5984392979863887,0.5984392979863887,0.0,0.31213348121094026,0,0,0,1,0.31213348121094026,0.0
7650,32,211,36,80,70,0,4088.15,74,974.637,MORE,-1448,2692,1244,2,2,-10.0,-0.9374084606744876,10.0,0.17460757394239454,0.09513051752644833,0.489122683847579,150,80,70,1,-0.19945027481823535,0.0,-0.3901668515136753,-0.4602424227711771,-1.3938880243088538,1.3938880243088538,-0.3901668515136753,0.0,0,0,0,1,0.0,-0.3901668515136753
7651,32,212,28,80,93,1,3594.637,84,1974.853,MORE,-1596,2682,1086,1,2,13.0,1.218630998876834,13.0,0.6984302957695783,0.7828210056694449,0.1080441478256781,173,80,93,0,0.25928535726370594,0.0,0.5072169069677779,-1.3731199555404536,-1.5766930111034576,1.5766930111034576,0.5072169069677779,0.0,1,0,0,1,0.5072169069677779,0.0
7652,32,213,21,82,80,1,4395.555,64,1545.98,MORE,-438,2554,2116,3,2,-2.0,-0.18748169213489754,2.0,-1.222253017596762,-0.5925599706165483,0.7264932239667096,162,82,80,1,0.03989005496364707,0.07803337030273506,0.0,0.4526351099980994,-0.14636750631865236,0.14636750631865236,0.0,0.07803337030273506,0,1,0,1,0.07803337030273506,0.0
7653,32,214,19,50,41,0,2505.763,84,1947.364,MORE,-680,1582,902,2,2,-9.0,-0.8436676146070391,9.0,0.0,0.7828210056694449,-0.7327574315294988,91,50,41,1,-1.376206896245824,-1.170500554541026,-1.5216507209033339,-0.4602424227711771,-0.4452783631044234,0.4452783631044234,-1.5216507209033339,-1.170500554541026,1,0,0,0,-1.170500554541026,-1.5216507209033339
7654,32,215,56,96,110,1,5229.414000000002,74,1405.411,MORE,200,1822,2022,3,2,14.0,1.3123718449442827,14.0,0.8730378697119728,0.09513051752644833,1.3703785258102006,206,96,110,0,0.9174712641638826,0.6242669624218805,1.170500554541026,0.4526351099980994,0.6416702070256531,0.6416702070256531,1.170500554541026,0.6242669624218805,0,1,1,2,1.170500554541026,0.6242669624218805
7655,32,216,23,80,85,0,3355.3459999999995,74,1734.003,MORE,-1438,2190,752,2,1,5.0,0.4687042303372438,5.0,-0.6984302957695783,0.09513051752644833,-0.07673044567685766,165,80,85,0,0.09972513740911768,0.0,0.19508342575683765,-0.4602424227711771,-1.3815363360119213,1.3815363360119213,0.19508342575683765,0.0,1,0,0,1,0.19508342575683765,0.0
7656,32,217,10,60,50,0,2938.083,64,1564.078,MORE,-298,1554,1256,2,2,-10.0,-0.9374084606744876,10.0,0.17460757394239454,-0.5925599706165483,-0.3989306170524977,110,60,50,1,-0.9972513740911768,-0.7803337030273506,-1.170500554541026,-0.4602424227711771,0.02655612983840528,0.02655612983840528,-1.170500554541026,-0.7803337030273506,0,0,0,0,-0.7803337030273506,-1.170500554541026
7657,32,218,19,41,50,1,1876.789,94,960.159,MORE,344,1012,1356,1,2,9.0,0.8436676146070391,9.0,0.0,1.4705114938124415,-1.2184356023493943,91,41,50,0,-1.376206896245824,-1.5216507209033339,-1.170500554541026,-1.3731199555404536,0.8195345185014838,0.8195345185014838,-1.170500554541026,-1.5216507209033339,1,0,1,0,-1.5216507209033339,-1.170500554541026
7658,32,219,56,110,96,0,4752.43,64,2448.397,MORE,-1002,2662,1660,2,1,-14.0,-1.3123718449442827,14.0,0.8730378697119728,-0.5925599706165483,1.0020632748930598,206,110,96,1,0.9174712641638826,1.170500554541026,0.6242669624218805,-0.4602424227711771,-0.843002726265656,0.843002726265656,0.6242669624218805,1.170500554541026,0,0,0,2,1.170500554541026,0.6242669624218805
7659,32,220,35,72,80,1,2400.5460000000007,84,978.448,MORE,50,1086,1136,0,2,8.0,0.7499267685395902,8.0,-0.17460757394239454,0.7828210056694449,-0.8140033973391453,152,72,80,0,-0.1595602198545883,-0.31213348121094026,0.0,-2.28599748830973,0.45639488257166283,0.45639488257166283,0.0,-0.31213348121094026,1,0,1,1,-0.31213348121094026,0.0
7660,32,221,11,49,50,1,1978.196,84,788.689,MORE,-112,970,858,1,2,1.0,0.09374084606744876,1.0,-1.3968605915391563,0.7828210056694449,-1.1401316243338753,99,49,50,0,-1.2166466763912356,-1.2095172396923934,-1.170500554541026,-1.3731199555404536,0.2562975321613533,0.2562975321613533,-1.170500554541026,-1.2095172396923934,1,0,0,0,-1.2095172396923934,-1.170500554541026
7661,32,222,17,43,50,1,3250.197,84,910.167,MORE,-1014,2232,1218,1,2,7.0,0.6561859224721414,7.0,-0.34921514788478913,0.7828210056694449,-0.15792390356786892,93,43,50,0,-1.3363168412821769,-1.4436173506005987,-1.170500554541026,-1.3731199555404536,-0.8578247522219752,0.8578247522219752,-1.170500554541026,-1.4436173506005987,1,0,0,0,-1.4436173506005987,-1.170500554541026
7662,32,223,1,51,50,1,4684.154,64,2294.369,MORE,288,2042,2330,3,1,-1.0,-0.09374084606744876,1.0,-1.3968605915391563,-0.5925599706165483,0.9493422358820688,101,51,50,1,-1.1767566214275886,-1.1314838693896585,-1.170500554541026,0.4526351099980994,0.7503650640386609,0.7503650640386609,-1.170500554541026,-1.1314838693896585,0,1,1,0,-1.1314838693896585,-1.170500554541026
7663,32,224,41,112,110,0,3395.576,84,2562.338,MORE,-1086,2284,1198,2,2,-2.0,-0.18748169213489754,2.0,-1.222253017596762,0.7828210056694449,-0.04566583440185324,222,112,110,1,1.2365917038730592,1.248533924843761,1.170500554541026,-0.4602424227711771,-0.9467569079598905,0.9467569079598905,1.170500554541026,1.248533924843761,1,0,0,2,1.248533924843761,1.170500554541026
7664,32,225,20,40,50,1,2339.674,84,1538.828,MORE,176,1370,1546,1,2,10.0,0.9374084606744876,10.0,0.17460757394239454,0.7828210056694449,-0.8610072506210759,90,40,50,0,-1.3961519237276474,-1.5606674060547012,-1.170500554541026,-1.3731199555404536,0.6120261551130147,0.6120261551130147,-1.170500554541026,-1.5606674060547012,1,0,1,0,-1.5606674060547012,-1.170500554541026
7665,32,226,1,50,51,1,5724.238,64,1142.075,MORE,-106,2538,2432,3,2,1.0,0.09374084606744876,1.0,-1.3968605915391563,-0.5925599706165483,1.7524693836163792,101,50,51,0,-1.1767566214275886,-1.170500554541026,-1.1314838693896585,0.4526351099980994,0.2637085451395129,0.2637085451395129,-1.1314838693896585,-1.170500554541026,0,1,0,0,-1.170500554541026,-1.1314838693896585
7666,32,227,23,85,80,0,5207.404,54,1711.697,MORE,-1242,2954,1712,3,1,-5.0,-0.4687042303372438,5.0,-0.6984302957695783,-1.280250458759545,1.353382948028374,165,85,80,1,0.09972513740911768,0.19508342575683765,0.0,0.4526351099980994,-1.1394432453920404,1.1394432453920404,0.0,0.19508342575683765,0,1,0,1,0.19508342575683765,0.0
7667,32,228,11,50,49,1,4020.919,84,786.7669999999998,MORE,506,1814,2320,3,2,-1.0,-0.09374084606744876,1.0,-1.3968605915391563,0.7828210056694449,0.4372085679979691,99,50,49,1,-1.2166466763912356,-1.170500554541026,-1.2095172396923934,0.4526351099980994,1.0196318689117934,1.0196318689117934,-1.2095172396923934,-1.170500554541026,1,1,1,0,-1.170500554541026,-1.2095172396923934
7668,32,229,17,50,43,0,3630.439,74,1567.495,MORE,-1380,2374,994,2,2,-7.0,-0.6561859224721414,7.0,-0.34921514788478913,0.09513051752644833,0.1356895669871915,93,50,43,1,-1.3363168412821769,-1.170500554541026,-1.4436173506005987,-0.4602424227711771,-1.3098965438897117,1.3098965438897117,-1.4436173506005987,-1.170500554541026,0,0,0,0,-1.170500554541026,-1.4436173506005987
7669,32,230,21,80,82,1,6681.408,64,1519.026,MORE,-126,3056,2930,3,2,2.0,0.18748169213489754,2.0,-1.222253017596762,-0.5925599706165483,2.4915723906781646,162,80,82,0,0.03989005496364707,0.0,0.07803337030273506,0.4526351099980994,0.23900516854564752,0.23900516854564752,0.07803337030273506,0.0,0,1,0,1,0.07803337030273506,0.0
7670,32,231,10,50,60,1,1670.856,64,2525.067,MORE,-20,1236,1216,1,2,10.0,0.9374084606744876,10.0,0.17460757394239454,-0.5925599706165483,-1.3774519730601924,110,50,60,0,-0.9972513740911768,-1.170500554541026,-0.7803337030273506,-1.3731199555404536,0.369933064493134,0.369933064493134,-0.7803337030273506,-1.170500554541026,0,0,1,0,-1.170500554541026,-0.7803337030273506
7671,32,232,3,53,50,0,4236.72,74,1450.134,MORE,-534,2466,1932,2,2,-3.0,-0.28122253820234633,3.0,-1.0476454436543674,0.09513051752644833,0.6038447643130862,103,53,50,1,-1.1368665664639415,-1.0534504990869233,-1.170500554541026,-0.4602424227711771,-0.2649437139692062,0.2649437139692062,-1.170500554541026,-1.0534504990869233,0,0,0,0,-1.0534504990869233,-1.170500554541026
7672,32,233,45,122,110,1,4435.93,54,1326.39,MORE,-490,2288,1798,3,2,-12.0,-1.124890152809385,12.0,0.5238227218271837,-1.280250458759545,0.7576698006564507,232,122,110,1,1.4360419786912946,1.6387007763574364,1.170500554541026,0.4526351099980994,-0.21059628546270234,0.21059628546270234,1.170500554541026,1.6387007763574364,0,1,0,2,1.6387007763574364,1.170500554541026
7673,32,234,38,67,80,1,2732.065,84,1557.41,MORE,548,1338,1886,1,2,13.0,1.218630998876834,13.0,0.6984302957695783,0.7828210056694449,-0.55801262266159,147,67,80,0,-0.25928535726370594,-0.5072169069677779,0.0,-1.3731199555404536,1.0715089597589107,1.0715089597589107,0.0,-0.5072169069677779,1,0,1,1,-0.5072169069677779,0.0
7674,32,235,38,80,67,0,4494.399,54,1635.714,MORE,-534,2470,1936,2,1,-13.0,-1.218630998876834,13.0,0.6984302957695783,-1.280250458759545,0.8028181167548404,147,80,67,1,-0.25928535726370594,0.0,-0.5072169069677779,-0.4602424227711771,-0.2649437139692062,0.2649437139692062,-0.5072169069677779,0.0,0,0,0,1,0.0,-0.5072169069677779
7675,32,236,36,70,80,1,3767.521,74,1623.433,MORE,-192,1554,1362,2,2,10.0,0.9374084606744876,10.0,0.17460757394239454,0.09513051752644833,0.24154089790442035,150,70,80,0,-0.19945027481823535,-0.3901668515136753,0.0,-0.4602424227711771,0.15748402578589177,0.15748402578589177,0.0,-0.3901668515136753,0,0,0,1,-0.3901668515136753,0.0
7676,32,237,45,110,122,1,4557.91,74,2627.101,MORE,22,2236,2258,4,1,12.0,1.124890152809385,12.0,0.5238227218271837,0.09513051752644833,0.8518597405849863,232,110,122,0,1.4360419786912946,1.170500554541026,1.6387007763574364,1.365512642767376,0.4218101553402513,0.4218101553402513,1.6387007763574364,1.170500554541026,0,1,1,2,1.6387007763574364,1.170500554541026
7677,32,238,42,110,115,0,5155.694,44,2408.588,MORE,910,1810,2720,3,2,5.0,0.4687042303372438,5.0,-0.6984302957695783,-1.9679409469025413,1.3134537646072841,225,110,115,0,1.2964267863185297,1.170500554541026,1.3655839802978638,0.4526351099980994,1.518640076107874,1.518640076107874,1.3655839802978638,1.170500554541026,0,1,1,2,1.3655839802978638,1.170500554541026
7678,32,239,41,110,112,0,4482.946,64,870.664,MORE,-892,2282,1390,2,1,2.0,0.18748169213489754,2.0,-1.222253017596762,-0.5925599706165483,0.7939743933411532,222,110,112,0,1.2365917038730592,1.170500554541026,1.248533924843761,-0.4602424227711771,-0.7071341549993965,0.7071341549993965,1.248533924843761,1.170500554541026,0,0,0,2,1.248533924843761,1.170500554541026
7679,32,240,53,110,103,0,4269.819,74,1068.912,MORE,804,1580,2384,2,2,-7.0,-0.6561859224721414,7.0,-0.34921514788478913,0.09513051752644833,0.6294029937088447,213,110,103,1,1.0570864565366473,1.170500554541026,0.8973837584814532,-0.4602424227711771,1.3877121801603876,1.3877121801603876,0.8973837584814532,1.170500554541026,0,1,1,2,1.170500554541026,0.8973837584814532
7680,33,1,49,110,131,0,4969.825,10,3628.837,MORE,-576,2804,2228,3,1,21.0,1.9685577674164243,21.0,2.0952908873087353,-1.531130216383406,0.4722047096997072,241,110,131,0,1.6155472260277064,1.170500554541026,1.9898509427197442,-0.6275334935546156,-0.7526438067521646,0.7526438067521646,1.9898509427197442,1.170500554541026,0,0,0,2,1.9898509427197442,1.170500554541026
7681,33,2,13,47,50,0,4530.13,90,1300.112,MORE,182,2222,2404,5,2,3.0,0.28122253820234633,3.0,-1.0476454436543674,1.4534078703740962,0.25673852688756416,97,47,50,0,-1.2565367313548828,-1.2875506099951286,-1.170500554541026,0.6069586249134807,0.2587237408121629,0.2587237408121629,-1.170500554541026,-1.2875506099951286,1,1,1,0,-1.2875506099951286,-1.170500554541026
7682,33,3,16,50,44,0,4601.218,80,1288.594,MORE,-218,2188,1970,6,1,-6.0,-0.5624450764046927,6.0,-0.5238227218271837,1.0803406095294084,0.2915741743335201,94,50,44,1,-1.3163718138003533,-1.170500554541026,-1.4046006654492311,1.224204684147529,-0.274979450514659,0.274979450514659,-1.4046006654492311,-1.170500554541026,1,1,0,0,-1.170500554541026,-1.4046006654492311
7683,33,4,7,57,50,0,8198.148000000001,70,2341.387,MORE,734,2996,3730,7,2,-7.0,-0.6561859224721414,7.0,-0.34921514788478913,0.7072733486847207,2.054197758732893,107,57,50,1,-1.0570864565366473,-0.8973837584814532,-1.170500554541026,1.8414507433815772,0.995234144843177,0.995234144843177,-1.170500554541026,-0.8973837584814532,1,1,1,0,-0.8973837584814532,-1.170500554541026
7684,33,5,18,42,50,0,5220.9940000000015,20,1495.0770000000002,MORE,736,2062,2798,7,2,8.0,0.7499267685395902,8.0,-0.17460757394239454,-1.1580629555387183,0.5952864497029903,92,42,50,0,-1.3562618687640005,-1.4826340357519663,-1.170500554541026,1.8414507433815772,0.997902660799811,0.997902660799811,-1.170500554541026,-1.4826340357519663,0,1,1,0,-1.4826340357519663,-1.170500554541026
7685,33,6,51,108,110,1,6595.5030000000015,30,1115.652,MORE,1286,2548,3834,4,1,2.0,0.18748169213489754,2.0,-1.222253017596762,-0.7849956946940304,1.2688447286712206,218,108,110,0,1.156811593945765,1.092467184238291,1.170500554541026,-0.010287434320567434,1.7317445488741912,1.7317445488741912,1.170500554541026,1.092467184238291,0,1,1,2,1.170500554541026,1.092467184238291
7686,33,7,31,78,80,1,3854.562,50,1356.3239999999996,MORE,686,1514,2200,5,2,2.0,0.18748169213489754,2.0,-1.222253017596762,-0.038861173004654886,-0.07431381209749129,158,78,80,0,-0.03989005496364707,-0.07803337030273506,0.0,0.6069586249134807,0.9311897618839584,0.9311897618839584,0.0,-0.07803337030273506,0,1,1,1,-0.07803337030273506,0.0
7687,33,8,58,110,92,0,2077.783,80,806.313,MORE,-78,1184,1106,2,2,-18.0,-1.6873352292140782,18.0,1.571468165481551,1.0803406095294084,-0.9449986932782573,202,110,92,1,0.8376911542365885,1.170500554541026,0.4682002218164104,-1.2447795527886638,-0.08818333355027133,0.08818333355027133,0.4682002218164104,1.170500554541026,1,0,0,2,1.170500554541026,0.4682002218164104
7688,33,9,12,50,48,0,3941.463,10,962.82,MORE,-1286,2776,1490,4,1,-2.0,-0.18748169213489754,2.0,-1.222253017596762,-1.531130216383406,-0.03172923243986926,98,50,48,1,-1.2365917038730592,-1.170500554541026,-1.248533924843761,-0.010287434320567434,-1.6999669713572734,1.6999669713572734,-1.248533924843761,-1.170500554541026,0,1,0,0,-1.170500554541026,-1.248533924843761
7689,33,10,54,110,101,0,4884.396,100,1601.307,MORE,456,2486,2942,5,1,-9.0,-0.8436676146070391,9.0,0.0,1.8264751312187841,0.4303414623772255,211,110,101,1,1.0171964015730004,1.170500554541026,0.8193503881787182,0.6069586249134807,0.6243104268710359,0.6243104268710359,0.8193503881787182,1.170500554541026,1,1,1,2,1.170500554541026,0.8193503881787182
7690,33,11,14,46,50,1,3222.219,80,992.597,MORE,628,1340,1968,5,2,4.0,0.3749633842697951,4.0,-0.8730378697119728,1.0803406095294084,-0.38418436427110936,96,46,50,0,-1.2764817588367063,-1.3265672951464962,-1.170500554541026,0.6069586249134807,0.8538027991415692,0.8538027991415692,-1.170500554541026,-1.3265672951464962,1,1,1,0,-1.3265672951464962,-1.170500554541026
7691,33,12,22,80,83,0,2489.951,60,1426.35,MORE,-572,1520,948,4,1,3.0,0.28122253820234633,3.0,-1.0476454436543674,0.3342060878400329,-0.7430217191545682,163,80,83,0,0.05983508244547061,0.0,0.1170500554541026,-0.010287434320567434,-0.7473067748388964,0.7473067748388964,0.1170500554541026,0.0,0,0,0,1,0.1170500554541026,0.0
7692,33,13,6,50,56,1,7643.177,10,1372.289,MORE,1086,3234,4320,9,1,6.0,0.5624450764046927,6.0,-0.5238227218271837,-1.531130216383406,1.7822422374250817,106,50,56,0,-1.077031484018471,-1.170500554541026,-0.9364004436328208,3.0759428618496734,1.4648929532107802,1.4648929532107802,-0.9364004436328208,-1.170500554541026,0,1,1,0,-1.170500554541026,-0.9364004436328208
7693,33,14,13,50,47,0,1917.466,30,1958.489,MORE,-1014,1548,534,2,1,-3.0,-0.28122253820234633,3.0,-1.0476454436543674,-0.7849956946940304,-1.0235597231509972,97,50,47,1,-1.2565367313548828,-1.170500554541026,-1.2875506099951286,-1.2447795527886638,-1.3370488012550346,1.3370488012550346,-1.2875506099951286,-1.170500554541026,0,0,0,0,-1.170500554541026,-1.2875506099951286
7694,33,15,46,110,124,1,1941.468,90,933.277,MORE,908,1004,1912,3,2,14.0,1.3123718449442827,14.0,0.8730378697119728,1.4534078703740962,-1.01179788978956,234,110,124,0,1.4759320336549415,1.170500554541026,1.7167341466601715,-0.6275334935546156,1.2273950330703445,1.2273950330703445,1.7167341466601715,1.170500554541026,1,0,1,2,1.7167341466601715,1.170500554541026
7695,33,16,27,91,80,0,2712.297,60,1341.516,MORE,-406,1596,1190,4,2,-11.0,-1.0311493067419364,11.0,0.34921514788478913,0.3342060878400329,-0.6340642739174179,171,91,80,1,0.21939530230005888,0.4291835366650429,0.0,-0.010287434320567434,-0.5258199504382652,0.5258199504382652,0.0,0.4291835366650429,0,0,0,1,0.4291835366650429,0.0
7696,33,17,40,64,80,1,2710.743,50,1498.559,MORE,366,1016,1382,3,2,16.0,1.4998535370791803,16.0,1.222253017596762,-0.038861173004654886,-0.6348257891679668,144,64,80,0,-0.3191204397091766,-0.6242669624218805,0.0,-0.6275334935546156,0.5042272088225009,0.5042272088225009,0.0,-0.6242669624218805,0,0,1,1,-0.6242669624218805,0.0
7697,33,18,22,83,80,1,7260.29,0,1508.396,MORE,-1958,4872,2914,7,1,-3.0,-0.28122253820234633,3.0,-1.0476454436543674,-1.9041974772280936,1.5946139943511484,163,83,80,1,0.05983508244547061,0.1170500554541026,0.0,1.8414507433815772,-2.596588332786334,2.596588332786334,0.0,0.1170500554541026,0,1,0,1,0.1170500554541026,0.0
7698,33,19,54,101,110,1,6293.3690000000015,10,1151.97,MORE,-196,3256,3060,5,1,9.0,0.8436676146070391,9.0,0.0,-1.531130216383406,1.1207883266703702,211,101,110,0,1.0171964015730004,0.8193503881787182,1.170500554541026,0.6069586249134807,-0.24562577499168378,0.24562577499168378,1.170500554541026,0.8193503881787182,0,1,0,2,1.170500554541026,0.8193503881787182
7699,33,20,6,56,50,1,2697.521,60,1081.697,MORE,44,1234,1278,3,2,-6.0,-0.5624450764046927,6.0,-0.5238227218271837,0.3342060878400329,-0.6413050392598307,106,56,50,1,-1.077031484018471,-0.9364004436328208,-1.170500554541026,-0.6275334935546156,0.07459613980440932,0.07459613980440932,-1.170500554541026,-0.9364004436328208,1,0,1,0,-0.9364004436328208,-1.170500554541026
7700,33,21,18,50,42,0,3416.717,40,1540.965,MORE,-842,2204,1362,4,1,-8.0,-0.7499267685395902,8.0,-0.17460757394239454,-0.4119284338493427,-0.28887342913517144,92,50,42,1,-1.3562618687640005,-1.170500554541026,-1.4826340357519663,-0.010287434320567434,-1.107556428984501,1.107556428984501,-1.4826340357519663,-1.170500554541026,0,1,0,0,-1.170500554541026,-1.4826340357519663
7701,33,22,43,110,117,0,10374.132,10,2008.325,MORE,-136,5104,4968,7,1,7.0,0.6561859224721414,7.0,-0.34921514788478913,-1.531130216383406,3.1205072831539082,227,110,117,0,1.3363168412821769,1.170500554541026,1.4436173506005987,1.8414507433815772,-0.1655702962926605,0.1655702962926605,1.4436173506005987,1.170500554541026,0,1,0,2,1.4436173506005987,1.170500554541026
7702,33,23,32,77,80,0,5886.0340000000015,70,1073.746,MORE,-634,2854,2220,6,2,3.0,0.28122253820234633,3.0,-1.0476454436543674,0.7072733486847207,0.921179694378021,157,77,80,0,-0.05983508244547061,-0.1170500554541026,0.0,1.224204684147529,-0.8300307694945538,0.8300307694945538,0.0,-0.1170500554541026,1,1,0,1,-0.1170500554541026,0.0
7703,33,24,27,80,91,1,2947.345,60,1290.567,MORE,460,1224,1684,3,2,11.0,1.0311493067419364,11.0,0.34921514788478913,0.3342060878400329,-0.5188823970763611,171,80,91,0,0.21939530230005888,0.0,0.4291835366650429,-0.6275334935546156,0.6296474587843041,0.6296474587843041,0.4291835366650429,0.0,1,0,1,1,0.4291835366650429,0.0
7704,33,25,16,44,50,0,5863.949000000001,30,962.466,MORE,-634,2962,2328,6,1,6.0,0.5624450764046927,6.0,-0.5238227218271837,-0.7849956946940304,0.910357259173149,94,44,50,0,-1.3163718138003533,-1.4046006654492311,-1.170500554541026,1.224204684147529,-0.8300307694945538,0.8300307694945538,-1.170500554541026,-1.4046006654492311,0,1,0,0,-1.4046006654492311,-1.170500554541026
7705,33,26,7,50,57,1,3906.319,70,1003.352,MORE,656,1602,2258,5,2,7.0,0.6561859224721414,7.0,-0.34921514788478913,0.7072733486847207,-0.04895104194134189,107,50,57,0,-1.0570864565366473,-1.170500554541026,-0.8973837584814532,0.6069586249134807,0.8911620225344468,0.8911620225344468,-0.8973837584814532,-1.170500554541026,1,1,1,0,-1.170500554541026,-0.8973837584814532
7706,33,27,14,50,46,0,5133.982,20,1745.75,MORE,-1432,3182,1750,4,1,-4.0,-0.3749633842697951,4.0,-0.8730378697119728,-1.1580629555387183,0.5526474760988999,96,50,46,1,-1.2764817588367063,-1.170500554541026,-1.3265672951464962,-0.010287434320567434,-1.8947686361915634,1.8947686361915634,-1.3265672951464962,-1.170500554541026,0,1,0,0,-1.170500554541026,-1.3265672951464962
7707,33,28,51,110,108,0,6102.943,50,1252.723,MORE,166,2872,3038,6,2,-2.0,-0.18748169213489754,2.0,-1.222253017596762,-0.038861173004654886,1.0274728163093572,218,110,108,1,1.156811593945765,1.170500554541026,1.092467184238291,1.224204684147529,0.23737561315909,0.23737561315909,1.092467184238291,1.170500554541026,0,1,1,2,1.170500554541026,1.092467184238291
7708,33,29,50,133,110,0,1920.556,100,1464.344,MORE,656,1276,1932,2,2,-23.0,-2.1560394595513217,23.0,2.444506035193524,1.8264751312187841,-1.0220455132898671,243,133,110,1,1.6554372809913533,2.0678843130224793,1.170500554541026,-1.2447795527886638,0.8911620225344468,0.8911620225344468,1.170500554541026,2.0678843130224793,1,0,1,2,2.0678843130224793,1.170500554541026
7709,33,30,49,131,110,0,6324.3409999999985,10,1440.7220000000002,MORE,-1692,4132,2440,6,1,-21.0,-1.9685577674164243,21.0,2.0952908873087353,-1.531130216383406,1.1359657078415386,241,131,110,1,1.6155472260277064,1.9898509427197442,1.170500554541026,1.224204684147529,-2.2416757105539977,2.2416757105539977,1.170500554541026,1.9898509427197442,0,1,0,2,1.9898509427197442,1.170500554541026
7710,33,31,47,126,110,0,2556.406,90,967.885,MORE,-426,1584,1158,2,2,-16.0,-1.4998535370791803,16.0,1.222253017596762,1.4534078703740962,-0.7104564064291996,236,126,110,1,1.5158220886185887,1.7947675169629065,1.170500554541026,-1.2447795527886638,-0.5525051100046063,0.5525051100046063,1.170500554541026,1.7947675169629065,1,0,0,2,1.7947675169629065,1.170500554541026
7711,33,32,50,110,133,1,2875.659,80,1466.37,MORE,-26,1460,1434,2,2,23.0,2.1560394595513217,23.0,2.444506035193524,1.0803406095294084,-0.5540110857834675,243,110,133,0,1.6554372809913533,1.170500554541026,2.0678843130224793,-1.2447795527886638,-0.018801918677784496,0.018801918677784496,2.0678843130224793,1.170500554541026,1,0,0,2,2.0678843130224793,1.170500554541026
7712,33,33,47,110,126,1,6366.476,40,1997.687,MORE,112,2950,3062,3,2,16.0,1.4998535370791803,16.0,1.222253017596762,-0.4119284338493427,1.156613355899374,236,110,126,0,1.5158220886185887,1.170500554541026,1.7947675169629065,-0.6275334935546156,0.16532568232996905,0.16532568232996905,1.7947675169629065,1.170500554541026,0,0,1,2,1.7947675169629065,1.170500554541026
7713,33,34,12,48,50,0,2097.473,70,676.666,MORE,-334,1106,772,2,1,2.0,0.18748169213489754,2.0,-1.222253017596762,0.7072733486847207,-0.9353498932246492,98,48,50,0,-1.2365917038730592,-1.248533924843761,-1.170500554541026,-1.2447795527886638,-0.4297533759994373,0.4297533759994373,-1.170500554541026,-1.248533924843761,1,0,0,0,-1.248533924843761,-1.170500554541026
7714,33,35,32,80,77,0,5123.344,30,1051.652,MORE,-760,2800,2040,4,1,-3.0,-0.28122253820234633,3.0,-1.0476454436543674,-0.7849956946940304,0.5474344778779613,157,80,77,1,-0.05983508244547061,0.0,-0.1170500554541026,-0.010287434320567434,-0.9981472747625026,0.9981472747625026,-0.1170500554541026,0.0,0,1,0,1,0.0,-0.1170500554541026
7715,33,36,43,117,110,0,3561.31,40,948.994,MORE,-142,1610,1468,4,1,-7.0,-0.6561859224721414,7.0,-0.34921514788478913,-0.4119284338493427,-0.21801771830981254,227,117,110,1,1.3363168412821769,1.4436173506005987,1.170500554541026,-0.010287434320567434,-0.17357584416256283,0.17357584416256283,1.170500554541026,1.4436173506005987,0,1,0,2,1.4436173506005987,1.170500554541026
7716,33,37,40,80,64,0,4914.125,30,1479.649,MORE,-1312,3126,1814,4,1,-16.0,-1.4998535370791803,16.0,1.222253017596762,-0.7849956946940304,0.4449097293550675,144,80,64,1,-0.3191204397091766,0.0,-0.6242669624218805,-0.010287434320567434,-1.7346576787935168,1.7346576787935168,-0.6242669624218805,0.0,0,0,0,1,0.0,-0.6242669624218805
7717,33,38,31,80,78,0,2074.403,20,989.223,MORE,-782,1438,656,2,1,-2.0,-0.18748169213489754,2.0,-1.222253017596762,-1.1580629555387183,-0.9466550134499788,158,80,78,1,-0.03989005496364707,0.0,-0.07803337030273506,-1.2447795527886638,-1.0275009502854777,1.0275009502854777,-0.07803337030273506,0.0,0,0,0,1,0.0,-0.07803337030273506
7718,33,39,46,124,110,0,2981.091,60,880.4830000000002,MORE,-710,1740,1030,3,1,-14.0,-1.3123718449442827,14.0,0.8730378697119728,0.3342060878400329,-0.50234565727905,234,124,110,1,1.4759320336549415,1.7167341466601715,1.170500554541026,-0.6275334935546156,-0.9314343758466499,0.9314343758466499,1.170500554541026,1.7167341466601715,1,0,0,2,1.7167341466601715,1.170500554541026
7719,33,40,58,92,110,1,3238.827,90,984.635,MORE,1034,1432,2466,3,2,18.0,1.6873352292140782,18.0,1.571468165481551,1.4534078703740962,-0.3760458537942013,202,92,110,0,0.8376911542365885,0.4682002218164104,1.170500554541026,-0.6275334935546156,1.3955115383382934,1.3955115383382934,1.170500554541026,0.4682002218164104,1,0,1,2,1.170500554541026,0.4682002218164104
7720,33,41,49,110,131,0,2713.69,100,973.269,LESS,-328,1668,1340,2,2,21.0,1.9685577674164243,21.0,2.0952908873087353,1.8264751312187841,-0.6333816543910251,241,110,131,1,1.6155472260277064,1.170500554541026,1.9898509427197442,-1.2447795527886638,-0.42174782812953493,0.42174782812953493,1.9898509427197442,1.170500554541026,1,0,0,2,1.9898509427197442,1.170500554541026
7721,33,42,13,47,50,0,1857.956,70,1775.48,LESS,-862,1474,612,2,1,3.0,0.28122253820234633,3.0,-1.0476454436543674,0.7072733486847207,-1.0527217389554766,97,47,50,1,-1.2565367313548828,-1.2875506099951286,-1.170500554541026,-1.2447795527886638,-1.1342415885508421,1.1342415885508421,-1.170500554541026,-1.2875506099951286,1,0,0,0,-1.2875506099951286,-1.170500554541026
7722,33,43,16,50,44,1,2420.8,40,1062.992,LESS,402,924,1326,3,2,-6.0,-0.5624450764046927,6.0,-0.5238227218271837,-0.4119284338493427,-0.7769081677328838,94,50,44,0,-1.3163718138003533,-1.170500554541026,-1.4046006654492311,-0.6275334935546156,0.552260496041915,0.552260496041915,-1.4046006654492311,-1.170500554541026,0,0,1,0,-1.170500554541026,-1.4046006654492311
7723,33,44,7,57,50,1,7465.545,0,2075.836,LESS,-1632,4974,3342,7,1,-7.0,-0.6561859224721414,7.0,-0.34921514788478913,-1.9041974772280936,1.6951962419389228,107,57,50,0,-1.0570864565366473,-0.8973837584814532,-1.170500554541026,1.8414507433815772,-2.1616202318549744,2.1616202318549744,-1.170500554541026,-0.8973837584814532,0,1,0,0,-0.8973837584814532,-1.170500554541026
7724,33,45,18,42,50,1,3167.684,40,1296.201,LESS,580,1172,1752,3,2,8.0,0.7499267685395902,8.0,-0.17460757394239454,-0.4119284338493427,-0.4109084531956143,92,42,50,1,-1.3562618687640005,-1.4826340357519663,-1.170500554541026,-0.6275334935546156,0.7897584161823505,0.7897584161823505,-1.170500554541026,-1.4826340357519663,0,0,1,0,-1.4826340357519663,-1.170500554541026
7725,33,46,51,108,110,1,6983.798000000002,30,1620.912,LESS,590,3030,3620,6,2,2.0,0.18748169213489754,2.0,-1.222253017596762,-0.7849956946940304,1.4591230840199083,218,108,110,1,1.156811593945765,1.092467184238291,1.170500554541026,1.224204684147529,0.8031009959655211,0.8031009959655211,1.170500554541026,1.092467184238291,0,1,1,2,1.170500554541026,1.092467184238291
7726,33,47,31,78,80,0,3161.079,60,2484.946,LESS,-496,1722,1226,4,1,2.0,0.18748169213489754,2.0,-1.222253017596762,0.3342060878400329,-0.4141451380282237,158,78,80,1,-0.03989005496364707,-0.07803337030273506,0.0,-0.010287434320567434,-0.6459031684868002,0.6459031684868002,0.0,-0.07803337030273506,1,1,0,1,-0.07803337030273506,0.0
7727,33,48,58,110,92,1,2150.882,80,1377.3429999999996,LESS,710,864,1574,3,2,-18.0,-1.6873352292140782,18.0,1.571468165481551,1.0803406095294084,-0.9091775843336822,202,110,92,0,0.8376911542365885,1.170500554541026,0.4682002218164104,-0.6275334935546156,0.9632119533635677,0.9632119533635677,0.4682002218164104,1.170500554541026,1,0,1,2,1.170500554541026,0.4682002218164104
7728,33,49,12,50,48,0,1691.261,90,1736.635,LESS,950,984,1934,2,2,-2.0,-0.18748169213489754,2.0,-1.222253017596762,1.4534078703740962,-1.1344082155901216,98,50,48,0,-1.2365917038730592,-1.170500554541026,-1.248533924843761,-1.2447795527886638,1.2834338681596609,1.2834338681596609,-1.248533924843761,-1.170500554541026,1,0,1,0,-1.170500554541026,-1.248533924843761
7729,33,50,54,110,101,1,6771.723000000001,0,1335.783,LESS,-156,3780,3624,8,1,-9.0,-0.8436676146070391,9.0,0.0,-1.9041974772280936,1.3551987939554648,211,110,101,0,1.0171964015730004,1.170500554541026,0.8193503881787182,2.4586968026156253,-0.1922554558590016,0.1922554558590016,0.8193503881787182,1.170500554541026,0,1,0,2,1.170500554541026,0.8193503881787182
7730,33,51,14,46,50,0,2614.847,50,2014.504,LESS,-720,1592,872,4,1,4.0,0.3749633842697951,4.0,-0.8730378697119728,-0.038861173004654886,-0.6818182386316933,96,46,50,1,-1.2764817588367063,-1.3265672951464962,-1.170500554541026,-0.010287434320567434,-0.9447769556298204,0.9447769556298204,-1.170500554541026,-1.3265672951464962,1,1,0,0,-1.3265672951464962,-1.170500554541026
7731,33,52,22,80,83,1,3907.799,30,869.263,LESS,910,1406,2316,5,2,3.0,0.28122253820234633,3.0,-1.0476454436543674,-0.7849956946940304,-0.048225789321771566,163,80,83,1,0.05983508244547061,0.0,0.1170500554541026,0.6069586249134807,1.2300635490269787,1.2300635490269787,0.1170500554541026,0.0,0,1,1,1,0.1170500554541026,0.0
7732,33,53,6,50,56,0,3284.743,0,1986.815,LESS,-1342,2702,1360,4,1,6.0,0.5624450764046927,6.0,-0.5238227218271837,-1.9041974772280936,-0.35354538130758595,106,50,56,1,-1.077031484018471,-1.170500554541026,-0.9364004436328208,-0.010287434320567434,-1.7746854181430285,1.7746854181430285,-0.9364004436328208,-1.170500554541026,0,1,0,0,-1.170500554541026,-0.9364004436328208
7733,33,54,13,50,47,1,5225.165,30,2804.127,LESS,1084,2144,3228,5,2,-3.0,-0.28122253820234633,3.0,-1.0476454436543674,-0.7849956946940304,0.5973303879977379,97,50,47,0,-1.2565367313548828,-1.170500554541026,-1.2875506099951286,0.6069586249134807,1.4622244372541462,1.4622244372541462,-1.2875506099951286,-1.170500554541026,0,1,1,0,-1.170500554541026,-1.2875506099951286
7734,33,55,46,110,124,0,3174.476,70,1093.915,LESS,230,1798,2028,4,2,14.0,1.3123718449442827,14.0,0.8730378697119728,0.7072733486847207,-0.4075801317144511,234,110,124,1,1.4759320336549415,1.170500554541026,1.7167341466601715,-0.010287434320567434,0.3227681237713815,0.3227681237713815,1.7167341466601715,1.170500554541026,1,1,1,2,1.7167341466601715,1.170500554541026
7735,33,56,27,91,80,1,4310.989000000001,50,1894.479,LESS,254,1938,2192,5,2,-11.0,-1.0311493067419364,11.0,0.34921514788478913,-0.038861173004654886,0.14935164560022732,171,91,80,0,0.21939530230005888,0.4291835366650429,0.0,0.6069586249134807,0.35479031525099086,0.35479031525099086,0.0,0.4291835366650429,1,1,1,1,0.4291835366650429,0.0
7736,33,57,40,64,80,0,3744.422,70,1299.335,LESS,-226,1876,1650,4,1,16.0,1.4998535370791803,16.0,1.222253017596762,0.7072733486847207,-0.12828632798902842,144,64,80,1,-0.3191204397091766,-0.6242669624218805,0.0,-0.010287434320567434,-0.2856535143411954,0.2856535143411954,0.0,-0.6242669624218805,1,1,0,1,-0.6242669624218805,0.0
7737,33,58,22,83,80,1,3383.4770000000008,60,982.277,LESS,640,1452,2092,3,2,-3.0,-0.28122253820234633,3.0,-1.0476454436543674,0.3342060878400329,-0.3051622109422775,163,83,80,0,0.05983508244547061,0.1170500554541026,0.0,-0.6275334935546156,0.8698138948813738,0.8698138948813738,0.0,0.1170500554541026,1,0,1,1,0.1170500554541026,0.0
7738,33,59,54,101,110,1,6491.788000000001,10,1297.814,LESS,1084,3014,4098,5,1,9.0,0.8436676146070391,9.0,0.0,-1.531130216383406,1.2180206912126152,211,101,110,1,1.0171964015730004,0.8193503881787182,1.170500554541026,0.6069586249134807,1.4622244372541462,1.4622244372541462,1.170500554541026,0.8193503881787182,0,1,1,2,1.170500554541026,0.8193503881787182
7739,33,60,6,56,50,1,2968.831,50,1573.64,LESS,274,1272,1546,3,2,-6.0,-0.5624450764046927,6.0,-0.5238227218271837,-0.038861173004654886,-0.5083534931681932,106,56,50,0,-1.077031484018471,-0.9364004436328208,-1.170500554541026,-0.6275334935546156,0.3814754748173319,0.3814754748173319,-1.170500554541026,-0.9364004436328208,1,0,1,0,-0.9364004436328208,-1.170500554541026
7740,33,61,18,50,42,0,2635.3459999999995,70,1742.201,LESS,-658,1610,952,4,1,-8.0,-0.7499267685395902,8.0,-0.17460757394239454,0.7072733486847207,-0.6717729998150911,92,50,42,0,-1.3562618687640005,-1.170500554541026,-1.4826340357519663,-0.010287434320567434,-0.8620529609741631,0.8620529609741631,-1.4826340357519663,-1.170500554541026,1,1,0,0,-1.170500554541026,-1.4826340357519663
7741,33,62,43,110,117,0,3411.244,30,1298.9,LESS,-426,1858,1432,4,1,7.0,0.6561859224721414,7.0,-0.34921514788478913,-0.7849956946940304,-0.2915553937209203,227,110,117,1,1.3363168412821769,1.170500554541026,1.4436173506005987,-0.010287434320567434,-0.5525051100046063,0.5525051100046063,1.4436173506005987,1.170500554541026,0,0,0,2,1.4436173506005987,1.170500554541026
7742,33,63,32,77,80,0,5853.726,10,2080.64,LESS,-1974,4644,2670,6,1,3.0,0.28122253820234633,3.0,-1.0476454436543674,-1.531130216383406,0.9053476257070217,157,77,80,1,-0.05983508244547061,-0.1170500554541026,0.0,1.224204684147529,-2.617936460439407,2.617936460439407,0.0,-0.1170500554541026,0,1,0,1,-0.1170500554541026,0.0
7743,33,64,27,80,91,0,6196.491,0,1493.795,LESS,-388,3452,3064,6,1,11.0,1.0311493067419364,11.0,0.34921514788478913,-1.9041974772280936,1.0733146622928464,171,80,91,1,0.21939530230005888,0.0,0.4291835366650429,1.224204684147529,-0.5018033068285582,0.5018033068285582,0.4291835366650429,0.0,0,1,0,1,0.4291835366650429,0.0
7744,33,65,16,44,50,0,3858.986,10,1765.3429999999996,LESS,-1670,3232,1562,4,1,6.0,0.5624450764046927,6.0,-0.5238227218271837,-1.531130216383406,-0.07214589480764055,94,44,50,1,-1.3163718138003533,-1.4046006654492311,-1.170500554541026,-0.010287434320567434,-2.2123220350310224,2.2123220350310224,-1.170500554541026,-1.4046006654492311,0,0,0,0,-1.4046006654492311,-1.170500554541026
7745,33,66,7,50,57,0,4190.61,20,1640.493,LESS,-134,2464,2330,4,1,7.0,0.6561859224721414,7.0,-0.34921514788478913,-1.1580629555387183,0.09036165567370244,107,50,57,1,-1.0570864565366473,-1.170500554541026,-0.8973837584814532,-0.010287434320567434,-0.1629017803360264,0.1629017803360264,-0.8973837584814532,-1.170500554541026,0,1,0,0,-1.170500554541026,-0.8973837584814532
7746,33,67,14,50,46,1,2659.802,20,1788.59,LESS,-236,1810,1574,3,1,-4.0,-0.3749633842697951,4.0,-0.8730378697119728,-1.1580629555387183,-0.6597886903122449,96,50,46,0,-1.2764817588367063,-1.170500554541026,-1.3265672951464962,-0.6275334935546156,-0.29899609412436595,0.29899609412436595,-1.3265672951464962,-1.170500554541026,0,0,0,0,-1.170500554541026,-1.3265672951464962
7747,33,68,51,110,108,0,2562.3920000000007,70,1206.53,LESS,-216,1372,1156,4,1,-2.0,-0.18748169213489754,2.0,-1.222253017596762,0.7072733486847207,-0.7075230536043695,218,110,108,0,1.156811593945765,1.170500554541026,1.092467184238291,-0.010287434320567434,-0.27231093455802485,0.27231093455802485,1.092467184238291,1.170500554541026,1,1,0,2,1.170500554541026,1.092467184238291
7748,33,69,50,133,110,1,2433.32,80,1584.182,LESS,346,1048,1394,3,2,-23.0,-2.1560394595513217,23.0,2.444506035193524,1.0803406095294084,-0.7707729225997619,243,133,110,0,1.6554372809913533,2.0678843130224793,1.170500554541026,-0.6275334935546156,0.47754204925615984,0.47754204925615984,1.170500554541026,2.0678843130224793,1,0,1,2,2.0678843130224793,1.170500554541026
7749,33,70,49,131,110,1,2741.156,80,2712.045,LESS,724,1062,1786,3,2,-21.0,-1.9685577674164243,21.0,2.0952908873087353,1.0803406095294084,-0.6199223378713505,241,131,110,0,1.6155472260277064,1.9898509427197442,1.170500554541026,-0.6275334935546156,0.9818915650600064,0.9818915650600064,1.170500554541026,1.9898509427197442,1,0,1,2,1.9898509427197442,1.170500554541026
7750,33,71,47,126,110,1,2847.1740000000004,50,1956.919,LESS,580,1132,1712,3,2,-16.0,-1.4998535370791803,16.0,1.222253017596762,-0.038861173004654886,-0.5679697485324272,236,126,110,0,1.5158220886185887,1.7947675169629065,1.170500554541026,-0.6275334935546156,0.7897584161823505,0.7897584161823505,1.170500554541026,1.7947675169629065,1,0,1,2,1.7947675169629065,1.170500554541026
7751,33,72,50,110,133,0,2610.871,30,1714.016,LESS,-386,1456,1070,4,1,23.0,2.1560394595513217,23.0,2.444506035193524,-0.7849956946940304,-0.6837666199934579,243,110,133,1,1.6554372809913533,1.170500554541026,2.0678843130224793,-0.010287434320567434,-0.49913479087192414,0.49913479087192414,2.0678843130224793,1.170500554541026,0,1,0,2,2.0678843130224793,1.170500554541026
7752,33,73,47,110,126,0,4865.008,10,1444.753,LESS,-1726,3674,1948,6,1,16.0,1.4998535370791803,16.0,1.222253017596762,-1.531130216383406,0.4208406530608543,236,110,126,1,1.5158220886185887,1.170500554541026,1.7947675169629065,1.224204684147529,-2.2870404818167773,2.2870404818167773,1.7947675169629065,1.170500554541026,0,1,0,2,1.7947675169629065,1.170500554541026
7753,33,74,12,48,50,1,3744.192,90,1598.106,LESS,806,1914,2720,5,2,2.0,0.18748169213489754,2.0,-1.222253017596762,1.4534078703740962,-0.1283990361663941,98,48,50,1,-1.2365917038730592,-1.248533924843761,-1.170500554541026,0.6069586249134807,1.091300719282005,1.091300719282005,-1.170500554541026,-1.248533924843761,1,1,1,0,-1.248533924843761,-1.170500554541026
7754,33,75,32,80,77,1,2733.39,70,2292.487,LESS,152,1454,1606,3,1,-3.0,-0.28122253820234633,3.0,-1.0476454436543674,0.7072733486847207,-0.6237279539818796,157,80,77,0,-0.05983508244547061,0.0,-0.1170500554541026,-0.6275334935546156,0.21869600146265122,0.21869600146265122,-0.1170500554541026,0.0,1,0,1,1,0.0,-0.1170500554541026
7755,33,76,43,117,110,0,6087.852,50,2361.071,LESS,-1272,3562,2290,4,1,-7.0,-0.6561859224721414,7.0,-0.34921514788478913,-0.038861173004654886,1.0200776897675086,227,117,110,0,1.3363168412821769,1.4436173506005987,1.170500554541026,-0.010287434320567434,-1.6812873596608346,1.6812873596608346,1.170500554541026,1.4436173506005987,1,1,0,2,1.4436173506005987,1.170500554541026
7756,33,77,40,80,64,1,3382.359000000001,60,1836.709,LESS,1256,1090,2346,2,2,-16.0,-1.4998535370791803,16.0,1.222253017596762,0.3342060878400329,-0.3057100706913853,144,80,64,0,-0.3191204397091766,0.0,-0.6242669624218805,-1.2447795527886638,1.6917168095246795,1.6917168095246795,-0.6242669624218805,0.0,1,0,1,1,0.0,-0.6242669624218805
7757,33,78,31,80,78,1,9695.418,20,1537.652,LESS,496,4494,4990,7,1,-2.0,-0.18748169213489754,2.0,-1.222253017596762,-1.1580629555387183,2.7879132923167123,158,80,78,0,-0.03989005496364707,0.0,-0.07803337030273506,1.8414507433815772,0.6776807460037181,0.6776807460037181,-0.07803337030273506,0.0,0,1,1,1,0.0,-0.07803337030273506
7758,33,79,46,124,110,1,4884.484,20,1726.2979999999998,LESS,426,2336,2762,5,1,-14.0,-1.3123718449442827,14.0,0.8730378697119728,-1.1580629555387183,0.430384585505957,234,124,110,0,1.4759320336549415,1.7167341466601715,1.170500554541026,0.6069586249134807,0.5842826875215242,0.5842826875215242,1.170500554541026,1.7167341466601715,0,1,1,2,1.7167341466601715,1.170500554541026
7759,33,80,58,92,110,0,1776.086,90,1022.648,LESS,124,1200,1324,2,2,18.0,1.6873352292140782,18.0,1.571468165481551,1.4534078703740962,-1.092840949742113,202,92,110,1,0.8376911542365885,0.4682002218164104,1.170500554541026,-1.2447795527886638,0.1813367780697737,0.1813367780697737,1.170500554541026,0.4682002218164104,1,0,0,2,1.170500554541026,0.4682002218164104
7760,33,81,48,128,110,0,1880.618,50,1388.506,MORE,-518,1130,612,2,1,-18.0,-1.6873352292140782,18.0,1.571468165481551,-0.038861173004654886,-1.041616553236083,238,128,110,1,1.5557121435822359,1.8728008872656416,1.170500554541026,-1.2447795527886638,-0.6752568440097754,0.6752568440097754,1.170500554541026,1.8728008872656416,0,0,0,2,1.8728008872656416,1.170500554541026
7761,33,82,8,50,58,1,3428.671,30,1687.1229999999996,MORE,954,1124,2078,4,2,8.0,0.7499267685395902,8.0,-0.17460757394239454,-0.7849956946940304,-0.2830155441254799,108,50,58,0,-1.0371414290548238,-1.170500554541026,-0.8583670733300858,-0.010287434320567434,1.288770900072929,1.288770900072929,-0.8583670733300858,-1.170500554541026,0,1,1,0,-1.170500554541026,-0.8583670733300858
7762,33,83,4,54,50,1,1851.164,40,1889.349,MORE,190,926,1116,2,2,-4.0,-0.3749633842697951,4.0,-0.8730378697119728,-0.4119284338493427,-1.0560500604366398,104,54,50,1,-1.116921538982118,-1.0144338139355558,-1.170500554541026,-1.2447795527886638,0.2693978046386993,0.2693978046386993,-1.170500554541026,-1.0144338139355558,0,0,1,0,-1.0144338139355558,-1.170500554541026
7763,33,84,37,80,69,0,4353.013,60,870.8739999999998,MORE,98,2098,2196,4,1,-11.0,-1.0311493067419364,11.0,0.34921514788478913,0.3342060878400329,0.16994489971159354,149,80,69,1,-0.21939530230005888,0.0,-0.4291835366650429,-0.010287434320567434,0.14664607063353027,0.14664607063353027,-0.4291835366650429,0.0,0,1,1,1,0.0,-0.4291835366650429
7764,33,85,52,105,110,0,3279.08,70,936.877,MORE,-712,1936,1224,4,1,5.0,0.4687042303372438,5.0,-0.6984302957695783,0.7072733486847207,-0.35632045264855,215,105,110,0,1.0969765115002945,0.9754171287841883,1.170500554541026,-0.010287434320567434,-0.934102891803284,0.934102891803284,1.170500554541026,0.9754171287841883,1,1,0,2,1.170500554541026,0.9754171287841883
7765,33,86,5,55,50,0,1684.774,90,1760.6429999999998,MORE,534,1022,1556,2,2,-5.0,-0.4687042303372438,5.0,-0.6984302957695783,1.4534078703740962,-1.137587076227387,105,55,50,1,-1.0969765115002945,-0.9754171287841883,-1.170500554541026,-1.2447795527886638,0.7283825491797661,0.7283825491797661,-1.170500554541026,-0.9754171287841883,1,0,1,0,-0.9754171287841883,-1.170500554541026
7766,33,87,30,96,80,0,3889.745,90,1960.45,MORE,262,1814,2076,3,2,-16.0,-1.4998535370791803,16.0,1.222253017596762,1.4534078703740962,-0.05707289120942199,176,96,80,1,0.3191204397091766,0.6242669624218805,0.0,-0.6275334935546156,0.36546437907752727,0.36546437907752727,0.0,0.6242669624218805,1,0,1,1,0.6242669624218805,0.0
7767,33,88,33,80,75,0,4650.883,50,1196.003,MORE,58,2156,2214,4,1,-5.0,-0.4687042303372438,5.0,-0.6984302957695783,-0.038861173004654886,0.3159117901111957,155,80,75,1,-0.09972513740911768,0.0,-0.19508342575683765,-0.010287434320567434,0.09327575150084809,0.09327575150084809,-0.19508342575683765,0.0,0,1,1,1,0.0,-0.19508342575683765
7768,33,89,48,110,128,1,2252.627,70,1868.655,MORE,138,1080,1218,3,2,18.0,1.6873352292140782,18.0,1.571468165481551,0.7072733486847207,-0.8593189169159916,238,110,128,0,1.5557121435822359,1.170500554541026,1.8728008872656416,-0.6275334935546156,0.20001638976621247,0.20001638976621247,1.8728008872656416,1.170500554541026,1,0,1,2,1.8728008872656416,1.170500554541026
7769,33,90,9,59,50,0,5194.09,20,921.33,MORE,-732,2914,2182,6,1,-9.0,-0.8436676146070391,9.0,0.0,-1.1580629555387183,0.5821025331645302,109,59,50,1,-1.0171964015730004,-0.8193503881787182,-1.170500554541026,1.224204684147529,-0.9607880513696251,0.9607880513696251,-1.170500554541026,-0.8193503881787182,0,1,0,0,-0.8193503881787182,-1.170500554541026
7770,33,91,44,110,119,1,2303.383,70,1510.37,MORE,362,914,1276,3,2,9.0,0.8436676146070391,9.0,0.0,0.7072733486847207,-0.8344466723491598,229,110,119,0,1.376206896245824,1.170500554541026,1.5216507209033339,-0.6275334935546156,0.4988901769092327,0.4988901769092327,1.5216507209033339,1.170500554541026,1,0,1,2,1.5216507209033339,1.170500554541026
7771,33,92,2,52,50,0,6131.493,10,2105.343,MORE,-1010,3772,2762,6,1,-2.0,-0.18748169213489754,2.0,-1.222253017596762,-1.531130216383406,1.0414633313693118,102,52,50,1,-1.156811593945765,-1.092467184238291,-1.170500554541026,1.224204684147529,-1.3317117693417664,1.3317117693417664,-1.170500554541026,-1.092467184238291,0,1,0,0,-1.092467184238291,-1.170500554541026
7772,33,93,8,58,50,0,6647.55,20,1255.787,MORE,-320,3296,2976,8,1,-8.0,-0.7499267685395902,8.0,-0.17460757394239454,-1.1580629555387183,1.2943496091379607,108,58,50,1,-1.0371414290548238,-0.8583670733300858,-1.170500554541026,2.4586968026156253,-0.4110737643029985,0.4110737643029985,-1.170500554541026,-0.8583670733300858,0,1,0,0,-0.8583670733300858,-1.170500554541026
7773,33,94,44,119,110,0,3527.815,50,1420.428,MORE,-492,1820,1328,4,1,-9.0,-0.8436676146070391,9.0,0.0,-0.038861173004654886,-0.2344314591831286,229,119,110,1,1.376206896245824,1.5216507209033339,1.170500554541026,-0.010287434320567434,-0.6405661365735319,0.6405661365735319,1.170500554541026,1.5216507209033339,0,1,0,2,1.5216507209033339,1.170500554541026
7774,33,95,34,74,80,1,4392.521,30,1269.567,MORE,284,2058,2342,5,2,6.0,0.5624450764046927,6.0,-0.5238227218271837,-0.7849956946940304,0.1893052243696909,154,74,80,0,-0.11967016489094122,-0.2341001109082052,0.0,0.6069586249134807,0.39481805460050245,0.39481805460050245,0.0,-0.2341001109082052,0,1,1,1,-0.2341001109082052,0.0
7775,33,96,24,86,80,0,5417.684,30,1045.188,MORE,-1202,3380,2178,6,1,-6.0,-0.5624450764046927,6.0,-0.5238227218271837,-0.7849956946940304,0.6916715427727776,166,86,80,1,0.11967016489094122,0.2341001109082052,0.0,1.224204684147529,-1.5878893011786408,1.5878893011786408,0.0,0.2341001109082052,0,1,0,1,0.2341001109082052,0.0
7776,33,97,39,66,80,0,3722.858,70,1169.005,MORE,-826,2208,1382,4,1,14.0,1.3123718449442827,14.0,0.8730378697119728,0.7072733486847207,-0.1388534546703894,146,66,80,0,-0.2792303847455295,-0.5462335921191455,0.0,-0.010287434320567434,-1.0862083013314283,1.0862083013314283,0.0,-0.5462335921191455,1,1,0,1,-0.5462335921191455,0.0
7777,33,98,9,50,59,1,5929.8,10,1176.414,MORE,-372,3290,2918,5,1,9.0,0.8436676146070391,9.0,0.0,-1.531130216383406,0.9426265904240438,109,50,59,0,-1.0171964015730004,-1.170500554541026,-0.8193503881787182,0.6069586249134807,-0.48045517917548536,0.48045517917548536,-0.8193503881787182,-1.170500554541026,0,1,0,0,-1.170500554541026,-0.8193503881787182
7778,33,99,57,94,110,1,1745.63,60,970.544,MORE,462,730,1192,3,2,16.0,1.4998535370791803,16.0,1.222253017596762,0.3342060878400329,-1.1077654725675412,204,94,110,0,0.8775812092002355,0.5462335921191455,1.170500554541026,-0.6275334935546156,0.6323159747409381,0.6323159747409381,1.170500554541026,0.5462335921191455,1,0,1,2,1.170500554541026,0.5462335921191455
7779,33,100,60,110,87,0,3357.066,80,1783.45,MORE,-54,1830,1776,3,1,-23.0,-2.1560394595513217,23.0,2.444506035193524,1.0803406095294084,-0.3181045399527318,197,110,87,1,0.7379660168274708,1.170500554541026,0.27311679605957273,-0.6275334935546156,-0.05616114207066203,0.05616114207066203,0.27311679605957273,1.170500554541026,1,0,0,2,1.170500554541026,0.27311679605957273
7780,33,101,33,75,80,1,4251.426,70,1392.6570000000004,MORE,312,1966,2278,5,2,5.0,0.4687042303372438,5.0,-0.6984302957695783,0.7072733486847207,0.12016365791139777,155,75,80,0,-0.09972513740911768,-0.19508342575683765,0.0,0.6069586249134807,0.43217727799338,0.43217727799338,0.0,-0.19508342575683765,1,1,1,1,-0.19508342575683765,0.0
7781,33,102,15,50,45,0,1431.442,90,1517.729,MORE,140,964,1104,2,2,-5.0,-0.4687042303372438,5.0,-0.6984302957695783,1.4534078703740962,-1.26172876313346,95,50,45,1,-1.2964267863185297,-1.170500554541026,-1.3655839802978638,-1.2447795527886638,0.20268490572284656,0.20268490572284656,-1.3655839802978638,-1.170500554541026,1,0,1,0,-1.170500554541026,-1.3655839802978638
7782,33,103,59,89,110,0,4601.335999999998,70,1145.678,MORE,194,2238,2432,4,2,21.0,1.9685577674164243,21.0,2.0952908873087353,0.7072733486847207,0.2916319985288635,199,89,110,0,0.7778560717911179,0.3511501663623078,1.170500554541026,-0.010287434320567434,0.2747348365519675,0.2747348365519675,1.170500554541026,0.3511501663623078,1,1,1,2,1.170500554541026,0.3511501663623078
7783,33,104,29,80,94,1,2398.748,100,1005.307,MORE,1026,992,2018,3,2,14.0,1.3123718449442827,14.0,0.8730378697119728,1.8264751312187841,-0.7877144317644816,174,80,94,0,0.2792303847455295,0.0,0.5462335921191455,-0.6275334935546156,1.3848374745117569,1.3848374745117569,0.5462335921191455,0.0,1,0,1,1,0.5462335921191455,0.0
7784,33,105,55,110,98,0,3649.435,60,1093.37,MORE,538,1622,2160,5,2,-12.0,-1.124890152809385,12.0,0.5238227218271837,0.3342060878400329,-0.17483333513438384,208,110,98,1,0.9573613191275298,1.170500554541026,0.7023003327246156,0.6069586249134807,0.7337195810930343,0.7337195810930343,0.7023003327246156,1.170500554541026,1,1,1,2,1.170500554541026,0.7023003327246156
7785,33,106,29,94,80,0,3241.128,50,1770.389,MORE,-40,1720,1680,3,1,-14.0,-1.3123718449442827,14.0,0.8730378697119728,-0.038861173004654886,-0.3749182819849909,174,94,80,1,0.2792303847455295,0.5462335921191455,0.0,-0.6275334935546156,-0.03748153037422326,0.03748153037422326,0.0,0.5462335921191455,0,0,0,1,0.5462335921191455,0.0
7786,33,107,57,110,94,0,3708.628,20,2056.259,MORE,1032,1602,2634,3,1,-16.0,-1.4998535370791803,16.0,1.222253017596762,-1.1580629555387183,-0.1458266606004473,204,110,94,1,0.8775812092002355,1.170500554541026,0.5462335921191455,-0.6275334935546156,1.3928430223816592,1.3928430223816592,0.5462335921191455,1.170500554541026,0,0,1,2,1.170500554541026,0.5462335921191455
7787,33,108,39,80,66,0,1534.3570000000002,60,1218.858,MORE,-292,930,638,2,1,-14.0,-1.3123718449442827,14.0,0.8730378697119728,0.3342060878400329,-1.211296754117866,146,80,66,1,-0.2792303847455295,0.0,-0.5462335921191455,-1.2447795527886638,-0.37371454091012096,0.37371454091012096,-0.5462335921191455,0.0,1,0,0,1,0.0,-0.5462335921191455
7788,33,109,4,50,54,1,5089.7829999999985,50,1021.336,MORE,1584,1650,3234,5,2,4.0,0.3749633842697951,4.0,-0.8730378697119728,-0.038861173004654886,0.530988394658096,104,50,54,0,-1.116921538982118,-1.170500554541026,-1.0144338139355558,0.6069586249134807,2.1293534264126732,2.1293534264126732,-1.0144338139355558,-1.170500554541026,0,1,1,0,-1.170500554541026,-1.0144338139355558
7789,33,110,55,98,110,1,10374.381,30,1517.192,MORE,1618,3958,5576,9,2,12.0,1.124890152809385,12.0,0.5238227218271837,-0.7849956946940304,3.1206293020067952,208,98,110,0,0.9573613191275298,0.7023003327246156,1.170500554541026,3.0759428618496734,2.1747181976754533,2.1747181976754533,1.170500554541026,0.7023003327246156,0,1,1,2,1.170500554541026,0.7023003327246156
7790,33,111,2,50,52,1,6969.709,60,1057.01,MORE,1120,2826,3946,7,2,2.0,0.18748169213489754,2.0,-1.222253017596762,0.3342060878400329,1.4522189731029298,102,50,52,0,-1.156811593945765,-1.170500554541026,-1.092467184238291,1.8414507433815772,1.51025772447356,1.51025772447356,-1.092467184238291,-1.170500554541026,0,1,1,0,-1.170500554541026,-1.092467184238291
7791,33,112,59,110,89,0,1514.825,70,1019.202,MORE,-278,840,562,2,1,-21.0,-1.9685577674164243,21.0,2.0952908873087353,0.7072733486847207,-1.2208681285539789,199,110,89,1,0.7778560717911179,1.170500554541026,0.3511501663623078,-1.2447795527886638,-0.35503492921368224,0.35503492921368224,0.3511501663623078,1.170500554541026,1,0,0,2,1.170500554541026,0.3511501663623078
7792,33,113,60,87,110,1,1858.269,80,1477.596,MORE,720,822,1542,3,2,23.0,2.1560394595513217,23.0,2.444506035193524,1.0803406095294084,-1.0525683578271483,197,87,110,0,0.7379660168274708,0.27311679605957273,1.170500554541026,-0.6275334935546156,0.9765545331467382,0.9765545331467382,1.170500554541026,0.27311679605957273,1,0,1,2,1.170500554541026,0.27311679605957273
7793,33,114,52,110,105,0,6416.581,50,1178.9489999999996,MORE,526,2882,3408,7,2,-5.0,-0.4687042303372438,5.0,-0.6984302957695783,-0.038861173004654886,1.1811665873207058,215,110,105,1,1.0969765115002945,1.170500554541026,0.9754171287841883,1.8414507433815772,0.7177084853532296,0.7177084853532296,0.9754171287841883,1.170500554541026,0,1,1,2,1.170500554541026,0.9754171287841883
7794,33,115,30,80,96,1,3910.93,60,2299.098,MORE,676,1578,2254,5,2,16.0,1.4998535370791803,16.0,1.222253017596762,0.3342060878400329,-0.0466914880029374,176,80,96,0,0.3191204397091766,0.0,0.6242669624218805,0.6069586249134807,0.9178471821007879,0.9178471821007879,0.6242669624218805,0.0,0,1,1,1,0.6242669624218805,0.0
7795,33,116,24,80,86,1,5398.642,50,1664.2179999999996,MORE,1308,2280,3588,5,2,6.0,0.5624450764046927,6.0,-0.5238227218271837,-0.038861173004654886,0.6823402857580084,166,80,86,0,0.11967016489094122,0.0,0.2341001109082052,0.6069586249134807,1.7610982243971662,1.7610982243971662,0.2341001109082052,0.0,0,1,1,1,0.2341001109082052,0.0
7796,33,117,5,50,55,1,2087.1,20,1039.838,MORE,-76,1314,1238,3,1,5.0,0.4687042303372438,5.0,-0.6984302957695783,-1.1580629555387183,-0.9404330320238404,105,50,55,0,-1.0969765115002945,-1.170500554541026,-0.9754171287841883,-0.6275334935546156,-0.08551481759363723,0.08551481759363723,-0.9754171287841883,-1.170500554541026,0,0,0,0,-1.170500554541026,-0.9754171287841883
7797,33,118,34,80,74,0,4061.396,80,2238.245,MORE,-1464,2998,1534,4,1,-6.0,-0.5624450764046927,6.0,-0.5238227218271837,1.0803406095294084,0.027042201629676133,154,80,74,1,-0.11967016489094122,0.0,-0.2341001109082052,-0.010287434320567434,-1.937464891497709,1.937464891497709,-0.2341001109082052,0.0,1,0,0,1,0.0,-0.2341001109082052
7798,33,119,15,45,50,1,4085.18,80,1335.6070000000002,MORE,1832,1596,3428,5,2,5.0,0.4687042303372438,5.0,-0.6984302957695783,1.0803406095294084,0.038697207240392516,95,45,50,0,-1.2964267863185297,-1.3655839802978638,-1.170500554541026,0.6069586249134807,2.4602494050353028,2.4602494050353028,-1.170500554541026,-1.3655839802978638,1,1,1,0,-1.3655839802978638,-1.170500554541026
7799,33,120,37,69,80,0,6443.634,0,2334.742,MORE,-1052,4118,3066,4,1,11.0,1.0311493067419364,11.0,0.34921514788478913,-1.9041974772280936,1.194423519156676,149,69,80,0,-0.21939530230005888,-0.4291835366650429,0.0,-0.010287434320567434,-1.3877506044310826,1.3877506044310826,0.0,-0.4291835366650429,0,1,0,1,-0.4291835366650429,0.0
7800,33,121,48,128,110,0,9912.744,30,1348.928,LESS,-958,4484,3526,6,1,-18.0,-1.6873352292140782,18.0,1.571468165481551,-0.7849956946940304,2.8944107590739687,238,128,110,0,1.5557121435822359,1.8728008872656416,1.170500554541026,1.224204684147529,-1.2623303544692794,1.2623303544692794,1.170500554541026,1.8728008872656416,0,1,0,2,1.8728008872656416,1.170500554541026
7801,33,122,8,50,58,1,4956.2170000000015,20,2139.626,LESS,836,2248,3084,5,2,8.0,0.7499267685395902,8.0,-0.17460757394239454,-1.1580629555387183,0.4655363058840912,108,50,58,1,-1.0371414290548238,-1.170500554541026,-0.8583670733300858,0.6069586249134807,1.1313284586315167,1.1313284586315167,-0.8583670733300858,-1.170500554541026,0,1,1,0,-1.170500554541026,-0.8583670733300858
7802,33,123,4,54,50,1,3466.463,60,1051.991,LESS,-20,1576,1556,3,2,-4.0,-0.3749633842697951,4.0,-0.8730378697119728,0.3342060878400329,-0.2644961204776409,104,54,50,0,-1.116921538982118,-1.0144338139355558,-1.170500554541026,-0.6275334935546156,-0.010796370807882167,0.010796370807882167,-1.170500554541026,-1.0144338139355558,1,0,0,0,-1.0144338139355558,-1.170500554541026
7803,33,124,37,80,69,0,11742.385,10,1028.749,LESS,922,4222,5144,7,1,-11.0,-1.0311493067419364,11.0,0.34921514788478913,-1.531130216383406,3.790999899697793,149,80,69,0,-0.21939530230005888,0.0,-0.4291835366650429,1.8414507433815772,1.2460746447667832,1.2460746447667832,-0.4291835366650429,0.0,0,1,1,1,0.0,-0.4291835366650429
7804,33,125,52,105,110,0,3035.147,40,1411.189,LESS,-216,1560,1344,4,1,5.0,0.4687042303372438,5.0,-0.6984302957695783,-0.4119284338493427,-0.4758562953847978,215,105,110,1,1.0969765115002945,0.9754171287841883,1.170500554541026,-0.010287434320567434,-0.27231093455802485,0.27231093455802485,1.170500554541026,0.9754171287841883,0,1,0,2,1.170500554541026,0.9754171287841883
7805,33,126,5,55,50,1,1883.488,30,1048.605,LESS,506,880,1386,3,2,-5.0,-0.4687042303372438,5.0,-0.6984302957695783,-0.7849956946940304,-1.040210151196781,105,55,50,0,-1.0969765115002945,-0.9754171287841883,-1.170500554541026,-0.6275334935546156,0.6910233257868885,0.6910233257868885,-1.170500554541026,-0.9754171287841883,0,0,1,0,-0.9754171287841883,-1.170500554541026
7806,33,127,30,96,80,1,2258.504,20,1081.054,LESS,446,946,1392,3,2,-16.0,-1.4998535370791803,16.0,1.222253017596762,-1.1580629555387183,-0.8564389779665222,176,96,80,0,0.3191204397091766,0.6242669624218805,0.0,-0.6275334935546156,0.6109678470878653,0.6109678470878653,0.0,0.6242669624218805,0,0,1,1,0.6242669624218805,0.0
7807,33,128,33,80,75,1,2103.169,0,1859.848,LESS,-472,1808,1336,3,1,-5.0,-0.4687042303372438,5.0,-0.6984302957695783,-1.9041974772280936,-0.9325586507104112,155,80,75,0,-0.09972513740911768,0.0,-0.19508342575683765,-0.6275334935546156,-0.6138809770071908,0.6138809770071908,-0.19508342575683765,0.0,0,0,0,1,0.0,-0.19508342575683765
7808,33,129,48,110,128,0,1443.26,80,633.472,LESS,-406,964,558,2,1,18.0,1.6873352292140782,18.0,1.571468165481551,1.0803406095294084,-1.25593752295908,238,110,128,1,1.5557121435822359,1.170500554541026,1.8728008872656416,-1.2447795527886638,-0.5258199504382652,0.5258199504382652,1.8728008872656416,1.170500554541026,1,0,0,2,1.8728008872656416,1.170500554541026
7809,33,130,9,59,50,1,2539.606,80,917.915,LESS,716,1080,1796,3,2,-9.0,-0.8436676146070391,9.0,0.0,1.0803406095294084,-0.7186890037324302,109,59,50,0,-1.0171964015730004,-0.8193503881787182,-1.170500554541026,-0.6275334935546156,0.97121750123347,0.97121750123347,-1.170500554541026,-0.8193503881787182,1,0,1,0,-0.8193503881787182,-1.170500554541026
7810,33,131,44,110,119,0,3106.006,50,883.738,LESS,-588,1778,1190,4,1,9.0,0.8436676146070391,9.0,0.0,-0.038861173004654886,-0.4411328660806538,229,110,119,1,1.376206896245824,1.170500554541026,1.5216507209033339,-0.010287434320567434,-0.7686549024919692,0.7686549024919692,1.5216507209033339,1.170500554541026,1,1,0,2,1.5216507209033339,1.170500554541026
7811,33,132,2,52,50,1,1854.279,90,786.8530000000002,LESS,1118,656,1774,3,2,-2.0,-0.18748169213489754,2.0,-1.222253017596762,1.4534078703740962,-1.0545235996866658,102,52,50,0,-1.156811593945765,-1.092467184238291,-1.170500554541026,-0.6275334935546156,1.507589208516926,1.507589208516926,-1.170500554541026,-1.092467184238291,1,0,1,0,-1.092467184238291,-1.170500554541026
7812,33,133,8,58,50,1,2148.818,80,1465.112,LESS,1864,774,2638,3,2,-8.0,-0.7499267685395902,8.0,-0.17460757394239454,1.0803406095294084,-0.9101890177166504,108,58,50,0,-1.0371414290548238,-0.8583670733300858,-1.170500554541026,-0.6275334935546156,2.5029456603414486,2.5029456603414486,-1.170500554541026,-0.8583670733300858,1,0,1,0,-0.8583670733300858,-1.170500554541026
7813,33,134,44,119,110,1,5173.625,90,885.29,LESS,-20,2682,2662,5,2,-9.0,-0.8436676146070391,9.0,0.0,1.4534078703740962,0.5720739555567554,229,119,110,0,1.376206896245824,1.5216507209033339,1.170500554541026,0.6069586249134807,-0.010796370807882167,0.010796370807882167,1.170500554541026,1.5216507209033339,1,1,0,2,1.5216507209033339,1.170500554541026
7814,33,135,34,74,80,0,3705.788,70,1995.354,LESS,-1250,2588,1338,3,1,6.0,0.5624450764046927,6.0,-0.5238227218271837,0.7072733486847207,-0.14721836157313636,154,74,80,1,-0.11967016489094122,-0.2341001109082052,0.0,-0.6275334935546156,-1.6519336841378593,1.6519336841378593,0.0,-0.2341001109082052,1,0,0,1,-0.2341001109082052,0.0
7815,33,136,24,86,80,1,4434.6190000000015,20,764.294,LESS,458,2034,2492,5,1,-6.0,-0.5624450764046927,6.0,-0.5238227218271837,-1.1580629555387183,0.20993474111203728,166,86,80,0,0.11967016489094122,0.2341001109082052,0.0,0.6069586249134807,0.62697894282767,0.62697894282767,0.0,0.2341001109082052,0,1,1,1,0.2341001109082052,0.0
7816,33,137,39,66,80,0,1666.6329999999996,70,1058.885,LESS,-274,862,588,2,1,14.0,1.3123718449442827,14.0,0.8730378697119728,0.7072733486847207,-1.1464768112082149,146,66,80,1,-0.2792303847455295,-0.5462335921191455,0.0,-1.2447795527886638,-0.349697897300414,0.349697897300414,0.0,-0.5462335921191455,1,0,0,1,-0.5462335921191455,0.0
7817,33,138,9,50,59,0,2893.832000000001,70,992.759,LESS,-254,1436,1182,4,1,9.0,0.8436676146070391,9.0,0.0,0.7072733486847207,-0.5451056696649189,109,50,59,1,-1.0171964015730004,-1.170500554541026,-0.8193503881787182,-0.010287434320567434,-0.32301273773407296,0.32301273773407296,-0.8193503881787182,-1.170500554541026,1,1,0,0,-1.170500554541026,-0.8193503881787182
7818,33,139,57,94,110,0,1582.342,70,1172.115,LESS,-254,1042,788,2,2,16.0,1.4998535370791803,16.0,1.222253017596762,0.7072733486847207,-1.1877823980705131,204,94,110,1,0.8775812092002355,0.5462335921191455,1.170500554541026,-1.2447795527886638,-0.32301273773407296,0.32301273773407296,1.170500554541026,0.5462335921191455,1,0,0,2,1.170500554541026,0.5462335921191455
7819,33,140,60,110,87,1,3695.395,80,1106.856,LESS,280,1686,1966,5,2,-23.0,-2.1560394595513217,23.0,2.444506035193524,1.0803406095294084,-0.15231130108340282,197,110,87,0,0.7379660168274708,1.170500554541026,0.27311679605957273,0.6069586249134807,0.3894810226872343,0.3894810226872343,0.27311679605957273,1.170500554541026,1,1,1,2,1.170500554541026,0.27311679605957273
7820,33,141,33,75,80,0,5574.181,70,971.626,LESS,-2,2408,2406,4,1,5.0,0.4687042303372438,5.0,-0.6984302957695783,0.7072733486847207,0.7683606368301397,155,75,80,1,-0.09972513740911768,-0.19508342575683765,0.0,-0.010287434320567434,0.013220272801824817,0.013220272801824817,0.0,-0.19508342575683765,1,1,0,1,-0.19508342575683765,0.0
7821,33,142,15,50,45,1,3548.1020000000008,30,982.569,LESS,280,1742,2022,3,2,-5.0,-0.4687042303372438,5.0,-0.6984302957695783,-0.7849956946940304,-0.22449010790392346,95,50,45,0,-1.2964267863185297,-1.170500554541026,-1.3655839802978638,-0.6275334935546156,0.3894810226872343,0.3894810226872343,-1.3655839802978638,-1.170500554541026,0,0,1,0,-1.170500554541026,-1.3655839802978638
7822,33,143,59,89,110,0,1623.716,30,1383.839,LESS,-542,1138,596,2,1,21.0,1.9685577674164243,21.0,2.0952908873087353,-0.7849956946940304,-1.1675076670690927,199,89,110,1,0.7778560717911179,0.3511501663623078,1.170500554541026,-1.2447795527886638,-0.7072790354893848,0.7072790354893848,1.170500554541026,0.3511501663623078,0,0,0,2,1.170500554541026,0.3511501663623078
7823,33,144,29,80,94,0,10280.819,50,1179.868,LESS,798,3974,4772,7,1,14.0,1.3123718449442827,14.0,0.8730378697119728,-0.038861173004654886,3.0747805955255534,174,80,94,1,0.2792303847455295,0.0,0.5462335921191455,1.8414507433815772,1.0806266554554684,1.0806266554554684,0.5462335921191455,0.0,0,1,1,1,0.5462335921191455,0.0
7824,33,145,55,110,98,1,5266.289000000002,10,1292.84,LESS,-540,2954,2414,7,1,-12.0,-1.124890152809385,12.0,0.5238227218271837,-1.531130216383406,0.6174826101107184,208,110,98,0,0.9573613191275298,1.170500554541026,0.7023003327246156,1.8414507433815772,-0.7046105195327506,0.7046105195327506,0.7023003327246156,1.170500554541026,0,1,0,2,1.170500554541026,0.7023003327246156
7825,33,146,29,94,80,1,1946.86,40,734.55,LESS,402,824,1226,3,2,-14.0,-1.3123718449442827,14.0,0.8730378697119728,-0.4119284338493427,-1.009155618083666,174,94,80,0,0.2792303847455295,0.5462335921191455,0.0,-0.6275334935546156,0.552260496041915,0.552260496041915,0.0,0.5462335921191455,0,0,1,1,0.5462335921191455,0.0
7826,33,147,57,110,94,1,4480.192,70,1135.156,LESS,414,1874,2288,7,2,-16.0,-1.4998535370791803,16.0,1.222253017596762,0.7072733486847207,0.23226713140371102,204,110,94,0,0.8775812092002355,1.170500554541026,0.5462335921191455,1.8414507433815772,0.5682715917817196,0.5682715917817196,0.5462335921191455,1.170500554541026,1,1,1,2,1.170500554541026,0.5462335921191455
7827,33,148,39,80,66,0,2948.228,30,1442.475,LESS,-410,1632,1222,4,1,-14.0,-1.3123718449442827,14.0,0.8730378697119728,-0.7849956946940304,-0.5184496956823874,146,80,66,0,-0.2792303847455295,0.0,-0.5462335921191455,-0.010287434320567434,-0.5311569823515334,0.5311569823515334,-0.5462335921191455,0.0,0,1,0,1,0.0,-0.5462335921191455
7828,33,149,4,50,54,1,2559.781,30,928.783,LESS,730,894,1624,3,2,4.0,0.3749633842697951,4.0,-0.8730378697119728,-0.7849956946940304,-0.708802536435247,104,50,54,1,-1.116921538982118,-1.170500554541026,-1.0144338139355558,-0.6275334935546156,0.9898971129299088,0.9898971129299088,-1.0144338139355558,-1.170500554541026,0,0,1,0,-1.170500554541026,-1.0144338139355558
7829,33,150,55,98,110,0,1842.027,70,1203.063,LESS,-642,1202,560,2,1,12.0,1.124890152809385,12.0,0.5238227218271837,0.7072733486847207,-1.0605275152913791,208,98,110,1,0.9573613191275298,0.7023003327246156,1.170500554541026,-1.2447795527886638,-0.8407048333210901,0.8407048333210901,1.170500554541026,0.7023003327246156,1,0,0,2,1.170500554541026,0.7023003327246156
7830,33,151,2,50,52,1,4939.104,70,1479.32,LESS,664,2252,2916,5,2,2.0,0.18748169213489754,2.0,-1.222253017596762,0.7072733486847207,0.4571503274525319,102,50,52,1,-1.156811593945765,-1.170500554541026,-1.092467184238291,0.6069586249134807,0.9018360863609831,0.9018360863609831,-1.092467184238291,-1.170500554541026,1,1,1,0,-1.170500554541026,-1.092467184238291
7831,33,152,59,110,89,1,2196.524,90,1711.878,LESS,590,828,1418,3,2,-21.0,-1.9685577674164243,21.0,2.0952908873087353,1.4534078703740962,-0.8868113815887982,199,110,89,0,0.7778560717911179,1.170500554541026,0.3511501663623078,-0.6275334935546156,0.8031009959655211,0.8031009959655211,0.3511501663623078,1.170500554541026,1,0,1,2,1.170500554541026,0.3511501663623078
7832,33,153,60,87,110,0,3524.365,90,1387.779,LESS,260,1698,1958,4,2,23.0,2.1560394595513217,23.0,2.444506035193524,1.4534078703740962,-0.2361220818436136,197,87,110,1,0.7379660168274708,0.27311679605957273,1.170500554541026,-0.010287434320567434,0.3627958631208932,0.3627958631208932,1.170500554541026,0.27311679605957273,1,1,1,2,1.170500554541026,0.27311679605957273
7833,33,154,52,110,105,1,9019.205,70,895.155,LESS,1044,3754,4798,7,2,-5.0,-0.4687042303372438,5.0,-0.6984302957695783,0.7072733486847207,2.456544880399479,215,110,105,0,1.0969765115002945,1.170500554541026,0.9754171287841883,1.8414507433815772,1.408854118121464,1.408854118121464,0.9754171287841883,1.170500554541026,1,1,1,2,1.170500554541026,0.9754171287841883
7834,33,155,30,80,96,0,4286.78,20,1606.445,LESS,-496,2362,1866,4,1,16.0,1.4998535370791803,16.0,1.222253017596762,-1.1580629555387183,0.13748837487916038,176,80,96,1,0.3191204397091766,0.0,0.6242669624218805,-0.010287434320567434,-0.6459031684868002,0.6459031684868002,0.6242669624218805,0.0,0,1,0,1,0.6242669624218805,0.0
7835,33,156,24,80,86,0,1866.205,100,1541.805,LESS,56,1162,1218,2,2,6.0,0.5624450764046927,6.0,-0.5238227218271837,1.8264751312187841,-1.0486794356724796,166,80,86,1,0.11967016489094122,0.0,0.2341001109082052,-1.2447795527886638,0.09060723554421399,0.09060723554421399,0.2341001109082052,0.0,1,0,0,1,0.2341001109082052,0.0
7836,33,157,5,50,55,0,4953.792,20,1815.389,LESS,-596,2594,1998,5,1,5.0,0.4687042303372438,5.0,-0.6984302957695783,-1.1580629555387183,0.4643479696662136,105,50,55,1,-1.0969765115002945,-1.170500554541026,-0.9754171287841883,0.6069586249134807,-0.7793289663185057,0.7793289663185057,-0.9754171287841883,-1.170500554541026,0,1,0,0,-1.170500554541026,-0.9754171287841883
7837,33,158,34,80,74,0,6165.749,20,1619.1529999999998,LESS,-958,3402,2444,6,1,-6.0,-0.5624450764046927,6.0,-0.5238227218271837,-1.1580629555387183,1.0582499892990418,154,80,74,0,-0.11967016489094122,0.0,-0.2341001109082052,1.224204684147529,-1.2623303544692794,1.2623303544692794,-0.2341001109082052,0.0,0,1,0,1,0.0,-0.2341001109082052
7838,33,159,15,45,50,0,1525.091,50,777.4060000000002,LESS,-276,906,630,2,1,5.0,0.4687042303372438,5.0,-0.6984302957695783,-0.038861173004654886,-1.2158374235590406,95,45,50,1,-1.2964267863185297,-1.3655839802978638,-1.170500554541026,-1.2447795527886638,-0.3523664132570481,0.3523664132570481,-1.170500554541026,-1.3655839802978638,0,0,0,0,-1.3655839802978638,-1.170500554541026
7839,33,160,37,69,80,0,1898.417,60,932.481,LESS,-498,1194,696,2,1,11.0,1.0311493067419364,11.0,0.34921514788478913,0.3342060878400329,-1.0328944104146425,149,69,80,1,-0.21939530230005888,-0.4291835366650429,0.0,-1.2447795527886638,-0.6485716844434343,0.6485716844434343,0.0,-0.4291835366650429,1,0,0,1,-0.4291835366650429,0.0
7840,33,161,3,50,53,1,6549.821,70,1524.05,MORE,-594,3374,2780,4,2,3.0,0.28122253820234633,3.0,-1.0476454436543674,0.7072733486847207,1.246458924504185,103,50,53,0,-1.1368665664639415,-1.170500554541026,-1.0534504990869233,-0.010287434320567434,-0.7766604503618716,0.7766604503618716,-1.0534504990869233,-1.170500554541026,1,0,0,0,-1.170500554541026,-1.0534504990869233
7841,33,162,20,50,40,0,3497.788,80,1002.732,MORE,-76,1742,1666,4,1,-10.0,-0.9374084606744876,10.0,0.17460757394239454,1.0803406095294084,-0.2491457567559921,90,50,40,1,-1.3961519237276474,-1.170500554541026,-1.5606674060547012,-0.010287434320567434,-0.08551481759363723,0.08551481759363723,-1.5606674060547012,-1.170500554541026,1,0,0,0,-1.170500554541026,-1.5606674060547012
7842,33,163,25,80,88,1,4550.765,80,1462.4779999999996,MORE,734,1980,2714,5,2,8.0,0.7499267685395902,8.0,-0.17460757394239454,1.0803406095294084,0.26685041053947883,168,80,88,0,0.1595602198545883,0.0,0.31213348121094026,0.6069586249134807,0.995234144843177,0.995234144843177,0.31213348121094026,0.0,1,1,1,1,0.31213348121094026,0.0
7843,33,164,42,115,110,0,1526.4129999999998,0,1275.715,MORE,-1110,1668,558,2,1,-5.0,-0.4687042303372438,5.0,-0.6984302957695783,-1.9041974772280936,-1.215189596556965,225,115,110,1,1.2964267863185297,1.3655839802978638,1.170500554541026,-1.2447795527886638,-1.4651375671734717,1.4651375671734717,1.170500554541026,1.3655839802978638,0,0,0,2,1.3655839802978638,1.170500554541026
7844,33,165,53,103,110,0,5756.064,30,904.897,MORE,86,2538,2624,5,1,7.0,0.6561859224721414,7.0,-0.34921514788478913,-0.7849956946940304,0.8574897734553485,213,103,110,0,1.0570864565366473,0.8973837584814532,1.170500554541026,0.6069586249134807,0.1306349748937256,0.1306349748937256,1.170500554541026,0.8973837584814532,0,1,1,2,1.170500554541026,0.8973837584814532
7845,33,166,26,90,80,0,9142.834,20,1389.664,MORE,-1882,5014,3132,6,1,-10.0,-0.9374084606744876,10.0,0.17460757394239454,-1.1580629555387183,2.5171274858757355,170,90,80,1,0.19945027481823535,0.3901668515136753,0.0,1.224204684147529,-2.4951847264342377,2.4951847264342377,0.0,0.3901668515136753,0,1,0,1,0.3901668515136753,0.0
7846,33,167,35,80,72,0,4035.357,60,1199.9589999999996,MORE,366,1802,2168,5,2,-8.0,-0.7499267685395902,8.0,-0.17460757394239454,0.3342060878400329,0.014282165845222268,152,80,72,1,-0.1595602198545883,0.0,-0.31213348121094026,0.6069586249134807,0.5042272088225009,0.5042272088225009,-0.31213348121094026,0.0,0,1,1,1,0.0,-0.31213348121094026
7847,33,168,28,93,80,0,2688.894,30,1455.529,MORE,-248,1418,1170,4,1,-13.0,-1.218630998876834,13.0,0.6984302957695783,-0.7849956946940304,-0.6455325759821506,173,93,80,1,0.25928535726370594,0.5072169069677779,0.0,-0.010287434320567434,-0.31500718986417064,0.31500718986417064,0.0,0.5072169069677779,0,0,0,1,0.5072169069677779,0.0
7848,33,169,26,80,90,1,1844.621,80,750.45,MORE,618,790,1408,3,2,10.0,0.9374084606744876,10.0,0.17460757394239454,1.0803406095294084,-1.059256363064916,170,80,90,0,0.19945027481823535,0.0,0.3901668515136753,-0.6275334935546156,0.8404602193583987,0.8404602193583987,0.3901668515136753,0.0,1,0,1,1,0.3901668515136753,0.0
7849,33,170,25,88,80,0,1453.716,70,784.6339999999999,MORE,-350,908,558,2,1,-8.0,-0.7499267685395902,8.0,-0.17460757394239454,0.7072733486847207,-1.2508137112089268,168,88,80,1,0.1595602198545883,0.31213348121094026,0.0,-1.2447795527886638,-0.45110150365251017,0.45110150365251017,0.0,0.31213348121094026,1,0,0,1,0.31213348121094026,0.0
7850,33,171,36,80,70,0,3936.449,70,813.283,MORE,-24,1886,1862,4,1,-10.0,-0.9374084606744876,10.0,0.17460757394239454,0.7072733486847207,-0.03418627070644067,150,80,70,1,-0.19945027481823535,0.0,-0.3901668515136753,-0.010287434320567434,-0.016133402721150384,0.016133402721150384,-0.3901668515136753,0.0,1,0,1,1,0.0,-0.3901668515136753
7851,33,172,28,80,93,0,2977.2209999999995,70,1080.921,MORE,-438,1758,1320,4,1,13.0,1.218630998876834,13.0,0.6984302957695783,0.7072733486847207,-0.5042420948721159,173,80,93,0,0.25928535726370594,0.0,0.5072169069677779,-0.010287434320567434,-0.568516205744411,0.568516205744411,0.5072169069677779,0.0,1,0,0,1,0.5072169069677779,0.0
7852,33,173,21,82,80,0,11964.377,70,2005.103,MORE,-56,5508,5452,12,1,-2.0,-0.18748169213489754,2.0,-1.222253017596762,0.7072733486847207,3.899783872348911,162,82,80,1,0.03989005496364707,0.07803337030273506,0.0,4.9276810395518185,-0.05882965802729614,0.05882965802729614,0.0,0.07803337030273506,1,1,0,1,0.07803337030273506,0.0
7853,33,174,19,50,41,0,4135.63,40,1021.755,MORE,-1108,2478,1370,4,1,-9.0,-0.8436676146070391,9.0,0.0,-0.4119284338493427,0.0634195009277728,91,50,41,1,-1.376206896245824,-1.170500554541026,-1.5216507209033339,-0.010287434320567434,-1.4624690512168377,1.4624690512168377,-1.5216507209033339,-1.170500554541026,0,1,0,0,-1.170500554541026,-1.5216507209033339
7854,33,175,56,96,110,1,2743.44,60,1578.227,MORE,174,1234,1408,2,2,14.0,1.3123718449442827,14.0,0.8730378697119728,0.3342060878400329,-0.6188030966665541,206,96,110,0,0.9174712641638826,0.6242669624218805,1.170500554541026,-1.2447795527886638,0.24804967698562644,0.24804967698562644,1.170500554541026,0.6242669624218805,1,0,1,2,1.170500554541026,0.6242669624218805
7855,33,176,23,80,85,0,3397.34,30,1124.74,MORE,-704,2028,1324,4,1,5.0,0.4687042303372438,5.0,-0.6984302957695783,-0.7849956946940304,-0.2983688480604512,165,80,85,0,0.09972513740911768,0.0,0.19508342575683765,-0.010287434320567434,-0.9234288279767475,0.9234288279767475,0.19508342575683765,0.0,0,0,0,1,0.19508342575683765,0.0
7856,33,177,10,60,50,0,2532.466,70,945.711,MORE,-360,1396,1036,4,1,-10.0,-0.9374084606744876,10.0,0.17460757394239454,0.7072733486847207,-0.7221878575863033,110,60,50,1,-0.9972513740911768,-0.7803337030273506,-1.170500554541026,-0.010287434320567434,-0.4644440834356807,0.4644440834356807,-1.170500554541026,-0.7803337030273506,1,0,0,0,-0.7803337030273506,-1.170500554541026
7857,33,178,19,41,50,0,6140.558000000001,70,1163.627,MORE,314,2786,3100,6,1,9.0,0.8436676146070391,9.0,0.0,0.7072733486847207,1.0459055036641802,91,41,50,0,-1.376206896245824,-1.5216507209033339,-1.170500554541026,1.224204684147529,0.4348457939500141,0.4348457939500141,-1.170500554541026,-1.5216507209033339,1,1,1,0,-1.5216507209033339,-1.170500554541026
7858,33,179,56,110,96,1,6412.806,20,1527.67,MORE,-804,3986,3182,5,1,-14.0,-1.3123718449442827,14.0,0.8730378697119728,-1.1580629555387183,1.1793167031052476,206,110,96,1,0.9174712641638826,1.170500554541026,0.6242669624218805,0.6069586249134807,-1.056854625808453,1.056854625808453,0.6242669624218805,1.170500554541026,0,1,0,2,1.170500554541026,0.6242669624218805
7859,33,180,35,72,80,1,4655.703,60,1542.304,MORE,830,1760,2590,5,2,8.0,0.7499267685395902,8.0,-0.17460757394239454,0.3342060878400329,0.31827376148033715,152,72,80,0,-0.1595602198545883,-0.31213348121094026,0.0,0.6069586249134807,1.1233229107616143,1.1233229107616143,0.0,-0.31213348121094026,1,1,1,1,-0.31213348121094026,0.0
7860,33,181,11,49,50,0,4007.788,40,1603.565,MORE,-612,2172,1560,4,1,1.0,0.09374084606744876,1.0,-1.3968605915391563,-0.4119284338493427,0.0007723756635100206,99,49,50,0,-1.2166466763912356,-1.2095172396923934,-1.170500554541026,-0.010287434320567434,-0.8006770939715785,0.8006770939715785,-1.170500554541026,-1.2095172396923934,0,0,0,0,-1.2095172396923934,-1.170500554541026
7861,33,182,17,43,50,0,5057.656,70,1287.006,MORE,180,2240,2420,4,1,7.0,0.6561859224721414,7.0,-0.34921514788478913,0.7072733486847207,0.5152450224223294,93,43,50,0,-1.3363168412821769,-1.4436173506005987,-1.170500554541026,-0.010287434320567434,0.25605522485552873,0.25605522485552873,-1.170500554541026,-1.4436173506005987,1,1,1,0,-1.4436173506005987,-1.170500554541026
7862,33,183,1,51,50,0,3685.316,70,1253.82,MORE,-728,2090,1362,4,1,-1.0,-0.09374084606744876,1.0,-1.3968605915391563,0.7072733486847207,-0.15725036942978754,101,51,50,1,-1.1767566214275886,-1.1314838693896585,-1.170500554541026,-0.010287434320567434,-0.9554510194563569,0.9554510194563569,-1.170500554541026,-1.1314838693896585,1,1,0,0,-1.1314838693896585,-1.170500554541026
7863,33,184,41,112,110,1,5533.621,20,1315.799,MORE,-1570,3924,2354,5,1,-2.0,-0.18748169213489754,2.0,-1.222253017596762,-1.1580629555387183,0.7484847947694829,222,112,110,1,1.2365917038730592,1.248533924843761,1.170500554541026,0.6069586249134807,-2.078896237199317,2.078896237199317,1.170500554541026,1.248533924843761,0,1,0,2,1.248533924843761,1.170500554541026
7864,33,185,20,40,50,1,1988.182,100,1186.665,MORE,1200,804,2004,3,2,10.0,0.9374084606744876,10.0,0.17460757394239454,1.8264751312187841,-0.9889063689310412,90,40,50,0,-1.3961519237276474,-1.5606674060547012,-1.170500554541026,-0.6275334935546156,1.6169983627389244,1.6169983627389244,-1.170500554541026,-1.5606674060547012,1,0,1,0,-1.5606674060547012,-1.170500554541026
7865,33,186,1,50,51,1,5891.906,30,1066.853,MORE,268,2522,2790,5,2,1.0,0.09374084606744876,1.0,-1.3968605915391563,-0.7849956946940304,0.9240571831497209,101,50,51,0,-1.1767566214275886,-1.170500554541026,-1.1314838693896585,0.6069586249134807,0.3734699269474296,0.3734699269474296,-1.1314838693896585,-1.170500554541026,0,1,1,0,-1.170500554541026,-1.1314838693896585
7866,33,187,23,85,80,0,4300.777,70,985.119,MORE,-30,1394,1364,3,1,-5.0,-0.4687042303372438,5.0,-0.6984302957695783,0.7072733486847207,0.14434740252519146,165,85,80,1,0.09972513740911768,0.19508342575683765,0.0,-0.6275334935546156,-0.024138950591052716,0.024138950591052716,0.0,0.19508342575683765,1,0,0,1,0.19508342575683765,0.0
7867,33,188,11,50,49,0,5242.89,40,1023.543,MORE,220,2242,2462,6,1,-1.0,-0.09374084606744876,1.0,-1.3968605915391563,-0.4119284338493427,0.6060162681882003,99,50,49,1,-1.2166466763912356,-1.170500554541026,-1.2095172396923934,1.224204684147529,0.3094255439882109,0.3094255439882109,-1.2095172396923934,-1.170500554541026,0,1,1,0,-1.170500554541026,-1.2095172396923934
7868,33,189,17,50,43,0,7640.656999999998,70,1191.156,MORE,-1200,3854,2654,3,1,-7.0,-0.6561859224721414,7.0,-0.34921514788478913,0.7072733486847207,1.7810073478295962,93,50,43,1,-1.3363168412821769,-1.170500554541026,-1.4436173506005987,-0.6275334935546156,-1.5852207852220066,1.5852207852220066,-1.4436173506005987,-1.170500554541026,1,0,0,0,-1.170500554541026,-1.4436173506005987
7869,33,190,21,80,82,0,3754.229,60,512.611,MORE,-636,2052,1416,4,1,2.0,0.18748169213489754,2.0,-1.222253017596762,0.3342060878400329,-0.12348054931326763,162,80,82,0,0.03989005496364707,0.0,0.07803337030273506,-0.010287434320567434,-0.8326992854511879,0.8326992854511879,0.07803337030273506,0.0,1,0,0,1,0.07803337030273506,0.0
7870,33,191,10,50,60,1,3341.929,70,1521.771,MORE,246,1544,1790,3,2,10.0,0.9374084606744876,10.0,0.17460757394239454,0.7072733486847207,-0.3255222081300532,110,50,60,0,-0.9972513740911768,-1.170500554541026,-0.7803337030273506,-0.6275334935546156,0.3441162514244544,0.3441162514244544,-0.7803337030273506,-1.170500554541026,1,0,1,0,-1.170500554541026,-0.7803337030273506
7871,33,192,3,53,50,0,1694.368,20,1987.436,MORE,280,1118,1398,2,1,-3.0,-0.28122253820234633,3.0,-1.0476454436543674,-1.1580629555387183,-1.1328856751245775,103,53,50,1,-1.1368665664639415,-1.0534504990869233,-1.170500554541026,-1.2447795527886638,0.3894810226872343,0.3894810226872343,-1.170500554541026,-1.0534504990869233,0,0,1,0,-1.0534504990869233,-1.170500554541026
7872,33,193,45,122,110,0,2674.219,90,1362.5120000000004,MORE,310,1646,1956,4,2,-12.0,-1.124890152809385,12.0,0.5238227218271837,1.4534078703740962,-0.6527238477336332,232,122,110,1,1.4360419786912946,1.6387007763574364,1.170500554541026,-0.010287434320567434,0.4295087620367459,0.4295087620367459,1.170500554541026,1.6387007763574364,1,0,1,2,1.6387007763574364,1.170500554541026
7873,33,194,38,67,80,1,2228.699,80,2385.772,MORE,2446,1034,3480,3,2,13.0,1.218630998876834,13.0,0.6984302957695783,1.0803406095294084,-0.8710444876464501,147,67,80,0,-0.25928535726370594,-0.5072169069677779,0.0,-0.6275334935546156,3.2794838037219747,3.2794838037219747,0.0,-0.5072169069677779,1,0,1,1,-0.5072169069677779,0.0
7874,33,195,38,80,67,1,2848.448,20,1458.319,MORE,66,1552,1618,3,1,-13.0,-1.218630998876834,13.0,0.6984302957695783,-1.1580629555387183,-0.5673454432369325,147,80,67,1,-0.25928535726370594,0.0,-0.5072169069677779,-0.6275334935546156,0.10394981532738452,0.10394981532738452,-0.5072169069677779,0.0,0,0,1,1,0.0,-0.5072169069677779
7875,33,196,36,70,80,0,4027.628,30,802.1489999999999,MORE,-452,2052,1600,4,1,10.0,0.9374084606744876,10.0,0.17460757394239454,-0.7849956946940304,0.010494681050182487,150,70,80,0,-0.19945027481823535,-0.3901668515136753,0.0,-0.010287434320567434,-0.5871958174408497,0.5871958174408497,0.0,-0.3901668515136753,0,0,0,1,-0.3901668515136753,0.0
7876,33,197,45,110,122,1,2835.649000000001,70,1275.939,MORE,-524,1846,1322,1,2,12.0,1.124890152809385,12.0,0.5238227218271837,0.7072733486847207,-0.573617408289554,232,110,122,0,1.4360419786912946,1.170500554541026,1.6387007763574364,-1.862025612022712,-0.6832623918796777,0.6832623918796777,1.6387007763574364,1.170500554541026,1,0,0,2,1.6387007763574364,1.170500554541026
7877,33,198,42,110,115,0,8278.587,80,2054.34,MORE,14,3902,3916,6,2,5.0,0.4687042303372438,5.0,-0.6984302957695783,1.0803406095294084,2.093615728642093,225,110,115,0,1.2964267863185297,1.170500554541026,1.3655839802978638,1.224204684147529,0.03456840045489769,0.03456840045489769,1.3655839802978638,1.170500554541026,1,1,1,2,1.3655839802978638,1.170500554541026
7878,33,199,41,110,112,1,3903.836,60,1607.1129999999996,MORE,908,1458,2366,3,2,2.0,0.18748169213489754,2.0,-1.222253017596762,0.3342060878400329,-0.05016780022133732,222,110,112,0,1.2365917038730592,1.170500554541026,1.248533924843761,-0.6275334935546156,1.2273950330703445,1.2273950330703445,1.248533924843761,1.170500554541026,1,0,1,2,1.248533924843761,1.170500554541026
7879,33,200,53,110,103,0,2579.74,70,992.616,MORE,-490,1576,1086,2,1,-7.0,-0.6561859224721414,7.0,-0.34921514788478913,0.7072733486847207,-0.6990219168176768,213,110,103,1,1.0570864565366473,1.170500554541026,0.8973837584814532,-1.2447795527886638,-0.6378976206168978,0.6378976206168978,0.8973837584814532,1.170500554541026,1,0,0,2,1.170500554541026,0.8973837584814532
7880,33,201,3,50,53,1,5318.646,10,945.704,LESS,-446,2538,2092,5,1,3.0,0.28122253820234633,3.0,-1.0476454436543674,-1.531130216383406,0.6431394015991251,103,50,53,1,-1.1368665664639415,-1.170500554541026,-1.0534504990869233,0.6069586249134807,-0.5791902695709474,0.5791902695709474,-1.0534504990869233,-1.170500554541026,0,1,0,0,-1.170500554541026,-1.0534504990869233
7881,33,202,20,50,40,1,2086.724,50,1912.752,LESS,642,814,1456,3,2,-10.0,-0.9374084606744876,10.0,0.17460757394239454,-0.038861173004654886,-0.9406172853920556,90,50,40,0,-1.3961519237276474,-1.170500554541026,-1.5606674060547012,-0.6275334935546156,0.8724824108380079,0.8724824108380079,-1.5606674060547012,-1.170500554541026,0,0,1,0,-1.170500554541026,-1.5606674060547012
7882,33,203,25,80,88,0,1867.922,60,1252.064,LESS,-524,1168,644,2,1,8.0,0.7499267685395902,8.0,-0.17460757394239454,0.3342060878400329,-1.0478380446266673,168,80,88,1,0.1595602198545883,0.0,0.31213348121094026,-1.2447795527886638,-0.6832623918796777,0.6832623918796777,0.31213348121094026,0.0,1,0,0,1,0.31213348121094026,0.0
7883,33,204,42,115,110,1,3287.542,0,786.082,LESS,-214,1794,1580,3,1,-5.0,-0.4687042303372438,5.0,-0.6984302957695783,-1.9041974772280936,-0.3521737717926013,225,115,110,0,1.2964267863185297,1.3655839802978638,1.170500554541026,-0.6275334935546156,-0.26964241860139077,0.26964241860139077,1.170500554541026,1.3655839802978638,0,0,0,2,1.3655839802978638,1.170500554541026
7884,33,205,53,103,110,0,4005.469,20,1826.911,LESS,228,1858,2086,4,1,7.0,0.6561859224721414,7.0,-0.34921514788478913,-1.1580629555387183,-0.00036401678566804895,213,103,110,1,1.0570864565366473,0.8973837584814532,1.170500554541026,-0.010287434320567434,0.3200996078147474,0.3200996078147474,1.170500554541026,0.8973837584814532,0,1,1,2,1.170500554541026,0.8973837584814532
7885,33,206,26,90,80,1,5558.85,30,955.412,LESS,-42,2460,2418,6,1,-10.0,-0.9374084606744876,10.0,0.17460757394239454,-0.7849956946940304,0.7608479017553883,170,90,80,0,0.19945027481823535,0.3901668515136753,0.0,1.224204684147529,-0.04015004633085737,0.04015004633085737,0.0,0.3901668515136753,0,1,0,1,0.3901668515136753,0.0
7886,33,207,35,80,72,0,4756.104,30,942.68,LESS,354,2112,2466,4,1,-8.0,-0.7499267685395902,8.0,-0.17460757394239454,-0.7849956946940304,0.3674738211137693,152,80,72,0,-0.1595602198545883,0.0,-0.31213348121094026,-0.010287434320567434,0.4882161130826963,0.4882161130826963,-0.31213348121094026,0.0,0,1,1,1,0.0,-0.31213348121094026
7887,33,208,28,93,80,1,3127.495,20,872.327,LESS,836,1112,1948,3,2,-13.0,-1.218630998876834,13.0,0.6984302957695783,-1.1580629555387183,-0.43060249206582496,173,93,80,0,0.25928535726370594,0.5072169069677779,0.0,-0.6275334935546156,1.1313284586315167,1.1313284586315167,0.0,0.5072169069677779,0,0,1,1,0.5072169069677779,0.0
7888,33,209,26,80,90,0,2002.718,10,1494.5839999999996,LESS,-1198,1854,656,2,1,10.0,0.9374084606744876,10.0,0.17460757394239454,-1.531130216383406,-0.9817832121215316,170,80,90,1,0.19945027481823535,0.0,0.3901668515136753,-1.2447795527886638,-1.5825522692653726,1.5825522692653726,0.3901668515136753,0.0,0,0,0,1,0.3901668515136753,0.0
7889,33,210,25,88,80,1,6819.028,50,788.567,LESS,282,3060,3342,7,2,-8.0,-0.7499267685395902,8.0,-0.17460757394239454,-0.038861173004654886,1.3783799258262577,168,88,80,0,0.1595602198545883,0.31213348121094026,0.0,1.8414507433815772,0.39214953864386837,0.39214953864386837,0.0,0.31213348121094026,0,1,1,1,0.31213348121094026,0.0
7890,33,211,36,80,70,1,2154.276,70,861.683,LESS,196,936,1132,3,2,-10.0,-0.9374084606744876,10.0,0.17460757394239454,0.7072733486847207,-0.9075144036642084,150,80,70,0,-0.19945027481823535,0.0,-0.3901668515136753,-0.6275334935546156,0.27740335250860165,0.27740335250860165,-0.3901668515136753,0.0,1,0,1,1,0.0,-0.3901668515136753
7891,33,212,28,80,93,0,1635.658,30,1555.445,LESS,-448,1028,580,2,1,13.0,1.218630998876834,13.0,0.6984302957695783,-0.7849956946940304,-1.161655662486046,173,80,93,1,0.25928535726370594,0.0,0.5072169069677779,-1.2447795527886638,-0.5818587855275815,0.5818587855275815,0.5072169069677779,0.0,0,0,0,1,0.5072169069677779,0.0
7892,33,213,21,82,80,1,3600.5890000000004,30,1327.454,LESS,170,1620,1790,3,2,-2.0,-0.18748169213489754,2.0,-1.222253017596762,-0.7849956946940304,-0.1987696117935268,162,82,80,0,0.03989005496364707,0.07803337030273506,0.0,-0.6275334935546156,0.2427126450723582,0.2427126450723582,0.0,0.07803337030273506,0,0,1,1,0.07803337030273506,0.0
7893,33,214,19,50,41,1,1985.539,90,1059.813,LESS,1096,992,2088,3,2,-9.0,-0.8436676146070391,9.0,0.0,1.4534078703740962,-0.9902015328996386,91,50,41,0,-1.376206896245824,-1.170500554541026,-1.5216507209033339,-0.6275334935546156,1.4782355329939507,1.4782355329939507,-1.5216507209033339,-1.170500554541026,1,0,1,0,-1.170500554541026,-1.5216507209033339
7894,33,215,56,96,110,0,3099.15,80,922.887,LESS,194,1484,1678,4,2,14.0,1.3123718449442827,14.0,0.8730378697119728,1.0803406095294084,-0.4444925498372578,206,96,110,1,0.9174712641638826,0.6242669624218805,1.170500554541026,-0.010287434320567434,0.2747348365519675,0.2747348365519675,1.170500554541026,0.6242669624218805,1,1,1,2,1.170500554541026,0.6242669624218805
7895,33,216,23,80,85,0,2016.568,50,1222.147,LESS,-388,1098,710,2,1,5.0,0.4687042303372438,5.0,-0.6984302957695783,-0.038861173004654886,-0.974996219701904,165,80,85,1,0.09972513740911768,0.0,0.19508342575683765,-1.2447795527886638,-0.5018033068285582,0.5018033068285582,0.19508342575683765,0.0,0,0,0,1,0.19508342575683765,0.0
7896,33,217,10,60,50,1,4201.412,40,1188.568,LESS,590,1810,2400,3,2,-10.0,-0.9374084606744876,10.0,0.17460757394239454,-0.4119284338493427,0.09565501972545856,110,60,50,0,-0.9972513740911768,-0.7803337030273506,-1.170500554541026,-0.6275334935546156,0.8031009959655211,0.8031009959655211,-1.170500554541026,-0.7803337030273506,0,0,1,0,-0.7803337030273506,-1.170500554541026
7897,33,218,19,41,50,0,7393.335,30,883.9169999999998,LESS,-1052,3902,2850,4,1,9.0,0.8436676146070391,9.0,0.0,-0.7849956946940304,1.659810774601644,91,41,50,1,-1.376206896245824,-1.5216507209033339,-1.170500554541026,-0.010287434320567434,-1.3877506044310826,1.3877506044310826,-1.170500554541026,-1.5216507209033339,0,1,0,0,-1.5216507209033339,-1.170500554541026
7898,33,219,56,110,96,1,2128.968,30,1121.363,LESS,494,852,1346,3,2,-14.0,-1.3123718449442827,14.0,0.8730378697119728,-0.7849956946940304,-0.9199162234588608,206,110,96,0,0.9174712641638826,1.170500554541026,0.6242669624218805,-0.6275334935546156,0.675012230047084,0.675012230047084,0.6242669624218805,1.170500554541026,0,0,1,2,1.170500554541026,0.6242669624218805
7899,33,220,35,72,80,0,3018.356,40,1935.841,LESS,246,1418,1664,2,2,8.0,0.7499267685395902,8.0,-0.17460757394239454,-0.4119284338493427,-0.4840844823680445,152,72,80,1,-0.1595602198545883,-0.31213348121094026,0.0,-1.2447795527886638,0.3441162514244544,0.3441162514244544,0.0,-0.31213348121094026,0,0,1,1,-0.31213348121094026,0.0
7900,33,221,11,49,50,0,2593.981,60,740.2819999999998,LESS,-378,1354,976,2,1,1.0,0.09374084606744876,1.0,-1.3968605915391563,0.3342060878400329,-0.6920433204965273,99,49,50,1,-1.2166466763912356,-1.2095172396923934,-1.170500554541026,-1.2447795527886638,-0.4884607270453877,0.4884607270453877,-1.170500554541026,-1.2095172396923934,1,0,0,0,-1.2095172396923934,-1.170500554541026
7901,33,222,17,43,50,0,5548.946,10,971.147,LESS,-1638,3512,1874,4,1,7.0,0.6561859224721414,7.0,-0.34921514788478913,-1.531130216383406,0.7559945896309122,93,43,50,1,-1.3363168412821769,-1.4436173506005987,-1.170500554541026,-0.010287434320567434,-2.1696257797248766,2.1696257797248766,-1.170500554541026,-1.4436173506005987,0,1,0,0,-1.4436173506005987,-1.170500554541026
7902,33,223,1,51,50,1,3422.548,50,1339.558,LESS,364,1602,1966,5,2,-1.0,-0.09374084606744876,1.0,-1.3968605915391563,-0.038861173004654886,-0.2860160318211753,101,51,50,0,-1.1767566214275886,-1.1314838693896585,-1.170500554541026,0.6069586249134807,0.5015586928658669,0.5015586928658669,-1.170500554541026,-1.1314838693896585,0,1,1,0,-1.1314838693896585,-1.170500554541026
7903,33,224,41,112,110,1,2089.469,80,641.617,LESS,522,922,1444,3,2,-2.0,-0.18748169213489754,2.0,-1.222253017596762,1.0803406095294084,-0.9392721377969742,222,112,110,0,1.2365917038730592,1.248533924843761,1.170500554541026,-0.6275334935546156,0.7123714534399614,0.7123714534399614,1.170500554541026,1.248533924843761,1,0,1,2,1.248533924843761,1.170500554541026
7904,33,225,20,40,50,0,3026.628,70,854.097,LESS,-350,1678,1328,4,2,10.0,0.9374084606744876,10.0,0.17460757394239454,0.7072733486847207,-0.480030908267311,90,40,50,1,-1.3961519237276474,-1.5606674060547012,-1.170500554541026,-0.010287434320567434,-0.45110150365251017,0.45110150365251017,-1.170500554541026,-1.5606674060547012,1,1,0,0,-1.5606674060547012,-1.170500554541026
7905,33,226,1,50,51,0,1934.204,80,1512.009,LESS,208,952,1160,2,2,1.0,0.09374084606744876,1.0,-1.3968605915391563,1.0803406095294084,-1.0153575080520998,101,50,51,1,-1.1767566214275886,-1.170500554541026,-1.1314838693896585,-1.2447795527886638,0.2934144482484063,0.2934144482484063,-1.1314838693896585,-1.170500554541026,1,0,1,0,-1.170500554541026,-1.1314838693896585
7906,33,227,23,85,80,1,4261.328,70,662.796,LESS,884,1560,2444,5,2,-5.0,-0.4687042303372438,5.0,-0.6984302957695783,0.7072733486847207,0.12501598996476626,165,85,80,0,0.09972513740911768,0.19508342575683765,0.0,0.6069586249134807,1.1953728415907352,1.1953728415907352,0.0,0.19508342575683765,1,1,1,1,0.19508342575683765,0.0
7907,33,228,11,50,49,0,3629.222,40,1432.429,LESS,120,1598,1718,4,1,-1.0,-0.09374084606744876,1.0,-1.3968605915391563,-0.4119284338493427,-0.18473842378261,99,50,49,0,-1.2166466763912356,-1.170500554541026,-1.2095172396923934,-0.010287434320567434,0.1759997461565055,0.1759997461565055,-1.2095172396923934,-1.170500554541026,0,1,0,0,-1.170500554541026,-1.2095172396923934
7908,33,229,17,50,43,1,2831.685,80,1426.629,LESS,722,986,1708,3,2,-7.0,-0.6561859224721414,7.0,-0.34921514788478913,1.0803406095294084,-0.5755599092246738,93,50,43,0,-1.3363168412821769,-1.170500554541026,-1.4436173506005987,-0.6275334935546156,0.9792230491033723,0.9792230491033723,-1.4436173506005987,-1.170500554541026,1,0,1,0,-1.170500554541026,-1.4436173506005987
7909,33,230,21,80,82,0,4352.493,80,699.6239999999998,LESS,-98,1966,1868,5,1,2.0,0.18748169213489754,2.0,-1.222253017596762,1.0803406095294084,0.16969008122363666,162,80,82,1,0.03989005496364707,0.0,0.07803337030273506,0.6069586249134807,-0.11486849311661243,0.11486849311661243,0.07803337030273506,0.0,1,1,0,1,0.07803337030273506,0.0
7910,33,231,10,50,60,0,1522.433,70,1606.979,LESS,174,744,918,2,2,10.0,0.9374084606744876,10.0,0.17460757394239454,0.7072733486847207,-1.2171399380609444,110,50,60,1,-0.9972513740911768,-1.170500554541026,-0.7803337030273506,-1.2447795527886638,0.24804967698562644,0.24804967698562644,-0.7803337030273506,-1.170500554541026,1,0,1,0,-1.170500554541026,-0.7803337030273506
7911,33,232,3,53,50,0,2025.634,80,1162.914,LESS,-614,1342,728,2,1,-3.0,-0.28122253820234633,3.0,-1.0476454436543674,1.0803406095294084,-0.970553557371482,103,53,50,0,-1.1368665664639415,-1.0534504990869233,-1.170500554541026,-1.2447795527886638,-0.8033456099282127,0.8033456099282127,-1.170500554541026,-1.0534504990869233,1,0,0,0,-1.0534504990869233,-1.170500554541026
7912,33,233,45,122,110,1,2271.982,70,1370.944,LESS,352,950,1302,3,2,-12.0,-1.124890152809385,12.0,0.5238227218271837,0.7072733486847207,-0.8498342787728946,232,122,110,0,1.4360419786912946,1.6387007763574364,1.170500554541026,-0.6275334935546156,0.4855475971260622,0.4855475971260622,1.170500554541026,1.6387007763574364,1,0,1,2,1.6387007763574364,1.170500554541026
7913,33,234,38,67,80,0,3836.855,50,1015.503,LESS,148,1618,1766,4,1,13.0,1.218630998876834,13.0,0.6984302957695783,-0.038861173004654886,-0.08299087164798559,147,67,80,1,-0.25928535726370594,-0.5072169069677779,0.0,-0.010287434320567434,0.21335896954938302,0.21335896954938302,0.0,-0.5072169069677779,1,1,0,1,-0.5072169069677779,0.0
7914,33,235,38,80,67,1,3589.465,80,1612.5279999999998,LESS,348,1568,1916,3,2,-13.0,-1.218630998876834,13.0,0.6984302957695783,1.0803406095294084,-0.20422076729359465,147,80,67,0,-0.25928535726370594,0.0,-0.5072169069677779,-0.6275334935546156,0.480210565212794,0.480210565212794,-0.5072169069677779,0.0,1,0,1,1,0.0,-0.5072169069677779
7915,33,236,36,70,80,0,3708.714,20,1111.763,LESS,-668,2228,1560,3,1,10.0,0.9374084606744876,10.0,0.17460757394239454,-1.1580629555387183,-0.1457845175428237,150,70,80,1,-0.19945027481823535,-0.3901668515136753,0.0,-0.6275334935546156,-0.8753955407573336,0.8753955407573336,0.0,-0.3901668515136753,0,0,0,1,-0.3901668515136753,0.0
7916,33,237,45,110,122,0,6127.148,60,1516.142,LESS,460,2574,3034,6,1,12.0,1.124890152809385,12.0,0.5238227218271837,0.3342060878400329,1.0393341268882084,232,110,122,1,1.4360419786912946,1.170500554541026,1.6387007763574364,1.224204684147529,0.6296474587843041,0.6296474587843041,1.6387007763574364,1.170500554541026,1,1,1,2,1.6387007763574364,1.170500554541026
7917,33,238,42,110,115,1,8632.543,30,1365.8270000000002,LESS,-382,4318,3936,7,2,5.0,0.4687042303372438,5.0,-0.6984302957695783,-0.7849956946940304,2.267066753110088,225,110,115,1,1.2964267863185297,1.170500554541026,1.3655839802978638,1.8414507433815772,-0.4937977589586559,0.4937977589586559,1.3655839802978638,1.170500554541026,0,1,0,2,1.3655839802978638,1.170500554541026
7918,33,239,41,110,112,1,3218.693,80,837.48,LESS,332,1334,1666,3,2,2.0,0.18748169213489754,2.0,-1.222253017596762,1.0803406095294084,-0.3859122296336802,222,110,112,1,1.2365917038730592,1.170500554541026,1.248533924843761,-0.6275334935546156,0.4588624375597211,0.4588624375597211,1.248533924843761,1.170500554541026,1,0,1,2,1.248533924843761,1.170500554541026
7919,33,240,53,110,103,1,6540.174,40,900.5360000000002,LESS,-684,3446,2762,5,2,-7.0,-0.6561859224721414,7.0,-0.34921514788478913,-0.4119284338493427,1.2417315515170264,213,110,103,0,1.0570864565366473,1.170500554541026,0.8973837584814532,0.6069586249134807,-0.8967436684104064,0.8967436684104064,0.8973837584814532,1.170500554541026,0,1,0,2,1.170500554541026,0.8973837584814532
